season,match_week,date,home_team,away_team,home_goals,away_goals,result,HomeTeamPoints,AwayTeamPoints,home_win_form,home_draw_form,home_loss_form,away_win_form,away_draw_form,away_loss_form,home_position,away_position,home_points,away_points,position_gap,points_gap,month,month_sin,month_cos,home_team_label,away_team_label,h2h_home_wins,h2h_draws,h2h_away_wins,home_avg_h2h_goals,away_avg_h2h_goals,home_team_goals_for,home_team_goals_against,home_team_goal_diff,away_team_goals_for,away_team_goals_against,away_team_goal_diff,month_year
1995-1996,1,1995-08-19,Aston Villa,Man United,3,1,H,3,0,0,0,0,0,0,0,2,11,0,0,9,0,August,-0.8660254037844384,-0.5000000000000004,1,28,0,0,0,0.0,0.0,0,0,0,0,0,0,"August, 1995"
1995-1996,1,1995-08-19,Blackburn,QPR,1,0,H,3,0,0,0,0,0,0,0,3,14,0,0,11,0,August,-0.8660254037844384,-0.5000000000000004,4,34,0,0,0,0.0,0.0,0,0,0,0,0,0,"August, 1995"
1995-1996,1,1995-08-19,Chelsea,Everton,0,0,D,1,1,0,0,0,0,0,0,5,7,0,0,2,0,August,-0.8660254037844384,-0.5000000000000004,14,18,0,0,0,0.0,0.0,0,0,0,0,0,0,"August, 1995"
1995-1996,1,1995-08-19,Liverpool,Sheffield Weds,1,0,H,3,0,0,0,0,0,0,0,9,14,0,0,5,0,August,-0.8660254037844384,-0.5000000000000004,25,37,0,0,0,0.0,0.0,0,0,0,0,0,0,"August, 1995"
1995-1996,1,1995-08-19,Man City,Tottenham,1,1,D,1,1,0,0,0,0,0,0,10,15,0,0,5,0,August,-0.8660254037844384,-0.5000000000000004,27,42,0,0,0,0.0,0.0,0,0,0,0,0,0,"August, 1995"
1995-1996,1,1995-08-19,Newcastle,Coventry,3,0,H,3,0,0,0,0,0,0,0,13,10,0,0,3,0,August,-0.8660254037844384,-0.5000000000000004,30,15,0,0,0,0.0,0.0,0,0,0,0,0,0,"August, 1995"
1995-1996,1,1995-08-19,Southampton,Nott'm Forest,3,4,A,0,3,0,0,0,0,0,0,14,13,0,0,1,0,August,-0.8660254037844384,-0.5000000000000004,38,32,0,0,0,0.0,0.0,0,0,0,0,0,0,"August, 1995"
1995-1996,1,1995-08-19,West Ham,Leeds,1,2,A,0,3,0,0,0,0,0,0,14,12,0,0,2,0,August,-0.8660254037844384,-0.5000000000000004,45,23,0,0,0,0.0,0.0,0,0,0,0,0,0,"August, 1995"
1995-1996,1,1995-08-19,Wimbledon,Bolton,3,2,H,3,0,0,0,0,0,0,0,14,12,0,0,2,0,August,-0.8660254037844384,-0.5000000000000004,47,6,0,0,0,0.0,0.0,0,0,0,0,0,0,"August, 1995"
1995-1996,1,1995-08-20,Arsenal,Middlesbrough,1,1,D,1,1,0,0,0,0,0,0,12,13,0,0,1,0,August,-0.8660254037844384,-0.5000000000000004,0,29,0,0,0,0.0,0.0,0,0,0,0,0,0,"August, 1995"
1995-1996,1,1995-08-21,Leeds,Liverpool,1,0,H,3,0,1,0,0,1,0,0,5,7,3,3,2,0,August,-0.8660254037844384,-0.5000000000000004,23,25,0,0,0,0.0,0.0,2,1,1,1,0,1,"August, 1995"
1995-1996,1,1995-08-22,Bolton,Newcastle,1,3,A,0,3,0,0,1,1,0,0,15,2,0,3,13,3,August,-0.8660254037844384,-0.5000000000000004,6,30,0,0,0,0.0,0.0,2,3,-1,3,0,3,"August, 1995"
1995-1996,1,1995-08-23,Coventry,Man City,2,1,H,3,0,0,0,1,0,1,0,20,9,0,1,11,1,August,-0.8660254037844384,-0.5000000000000004,15,27,0,0,0,0.0,0.0,0,3,-3,1,1,0,"August, 1995"
1995-1996,1,1995-08-23,Everton,Arsenal,0,2,A,0,3,0,1,0,0,1,0,13,9,1,1,4,0,August,-0.8660254037844384,-0.5000000000000004,18,0,0,0,0,0.0,0.0,0,0,0,1,1,0,"August, 1995"
1995-1996,1,1995-08-23,Man United,West Ham,2,1,H,3,0,0,0,1,0,0,1,19,16,0,0,3,0,August,-0.8660254037844384,-0.5000000000000004,28,45,0,0,0,0.0,0.0,1,3,-2,1,2,-1,"August, 1995"
1995-1996,1,1995-08-23,Nott'm Forest,Chelsea,0,0,D,1,1,1,0,0,0,1,0,5,13,3,1,8,2,August,-0.8660254037844384,-0.5000000000000004,32,14,0,0,0,0.0,0.0,4,3,1,0,0,0,"August, 1995"
1995-1996,1,1995-08-23,QPR,Wimbledon,0,3,A,0,3,0,0,1,1,0,0,17,6,0,3,11,3,August,-0.8660254037844384,-0.5000000000000004,34,47,0,0,0,0.0,0.0,0,1,-1,3,2,1,"August, 1995"
1995-1996,1,1995-08-23,Sheffield Weds,Blackburn,2,1,H,3,0,0,0,1,1,0,0,17,7,0,3,10,3,August,-0.8660254037844384,-0.5000000000000004,37,4,0,0,0,0.0,0.0,0,1,-1,1,0,1,"August, 1995"
1995-1996,1,1995-08-23,Tottenham,Aston Villa,0,1,A,0,3,0,1,0,1,0,0,14,6,1,3,8,2,August,-0.8660254037844384,-0.5000000000000004,42,1,0,0,0,0.0,0.0,1,1,0,3,1,2,"August, 1995"
1995-1996,2,1995-08-26,Tottenham,Liverpool,1,3,A,0,3,0,1,1,1,0,1,17,12,1,3,5,2,August,-0.8660254037844384,-0.5000000000000004,42,25,0,0,0,0.0,0.0,1,2,-1,1,1,0,"August, 1995"
1995-1996,2,1995-08-26,QPR,Man City,1,0,H,3,0,0,0,2,0,1,1,20,16,0,1,4,1,August,-0.8660254037844384,-0.5000000000000004,34,27,0,0,0,0.0,0.0,0,4,-4,2,3,-1,"August, 1995"
1995-1996,2,1995-08-26,Nott'm Forest,West Ham,1,1,D,1,1,1,1,0,0,0,2,8,18,4,0,10,4,August,-0.8660254037844384,-0.5000000000000004,32,45,0,0,0,0.0,0.0,4,3,1,2,4,-2,"August, 1995"
1995-1996,2,1995-08-26,Middlesbrough,Chelsea,2,0,H,3,0,0,1,0,0,2,0,15,14,1,2,1,1,August,-0.8660254037844384,-0.5000000000000004,29,14,0,0,0,0.0,0.0,1,1,0,0,0,0,"August, 1995"
1995-1996,2,1995-08-26,Everton,Southampton,2,0,H,3,0,0,1,1,0,0,1,17,18,1,0,1,1,August,-0.8660254037844384,-0.5000000000000004,18,38,0,0,0,0.0,0.0,0,2,-2,3,4,-1,"August, 1995"
1995-1996,2,1995-08-26,Leeds,Aston Villa,2,0,H,3,0,2,0,0,2,0,0,4,3,6,6,1,0,August,-0.8660254037844384,-0.5000000000000004,23,1,0,0,0,0.0,0.0,3,1,2,4,1,3,"August, 1995"
1995-1996,2,1995-08-26,Coventry,Arsenal,0,0,D,1,1,1,0,1,1,1,0,12,5,3,4,7,1,August,-0.8660254037844384,-0.5000000000000004,15,0,0,0,0,0.0,0.0,2,4,-2,3,1,2,"August, 1995"
1995-1996,2,1995-08-26,Bolton,Blackburn,2,1,H,3,0,0,0,2,1,0,1,19,7,0,3,12,3,August,-0.8660254037844384,-0.5000000000000004,6,4,0,0,0,0.0,0.0,3,6,-3,2,2,0,"August, 1995"
1995-1996,2,1995-08-26,Man United,Wimbledon,3,1,H,3,0,1,0,1,2,0,0,12,3,3,6,9,3,August,-0.8660254037844384,-0.5000000000000004,28,47,0,0,0,0.0,0.0,3,4,-1,6,2,4,"August, 1995"
1995-1996,2,1995-08-27,Sheffield Weds,Newcastle,0,2,A,0,3,1,0,1,2,0,0,12,2,3,6,10,3,August,-0.8660254037844384,-0.5000000000000004,37,30,0,0,0,0.0,0.0,2,2,0,6,1,5,"August, 1995"
1995-1996,2,1995-08-28,Blackburn,Man United,1,2,A,0,3,1,0,2,2,0,1,12,5,3,6,7,3,August,-0.8660254037844384,-0.5000000000000004,4,28,0,0,0,0.0,0.0,3,4,-1,6,5,1,"August, 1995"
1995-1996,2,1995-08-29,Arsenal,Nott'm Forest,1,1,D,1,1,1,2,0,1,2,0,7,8,5,5,1,0,August,-0.8660254037844384,-0.5000000000000004,0,32,0,0,0,0.0,0.0,3,1,2,5,4,1,"August, 1995"
1995-1996,2,1995-08-30,Wimbledon,Sheffield Weds,2,2,D,1,1,2,0,1,1,0,2,7,14,6,3,7,3,August,-0.8660254037844384,-0.5000000000000004,47,37,0,0,0,0.0,0.0,7,5,2,2,4,-2,"August, 1995"
1995-1996,2,1995-08-30,West Ham,Tottenham,1,1,D,1,1,0,1,2,0,1,2,17,19,1,1,2,0,August,-0.8660254037844384,-0.5000000000000004,45,42,0,0,0,0.0,0.0,3,5,-2,2,5,-3,"August, 1995"
1995-1996,2,1995-08-30,Southampton,Leeds,1,1,D,1,1,0,0,2,3,0,0,20,2,0,9,18,9,August,-0.8660254037844384,-0.5000000000000004,38,23,0,0,0,0.0,0.0,3,6,-3,5,1,4,"August, 1995"
1995-1996,2,1995-08-30,Newcastle,Middlesbrough,1,0,H,3,0,3,0,0,1,1,0,1,11,9,4,10,5,August,-0.8660254037844384,-0.5000000000000004,30,29,0,0,0,0.0,0.0,8,1,7,3,1,2,"August, 1995"
1995-1996,2,1995-08-30,Liverpool,QPR,1,0,H,3,0,2,0,1,1,0,2,7,16,6,3,9,3,August,-0.8660254037844384,-0.5000000000000004,25,34,0,0,0,0.0,0.0,4,2,2,1,4,-3,"August, 1995"
1995-1996,2,1995-08-30,Chelsea,Coventry,2,2,D,1,1,0,2,1,1,1,1,16,11,2,4,5,2,August,-0.8660254037844384,-0.5000000000000004,14,15,0,0,0,0.0,0.0,0,2,-2,2,4,-2,"August, 1995"
1995-1996,2,1995-08-30,Aston Villa,Bolton,1,0,H,3,0,2,0,1,1,0,2,8,12,6,3,4,3,August,-0.8660254037844384,-0.5000000000000004,1,6,0,0,0,0.0,0.0,4,3,1,5,7,-2,"August, 1995"
1995-1996,2,1995-08-30,Man City,Everton,0,2,A,0,3,0,1,2,1,1,1,18,11,1,4,7,3,August,-0.8660254037844384,-0.5000000000000004,27,18,0,0,0,0.0,0.0,2,4,-2,2,2,0,"August, 1995"
1995-1996,3,1995-09-09,Southampton,Newcastle,1,0,H,3,0,0,1,2,4,0,0,19,1,1,12,18,11,September,-1.0,-1.8369701987210287e-16,38,30,0,0,0,0.0,0.0,4,7,-3,9,1,8,"September, 1995"
1995-1996,3,1995-09-09,Wimbledon,Liverpool,1,0,H,3,0,2,1,1,3,0,1,6,5,7,9,1,2,September,-1.0,-1.8369701987210287e-16,47,25,0,0,0,0.0,0.0,9,7,2,5,2,3,"September, 1995"
1995-1996,3,1995-09-09,Tottenham,Leeds,2,1,H,3,0,0,2,2,3,1,0,19,3,2,10,16,8,September,-1.0,-1.8369701987210287e-16,42,23,0,0,0,0.0,0.0,3,6,-3,6,2,4,"September, 1995"
1995-1996,3,1995-09-09,QPR,Sheffield Weds,0,3,A,0,3,1,0,3,1,1,2,16,13,3,4,3,1,September,-1.0,-1.8369701987210287e-16,34,37,0,0,0,0.0,0.0,1,5,-4,4,6,-2,"September, 1995"
1995-1996,3,1995-09-09,Coventry,Nott'm Forest,1,1,D,1,1,1,2,1,1,3,0,11,9,5,6,2,1,September,-1.0,-1.8369701987210287e-16,15,32,0,0,0,0.0,0.0,4,6,-2,6,5,1,"September, 1995"
1995-1996,3,1995-09-09,Everton,Man United,2,3,A,0,3,2,1,1,3,0,1,7,5,7,9,2,2,September,-1.0,-1.8369701987210287e-16,18,28,0,0,0,0.0,0.0,4,2,2,8,6,2,"September, 1995"
1995-1996,3,1995-09-09,Bolton,Middlesbrough,1,1,D,1,1,1,0,3,1,1,1,15,11,3,4,4,1,September,-1.0,-1.8369701987210287e-16,6,29,0,0,0,0.0,0.0,5,8,-3,3,2,1,"September, 1995"
1995-1996,3,1995-09-09,Blackburn,Aston Villa,1,1,D,1,1,1,0,3,3,0,1,13,5,3,9,8,6,September,-1.0,-1.8369701987210287e-16,4,1,0,0,0,0.0,0.0,4,6,-2,5,3,2,"September, 1995"
1995-1996,3,1995-09-10,Man City,Arsenal,0,1,A,0,3,0,1,3,1,3,0,20,10,1,6,10,5,September,-1.0,-1.8369701987210287e-16,27,0,0,0,0,0.0,0.0,2,6,-4,4,2,2,"September, 1995"
1995-1996,3,1995-09-11,West Ham,Chelsea,1,3,A,0,3,0,2,2,0,3,1,19,17,2,3,2,1,September,-1.0,-1.8369701987210287e-16,45,14,0,0,0,0.0,0.0,4,6,-2,2,4,-2,"September, 1995"
1995-1996,3,1995-09-12,Middlesbrough,Southampton,0,0,D,1,1,1,2,1,1,1,2,13,16,5,4,3,1,September,-1.0,-1.8369701987210287e-16,29,38,0,0,0,0.0,0.0,4,3,1,5,7,-2,"September, 1995"
1995-1996,4,1995-09-16,Sheffield Weds,Tottenham,1,3,A,0,3,2,1,2,1,2,2,11,15,7,5,4,2,September,-1.0,-1.8369701987210287e-16,37,42,0,0,0,0.0,0.0,7,6,1,5,7,-2,"September, 1995"
1995-1996,4,1995-09-16,Newcastle,Man City,3,1,H,3,0,4,0,1,0,1,4,3,20,12,1,17,11,September,-1.0,-1.8369701987210287e-16,30,27,0,0,0,0.0,0.0,9,2,7,2,7,-5,"September, 1995"
1995-1996,4,1995-09-16,Middlesbrough,Coventry,2,1,H,3,0,1,3,1,1,3,1,12,13,6,6,1,0,September,-1.0,-1.8369701987210287e-16,29,15,0,0,0,0.0,0.0,4,3,1,5,7,-2,"September, 1995"
1995-1996,4,1995-09-16,Man United,Bolton,3,0,H,3,0,4,0,1,1,1,3,5,17,12,4,12,8,September,-1.0,-1.8369701987210287e-16,28,6,0,0,0,0.0,0.0,11,8,3,6,9,-3,"September, 1995"
1995-1996,4,1995-09-16,Leeds,QPR,1,3,A,0,3,3,1,1,1,0,4,5,18,10,3,13,7,September,-1.0,-1.8369701987210287e-16,23,34,0,0,0,0.0,0.0,7,4,3,1,8,-7,"September, 1995"
1995-1996,4,1995-09-16,Chelsea,Southampton,3,0,H,3,0,1,3,1,1,2,2,12,14,6,5,2,1,September,-1.0,-1.8369701987210287e-16,14,38,0,0,0,0.0,0.0,5,5,0,5,7,-2,"September, 1995"
1995-1996,4,1995-09-16,Aston Villa,Wimbledon,2,0,H,3,0,3,1,1,3,1,1,6,4,10,10,2,0,September,-1.0,-1.8369701987210287e-16,1,47,0,0,0,0.0,0.0,6,4,2,10,7,3,"September, 1995"
1995-1996,4,1995-09-16,Arsenal,West Ham,1,0,H,3,0,2,3,0,0,2,3,6,19,9,2,13,7,September,-1.0,-1.8369701987210287e-16,0,45,0,0,0,0.0,0.0,5,2,3,5,9,-4,"September, 1995"
1995-1996,4,1995-09-16,Liverpool,Blackburn,3,0,H,3,0,3,0,2,1,1,3,8,17,9,4,9,5,September,-1.0,-1.8369701987210287e-16,25,4,0,0,0,0.0,0.0,5,3,2,5,7,-2,"September, 1995"
1995-1996,4,1995-09-17,Nott'm Forest,Everton,3,2,H,3,0,1,4,0,2,1,2,11,12,7,7,1,0,September,-1.0,-1.8369701987210287e-16,32,18,0,0,0,0.0,0.0,7,6,1,6,5,1,"September, 1995"
1995-1996,5,1995-09-23,Sheffield Weds,Man United,0,0,D,1,1,2,1,2,5,0,0,14,3,7,15,11,8,September,-1.0,-1.8369701987210287e-16,37,28,0,0,0,0.0,0.0,8,9,-1,14,8,6,"September, 1995"
1995-1996,5,1995-09-23,Wimbledon,Leeds,2,4,A,0,3,2,1,2,2,1,2,8,9,10,10,1,0,September,-1.0,-1.8369701987210287e-16,47,23,0,0,0,0.0,0.0,10,9,1,8,7,1,"September, 1995"
1995-1996,5,1995-09-23,West Ham,Everton,2,1,H,3,0,0,2,3,2,0,3,19,13,2,7,6,5,September,-1.0,-1.8369701987210287e-16,45,18,0,0,0,0.0,0.0,5,10,-5,8,8,0,"September, 1995"
1995-1996,5,1995-09-23,Liverpool,Bolton,5,2,H,3,0,3,0,2,1,1,3,5,18,12,4,13,8,September,-1.0,-1.8369701987210287e-16,25,6,0,0,0,0.0,0.0,8,3,5,6,12,-6,"September, 1995"
1995-1996,5,1995-09-23,Aston Villa,Nott'm Forest,1,1,D,1,1,3,1,1,1,4,0,4,6,13,10,2,3,September,-1.0,-1.8369701987210287e-16,1,32,0,0,0,0.0,0.0,8,4,4,10,8,2,"September, 1995"
1995-1996,5,1995-09-23,Blackburn,Coventry,5,1,H,3,0,0,1,4,1,3,1,17,14,4,6,3,2,September,-1.0,-1.8369701987210287e-16,4,15,0,0,0,0.0,0.0,5,10,-5,6,9,-3,"September, 1995"
1995-1996,5,1995-09-23,Arsenal,Southampton,4,2,H,3,0,3,2,0,1,2,2,5,16,12,5,11,7,September,-1.0,-1.8369701987210287e-16,0,38,0,0,0,0.0,0.0,6,2,4,5,10,-5,"September, 1995"
1995-1996,5,1995-09-23,Man City,Middlesbrough,0,1,A,0,3,0,0,5,2,2,1,20,10,1,9,10,8,September,-1.0,-1.8369701987210287e-16,27,29,0,0,0,0.0,0.0,3,10,-7,6,4,2,"September, 1995"
1995-1996,5,1995-09-24,Newcastle,Chelsea,2,0,H,3,0,4,0,1,2,2,1,2,10,15,9,8,6,September,-1.0,-1.8369701987210287e-16,30,14,0,0,0,0.0,0.0,12,3,9,8,5,3,"September, 1995"
1995-1996,5,1995-09-25,QPR,Tottenham,2,3,A,0,3,2,0,3,2,1,2,15,11,6,8,4,2,September,-1.0,-1.8369701987210287e-16,34,42,0,0,0,0.0,0.0,4,9,-5,8,8,0,"September, 1995"
1995-1996,6,1995-09-30,Bolton,QPR,0,1,A,0,3,1,1,3,2,0,3,19,15,4,6,4,2,September,-1.0,-1.8369701987210287e-16,6,34,0,0,0,0.0,0.0,8,17,-9,6,12,-6,"September, 1995"
1995-1996,6,1995-09-30,Chelsea,Arsenal,1,0,H,3,0,2,1,2,3,2,0,11,4,9,15,7,6,September,-1.0,-1.8369701987210287e-16,14,0,0,0,0,0.0,0.0,8,7,1,10,4,6,"September, 1995"
1995-1996,6,1995-09-30,Coventry,Aston Villa,0,3,A,0,3,0,3,2,2,2,1,16,5,6,14,11,8,September,-1.0,-1.8369701987210287e-16,15,1,0,0,0,0.0,0.0,7,14,-7,9,5,4,"September, 1995"
1995-1996,6,1995-09-30,Leeds,Sheffield Weds,2,0,H,3,0,2,1,2,1,2,2,6,13,13,8,7,5,September,-1.0,-1.8369701987210287e-16,23,37,0,0,0,0.0,0.0,12,9,3,8,9,-1,"September, 1995"
1995-1996,6,1995-09-30,Middlesbrough,Blackburn,2,0,H,3,0,2,2,1,1,1,3,7,14,12,7,7,5,September,-1.0,-1.8369701987210287e-16,29,4,0,0,0,0.0,0.0,7,4,3,10,11,-1,"September, 1995"
1995-1996,6,1995-09-30,Nott'm Forest,Man City,3,0,H,3,0,1,4,0,0,0,5,9,20,11,1,11,10,September,-1.0,-1.8369701987210287e-16,32,27,0,0,0,0.0,0.0,11,9,2,3,11,-8,"September, 1995"
1995-1996,6,1995-09-30,Tottenham,Wimbledon,3,1,H,3,0,3,1,1,1,1,3,10,11,11,10,1,1,September,-1.0,-1.8369701987210287e-16,42,47,0,0,0,0.0,0.0,11,10,1,12,13,-1,"September, 1995"
1995-1996,6,1995-10-01,Man United,Liverpool,2,2,D,1,1,4,1,0,4,0,1,3,5,16,15,2,1,October,-0.8660254037844386,0.5,28,25,0,0,0,0.0,0.0,14,8,6,13,5,8,"October, 1995"
1995-1996,6,1995-10-01,Everton,Newcastle,1,3,A,0,3,2,0,3,4,0,1,14,1,7,18,13,11,October,-0.8660254037844386,0.5,18,30,0,0,0,0.0,0.0,9,10,-1,14,3,11,"October, 1995"
1995-1996,6,1995-10-02,Southampton,West Ham,0,0,D,1,1,1,2,2,1,2,2,18,17,5,5,1,0,October,-0.8660254037844386,0.5,38,45,0,0,0,0.0,0.0,7,14,-7,7,11,-4,"October, 1995"
1995-1996,7,1995-10-14,QPR,Newcastle,2,3,A,0,3,2,0,3,4,0,1,13,1,9,21,12,12,October,-0.8660254037844386,0.5,34,30,0,0,0,0.0,0.0,7,12,-5,17,4,13,"October, 1995"
1995-1996,7,1995-10-14,Tottenham,Nott'm Forest,0,1,A,0,3,4,1,0,2,3,0,10,9,14,14,1,0,October,-0.8660254037844386,0.5,42,32,0,0,0,0.0,0.0,14,11,3,14,9,5,"October, 1995"
1995-1996,7,1995-10-14,Liverpool,Coventry,0,0,D,1,1,3,1,1,0,2,3,5,18,16,6,13,10,October,-0.8660254037844386,0.5,25,15,0,0,0,0.0,0.0,15,7,8,7,17,-10,"October, 1995"
1995-1996,7,1995-10-14,Man United,Man City,1,0,H,3,0,3,2,0,0,0,5,4,20,17,1,16,16,October,-0.8660254037844386,0.5,28,27,0,0,0,0.0,0.0,16,10,6,3,14,-11,"October, 1995"
1995-1996,7,1995-10-14,Bolton,Everton,1,1,D,1,1,0,1,4,1,0,4,19,15,4,7,4,3,October,-0.8660254037844386,0.5,6,18,0,0,0,0.0,0.0,8,18,-10,10,13,-3,"October, 1995"
1995-1996,7,1995-10-14,Leeds,Arsenal,0,3,A,0,3,2,1,2,3,1,1,5,6,16,15,1,1,October,-0.8660254037844386,0.5,23,0,0,0,0,0.0,0.0,14,9,5,10,5,5,"October, 1995"
1995-1996,7,1995-10-14,Blackburn,Southampton,2,1,H,3,0,1,1,3,1,2,2,14,17,7,6,3,1,October,-0.8660254037844386,0.5,4,38,0,0,0,0.0,0.0,10,13,-3,7,14,-7,"October, 1995"
1995-1996,7,1995-10-14,Aston Villa,Chelsea,0,1,A,0,3,3,2,0,3,1,1,2,10,17,12,8,5,October,-0.8660254037844386,0.5,1,14,0,0,0,0.0,0.0,12,5,7,9,7,2,"October, 1995"
1995-1996,7,1995-10-15,Sheffield Weds,Middlesbrough,0,1,A,0,3,1,2,2,3,2,0,15,8,8,15,7,7,October,-0.8660254037844386,0.5,37,29,0,0,0,0.0,0.0,8,11,-3,9,4,5,"October, 1995"
1995-1996,7,1995-10-16,Wimbledon,West Ham,0,1,A,0,3,1,1,3,1,2,2,12,17,10,6,5,4,October,-0.8660254037844386,0.5,47,45,0,0,0,0.0,0.0,13,16,-3,7,11,-4,"October, 1995"
1995-1996,8,1995-10-21,West Ham,Blackburn,1,1,D,1,1,2,1,2,2,1,2,14,12,9,10,2,1,October,-0.8660254037844386,0.5,45,4,0,0,0,0.0,0.0,8,11,-3,12,14,-2,"October, 1995"
1995-1996,8,1995-10-21,Nott'm Forest,Bolton,3,2,H,3,0,3,2,0,0,2,3,6,19,17,5,13,12,October,-0.8660254037844386,0.5,32,6,0,0,0,0.0,0.0,15,9,6,9,19,-10,"October, 1995"
1995-1996,8,1995-10-21,Newcastle,Wimbledon,6,1,H,3,0,4,0,1,1,0,4,1,13,24,10,12,14,October,-0.8660254037844386,0.5,30,47,0,0,0,0.0,0.0,20,6,14,13,17,-4,"October, 1995"
1995-1996,8,1995-10-21,Middlesbrough,QPR,1,0,H,3,0,4,1,0,2,0,3,4,15,18,9,11,9,October,-0.8660254037844386,0.5,29,34,0,0,0,0.0,0.0,10,4,6,9,15,-6,"October, 1995"
1995-1996,8,1995-10-21,Man City,Leeds,0,0,D,1,1,0,0,5,2,0,3,20,8,1,16,12,15,October,-0.8660254037844386,0.5,27,23,0,0,0,0.0,0.0,3,15,-12,14,12,2,"October, 1995"
1995-1996,8,1995-10-21,Coventry,Sheffield Weds,0,1,A,0,3,0,2,3,1,1,3,17,16,7,8,1,1,October,-0.8660254037844386,0.5,15,37,0,0,0,0.0,0.0,7,17,-10,8,12,-4,"October, 1995"
1995-1996,8,1995-10-21,Chelsea,Man United,1,4,A,0,3,4,0,1,3,2,0,9,3,15,20,6,5,October,-0.8660254037844386,0.5,14,28,0,0,0,0.0,0.0,10,7,3,17,10,7,"October, 1995"
1995-1996,8,1995-10-21,Arsenal,Aston Villa,2,0,H,3,0,4,0,1,2,2,1,3,7,18,17,4,1,October,-0.8660254037844386,0.5,0,1,0,0,0,0.0,0.0,13,5,8,12,6,6,"October, 1995"
1995-1996,8,1995-10-22,Everton,Tottenham,1,1,D,1,1,0,1,4,4,0,1,16,10,8,14,6,6,October,-0.8660254037844386,0.5,18,42,0,0,0,0.0,0.0,11,14,-3,14,12,2,"October, 1995"
1995-1996,8,1995-10-22,Southampton,Liverpool,1,3,A,0,3,0,2,3,2,2,1,18,6,6,17,12,11,October,-0.8660254037844386,0.5,38,25,0,0,0,0.0,0.0,8,16,-8,15,7,8,"October, 1995"
1995-1996,9,1995-10-28,Wimbledon,Southampton,1,2,A,0,3,0,0,5,0,1,4,15,18,10,6,3,4,October,-0.8660254037844386,0.5,47,38,0,0,0,0.0,0.0,14,23,-9,9,19,-10,"October, 1995"
1995-1996,9,1995-10-28,Sheffield Weds,West Ham,0,1,A,0,3,1,1,3,2,2,1,12,13,11,10,1,1,October,-0.8660254037844386,0.5,37,45,0,0,0,0.0,0.0,9,12,-3,9,12,-3,"October, 1995"
1995-1996,9,1995-10-28,QPR,Nott'm Forest,1,1,D,1,1,2,0,3,4,1,0,16,6,9,20,10,11,October,-0.8660254037844386,0.5,34,32,0,0,0,0.0,0.0,9,16,-7,18,11,7,"October, 1995"
1995-1996,9,1995-10-28,Man United,Middlesbrough,2,0,H,3,0,3,2,0,5,0,0,3,5,23,21,2,2,October,-0.8660254037844386,0.5,28,29,0,0,0,0.0,0.0,21,11,10,11,4,7,"October, 1995"
1995-1996,9,1995-10-28,Leeds,Coventry,3,1,H,3,0,2,1,2,0,1,4,8,17,17,7,9,10,October,-0.8660254037844386,0.5,23,15,0,0,0,0.0,0.0,14,12,2,7,18,-11,"October, 1995"
1995-1996,9,1995-10-28,Blackburn,Chelsea,3,0,H,3,0,2,1,2,3,0,2,11,10,11,15,1,4,October,-0.8660254037844386,0.5,4,14,0,0,0,0.0,0.0,13,15,-2,11,11,0,"October, 1995"
1995-1996,9,1995-10-28,Aston Villa,Everton,1,0,H,3,0,2,1,2,0,2,3,7,15,17,9,8,8,October,-0.8660254037844386,0.5,1,18,0,0,0,0.0,0.0,12,8,4,12,15,-3,"October, 1995"
1995-1996,9,1995-10-28,Liverpool,Man City,6,0,H,3,0,3,2,0,0,1,4,5,20,20,2,15,18,October,-0.8660254037844386,0.5,25,27,0,0,0,0.0,0.0,18,8,10,3,15,-12,"October, 1995"
1995-1996,9,1995-10-29,Tottenham,Newcastle,1,1,D,1,1,3,1,1,5,0,0,9,1,15,27,8,12,October,-0.8660254037844386,0.5,42,30,0,0,0,0.0,0.0,15,13,2,26,7,19,"October, 1995"
1995-1996,9,1995-10-30,Bolton,Arsenal,1,0,H,3,0,0,1,4,4,0,1,19,4,5,21,15,16,October,-0.8660254037844386,0.5,6,0,0,0,0,0.0,0.0,11,22,-11,15,5,10,"October, 1995"
1995-1996,10,1995-11-04,Middlesbrough,Leeds,1,1,D,1,1,4,0,1,3,1,1,6,8,21,20,2,1,November,-0.5000000000000004,0.8660254037844384,29,23,0,0,0,0.0,0.0,11,6,5,17,13,4,"November, 1995"
1995-1996,10,1995-11-04,West Ham,Aston Villa,1,4,A,0,3,3,2,0,2,1,2,12,8,13,20,4,7,November,-0.5000000000000004,0.8660254037844384,45,1,0,0,0,0.0,0.0,10,12,-2,13,8,5,"November, 1995"
1995-1996,10,1995-11-04,Southampton,QPR,2,0,H,3,0,1,1,3,1,1,3,17,14,9,10,3,1,November,-0.5000000000000004,0.8660254037844384,38,34,0,0,0,0.0,0.0,11,20,-9,10,17,-7,"November, 1995"
1995-1996,10,1995-11-04,Newcastle,Liverpool,2,1,H,3,0,4,1,0,3,2,0,1,4,28,23,3,5,November,-0.5000000000000004,0.8660254037844384,30,25,0,0,0,0.0,0.0,27,8,19,24,8,16,"November, 1995"
1995-1996,10,1995-11-04,Coventry,Tottenham,2,3,A,0,3,0,1,4,2,2,1,19,9,7,16,10,9,November,-0.5000000000000004,0.8660254037844384,15,42,0,0,0,0.0,0.0,8,21,-13,16,14,2,"November, 1995"
1995-1996,10,1995-11-04,Chelsea,Sheffield Weds,0,0,D,1,1,2,0,3,1,1,3,10,13,15,11,3,4,November,-0.5000000000000004,0.8660254037844384,14,37,0,0,0,0.0,0.0,11,14,-3,9,13,-4,"November, 1995"
1995-1996,10,1995-11-04,Arsenal,Man United,1,0,H,3,0,3,0,2,3,2,0,4,2,21,26,2,5,November,-0.5000000000000004,0.8660254037844384,0,28,0,0,0,0.0,0.0,15,6,9,23,11,12,"November, 1995"
1995-1996,10,1995-11-04,Man City,Bolton,1,0,H,3,0,0,1,4,1,1,3,20,18,2,8,2,6,November,-0.5000000000000004,0.8660254037844384,27,6,0,0,0,0.0,0.0,3,21,-18,12,22,-10,"November, 1995"
1995-1996,10,1995-11-05,Everton,Blackburn,1,0,H,3,0,0,2,3,3,1,1,17,11,9,14,6,5,November,-0.5000000000000004,0.8660254037844384,18,4,0,0,0,0.0,0.0,12,16,-4,16,15,1,"November, 1995"
1995-1996,10,1995-11-06,Nott'm Forest,Wimbledon,4,1,H,3,0,3,2,0,0,0,5,7,17,21,10,10,11,November,-0.5000000000000004,0.8660254037844384,32,47,0,0,0,0.0,0.0,19,12,7,15,25,-10,"November, 1995"
1995-1996,10,1995-11-08,Newcastle,Blackburn,1,0,H,3,0,4,1,0,2,1,2,1,11,31,14,10,17,November,-0.5000000000000004,0.8660254037844384,30,4,0,0,0,0.0,0.0,29,9,20,16,16,0,"November, 1995"
1995-1996,11,1995-11-18,Wimbledon,Middlesbrough,0,0,D,1,1,0,0,5,3,1,1,17,8,10,22,9,12,November,-0.5000000000000004,0.8660254037844384,47,29,0,0,0,0.0,0.0,16,29,-13,12,7,5,"November, 1995"
1995-1996,11,1995-11-18,Man United,Southampton,4,1,H,3,0,3,1,1,2,1,2,2,15,26,12,13,14,November,-0.5000000000000004,0.8660254037844384,28,38,0,0,0,0.0,0.0,23,12,11,13,20,-7,"November, 1995"
1995-1996,11,1995-11-18,Tottenham,Arsenal,2,1,H,3,0,2,2,1,3,0,2,9,3,19,24,6,5,November,-0.5000000000000004,0.8660254037844384,42,0,0,0,0,0.0,0.0,19,16,3,16,6,10,"November, 1995"
1995-1996,11,1995-11-18,Liverpool,Everton,1,2,A,0,3,2,2,1,1,2,2,7,13,23,12,6,11,November,-0.5000000000000004,0.8660254037844384,25,18,0,0,0,0.0,0.0,25,10,15,13,16,-3,"November, 1995"
1995-1996,11,1995-11-18,Sheffield Weds,Man City,1,1,D,1,1,1,1,3,1,1,3,14,20,12,5,6,7,November,-0.5000000000000004,0.8660254037844384,37,27,0,0,0,0.0,0.0,9,13,-4,4,21,-17,"November, 1995"
1995-1996,11,1995-11-18,Bolton,West Ham,0,3,A,0,3,1,1,3,2,2,1,18,12,8,13,6,5,November,-0.5000000000000004,0.8660254037844384,6,45,0,0,0,0.0,0.0,12,23,-11,11,16,-5,"November, 1995"
1995-1996,11,1995-11-18,Blackburn,Nott'm Forest,7,0,H,3,0,2,1,2,4,1,0,11,3,14,24,8,10,November,-0.5000000000000004,0.8660254037844384,4,32,0,0,0,0.0,0.0,16,17,-1,23,13,10,"November, 1995"
1995-1996,11,1995-11-18,Aston Villa,Newcastle,1,1,D,1,1,3,0,2,4,1,0,6,1,23,34,5,11,November,-0.5000000000000004,0.8660254037844384,1,30,0,0,0,0.0,0.0,17,9,8,30,9,21,"November, 1995"
1995-1996,11,1995-11-18,Leeds,Chelsea,1,0,H,3,0,2,2,1,2,1,2,8,12,21,16,4,5,November,-0.5000000000000004,0.8660254037844384,23,14,0,0,0,0.0,0.0,18,14,4,11,14,-3,"November, 1995"
1995-1996,11,1995-11-19,QPR,Coventry,1,1,D,1,1,1,1,3,0,1,4,17,19,10,7,2,3,November,-0.5000000000000004,0.8660254037844384,34,15,0,0,0,0.0,0.0,10,19,-9,10,24,-14,"November, 1995"
1995-1996,11,1995-11-20,Southampton,Aston Villa,0,1,A,0,3,2,0,3,2,1,2,15,4,12,24,11,12,November,-0.5000000000000004,0.8660254037844384,38,1,0,0,0,0.0,0.0,14,24,-10,18,10,8,"November, 1995"
1995-1996,11,1995-11-21,Arsenal,Sheffield Weds,4,2,H,3,0,3,0,2,1,2,2,4,14,24,13,10,11,November,-0.5000000000000004,0.8660254037844384,0,37,0,0,0,0.0,0.0,17,8,9,10,14,-4,"November, 1995"
1995-1996,11,1995-11-21,Middlesbrough,Tottenham,0,1,A,0,3,2,2,1,2,2,1,8,9,23,22,1,1,November,-0.5000000000000004,0.8660254037844384,29,42,0,0,0,0.0,0.0,12,7,5,21,17,4,"November, 1995"
1995-1996,11,1995-11-22,West Ham,Liverpool,0,0,D,1,1,3,1,1,2,1,2,13,8,16,23,5,7,November,-0.5000000000000004,0.8660254037844384,45,25,0,0,0,0.0,0.0,14,16,-2,26,12,14,"November, 1995"
1995-1996,11,1995-11-22,Man City,Wimbledon,1,0,H,3,0,1,2,2,0,1,4,20,17,6,11,3,5,November,-0.5000000000000004,0.8660254037844384,27,47,0,0,0,0.0,0.0,5,22,-17,16,29,-13,"November, 1995"
1995-1996,11,1995-11-22,Everton,QPR,2,0,H,3,0,2,2,1,0,2,3,13,16,15,11,3,4,November,-0.5000000000000004,0.8660254037844384,18,34,0,0,0,0.0,0.0,15,17,-2,11,20,-9,"November, 1995"
1995-1996,11,1995-11-22,Coventry,Man United,0,4,A,0,3,0,2,3,4,0,1,18,2,8,29,16,21,November,-0.5000000000000004,0.8660254037844384,15,28,0,0,0,0.0,0.0,11,25,-14,27,13,14,"November, 1995"
1995-1996,11,1995-11-22,Chelsea,Bolton,3,2,H,3,0,1,1,3,1,1,3,12,18,16,8,6,8,November,-0.5000000000000004,0.8660254037844384,14,6,0,0,0,0.0,0.0,11,15,-4,12,26,-14,"November, 1995"
1995-1996,12,1995-11-25,Chelsea,Tottenham,0,0,D,1,1,1,1,3,3,2,0,10,5,19,25,5,6,November,-0.5000000000000004,0.8660254037844384,14,42,0,0,0,0.0,0.0,14,17,-3,22,17,5,"November, 1995"
1995-1996,12,1995-11-25,Coventry,Wimbledon,3,3,D,1,1,0,1,4,0,1,4,20,17,8,11,3,3,November,-0.5000000000000004,0.8660254037844384,15,47,0,0,0,0.0,0.0,11,29,-18,16,30,-14,"November, 1995"
1995-1996,12,1995-11-25,Everton,Sheffield Weds,2,2,D,1,1,3,1,1,1,2,2,11,14,18,13,3,5,November,-0.5000000000000004,0.8660254037844384,18,37,0,0,0,0.0,0.0,17,17,0,12,18,-6,"November, 1995"
1995-1996,12,1995-11-25,Man City,Aston Villa,1,0,H,3,0,2,2,1,3,1,1,18,4,9,27,14,18,November,-0.5000000000000004,0.8660254037844384,27,1,0,0,0,0.0,0.0,6,22,-16,19,10,9,"November, 1995"
1995-1996,12,1995-11-25,Middlesbrough,Liverpool,2,1,H,3,0,1,2,2,2,1,2,9,6,23,24,3,1,November,-0.5000000000000004,0.8660254037844384,29,25,0,0,0,0.0,0.0,12,8,4,26,12,14,"November, 1995"
1995-1996,12,1995-11-25,Newcastle,Leeds,2,1,H,3,0,3,2,0,2,2,1,1,8,35,24,7,11,November,-0.5000000000000004,0.8660254037844384,30,23,0,0,0,0.0,0.0,31,10,21,19,14,5,"November, 1995"
1995-1996,12,1995-11-25,Southampton,Bolton,1,0,H,3,0,2,0,3,1,0,4,15,20,12,8,5,4,November,-0.5000000000000004,0.8660254037844384,38,6,0,0,0,0.0,0.0,14,25,-11,14,29,-15,"November, 1995"
1995-1996,12,1995-11-25,West Ham,QPR,1,0,H,3,0,2,2,1,0,2,3,13,18,17,11,5,6,November,-0.5000000000000004,0.8660254037844384,45,34,0,0,0,0.0,0.0,14,16,-2,11,22,-11,"November, 1995"
1995-1996,12,1995-11-26,Arsenal,Blackburn,0,0,D,1,1,3,0,2,2,1,2,3,13,27,17,10,10,November,-0.5000000000000004,0.8660254037844384,0,4,0,0,0,0.0,0.0,21,10,11,23,17,6,"November, 1995"
1995-1996,12,1995-11-27,Nott'm Forest,Man United,1,1,D,1,1,3,1,1,4,0,1,9,2,24,32,7,8,November,-0.5000000000000004,0.8660254037844384,32,28,0,0,0,0.0,0.0,23,20,3,31,13,18,"November, 1995"
1995-1996,13,1995-12-02,Aston Villa,Arsenal,1,1,D,1,1,3,1,1,2,1,2,4,3,27,28,1,1,December,-2.4492935982947064e-16,1.0,1,0,0,0,1,0.0,2.0,19,11,8,21,10,11,"December, 1995"
1995-1996,13,1995-12-02,Blackburn,West Ham,4,2,H,3,0,2,1,2,3,1,1,13,10,18,20,3,2,December,-2.4492935982947064e-16,1.0,4,45,0,1,0,1.0,1.0,23,17,6,15,16,-1,"December, 1995"
1995-1996,13,1995-12-02,Bolton,Nott'm Forest,1,1,D,1,1,1,0,4,2,2,1,20,7,8,25,13,17,December,-2.4492935982947064e-16,1.0,6,32,0,0,1,2.0,3.0,14,30,-16,24,21,3,"December, 1995"
1995-1996,13,1995-12-02,Leeds,Man City,0,1,A,0,3,2,2,1,3,1,1,9,17,24,12,8,12,December,-2.4492935982947064e-16,1.0,23,27,0,1,0,0.0,0.0,20,16,4,7,22,-15,"December, 1995"
1995-1996,13,1995-12-02,Liverpool,Southampton,1,1,D,1,1,1,1,3,3,0,2,8,14,24,15,6,9,December,-2.4492935982947064e-16,1.0,25,38,1,0,0,3.0,1.0,27,14,13,15,25,-10,"December, 1995"
1995-1996,13,1995-12-02,Man United,Chelsea,1,1,D,1,1,3,1,1,1,2,2,2,12,33,20,10,13,December,-2.4492935982947064e-16,1.0,28,14,1,0,0,4.0,1.0,32,14,18,14,17,-3,"December, 1995"
1995-1996,13,1995-12-02,QPR,Middlesbrough,1,1,D,1,1,0,2,3,1,2,2,18,6,11,26,12,15,December,-2.4492935982947064e-16,1.0,34,29,0,0,1,0.0,1.0,11,23,-12,14,9,5,"December, 1995"
1995-1996,13,1995-12-02,Tottenham,Everton,0,0,D,1,1,3,2,0,3,1,1,6,13,26,19,7,7,December,-2.4492935982947064e-16,1.0,42,18,0,1,0,1.0,1.0,22,17,5,19,19,0,"December, 1995"
1995-1996,13,1995-12-03,Wimbledon,Newcastle,3,3,D,1,1,0,2,3,3,2,0,18,1,12,38,17,26,December,-2.4492935982947064e-16,1.0,47,30,0,0,1,1.0,6.0,19,33,-14,33,11,22,"December, 1995"
1995-1996,13,1995-12-04,Sheffield Weds,Coventry,4,3,H,3,0,0,3,2,0,2,3,16,20,14,9,4,5,December,-2.4492935982947064e-16,1.0,37,15,1,0,0,1.0,0.0,14,20,-6,14,32,-18,"December, 1995"
1995-1996,14,1995-12-09,Tottenham,QPR,1,0,H,3,0,3,2,0,0,2,3,7,18,27,12,11,15,December,-2.4492935982947064e-16,1.0,42,34,1,0,0,3.0,2.0,22,17,5,12,24,-12,"December, 1995"
1995-1996,14,1995-12-09,Southampton,Arsenal,0,0,D,1,1,2,1,2,2,2,1,15,4,16,29,11,13,December,-2.4492935982947064e-16,1.0,38,0,0,0,1,2.0,4.0,16,26,-10,22,11,11,"December, 1995"
1995-1996,14,1995-12-09,Middlesbrough,Man City,4,1,H,3,0,1,3,1,4,1,0,7,16,27,15,9,12,December,-2.4492935982947064e-16,1.0,29,27,1,0,0,1.0,0.0,15,10,5,8,22,-14,"December, 1995"
1995-1996,14,1995-12-09,Man United,Sheffield Weds,2,2,D,1,1,2,2,1,1,3,1,2,14,34,17,12,17,December,-2.4492935982947064e-16,1.0,28,37,0,1,0,0.0,0.0,33,15,18,18,23,-5,"December, 1995"
1995-1996,14,1995-12-09,Chelsea,Newcastle,1,0,H,3,0,1,3,1,3,2,0,11,1,21,39,10,18,December,-2.4492935982947064e-16,1.0,14,30,0,0,1,0.0,2.0,15,18,-3,36,14,22,"December, 1995"
1995-1996,14,1995-12-09,Coventry,Blackburn,5,0,H,3,0,0,2,3,2,1,2,20,11,9,21,9,12,December,-2.4492935982947064e-16,1.0,15,4,0,0,1,1.0,5.0,17,36,-19,27,19,8,"December, 1995"
1995-1996,14,1995-12-09,Bolton,Liverpool,0,1,A,0,3,0,1,4,0,2,3,19,8,9,25,11,16,December,-2.4492935982947064e-16,1.0,6,25,0,0,1,2.0,5.0,15,31,-16,28,15,13,"December, 1995"
1995-1996,14,1995-12-09,Leeds,Wimbledon,1,1,D,1,1,2,1,2,0,3,2,9,17,24,13,8,11,December,-2.4492935982947064e-16,1.0,23,47,1,0,0,4.0,2.0,20,17,3,22,36,-14,"December, 1995"
1995-1996,14,1995-12-10,Nott'm Forest,Aston Villa,1,1,D,1,1,1,3,1,2,2,1,8,7,26,28,1,2,December,-2.4492935982947064e-16,1.0,32,1,0,1,0,1.0,1.0,25,22,3,20,12,8,"December, 1995"
1995-1996,14,1995-12-11,Everton,West Ham,3,0,H,3,0,3,2,0,2,1,2,12,13,20,20,1,0,December,-2.4492935982947064e-16,1.0,18,45,0,0,1,1.0,2.0,19,19,0,17,20,-3,"December, 1995"
1995-1996,15,1995-12-16,Sheffield Weds,Leeds,6,2,H,3,0,1,3,1,1,2,2,14,9,18,25,5,7,December,-2.4492935982947064e-16,1.0,37,23,0,0,1,0.0,2.0,20,25,-5,21,18,3,"December, 1995"
1995-1996,15,1995-12-16,West Ham,Southampton,2,1,H,3,0,2,1,2,1,2,2,14,15,20,17,1,3,December,-2.4492935982947064e-16,1.0,45,38,0,1,0,0.0,0.0,17,23,-6,16,26,-10,"December, 1995"
1995-1996,15,1995-12-16,QPR,Bolton,2,1,H,3,0,0,2,3,0,1,4,18,20,12,9,2,3,December,-2.4492935982947064e-16,1.0,34,6,1,0,0,1.0,0.0,12,25,-13,15,32,-17,"December, 1995"
1995-1996,15,1995-12-16,Wimbledon,Tottenham,0,1,A,0,3,0,4,1,3,2,0,18,6,14,30,12,16,December,-2.4492935982947064e-16,1.0,47,42,0,0,1,1.0,3.0,23,37,-14,23,17,6,"December, 1995"
1995-1996,15,1995-12-16,Blackburn,Middlesbrough,1,0,H,3,0,2,1,2,2,2,1,12,5,21,30,7,9,December,-2.4492935982947064e-16,1.0,4,29,0,0,1,0.0,2.0,27,24,3,19,11,8,"December, 1995"
1995-1996,15,1995-12-16,Aston Villa,Coventry,4,1,H,3,0,1,3,1,1,2,2,6,19,29,12,13,17,December,-2.4492935982947064e-16,1.0,1,15,1,0,0,3.0,0.0,21,13,8,22,36,-14,"December, 1995"
1995-1996,15,1995-12-16,Arsenal,Chelsea,1,1,D,1,1,1,3,1,2,2,1,3,10,30,24,7,6,December,-2.4492935982947064e-16,1.0,0,14,0,0,1,0.0,1.0,22,11,11,16,18,-2,"December, 1995"
1995-1996,15,1995-12-16,Newcastle,Everton,1,0,H,3,0,2,2,1,3,2,0,1,12,39,23,11,16,December,-2.4492935982947064e-16,1.0,30,18,1,0,0,3.0,1.0,36,15,21,22,19,3,"December, 1995"
1995-1996,15,1995-12-17,Liverpool,Man United,2,0,H,3,0,1,2,2,2,3,0,7,2,28,35,5,7,December,-2.4492935982947064e-16,1.0,25,28,0,1,0,2.0,2.0,29,15,14,35,17,18,"December, 1995"
1995-1996,15,1995-12-18,Man City,Nott'm Forest,1,1,D,1,1,3,1,1,1,3,1,17,8,15,27,9,12,December,-2.4492935982947064e-16,1.0,27,32,0,0,1,0.0,3.0,9,26,-17,26,23,3,"December, 1995"
1995-1996,16,1995-12-23,Wimbledon,Blackburn,1,1,D,1,1,0,3,2,3,1,1,19,11,14,24,8,10,December,-2.4492935982947064e-16,1.0,47,4,0,0,0,0.0,0.0,23,38,-15,28,24,4,"December, 1995"
1995-1996,16,1995-12-23,Tottenham,Bolton,2,2,D,1,1,3,2,0,0,1,4,5,20,33,9,15,24,December,-2.4492935982947064e-16,1.0,42,6,0,0,0,0.0,0.0,24,17,7,16,34,-18,"December, 1995"
1995-1996,16,1995-12-23,Sheffield Weds,Southampton,2,2,D,1,1,2,2,1,1,2,2,14,16,21,17,2,4,December,-2.4492935982947064e-16,1.0,37,38,0,0,0,0.0,0.0,26,27,-1,17,28,-11,"December, 1995"
1995-1996,16,1995-12-23,Newcastle,Nott'm Forest,3,1,H,3,0,2,2,1,0,4,1,1,8,42,28,7,14,December,-2.4492935982947064e-16,1.0,30,32,0,0,0,0.0,0.0,37,15,22,27,24,3,"December, 1995"
1995-1996,16,1995-12-23,QPR,Aston Villa,1,0,H,3,0,1,1,3,2,2,1,17,6,15,32,11,17,December,-2.4492935982947064e-16,1.0,34,1,0,0,0,0.0,0.0,14,26,-12,25,14,11,"December, 1995"
1995-1996,16,1995-12-23,Man City,Chelsea,0,1,A,0,3,3,1,1,2,3,0,16,10,16,25,6,9,December,-2.4492935982947064e-16,1.0,27,14,0,0,0,0.0,0.0,10,27,-17,17,19,-2,"December, 1995"
1995-1996,16,1995-12-23,Liverpool,Arsenal,3,1,H,3,0,2,2,1,1,4,0,5,6,31,31,1,0,December,-2.4492935982947064e-16,1.0,25,0,0,0,0,0.0,0.0,31,15,16,23,12,11,"December, 1995"
1995-1996,16,1995-12-23,Coventry,Everton,2,1,H,3,0,1,1,3,2,2,1,19,12,12,23,7,11,December,-2.4492935982947064e-16,1.0,15,18,0,0,0,0.0,0.0,23,40,-17,22,20,2,"December, 1995"
1995-1996,16,1995-12-23,Middlesbrough,West Ham,4,2,H,3,0,2,1,2,2,1,2,7,13,30,23,6,7,December,-2.4492935982947064e-16,1.0,29,45,0,0,0,0.0,0.0,19,12,7,19,24,-5,"December, 1995"
1995-1996,16,1995-12-24,Leeds,Man United,3,1,H,3,0,1,1,3,1,3,1,11,2,25,35,9,10,December,-2.4492935982947064e-16,1.0,23,28,0,0,0,0.0,0.0,23,24,-1,35,19,16,"December, 1995"
1995-1996,17,1995-12-26,Southampton,Tottenham,0,0,D,1,1,1,3,1,2,3,0,15,5,18,34,10,16,December,-2.4492935982947064e-16,1.0,38,42,0,0,0,0.0,0.0,19,30,-11,26,19,7,"December, 1995"
1995-1996,17,1995-12-26,Arsenal,QPR,3,0,H,3,0,0,4,1,2,1,2,7,16,31,18,9,13,December,-2.4492935982947064e-16,1.0,0,34,0,0,0,0.0,0.0,24,15,9,15,26,-11,"December, 1995"
1995-1996,17,1995-12-26,Blackburn,Man City,2,0,H,3,0,2,2,1,2,1,2,11,17,25,16,6,9,December,-2.4492935982947064e-16,1.0,4,27,0,0,0,0.0,0.0,29,25,4,10,28,-18,"December, 1995"
1995-1996,17,1995-12-26,Chelsea,Wimbledon,1,2,A,0,3,2,3,0,0,4,1,11,18,28,15,7,13,December,-2.4492935982947064e-16,1.0,14,47,0,0,0,0.0,0.0,18,19,-1,24,39,-15,"December, 1995"
1995-1996,17,1995-12-26,Everton,Middlesbrough,4,0,H,3,0,1,2,2,3,1,1,12,6,23,33,6,10,December,-2.4492935982947064e-16,1.0,18,29,0,0,0,0.0,0.0,23,22,1,23,14,9,"December, 1995"
1995-1996,17,1995-12-26,Nott'm Forest,Sheffield Weds,1,0,H,3,0,0,4,1,2,3,0,9,14,28,22,5,6,December,-2.4492935982947064e-16,1.0,32,37,0,0,0,0.0,0.0,28,27,1,28,29,-1,"December, 1995"
1995-1996,17,1995-12-27,Man United,Newcastle,2,0,H,3,0,0,3,2,3,1,1,2,1,35,45,1,10,December,-2.4492935982947064e-16,1.0,28,30,0,0,0,0.0,0.0,36,22,14,40,16,24,"December, 1995"
1995-1996,17,1995-12-27,Bolton,Leeds,0,2,A,0,3,0,2,3,1,1,3,20,10,10,28,10,18,December,-2.4492935982947064e-16,1.0,6,23,0,0,0,0.0,0.0,18,36,-18,26,25,1,"December, 1995"
1995-1996,18,1995-12-30,Arsenal,Wimbledon,1,3,A,0,3,1,3,1,1,3,1,5,16,34,18,11,16,December,-2.4492935982947064e-16,1.0,0,47,0,0,0,0.0,0.0,27,15,12,26,40,-14,"December, 1995"
1995-1996,18,1995-12-30,Blackburn,Tottenham,2,1,H,3,0,3,1,1,2,3,0,10,3,28,35,7,7,December,-2.4492935982947064e-16,1.0,4,42,0,0,0,0.0,0.0,31,25,6,26,19,7,"December, 1995"
1995-1996,18,1995-12-30,Bolton,Coventry,1,2,A,0,3,0,2,3,2,1,2,20,19,10,15,1,5,December,-2.4492935982947064e-16,1.0,6,15,0,0,0,0.0,0.0,18,38,-20,25,41,-16,"December, 1995"
1995-1996,18,1995-12-30,Chelsea,Liverpool,2,2,D,1,1,2,2,1,3,1,1,11,4,28,34,7,6,December,-2.4492935982947064e-16,1.0,14,25,0,0,0,0.0,0.0,19,21,-2,34,16,18,"December, 1995"
1995-1996,18,1995-12-30,Everton,Leeds,2,0,H,3,0,2,1,2,2,1,2,12,9,26,31,3,5,December,-2.4492935982947064e-16,1.0,18,23,0,0,0,0.0,0.0,27,22,5,28,25,3,"December, 1995"
1995-1996,18,1995-12-30,Man United,QPR,2,1,H,3,0,1,2,2,2,1,2,2,17,38,18,15,20,December,-2.4492935982947064e-16,1.0,28,34,0,0,0,0.0,0.0,38,22,16,15,29,-14,"December, 1995"
1995-1996,18,1995-12-30,Nott'm Forest,Middlesbrough,1,0,H,3,0,1,3,1,2,1,2,9,6,31,33,3,2,December,-2.4492935982947064e-16,1.0,32,29,0,0,0,0.0,0.0,29,27,2,23,18,5,"December, 1995"
1995-1996,19,1996-01-01,Wimbledon,Everton,2,3,A,0,3,2,2,1,3,0,2,15,11,21,29,4,8,January,0.4999999999999999,0.8660254037844387,47,18,0,0,0,0.0,0.0,29,41,-12,29,22,7,"January, 1996"
1995-1996,19,1996-01-01,Tottenham,Man United,4,1,H,3,0,2,2,1,2,1,2,5,2,35,41,3,6,January,0.4999999999999999,0.8660254037844387,42,28,0,0,0,0.0,0.0,27,21,6,40,23,17,"January, 1996"
1995-1996,19,1996-01-01,Sheffield Weds,Bolton,4,2,H,3,0,2,2,1,0,1,4,14,20,22,10,6,12,January,0.4999999999999999,0.8660254037844387,37,6,0,0,0,0.0,0.0,28,30,-2,19,40,-21,"January, 1996"
1995-1996,19,1996-01-01,Middlesbrough,Aston Villa,0,2,A,0,3,2,0,3,1,2,2,7,8,33,32,1,1,January,0.4999999999999999,0.8660254037844387,29,1,0,0,0,0.0,0.0,23,19,4,25,15,10,"January, 1996"
1995-1996,19,1996-01-01,Man City,West Ham,2,1,H,3,0,1,1,3,2,0,3,19,13,16,23,6,7,January,0.4999999999999999,0.8660254037844387,27,45,0,0,0,0.0,0.0,10,30,-20,21,28,-7,"January, 1996"
1995-1996,19,1996-01-01,Liverpool,Nott'm Forest,4,2,H,3,0,3,2,0,2,2,1,3,6,35,34,3,1,January,0.4999999999999999,0.8660254037844387,25,32,0,0,0,0.0,0.0,36,18,18,30,27,3,"January, 1996"
1995-1996,19,1996-01-01,Leeds,Blackburn,0,0,D,1,1,2,1,2,3,1,1,10,9,31,31,1,0,January,0.4999999999999999,0.8660254037844387,23,4,0,0,0,0.0,0.0,28,27,1,33,26,7,"January, 1996"
1995-1996,19,1996-01-01,Coventry,Southampton,1,1,D,1,1,3,0,2,0,4,1,17,16,18,19,1,1,January,0.4999999999999999,0.8660254037844387,15,38,0,0,0,0.0,0.0,27,42,-15,19,30,-11,"January, 1996"
1995-1996,19,1996-01-02,Newcastle,Arsenal,2,0,H,3,0,2,1,2,1,2,2,1,6,45,34,5,11,January,0.4999999999999999,0.8660254037844387,30,0,0,0,0,0.0,0.0,40,18,22,28,18,10,"January, 1996"
1995-1996,19,1996-01-02,QPR,Chelsea,1,2,A,0,3,2,0,3,2,2,1,19,12,18,29,7,11,January,0.4999999999999999,0.8660254037844387,34,14,0,0,0,0.0,0.0,16,31,-15,21,23,-2,"January, 1996"
1995-1996,20,1996-01-13,Tottenham,Man City,1,0,H,3,0,2,2,1,1,1,3,4,18,38,19,14,19,January,0.4999999999999999,0.8660254037844387,42,27,0,1,0,1.0,1.0,31,22,9,12,31,-19,"January, 1996"
1995-1996,20,1996-01-13,Sheffield Weds,Liverpool,1,1,D,1,1,2,2,1,4,1,0,13,3,25,38,10,13,January,0.4999999999999999,0.8660254037844387,37,25,0,0,1,0.0,1.0,32,32,0,40,20,20,"January, 1996"
1995-1996,20,1996-01-13,QPR,Blackburn,0,1,A,0,3,2,0,3,3,2,0,19,12,18,32,7,14,January,0.4999999999999999,0.8660254037844387,34,4,0,0,1,0.0,1.0,17,33,-16,33,26,7,"January, 1996"
1995-1996,20,1996-01-13,Middlesbrough,Arsenal,2,3,A,0,3,1,0,4,1,1,3,10,7,33,34,3,1,January,0.4999999999999999,0.8660254037844387,29,0,0,1,0,1.0,1.0,23,21,2,28,20,8,"January, 1996"
1995-1996,20,1996-01-13,Nott'm Forest,Southampton,1,0,H,3,0,2,1,2,0,4,1,8,16,34,20,8,14,January,0.4999999999999999,0.8660254037844387,32,38,1,0,0,4.0,3.0,32,31,1,20,31,-11,"January, 1996"
1995-1996,20,1996-01-13,Man United,Aston Villa,0,0,D,1,1,2,0,3,2,2,1,2,5,41,35,3,6,January,0.4999999999999999,0.8660254037844387,28,1,0,0,1,1.0,3.0,41,27,14,27,15,12,"January, 1996"
1995-1996,20,1996-01-13,Leeds,West Ham,2,0,H,3,0,2,1,2,1,0,4,12,14,32,23,2,9,January,0.4999999999999999,0.8660254037844387,23,45,1,0,0,2.0,1.0,28,27,1,22,30,-8,"January, 1996"
1995-1996,20,1996-01-13,Everton,Chelsea,1,1,D,1,1,3,0,2,2,2,1,9,12,32,32,3,0,January,0.4999999999999999,0.8660254037844387,18,14,0,1,0,0.0,0.0,32,24,8,23,24,-1,"January, 1996"
1995-1996,20,1996-01-13,Bolton,Wimbledon,1,0,H,3,0,0,1,4,2,1,2,20,15,10,21,5,11,January,0.4999999999999999,0.8660254037844387,6,47,0,0,1,2.0,3.0,21,44,-23,31,44,-13,"January, 1996"
1995-1996,20,1996-01-14,Coventry,Newcastle,0,1,A,0,3,3,1,1,3,0,2,17,1,19,48,16,29,January,0.4999999999999999,0.8660254037844387,15,30,0,0,1,0.0,3.0,28,43,-15,42,18,24,"January, 1996"
1995-1996,21,1996-01-20,Wimbledon,QPR,2,1,H,3,0,2,1,2,1,0,4,16,19,21,18,3,3,January,0.4999999999999999,0.8660254037844387,47,34,1,0,0,3.0,0.0,31,45,-14,17,34,-17,"January, 1996"
1995-1996,21,1996-01-20,Newcastle,Bolton,2,1,H,3,0,4,0,1,1,1,3,1,20,51,13,19,38,January,0.4999999999999999,0.8660254037844387,30,6,1,0,0,3.0,1.0,43,18,25,22,44,-22,"January, 1996"
1995-1996,21,1996-01-20,Man City,Coventry,1,1,D,1,1,1,1,3,2,1,2,18,17,19,19,1,0,January,0.4999999999999999,0.8660254037844387,27,15,0,0,1,1.0,2.0,12,32,-20,28,44,-16,"January, 1996"
1995-1996,21,1996-01-20,Southampton,Middlesbrough,2,1,H,3,0,0,3,2,1,0,4,16,12,20,33,4,13,January,0.4999999999999999,0.8660254037844387,38,29,0,1,0,0.0,0.0,20,32,-12,25,24,1,"January, 1996"
1995-1996,21,1996-01-20,Chelsea,Nott'm Forest,1,0,H,3,0,2,2,1,3,0,2,12,7,33,37,5,4,January,0.4999999999999999,0.8660254037844387,14,32,0,1,0,0.0,0.0,24,25,-1,33,31,2,"January, 1996"
1995-1996,21,1996-01-20,Blackburn,Sheffield Weds,3,0,H,3,0,3,2,0,2,2,1,9,13,35,26,4,9,January,0.4999999999999999,0.8660254037844387,4,37,0,0,1,1.0,2.0,34,26,8,33,33,0,"January, 1996"
1995-1996,21,1996-01-20,Arsenal,Everton,1,2,A,0,3,2,0,3,3,1,1,5,10,37,33,5,4,January,0.4999999999999999,0.8660254037844387,0,18,1,0,0,2.0,0.0,31,22,9,33,25,8,"January, 1996"
1995-1996,21,1996-01-20,Liverpool,Leeds,5,0,H,3,0,3,2,0,3,1,1,4,11,39,35,7,4,January,0.4999999999999999,0.8660254037844387,25,23,0,0,1,0.0,1.0,41,21,20,30,27,3,"January, 1996"
1995-1996,21,1996-01-21,Aston Villa,Tottenham,2,1,H,3,0,2,2,1,2,2,1,8,4,36,41,4,5,January,0.4999999999999999,0.8660254037844387,1,42,1,0,0,1.0,0.0,27,15,12,32,22,10,"January, 1996"
1995-1996,21,1996-01-23,West Ham,Man United,0,1,A,0,3,1,0,4,2,1,2,15,3,23,42,12,19,January,0.4999999999999999,0.8660254037844387,45,28,0,0,1,1.0,2.0,22,32,-10,41,27,14,"January, 1996"
1995-1996,22,1996-01-31,Aston Villa,Liverpool,0,2,A,0,3,3,1,1,3,2,0,5,3,39,42,2,3,January,0.4999999999999999,0.8660254037844387,1,25,0,0,0,0.0,0.0,29,16,13,46,21,25,"January, 1996"
1995-1996,22,1996-01-31,Nott'm Forest,Leeds,2,1,H,3,0,3,0,2,2,1,2,8,11,37,35,3,2,January,0.4999999999999999,0.8660254037844387,32,23,0,0,0,0.0,0.0,33,32,1,30,32,-2,"January, 1996"
1995-1996,22,1996-01-31,Southampton,Man City,1,1,D,1,1,1,3,1,1,1,3,15,18,23,20,3,3,January,0.4999999999999999,0.8660254037844387,38,27,0,0,0,0.0,0.0,22,33,-11,13,33,-20,"January, 1996"
1995-1996,22,1996-01-31,West Ham,Coventry,3,2,H,3,0,1,0,4,2,2,1,16,18,23,20,2,3,January,0.4999999999999999,0.8660254037844387,45,15,0,0,0,0.0,0.0,22,33,-11,29,45,-16,"January, 1996"
1995-1996,23,1996-02-03,Newcastle,Sheffield Weds,2,0,H,3,0,4,0,1,1,2,2,1,13,54,26,12,28,February,0.8660254037844386,0.5000000000000001,30,37,1,0,0,2.0,0.0,45,19,26,33,36,-3,"February, 1996"
1995-1996,23,1996-02-03,Wimbledon,Man United,2,4,A,0,3,3,0,2,3,1,1,16,3,24,45,13,21,February,0.8660254037844386,0.5000000000000001,47,28,0,0,1,1.0,3.0,33,46,-13,42,27,15,"February, 1996"
1995-1996,23,1996-02-03,West Ham,Nott'm Forest,1,0,H,3,0,1,0,4,3,0,2,14,7,26,40,7,14,February,0.8660254037844386,0.5000000000000001,45,32,0,1,0,1.0,1.0,25,35,-10,35,33,2,"February, 1996"
1995-1996,23,1996-02-03,Southampton,Everton,2,2,D,1,1,1,3,1,4,1,0,15,9,24,36,6,12,February,0.8660254037844386,0.5000000000000001,38,18,0,0,1,0.0,2.0,23,34,-11,35,26,9,"February, 1996"
1995-1996,23,1996-02-03,Man City,QPR,2,0,H,3,0,1,2,2,0,0,5,18,19,21,18,1,3,February,0.8660254037844386,0.5000000000000001,27,34,0,0,1,0.0,1.0,14,34,-20,18,36,-18,"February, 1996"
1995-1996,23,1996-02-03,Blackburn,Bolton,3,1,H,3,0,4,1,0,1,0,4,7,20,38,13,13,25,February,0.8660254037844386,0.5000000000000001,4,6,0,0,1,1.0,2.0,37,26,11,23,46,-23,"February, 1996"
1995-1996,23,1996-02-03,Aston Villa,Leeds,3,0,H,3,0,2,1,2,1,1,3,6,11,39,35,5,4,February,0.8660254037844386,0.5000000000000001,1,23,0,0,1,0.0,2.0,29,18,11,31,34,-3,"February, 1996"
1995-1996,23,1996-02-03,Arsenal,Coventry,1,1,D,1,1,2,0,3,1,2,2,8,18,37,20,10,17,February,0.8660254037844386,0.5000000000000001,0,15,0,1,0,0.0,0.0,32,24,8,31,48,-17,"February, 1996"
1995-1996,23,1996-02-03,Liverpool,Tottenham,0,0,D,1,1,3,2,0,2,1,2,2,6,45,41,4,4,February,0.8660254037844386,0.5000000000000001,25,42,1,0,0,3.0,1.0,48,21,27,33,24,9,"February, 1996"
1995-1996,23,1996-02-04,Chelsea,Middlesbrough,5,0,H,3,0,2,2,1,0,0,5,10,12,36,33,2,3,February,0.8660254037844386,0.5000000000000001,14,29,0,0,1,0.0,2.0,25,25,0,26,26,0,"February, 1996"
1995-1996,24,1996-02-10,Nott'm Forest,Arsenal,0,1,A,0,3,2,0,3,1,1,3,8,10,40,38,2,2,February,0.8660254037844386,0.5000000000000001,32,0,0,1,0,1.0,1.0,35,34,1,33,25,8,"February, 1996"
1995-1996,24,1996-02-10,Bolton,Aston Villa,0,2,A,0,3,1,0,4,3,1,1,20,4,13,42,16,29,February,0.8660254037844386,0.5000000000000001,6,1,0,0,1,0.0,1.0,24,49,-25,32,18,14,"February, 1996"
1995-1996,24,1996-02-10,Coventry,Chelsea,1,0,H,3,0,0,3,2,3,2,0,18,8,21,39,10,18,February,0.8660254037844386,0.5000000000000001,15,14,0,1,0,2.0,2.0,32,49,-17,30,25,5,"February, 1996"
1995-1996,24,1996-02-10,Everton,Man City,2,0,H,3,0,3,2,0,2,2,1,10,18,37,24,8,13,February,0.8660254037844386,0.5000000000000001,18,27,1,0,0,2.0,0.0,37,28,9,16,34,-18,"February, 1996"
1995-1996,24,1996-02-10,Man United,Blackburn,1,0,H,3,0,3,1,1,4,1,0,2,6,48,41,4,7,February,0.8660254037844386,0.5000000000000001,28,4,1,0,0,2.0,1.0,46,29,17,40,27,13,"February, 1996"
1995-1996,24,1996-02-10,Middlesbrough,Newcastle,1,2,A,0,3,0,0,5,4,0,1,12,1,33,57,11,24,February,0.8660254037844386,0.5000000000000001,29,30,0,0,1,0.0,1.0,26,31,-5,47,19,28,"February, 1996"
1995-1996,24,1996-02-10,Sheffield Weds,Wimbledon,2,1,H,3,0,1,1,3,2,0,3,14,16,26,24,2,2,February,0.8660254037844386,0.5000000000000001,37,47,0,1,0,2.0,2.0,33,38,-5,35,50,-15,"February, 1996"
1995-1996,24,1996-02-11,QPR,Liverpool,1,2,A,0,3,0,0,5,3,2,0,19,3,18,46,16,28,February,0.8660254037844386,0.5000000000000001,34,25,0,0,1,0.0,1.0,18,38,-20,48,21,27,"February, 1996"
1995-1996,24,1996-02-12,Tottenham,West Ham,0,1,A,0,3,2,1,2,2,0,3,5,14,42,29,9,13,February,0.8660254037844386,0.5000000000000001,42,45,0,1,0,1.0,1.0,33,24,9,26,35,-9,"February, 1996"
1995-1996,25,1996-02-17,Chelsea,West Ham,1,2,A,0,3,3,1,1,3,0,2,10,13,39,32,3,7,February,0.8660254037844386,0.5000000000000001,14,45,1,0,0,3.0,1.0,30,26,4,27,35,-8,"February, 1996"
1995-1996,25,1996-02-17,Middlesbrough,Bolton,1,4,A,0,3,0,0,5,1,0,4,13,20,33,13,7,20,February,0.8660254037844386,0.5000000000000001,29,6,0,1,0,1.0,1.0,27,33,-6,24,51,-27,"February, 1996"
1995-1996,25,1996-02-17,Sheffield Weds,QPR,1,3,A,0,3,2,1,2,0,0,5,14,19,29,18,5,11,February,0.8660254037844386,0.5000000000000001,37,34,1,0,0,3.0,0.0,35,39,-4,19,40,-21,"February, 1996"
1995-1996,25,1996-02-21,West Ham,Newcastle,2,0,H,3,0,4,0,1,5,0,0,12,1,35,60,11,25,February,0.8660254037844386,0.5000000000000001,45,30,0,0,0,0.0,0.0,29,36,-7,49,20,29,"February, 1996"
1995-1996,25,1996-02-21,Man United,Everton,2,0,H,3,0,3,1,1,3,2,0,2,8,51,40,6,11,February,0.8660254037844386,0.5000000000000001,28,18,1,0,0,3.0,2.0,47,29,18,39,28,11,"February, 1996"
1995-1996,26,1996-02-24,Wimbledon,Aston Villa,3,3,D,1,1,1,0,4,3,1,1,18,4,24,45,14,21,February,0.8660254037844386,0.5000000000000001,47,1,0,0,1,0.0,2.0,36,52,-16,34,18,16,"February, 1996"
1995-1996,26,1996-02-24,Tottenham,Sheffield Weds,1,0,H,3,0,2,1,2,1,1,3,6,14,42,29,8,13,February,0.8660254037844386,0.5000000000000001,42,37,1,0,0,3.0,1.0,33,25,8,36,42,-6,"February, 1996"
1995-1996,26,1996-02-24,West Ham,Arsenal,0,1,A,0,3,5,0,0,2,1,2,11,9,38,41,2,3,February,0.8660254037844386,0.5000000000000001,45,0,0,0,1,0.0,1.0,31,36,-5,34,25,9,"February, 1996"
1995-1996,26,1996-02-24,Southampton,Chelsea,2,3,A,0,3,1,3,1,2,1,2,15,10,25,39,5,14,February,0.8660254037844386,0.5000000000000001,38,14,0,0,1,0.0,3.0,25,36,-11,31,28,3,"February, 1996"
1995-1996,26,1996-02-24,Coventry,Middlesbrough,0,0,D,1,1,1,2,2,0,0,5,17,13,24,33,4,9,February,0.8660254037844386,0.5000000000000001,15,29,0,0,1,1.0,2.0,33,49,-16,28,37,-9,"February, 1996"
1995-1996,26,1996-02-24,Everton,Nott'm Forest,3,0,H,3,0,2,2,1,2,0,3,8,9,40,40,1,0,February,0.8660254037844386,0.5000000000000001,18,32,0,0,1,2.0,3.0,39,30,9,35,35,0,"February, 1996"
1995-1996,26,1996-02-24,Blackburn,Liverpool,2,3,A,0,3,3,1,1,3,2,0,6,3,41,49,3,8,February,0.8660254037844386,0.5000000000000001,4,25,0,0,1,0.0,3.0,40,28,12,50,22,28,"February, 1996"
1995-1996,26,1996-02-24,Man City,Newcastle,3,3,D,1,1,1,2,2,4,0,1,18,1,24,60,17,36,February,0.8660254037844386,0.5000000000000001,27,30,0,0,1,1.0,3.0,16,36,-20,49,22,27,"February, 1996"
1995-1996,26,1996-02-25,Bolton,Man United,0,6,A,0,3,2,0,3,4,1,0,20,2,16,54,18,38,February,0.8660254037844386,0.5000000000000001,6,28,0,0,1,0.0,3.0,28,52,-24,49,29,20,"February, 1996"
1995-1996,26,1996-02-28,Aston Villa,Blackburn,2,0,H,3,0,3,1,1,3,0,2,4,9,46,41,5,5,February,0.8660254037844386,0.5000000000000001,1,4,0,1,0,1.0,1.0,37,21,16,42,31,11,"February, 1996"
1995-1996,27,1996-03-02,Wimbledon,Chelsea,1,1,D,1,1,1,1,3,3,0,2,18,10,25,42,8,17,March,1.0,6.123233995736766e-17,47,14,1,0,0,2.0,1.0,39,55,-16,34,30,4,"March, 1996"
1995-1996,27,1996-03-02,Tottenham,Southampton,1,0,H,3,0,2,1,2,1,2,2,7,17,45,25,10,20,March,1.0,6.123233995736766e-17,42,38,0,1,0,0.0,0.0,34,25,9,27,39,-12,"March, 1996"
1995-1996,27,1996-03-02,Sheffield Weds,Nott'm Forest,1,3,A,0,3,1,0,4,1,0,4,14,10,29,40,4,11,March,1.0,6.123233995736766e-17,37,32,0,0,1,0.0,1.0,36,43,-7,35,38,-3,"March, 1996"
1995-1996,27,1996-03-02,QPR,Arsenal,1,1,D,1,1,1,0,4,3,1,1,19,7,21,44,12,23,March,1.0,6.123233995736766e-17,34,0,0,0,1,0.0,3.0,22,41,-19,35,25,10,"March, 1996"
1995-1996,27,1996-03-02,Man City,Blackburn,1,1,D,1,1,1,3,1,2,0,3,18,9,25,41,9,16,March,1.0,6.123233995736766e-17,27,4,0,0,1,0.0,2.0,19,39,-20,42,33,9,"March, 1996"
1995-1996,27,1996-03-02,Leeds,Bolton,0,1,A,0,3,1,1,3,1,0,4,12,20,35,16,8,19,March,1.0,6.123233995736766e-17,23,6,1,0,0,2.0,0.0,31,37,-6,28,58,-30,"March, 1996"
1995-1996,27,1996-03-02,Coventry,West Ham,2,2,D,1,1,1,3,1,4,0,1,17,11,25,38,6,13,March,1.0,6.123233995736766e-17,15,45,0,0,1,2.0,3.0,33,49,-16,31,37,-6,"March, 1996"
1995-1996,27,1996-03-02,Middlesbrough,Everton,0,2,A,0,3,0,1,4,3,1,1,13,7,34,43,6,9,March,1.0,6.123233995736766e-17,29,18,0,0,1,0.0,4.0,28,37,-9,42,30,12,"March, 1996"
1995-1996,27,1996-03-03,Liverpool,Aston Villa,3,0,H,3,0,4,1,0,3,1,1,3,4,52,49,1,3,March,1.0,6.123233995736766e-17,25,1,1,0,0,2.0,0.0,53,24,29,39,21,18,"March, 1996"
1995-1996,27,1996-03-04,Newcastle,Man United,0,1,A,0,3,3,1,1,5,0,0,1,2,61,57,1,4,March,1.0,6.123233995736766e-17,30,28,0,0,1,0.0,2.0,52,25,27,55,29,26,"March, 1996"
1995-1996,27,1996-03-05,Arsenal,Man City,3,1,H,3,0,2,2,1,1,3,1,7,17,45,26,10,19,March,1.0,6.123233995736766e-17,0,27,1,0,0,1.0,0.0,36,26,10,20,40,-20,"March, 1996"
1995-1996,27,1996-03-06,QPR,Leeds,1,2,A,0,3,1,1,3,1,0,4,19,12,22,35,7,13,March,1.0,6.123233995736766e-17,34,23,1,0,0,3.0,1.0,23,42,-19,31,38,-7,"March, 1996"
1995-1996,27,1996-03-06,Aston Villa,Sheffield Weds,3,2,H,3,0,3,1,1,1,0,4,4,14,49,29,10,20,March,1.0,6.123233995736766e-17,1,37,0,0,0,0.0,0.0,39,24,15,37,46,-9,"March, 1996"
1995-1996,28,1996-03-09,West Ham,Middlesbrough,2,0,H,3,0,3,1,1,0,1,4,11,13,39,34,2,5,March,1.0,6.123233995736766e-17,45,29,0,0,1,2.0,4.0,33,39,-6,28,39,-11,"March, 1996"
1995-1996,28,1996-03-09,Everton,Coventry,2,2,D,1,1,3,1,1,1,3,1,7,16,46,26,9,20,March,1.0,6.123233995736766e-17,18,15,0,0,1,1.0,2.0,44,30,14,35,51,-16,"March, 1996"
1995-1996,28,1996-03-09,Aston Villa,QPR,4,2,H,3,0,3,1,1,1,1,3,4,19,52,22,15,30,March,1.0,6.123233995736766e-17,1,34,0,0,1,0.0,1.0,42,26,16,24,44,-20,"March, 1996"
1995-1996,29,1996-03-12,Chelsea,Man City,1,1,D,1,1,2,1,2,1,2,2,8,17,43,26,9,17,March,1.0,6.123233995736766e-17,14,27,1,0,0,1.0,0.0,35,31,4,21,43,-22,"March, 1996"
1995-1996,29,1996-03-13,Blackburn,Leeds,1,0,H,3,0,1,1,3,1,0,4,10,12,42,38,2,4,March,1.0,6.123233995736766e-17,4,23,0,1,0,0.0,0.0,43,34,9,33,39,-6,"March, 1996"
1995-1996,29,1996-03-13,Liverpool,Wimbledon,2,2,D,1,1,4,1,0,1,2,2,3,17,55,26,14,29,March,1.0,6.123233995736766e-17,25,47,0,0,1,0.0,1.0,56,24,32,40,56,-16,"March, 1996"
1995-1996,30,1996-03-16,Wimbledon,Arsenal,0,3,A,0,3,0,3,2,3,2,0,16,5,27,48,11,21,March,1.0,6.123233995736766e-17,47,0,1,0,0,3.0,1.0,42,58,-16,39,27,12,"March, 1996"
1995-1996,30,1996-03-16,Tottenham,Blackburn,2,3,A,0,3,2,1,2,1,1,3,6,8,48,45,2,3,March,1.0,6.123233995736766e-17,42,4,0,0,1,1.0,2.0,35,25,10,44,34,10,"March, 1996"
1995-1996,30,1996-03-16,QPR,Man United,1,1,D,1,1,1,1,3,5,0,0,19,2,22,60,17,38,March,1.0,6.123233995736766e-17,34,28,0,0,1,1.0,2.0,26,48,-22,56,29,27,"March, 1996"
1995-1996,30,1996-03-16,Sheffield Weds,Aston Villa,2,0,H,3,0,1,0,4,3,1,1,15,4,29,55,11,26,March,1.0,6.123233995736766e-17,37,1,0,0,1,2.0,3.0,39,49,-10,46,28,18,"March, 1996"
1995-1996,30,1996-03-16,Man City,Southampton,2,1,H,3,0,0,3,2,1,2,2,17,18,27,25,1,2,March,1.0,6.123233995736766e-17,27,38,0,1,0,1.0,1.0,22,44,-22,27,40,-13,"March, 1996"
1995-1996,30,1996-03-16,Liverpool,Chelsea,2,0,H,3,0,3,2,0,1,2,2,3,9,56,44,6,12,March,1.0,6.123233995736766e-17,25,14,0,1,0,2.0,2.0,58,26,32,36,32,4,"March, 1996"
1995-1996,30,1996-03-16,Coventry,Bolton,0,2,A,0,3,1,4,0,2,0,3,16,20,27,19,4,8,March,1.0,6.123233995736766e-17,15,6,1,0,0,2.0,1.0,37,53,-16,29,58,-29,"March, 1996"
1995-1996,30,1996-03-16,Middlesbrough,Nott'm Forest,1,1,D,1,1,0,1,4,2,0,3,13,10,34,43,3,9,March,1.0,6.123233995736766e-17,29,32,0,0,1,0.0,1.0,28,41,-13,38,39,-1,"March, 1996"
1995-1996,30,1996-03-17,Leeds,Everton,2,2,D,1,1,1,0,4,3,1,1,12,8,38,47,4,9,March,1.0,6.123233995736766e-17,23,18,0,0,1,0.0,2.0,33,40,-7,46,32,14,"March, 1996"
1995-1996,30,1996-03-18,Newcastle,West Ham,3,0,H,3,0,2,1,2,3,1,1,2,11,61,42,9,19,March,1.0,6.123233995736766e-17,30,45,0,0,1,0.0,2.0,52,26,26,35,39,-4,"March, 1996"
1995-1996,30,1996-03-19,Aston Villa,Middlesbrough,0,0,D,1,1,3,0,2,0,2,3,4,13,55,35,9,20,March,1.0,6.123233995736766e-17,1,29,1,0,0,2.0,0.0,46,30,16,29,42,-13,"March, 1996"
1995-1996,30,1996-03-20,Bolton,Tottenham,2,3,A,0,3,3,0,2,2,1,2,20,8,22,48,12,26,March,1.0,6.123233995736766e-17,6,42,0,1,0,2.0,2.0,31,58,-27,37,28,9,"March, 1996"
1995-1996,30,1996-03-20,Man United,Arsenal,1,0,H,3,0,4,1,0,4,1,0,2,5,61,51,3,10,March,1.0,6.123233995736766e-17,28,0,0,0,1,0.0,1.0,57,30,27,42,27,15,"March, 1996"
1995-1996,30,1996-03-20,Southampton,Sheffield Weds,0,1,A,0,3,0,2,3,1,0,4,18,14,25,32,4,7,March,1.0,6.123233995736766e-17,38,37,0,1,0,2.0,2.0,28,42,-14,41,49,-8,"March, 1996"
1995-1996,31,1996-03-23,Nott'm Forest,Liverpool,1,0,H,3,0,1,1,3,4,1,0,10,3,44,59,7,15,March,1.0,6.123233995736766e-17,32,25,0,0,1,2.0,4.0,39,40,-1,60,26,34,"March, 1996"
1995-1996,31,1996-03-23,Everton,Wimbledon,2,4,A,0,3,2,2,1,0,3,2,7,17,48,27,10,21,March,1.0,6.123233995736766e-17,18,47,1,0,0,3.0,2.0,48,34,14,42,61,-19,"March, 1996"
1995-1996,31,1996-03-23,West Ham,Man City,4,2,H,3,0,2,1,2,1,3,1,11,16,42,30,5,12,March,1.0,6.123233995736766e-17,45,27,0,0,1,1.0,2.0,35,42,-7,24,45,-21,"March, 1996"
1995-1996,31,1996-03-23,Bolton,Sheffield Weds,2,1,H,3,0,3,0,2,2,0,3,20,14,22,35,6,13,March,1.0,6.123233995736766e-17,6,37,0,0,1,2.0,4.0,33,61,-28,42,49,-7,"March, 1996"
1995-1996,31,1996-03-23,Arsenal,Newcastle,2,0,H,3,0,3,1,1,2,1,2,5,1,51,64,4,13,March,1.0,6.123233995736766e-17,0,30,0,0,1,0.0,2.0,42,28,14,55,26,29,"March, 1996"
1995-1996,31,1996-03-23,Chelsea,QPR,1,1,D,1,1,1,2,2,1,2,2,9,20,44,23,11,21,March,1.0,6.123233995736766e-17,14,34,1,0,0,2.0,1.0,36,34,2,27,49,-22,"March, 1996"
1995-1996,31,1996-03-24,Man United,Tottenham,1,0,H,3,0,4,1,0,3,0,2,1,6,64,51,5,13,March,1.0,6.123233995736766e-17,28,42,0,0,1,1.0,4.0,58,30,28,40,30,10,"March, 1996"
1995-1996,31,1996-03-25,Southampton,Coventry,1,0,H,3,0,0,1,4,1,3,1,18,17,25,27,1,2,March,1.0,6.123233995736766e-17,38,15,0,1,0,1.0,1.0,28,43,-15,37,55,-18,"March, 1996"
1995-1996,32,1996-03-30,Wimbledon,Nott'm Forest,1,0,H,3,0,1,3,1,2,1,2,16,9,30,47,7,17,March,1.0,6.123233995736766e-17,47,32,0,0,1,1.0,4.0,46,63,-17,40,40,0,"March, 1996"
1995-1996,32,1996-03-30,Tottenham,Coventry,3,1,H,3,0,3,0,2,0,3,2,7,18,51,27,11,24,March,1.0,6.123233995736766e-17,42,15,1,0,0,3.0,2.0,40,31,9,37,56,-19,"March, 1996"
1995-1996,32,1996-03-30,QPR,Southampton,3,0,H,3,0,0,3,2,1,0,4,20,17,24,28,3,4,March,1.0,6.123233995736766e-17,34,38,0,0,1,0.0,2.0,28,50,-22,29,43,-14,"March, 1996"
1995-1996,32,1996-03-30,Bolton,Man City,1,1,D,1,1,3,0,2,1,2,2,19,16,25,30,3,5,March,1.0,6.123233995736766e-17,6,27,0,0,1,0.0,1.0,35,62,-27,26,49,-23,"March, 1996"
1995-1996,32,1996-03-30,Blackburn,Everton,0,3,A,0,3,2,1,2,2,2,1,8,7,48,48,1,0,March,1.0,6.123233995736766e-17,4,18,0,0,1,0.0,1.0,47,36,11,50,38,12,"March, 1996"
1995-1996,32,1996-03-30,Leeds,Middlesbrough,0,1,A,0,3,1,1,3,0,3,2,12,13,39,36,1,3,March,1.0,6.123233995736766e-17,23,29,0,1,0,1.0,1.0,35,42,-7,29,42,-13,"March, 1996"
1995-1996,32,1996-04-03,Leeds,Southampton,1,0,H,3,0,1,1,3,1,0,4,12,17,39,28,5,11,April,0.8660254037844388,-0.4999999999999998,23,38,0,1,0,1.0,1.0,35,43,-8,29,46,-17,"April, 1996"
1995-1996,32,1996-04-03,Liverpool,Newcastle,4,3,H,3,0,3,1,1,1,1,3,3,2,59,64,1,5,April,0.8660254037844388,-0.4999999999999998,25,30,0,0,1,1.0,2.0,60,27,33,55,28,27,"April, 1996"
1995-1996,33,1996-04-05,Middlesbrough,Sheffield Weds,3,1,H,3,0,1,2,2,2,0,3,13,14,39,35,1,4,April,0.8660254037844388,-0.4999999999999998,29,37,1,0,0,1.0,0.0,30,42,-12,43,51,-8,"April, 1996"
1995-1996,33,1996-04-06,Newcastle,QPR,2,1,H,3,0,1,1,3,1,2,2,2,19,64,27,17,37,April,0.8660254037844388,-0.4999999999999998,30,34,1,0,0,3.0,2.0,58,32,26,31,50,-19,"April, 1996"
1995-1996,33,1996-04-06,Southampton,Blackburn,1,0,H,3,0,1,0,4,2,1,2,18,9,28,48,9,20,April,0.8660254037844388,-0.4999999999999998,38,4,0,0,1,1.0,2.0,29,47,-18,47,39,8,"April, 1996"
1995-1996,33,1996-04-06,Nott'm Forest,Tottenham,2,1,H,3,0,2,1,2,3,0,2,9,7,47,54,2,7,April,0.8660254037844388,-0.4999999999999998,32,42,1,0,0,1.0,0.0,40,41,-1,43,32,11,"April, 1996"
1995-1996,33,1996-04-06,Man City,Man United,2,3,A,0,3,1,2,2,4,1,0,16,1,31,67,15,36,April,0.8660254037844388,-0.4999999999999998,27,28,0,0,1,0.0,1.0,27,50,-23,59,30,29,"April, 1996"
1995-1996,33,1996-04-06,West Ham,Wimbledon,1,1,D,1,1,2,1,2,2,2,1,11,15,45,33,4,12,April,0.8660254037844388,-0.4999999999999998,45,47,1,0,0,1.0,0.0,39,44,-5,47,63,-16,"April, 1996"
1995-1996,33,1996-04-06,Coventry,Liverpool,1,0,H,3,0,0,2,3,3,1,1,19,3,27,62,16,35,April,0.8660254037844388,-0.4999999999999998,15,25,0,1,0,0.0,0.0,38,59,-21,64,30,34,"April, 1996"
1995-1996,33,1996-04-06,Chelsea,Aston Villa,1,2,A,0,3,1,3,1,2,1,2,10,5,45,56,5,11,April,0.8660254037844388,-0.4999999999999998,14,1,1,0,0,1.0,0.0,37,35,2,46,30,16,"April, 1996"
1995-1996,33,1996-04-06,Arsenal,Leeds,2,1,H,3,0,3,1,1,2,1,2,5,12,54,42,7,12,April,0.8660254037844388,-0.4999999999999998,0,23,1,0,0,3.0,0.0,44,28,16,36,43,-7,"April, 1996"
1995-1996,33,1996-04-06,Everton,Bolton,3,0,H,3,0,2,2,1,3,1,1,7,20,51,26,13,25,April,0.8660254037844388,-0.4999999999999998,18,6,0,1,0,1.0,1.0,53,38,15,36,63,-27,"April, 1996"
1995-1996,34,1996-04-08,Tottenham,Middlesbrough,1,1,D,1,1,2,0,3,2,2,1,7,13,54,42,6,12,April,0.8660254037844388,-0.4999999999999998,42,29,1,0,0,1.0,0.0,44,34,10,33,43,-10,"April, 1996"
1995-1996,34,1996-04-08,Sheffield Weds,Arsenal,1,0,H,3,0,2,0,3,4,0,1,14,5,35,57,9,22,April,0.8660254037844388,-0.4999999999999998,37,0,0,0,1,2.0,4.0,44,54,-10,46,29,17,"April, 1996"
1995-1996,34,1996-04-08,QPR,Everton,3,1,H,3,0,1,2,2,2,2,1,20,6,27,54,14,27,April,0.8660254037844388,-0.4999999999999998,34,18,0,0,1,0.0,2.0,32,52,-20,56,38,18,"April, 1996"
1995-1996,34,1996-04-08,Man United,Coventry,1,0,H,3,0,4,1,0,1,1,3,1,18,70,30,17,40,April,0.8660254037844388,-0.4999999999999998,28,15,1,0,0,4.0,0.0,62,32,30,39,59,-20,"April, 1996"
1995-1996,34,1996-04-08,Wimbledon,Man City,3,0,H,3,0,2,2,1,1,2,2,15,17,34,31,2,3,April,0.8660254037844388,-0.4999999999999998,47,27,0,0,1,0.0,1.0,48,64,-16,29,53,-24,"April, 1996"
1995-1996,34,1996-04-08,Leeds,Nott'm Forest,1,3,A,0,3,1,1,3,3,1,1,12,9,42,50,3,8,April,0.8660254037844388,-0.4999999999999998,23,32,0,0,1,1.0,2.0,37,45,-8,42,42,0,"April, 1996"
1995-1996,34,1996-04-08,Bolton,Chelsea,2,1,H,3,0,2,1,2,0,3,2,20,11,26,45,9,19,April,0.8660254037844388,-0.4999999999999998,6,14,0,0,1,2.0,3.0,36,66,-30,38,37,1,"April, 1996"
1995-1996,34,1996-04-08,Blackburn,Newcastle,2,1,H,3,0,2,1,2,2,0,3,9,2,48,67,7,19,April,0.8660254037844388,-0.4999999999999998,4,30,0,0,1,0.0,1.0,47,40,7,60,33,27,"April, 1996"
1995-1996,34,1996-04-08,Aston Villa,Southampton,3,0,H,3,0,3,1,1,2,0,3,4,16,59,31,12,28,April,0.8660254037844388,-0.4999999999999998,1,38,1,0,0,1.0,0.0,48,31,17,30,47,-17,"April, 1996"
1995-1996,34,1996-04-08,Liverpool,West Ham,2,0,H,3,0,2,1,2,2,2,1,3,10,62,46,7,16,April,0.8660254037844388,-0.4999999999999998,25,45,0,1,0,0.0,0.0,64,31,33,40,45,-5,"April, 1996"
1995-1996,35,1996-04-13,West Ham,Bolton,1,0,H,3,0,2,1,2,2,1,2,11,20,46,29,9,17,April,0.8660254037844388,-0.4999999999999998,45,6,1,0,0,3.0,0.0,40,47,-7,38,67,-29,"April, 1996"
1995-1996,35,1996-04-13,Southampton,Man United,3,1,H,3,0,2,0,3,4,1,0,18,1,31,73,17,42,April,0.8660254037844388,-0.4999999999999998,38,28,0,0,1,1.0,4.0,30,50,-20,63,32,31,"April, 1996"
1995-1996,35,1996-04-13,Nott'm Forest,Blackburn,1,5,A,0,3,3,1,1,3,0,2,8,9,53,51,1,2,April,0.8660254037844388,-0.4999999999999998,32,4,0,0,1,0.0,7.0,45,43,2,49,41,8,"April, 1996"
1995-1996,35,1996-04-13,Middlesbrough,Wimbledon,1,2,A,0,3,2,3,0,3,1,1,12,15,43,37,3,6,April,0.8660254037844388,-0.4999999999999998,29,47,0,1,0,0.0,0.0,34,44,-10,51,64,-13,"April, 1996"
1995-1996,35,1996-04-13,Coventry,QPR,1,0,H,3,0,1,0,4,2,2,1,19,18,30,30,1,0,April,0.8660254037844388,-0.4999999999999998,15,34,0,1,0,1.0,1.0,39,60,-21,35,53,-18,"April, 1996"
1995-1996,35,1996-04-13,Chelsea,Leeds,4,1,H,3,0,0,2,3,1,1,3,11,13,45,42,2,3,April,0.8660254037844388,-0.4999999999999998,14,23,0,0,1,0.0,1.0,39,39,0,38,48,-10,"April, 1996"
1995-1996,35,1996-04-13,Man City,Sheffield Weds,1,0,H,3,0,1,1,3,3,0,2,18,14,31,38,4,7,April,0.8660254037844388,-0.4999999999999998,27,37,0,1,0,1.0,1.0,29,56,-27,45,54,-9,"April, 1996"
1995-1996,35,1996-04-14,Newcastle,Aston Villa,1,0,H,3,0,2,0,3,3,1,1,2,4,67,62,2,5,April,0.8660254037844388,-0.4999999999999998,30,1,0,1,0,1.0,1.0,61,35,26,51,31,20,"April, 1996"
1995-1996,35,1996-04-15,Arsenal,Tottenham,0,0,D,1,1,3,0,2,2,1,2,5,6,57,55,1,2,April,0.8660254037844388,-0.4999999999999998,0,42,0,0,1,1.0,2.0,46,30,16,45,35,10,"April, 1996"
1995-1996,35,1996-04-16,Everton,Liverpool,1,1,D,1,1,2,1,2,3,0,2,7,3,54,65,4,11,April,0.8660254037844388,-0.4999999999999998,18,25,1,0,0,2.0,1.0,57,41,16,66,31,35,"April, 1996"
1995-1996,35,1996-04-17,Nott'm Forest,Coventry,0,0,D,1,1,3,0,2,2,0,3,9,18,53,33,9,20,April,0.8660254037844388,-0.4999999999999998,32,15,0,1,0,1.0,1.0,46,48,-2,40,60,-20,"April, 1996"
1995-1996,35,1996-04-17,Sheffield Weds,Chelsea,0,0,D,1,1,2,0,3,1,1,3,15,11,38,48,4,10,April,0.8660254037844388,-0.4999999999999998,37,14,0,1,0,0.0,0.0,45,55,-10,43,40,3,"April, 1996"
1995-1996,35,1996-04-17,Newcastle,Southampton,1,0,H,3,0,2,0,3,2,0,3,2,16,70,34,14,36,April,0.8660254037844388,-0.4999999999999998,30,38,0,0,1,0.0,1.0,62,35,27,33,51,-18,"April, 1996"
1995-1996,35,1996-04-17,Man United,Leeds,1,0,H,3,0,4,0,1,1,0,4,1,13,73,42,12,31,April,0.8660254037844388,-0.4999999999999998,28,23,0,0,1,1.0,3.0,64,35,29,39,52,-13,"April, 1996"
1995-1996,35,1996-04-17,Blackburn,Wimbledon,3,2,H,3,0,3,0,2,4,1,0,8,14,54,40,6,14,April,0.8660254037844388,-0.4999999999999998,4,47,0,1,0,1.0,1.0,54,42,12,53,65,-12,"April, 1996"
1995-1996,35,1996-04-17,Aston Villa,West Ham,1,1,D,1,1,2,1,2,2,1,2,4,10,62,49,6,13,April,0.8660254037844388,-0.4999999999999998,1,45,1,0,0,4.0,1.0,51,32,19,41,47,-6,"April, 1996"
1995-1996,36,1996-04-27,Tottenham,Chelsea,1,1,D,1,1,1,2,2,1,2,2,8,11,56,49,3,7,April,0.8660254037844388,-0.4999999999999998,42,14,0,1,0,0.0,0.0,45,35,10,43,40,3,"April, 1996"
1995-1996,36,1996-04-27,Sheffield Weds,Everton,2,5,A,0,3,1,1,3,2,1,2,15,8,39,55,7,16,April,0.8660254037844388,-0.4999999999999998,37,18,0,1,0,2.0,2.0,45,55,-10,58,42,16,"April, 1996"
1995-1996,36,1996-04-27,QPR,West Ham,3,0,H,3,0,2,1,2,2,2,1,19,10,30,50,9,20,April,0.8660254037844388,-0.4999999999999998,34,45,0,0,1,0.0,1.0,35,54,-19,42,48,-6,"April, 1996"
1995-1996,36,1996-04-27,Wimbledon,Coventry,0,2,A,0,3,3,1,1,2,1,2,14,18,40,34,4,6,April,0.8660254037844388,-0.4999999999999998,47,15,0,1,0,3.0,3.0,55,68,-13,40,60,-20,"April, 1996"
1995-1996,36,1996-04-27,Bolton,Southampton,0,1,A,0,3,2,1,2,2,0,3,20,17,29,34,3,5,April,0.8660254037844388,-0.4999999999999998,6,38,0,0,1,0.0,1.0,38,68,-30,33,52,-19,"April, 1996"
1995-1996,36,1996-04-27,Blackburn,Arsenal,1,1,D,1,1,3,0,2,2,1,2,6,5,57,58,1,1,April,0.8660254037844388,-0.4999999999999998,4,0,0,1,0,0.0,0.0,57,44,13,46,30,16,"April, 1996"
1995-1996,36,1996-04-27,Aston Villa,Man City,0,1,A,0,3,2,2,1,1,1,3,4,18,63,34,14,29,April,0.8660254037844388,-0.4999999999999998,1,27,0,0,1,0.0,1.0,52,33,19,30,56,-26,"April, 1996"
1995-1996,36,1996-04-27,Liverpool,Middlesbrough,1,0,H,3,0,2,1,2,2,2,1,3,12,66,43,9,23,April,0.8660254037844388,-0.4999999999999998,25,29,0,0,1,1.0,2.0,67,32,35,35,46,-11,"April, 1996"
1995-1996,36,1996-04-28,Man United,Nott'm Forest,5,0,H,3,0,4,0,1,2,1,2,1,9,76,54,8,22,April,0.8660254037844388,-0.4999999999999998,28,32,0,1,0,1.0,1.0,65,35,30,46,48,-2,"April, 1996"
1995-1996,36,1996-04-29,Leeds,Newcastle,0,1,A,0,3,1,0,4,3,0,2,13,2,42,73,11,31,April,0.8660254037844388,-0.4999999999999998,23,30,0,0,1,1.0,2.0,39,53,-14,63,35,28,"April, 1996"
1995-1996,37,1996-05-01,Arsenal,Liverpool,0,0,D,1,1,2,2,1,3,1,1,5,3,59,69,2,10,May,0.4999999999999999,-0.8660254037844387,0,25,0,0,1,1.0,3.0,47,31,16,68,32,36,"May, 1996"
1995-1996,37,1996-05-02,Leeds,Tottenham,1,3,A,0,3,0,0,5,1,3,1,13,8,42,57,5,15,May,0.4999999999999999,-0.8660254037844387,23,42,0,0,1,1.0,2.0,39,54,-15,46,36,10,"May, 1996"
1995-1996,37,1996-05-02,Nott'm Forest,Newcastle,1,1,D,1,1,2,1,2,4,0,1,9,2,54,76,7,22,May,0.4999999999999999,-0.8660254037844387,32,30,0,0,1,1.0,3.0,46,53,-7,64,35,29,"May, 1996"
1995-1996,38,1996-05-04,Newcastle,Tottenham,1,1,D,1,1,3,1,1,1,3,1,2,8,77,60,6,17,May,0.4999999999999999,-0.8660254037844387,30,42,0,1,0,1.0,1.0,65,36,29,49,37,12,"May, 1996"
1995-1996,38,1996-05-04,West Ham,Sheffield Weds,1,1,D,1,1,1,2,2,1,1,3,11,15,50,39,4,11,May,0.4999999999999999,-0.8660254037844387,45,37,1,0,0,1.0,0.0,42,51,-9,47,60,-13,"May, 1996"
1995-1996,38,1996-05-04,Southampton,Wimbledon,0,0,D,1,1,3,0,2,2,1,2,18,14,37,40,4,3,May,0.4999999999999999,-0.8660254037844387,38,47,1,0,0,2.0,1.0,34,52,-18,55,70,-15,"May, 1996"
1995-1996,38,1996-05-04,Nott'm Forest,QPR,3,0,H,3,0,1,2,2,3,0,2,9,19,55,33,10,22,May,0.4999999999999999,-0.8660254037844387,32,34,0,1,0,1.0,1.0,47,54,-7,38,54,-16,"May, 1996"
1995-1996,38,1996-05-04,Middlesbrough,Man United,0,3,A,0,3,2,1,2,4,0,1,12,1,43,79,11,36,May,0.4999999999999999,-0.8660254037844387,29,28,0,0,1,0.0,2.0,35,47,-12,70,35,35,"May, 1996"
1995-1996,38,1996-05-04,Man City,Liverpool,2,2,D,1,1,2,1,2,2,2,1,18,3,37,70,15,33,May,0.4999999999999999,-0.8660254037844387,27,25,0,0,1,0.0,6.0,31,56,-25,68,32,36,"May, 1996"
1995-1996,38,1996-05-04,Everton,Aston Villa,1,0,H,3,0,3,1,1,2,1,2,8,4,58,63,4,5,May,0.4999999999999999,-0.8660254037844387,18,1,0,0,1,0.0,1.0,63,44,19,52,34,18,"May, 1996"
1995-1996,38,1996-05-04,Coventry,Leeds,0,0,D,1,1,3,1,1,0,0,5,16,13,37,42,3,5,May,0.4999999999999999,-0.8660254037844387,15,23,0,0,1,1.0,3.0,42,60,-18,40,57,-17,"May, 1996"
1995-1996,38,1996-05-04,Chelsea,Blackburn,2,3,A,0,3,1,2,2,3,1,1,10,8,50,58,2,8,May,0.4999999999999999,-0.8660254037844387,14,4,0,0,1,0.0,3.0,44,41,3,58,45,13,"May, 1996"
1995-1996,38,1996-05-04,Arsenal,Bolton,2,1,H,3,0,1,3,1,1,1,3,5,20,60,29,15,31,May,0.4999999999999999,-0.8660254037844387,0,6,0,0,1,0.0,1.0,47,31,16,38,69,-31,"May, 1996"
1996-1997,1,1996-08-17,Wimbledon,Man United,0,3,A,0,3,2,1,2,2,3,0,15,13,0,0,2,0,August,-0.8660254037844384,-0.5000000000000004,47,28,0,0,2,1.5,3.5,0,0,0,0,0,0,"August, 1996"
1996-1997,1,1996-08-17,Sunderland,Leicester,0,0,D,1,1,2,0,3,2,1,2,14,11,0,0,3,0,August,-0.8660254037844384,-0.5000000000000004,40,24,0,0,0,0.0,0.0,0,0,0,0,0,0,"August, 1996"
1996-1997,1,1996-08-17,Sheffield Weds,Aston Villa,2,1,H,3,0,1,1,3,1,2,2,13,9,0,0,4,0,August,-0.8660254037844384,-0.5000000000000004,37,1,1,0,1,2.0,1.5,0,0,0,0,0,0,"August, 1996"
1996-1997,1,1996-08-17,Everton,Newcastle,2,0,H,3,0,1,2,2,3,2,0,8,13,0,0,5,0,August,-0.8660254037844384,-0.5000000000000004,18,30,0,0,2,0.5,2.0,0,0,0,0,0,0,"August, 1996"
1996-1997,1,1996-08-17,Middlesbrough,Liverpool,3,3,D,1,1,1,3,1,1,2,2,12,10,0,0,2,0,August,-0.8660254037844384,-0.5000000000000004,29,25,1,0,1,1.0,1.0,0,0,0,0,0,0,"August, 1996"
1996-1997,1,1996-08-17,Coventry,Nott'm Forest,0,3,A,0,3,2,2,1,0,3,2,5,14,0,0,9,0,August,-0.8660254037844384,-0.5000000000000004,15,32,0,2,0,0.5,0.5,0,0,0,0,0,0,"August, 1996"
1996-1997,1,1996-08-17,Blackburn,Tottenham,0,2,A,0,3,1,2,2,1,1,3,3,18,0,0,15,0,August,-0.8660254037844384,-0.5000000000000004,4,42,2,0,0,2.5,1.5,0,0,0,0,0,0,"August, 1996"
1996-1997,1,1996-08-17,Arsenal,West Ham,2,0,H,3,0,2,2,1,2,2,1,1,19,0,0,18,0,August,-0.8660254037844384,-0.5000000000000004,0,45,2,0,0,1.0,0.0,0,0,0,0,0,0,"August, 1996"
1996-1997,1,1996-08-17,Derby,Leeds,3,3,D,1,1,2,1,2,0,4,1,6,8,0,0,2,0,August,-0.8660254037844384,-0.5000000000000004,17,23,0,0,0,0.0,0.0,0,0,0,0,0,0,"August, 1996"
1996-1997,1,1996-08-18,Southampton,Chelsea,0,0,D,1,1,3,1,1,3,1,1,14,13,0,0,1,0,August,-0.8660254037844384,-0.5000000000000004,38,14,0,0,2,1.0,3.0,0,0,0,0,0,0,"August, 1996"
1996-1997,1,1996-08-19,Liverpool,Arsenal,2,0,H,3,0,1,2,2,2,2,1,9,3,1,3,6,2,August,-0.8660254037844384,-0.5000000000000004,25,0,1,1,0,1.5,0.5,3,3,0,2,0,2,"August, 1996"
1996-1997,1,1996-08-20,Leeds,Sheffield Weds,0,2,A,0,3,0,4,1,1,1,3,9,6,1,3,3,2,August,-0.8660254037844384,-0.5000000000000004,23,37,1,0,1,2.0,3.0,3,3,0,2,1,1,"August, 1996"
1996-1997,1,1996-08-21,Nott'm Forest,Sunderland,1,4,A,0,3,0,3,2,2,0,3,7,13,3,1,6,2,August,-0.8660254037844384,-0.5000000000000004,32,40,0,0,0,0.0,0.0,3,0,3,0,0,0,"August, 1996"
1996-1997,1,1996-08-21,Tottenham,Derby,1,1,D,1,1,1,1,3,2,1,2,8,13,3,1,5,2,August,-0.8660254037844384,-0.5000000000000004,42,17,0,0,0,0.0,0.0,2,0,2,3,3,0,"August, 1996"
1996-1997,1,1996-08-21,Newcastle,Wimbledon,2,0,H,3,0,3,2,0,2,1,2,16,20,0,0,4,0,August,-0.8660254037844384,-0.5000000000000004,30,47,1,1,0,4.5,2.0,0,2,-2,0,3,-3,"August, 1996"
1996-1997,1,1996-08-21,West Ham,Coventry,1,1,D,1,1,2,2,1,2,2,1,17,19,0,0,2,0,August,-0.8660254037844384,-0.5000000000000004,45,15,1,1,0,2.5,2.0,0,2,-2,0,3,-3,"August, 1996"
1996-1997,1,1996-08-21,Leicester,Southampton,2,1,H,3,0,2,1,2,3,1,1,11,12,1,1,1,0,August,-0.8660254037844384,-0.5000000000000004,24,38,0,0,0,0.0,0.0,0,0,0,0,0,0,"August, 1996"
1996-1997,1,1996-08-21,Chelsea,Middlesbrough,1,0,H,3,0,3,1,1,1,3,1,11,10,1,1,1,0,August,-0.8660254037844384,-0.5000000000000004,14,29,1,0,1,2.5,1.0,0,0,0,3,3,0,"August, 1996"
1996-1997,1,1996-08-21,Aston Villa,Blackburn,1,0,H,3,0,1,2,2,1,2,2,15,16,0,0,1,0,August,-0.8660254037844384,-0.5000000000000004,1,4,1,1,0,1.5,0.5,1,2,-1,0,2,-2,"August, 1996"
1996-1997,1,1996-08-21,Man United,Everton,2,2,D,1,1,2,3,0,1,2,2,5,7,3,3,2,0,August,-0.8660254037844384,-0.5000000000000004,28,18,2,0,0,2.5,1.0,3,0,3,2,0,2,"August, 1996"
1996-1997,2,1996-08-24,West Ham,Southampton,2,1,H,3,0,2,2,1,3,1,1,17,15,1,1,2,0,August,-0.8660254037844384,-0.5000000000000004,45,38,1,1,0,1.0,0.5,1,3,-2,1,2,-1,"August, 1996"
1996-1997,2,1996-08-24,Tottenham,Everton,0,0,D,1,1,1,1,3,1,2,2,9,8,4,4,1,0,August,-0.8660254037844384,-0.5000000000000004,42,18,0,2,0,0.5,0.5,3,1,2,4,2,2,"August, 1996"
1996-1997,2,1996-08-24,Newcastle,Sheffield Weds,1,2,A,0,3,3,2,0,1,1,3,12,2,3,6,10,3,August,-0.8660254037844384,-0.5000000000000004,30,37,2,0,0,2.0,0.0,2,2,0,4,1,3,"August, 1996"
1996-1997,2,1996-08-24,Nott'm Forest,Middlesbrough,1,1,D,1,1,0,3,2,1,3,1,11,14,3,1,3,2,August,-0.8660254037844384,-0.5000000000000004,32,29,1,1,0,1.0,0.5,4,4,0,3,4,-1,"August, 1996"
1996-1997,2,1996-08-24,Leicester,Arsenal,0,2,A,0,3,2,1,2,2,2,1,9,11,4,3,2,1,August,-0.8660254037844384,-0.5000000000000004,24,0,0,0,0,0.0,0.0,2,1,1,2,2,0,"August, 1996"
1996-1997,2,1996-08-24,Chelsea,Coventry,2,0,H,3,0,3,1,1,2,2,1,9,18,4,1,9,3,August,-0.8660254037844384,-0.5000000000000004,14,15,0,1,1,1.0,1.5,1,0,1,1,4,-3,"August, 1996"
1996-1997,2,1996-08-24,Aston Villa,Derby,2,0,H,3,0,1,2,2,2,1,2,11,13,3,2,2,1,August,-0.8660254037844384,-0.5000000000000004,1,17,0,0,0,0.0,0.0,2,2,0,4,4,0,"August, 1996"
1996-1997,2,1996-08-24,Liverpool,Sunderland,0,0,D,1,1,1,2,2,2,0,3,7,6,4,4,1,0,August,-0.8660254037844384,-0.5000000000000004,25,40,0,0,0,0.0,0.0,5,3,2,4,1,3,"August, 1996"
1996-1997,2,1996-08-25,Man United,Blackburn,2,2,D,1,1,2,3,0,1,2,2,9,19,4,0,10,4,August,-0.8660254037844384,-0.5000000000000004,28,4,2,0,0,1.5,0.5,5,2,3,0,3,-3,"August, 1996"
1996-1997,2,1996-08-26,Leeds,Wimbledon,1,0,H,3,0,0,4,1,2,1,2,16,20,1,0,4,1,August,-0.8660254037844384,-0.5000000000000004,23,47,1,1,0,2.5,1.5,3,5,-2,0,5,-5,"August, 1996"
1996-1997,2,1996-09-02,Sheffield Weds,Leicester,2,1,H,3,0,1,1,3,2,1,2,1,13,9,4,12,5,September,-1.0,-1.8369701987210287e-16,37,24,0,0,0,0.0,0.0,6,2,4,2,3,-1,"September, 1996"
1996-1997,3,1996-09-04,Middlesbrough,West Ham,4,1,H,3,0,1,3,1,2,2,1,16,12,2,4,4,2,September,-1.0,-1.8369701987210287e-16,29,45,1,0,1,2.0,2.0,4,5,-1,3,4,-1,"September, 1996"
1996-1997,3,1996-09-04,Sunderland,Newcastle,1,2,A,0,3,2,0,3,3,2,0,8,15,5,3,7,2,September,-1.0,-1.8369701987210287e-16,40,30,0,0,0,0.0,0.0,4,1,3,3,4,-1,"September, 1996"
1996-1997,3,1996-09-04,Southampton,Nott'm Forest,2,2,D,1,1,3,1,1,0,3,2,17,12,1,4,5,3,September,-1.0,-1.8369701987210287e-16,38,32,0,0,2,1.5,2.5,2,4,-2,5,5,0,"September, 1996"
1996-1997,3,1996-09-04,Everton,Aston Villa,0,1,A,0,3,1,2,2,1,2,2,9,7,5,6,2,1,September,-1.0,-1.8369701987210287e-16,18,1,1,0,1,0.5,0.5,4,2,2,4,2,2,"September, 1996"
1996-1997,3,1996-09-04,Wimbledon,Tottenham,1,0,H,3,0,2,1,2,1,1,3,20,11,0,5,9,5,September,-1.0,-1.8369701987210287e-16,47,42,0,0,2,0.5,2.0,0,6,-6,3,1,2,"September, 1996"
1996-1997,3,1996-09-04,Coventry,Liverpool,0,1,A,0,3,2,2,1,1,2,2,19,8,1,5,11,4,September,-1.0,-1.8369701987210287e-16,15,25,1,1,0,0.5,0.0,1,6,-5,5,3,2,"September, 1996"
1996-1997,3,1996-09-04,Blackburn,Leeds,0,1,A,0,3,1,2,2,0,4,1,18,11,1,4,7,3,September,-1.0,-1.8369701987210287e-16,4,23,1,1,0,0.5,0.0,2,5,-3,4,5,-1,"September, 1996"
1996-1997,3,1996-09-04,Arsenal,Chelsea,3,3,D,1,1,2,2,1,3,1,1,3,2,6,7,1,1,September,-1.0,-1.8369701987210287e-16,0,14,0,1,1,0.5,1.0,4,2,2,3,0,3,"September, 1996"
1996-1997,3,1996-09-04,Derby,Man United,1,1,D,1,1,2,1,2,2,3,0,16,7,2,5,9,3,September,-1.0,-1.8369701987210287e-16,17,28,0,0,0,0.0,0.0,4,6,-2,7,4,3,"September, 1996"
1996-1997,4,1996-09-07,Aston Villa,Arsenal,2,2,D,1,1,1,2,2,2,2,1,2,5,9,7,3,2,September,-1.0,-1.8369701987210287e-16,1,0,0,1,1,0.5,1.5,5,2,3,7,5,2,"September, 1996"
1996-1997,4,1996-09-07,Leeds,Man United,0,4,A,0,3,0,4,1,2,3,0,6,7,7,6,1,1,September,-1.0,-1.8369701987210287e-16,23,28,1,0,1,1.5,1.0,5,5,0,8,5,3,"September, 1996"
1996-1997,4,1996-09-07,Liverpool,Southampton,2,1,H,3,0,1,2,2,3,1,1,5,18,8,2,13,6,September,-1.0,-1.8369701987210287e-16,25,38,1,1,0,2.0,1.0,6,3,3,4,6,-2,"September, 1996"
1996-1997,4,1996-09-07,Middlesbrough,Coventry,4,0,H,3,0,1,3,1,2,2,1,9,20,5,1,11,4,September,-1.0,-1.8369701987210287e-16,29,15,1,1,0,1.0,0.5,8,6,2,1,7,-6,"September, 1996"
1996-1997,4,1996-09-07,Nott'm Forest,Leicester,0,0,D,1,1,0,3,2,2,1,2,13,14,5,4,1,1,September,-1.0,-1.8369701987210287e-16,32,24,0,0,0,0.0,0.0,7,7,0,3,5,-2,"September, 1996"
1996-1997,4,1996-09-07,Sheffield Weds,Chelsea,0,2,A,0,3,1,1,3,3,1,1,1,6,12,8,5,4,September,-1.0,-1.8369701987210287e-16,37,14,0,2,0,0.0,0.0,8,3,5,6,3,3,"September, 1996"
1996-1997,4,1996-09-07,Tottenham,Newcastle,1,2,A,0,3,1,1,3,3,2,0,13,10,5,6,3,1,September,-1.0,-1.8369701987210287e-16,42,30,0,2,0,1.0,1.0,3,2,1,5,5,0,"September, 1996"
1996-1997,4,1996-09-07,Wimbledon,Everton,4,0,H,3,0,2,1,2,1,2,2,17,12,3,5,5,2,September,-1.0,-1.8369701987210287e-16,47,18,1,0,1,3.0,2.5,1,6,-5,4,3,1,"September, 1996"
1996-1997,4,1996-09-08,Sunderland,West Ham,0,0,D,1,1,2,0,3,2,2,1,12,16,5,4,4,1,September,-1.0,-1.8369701987210287e-16,40,45,0,0,0,0.0,0.0,5,3,2,4,8,-4,"September, 1996"
1996-1997,4,1996-09-09,Blackburn,Derby,1,2,A,0,3,1,2,2,2,1,2,19,17,1,3,2,2,September,-1.0,-1.8369701987210287e-16,4,17,0,0,0,0.0,0.0,2,6,-4,5,7,-2,"September, 1996"
1996-1997,5,1996-09-14,Coventry,Leeds,2,1,H,3,0,2,2,1,0,4,1,20,9,1,7,11,6,September,-1.0,-1.8369701987210287e-16,15,23,0,1,1,0.5,1.5,1,11,-10,5,9,-4,"September, 1996"
1996-1997,5,1996-09-14,Derby,Sunderland,1,0,H,3,0,2,1,2,2,0,3,12,10,6,6,2,0,September,-1.0,-1.8369701987210287e-16,17,40,0,0,0,0.0,0.0,7,8,-1,5,3,2,"September, 1996"
1996-1997,5,1996-09-14,Everton,Middlesbrough,1,2,A,0,3,1,2,2,1,3,1,16,8,5,8,8,3,September,-1.0,-1.8369701987210287e-16,18,29,2,0,0,3.0,0.0,4,7,-3,12,6,6,"September, 1996"
1996-1997,5,1996-09-14,Man United,Nott'm Forest,4,1,H,3,0,2,3,0,0,3,2,6,12,9,6,6,3,September,-1.0,-1.8369701987210287e-16,28,32,1,1,0,3.0,0.5,12,5,7,7,7,0,"September, 1996"
1996-1997,5,1996-09-14,Newcastle,Blackburn,2,1,H,3,0,3,2,0,1,2,2,7,20,9,1,13,8,September,-1.0,-1.8369701987210287e-16,30,4,1,0,1,1.0,1.0,7,6,1,3,8,-5,"September, 1996"
1996-1997,5,1996-09-14,Southampton,Tottenham,0,1,A,0,3,3,1,1,1,1,3,19,14,2,5,5,3,September,-1.0,-1.8369701987210287e-16,38,42,0,1,1,0.0,0.5,5,8,-3,4,4,0,"September, 1996"
1996-1997,5,1996-09-14,West Ham,Wimbledon,0,2,A,0,3,2,2,1,2,1,2,17,13,5,6,4,1,September,-1.0,-1.8369701987210287e-16,45,47,1,1,0,1.0,0.5,4,8,-4,5,6,-1,"September, 1996"
1996-1997,5,1996-09-15,Chelsea,Aston Villa,1,1,D,1,1,3,1,1,1,2,2,5,7,11,10,2,1,September,-1.0,-1.8369701987210287e-16,14,1,1,0,1,1.0,1.0,8,3,5,7,4,3,"September, 1996"
1996-1997,5,1996-09-15,Leicester,Liverpool,0,3,A,0,3,2,1,2,1,2,2,15,6,5,11,9,6,September,-1.0,-1.8369701987210287e-16,24,25,0,0,0,0.0,0.0,3,5,-2,8,4,4,"September, 1996"
1996-1997,5,1996-09-16,Arsenal,Sheffield Weds,4,1,H,3,0,2,2,1,1,1,3,10,4,8,12,6,4,September,-1.0,-1.8369701987210287e-16,0,37,1,0,1,2.0,1.5,9,7,2,8,5,3,"September, 1996"
1996-1997,6,1996-09-21,Sunderland,Coventry,1,0,H,3,0,2,0,3,2,2,1,14,18,6,4,4,2,September,-1.0,-1.8369701987210287e-16,40,15,0,0,0,0.0,0.0,5,4,1,3,12,-9,"September, 1996"
1996-1997,6,1996-09-21,Sheffield Weds,Derby,0,0,D,1,1,1,1,3,2,1,2,7,10,12,9,3,3,September,-1.0,-1.8369701987210287e-16,37,17,0,0,0,0.0,0.0,9,9,0,8,8,0,"September, 1996"
1996-1997,6,1996-09-21,Nott'm Forest,West Ham,0,2,A,0,3,0,3,2,2,2,1,14,17,6,5,3,1,September,-1.0,-1.8369701987210287e-16,32,45,0,1,1,0.5,1.0,8,11,-3,4,10,-6,"September, 1996"
1996-1997,6,1996-09-21,Middlesbrough,Arsenal,0,2,A,0,3,1,3,1,2,2,1,7,8,11,11,1,0,September,-1.0,-1.8369701987210287e-16,29,0,0,1,1,1.5,2.0,14,7,7,13,8,5,"September, 1996"
1996-1997,6,1996-09-21,Liverpool,Chelsea,5,1,H,3,0,1,2,2,3,1,1,2,4,14,12,2,2,September,-1.0,-1.8369701987210287e-16,25,14,1,1,0,2.0,1.0,11,4,7,9,4,5,"September, 1996"
1996-1997,6,1996-09-21,Leeds,Newcastle,0,1,A,0,3,0,4,1,3,2,0,12,5,7,12,7,5,September,-1.0,-1.8369701987210287e-16,23,30,0,0,2,0.5,1.5,6,11,-5,9,7,2,"September, 1996"
1996-1997,6,1996-09-21,Blackburn,Everton,1,1,D,1,1,1,2,2,1,2,2,20,15,1,5,5,4,September,-1.0,-1.8369701987210287e-16,4,18,0,0,2,0.0,2.0,4,10,-6,5,9,-4,"September, 1996"
1996-1997,6,1996-09-21,Aston Villa,Man United,0,0,D,1,1,1,2,2,2,3,0,8,2,11,12,6,1,September,-1.0,-1.8369701987210287e-16,1,28,1,1,0,1.5,0.5,8,5,3,16,6,10,"September, 1996"
1996-1997,6,1996-09-22,Tottenham,Leicester,1,2,A,0,3,1,1,3,2,1,2,12,17,8,5,5,3,September,-1.0,-1.8369701987210287e-16,42,24,0,0,0,0.0,0.0,5,4,1,3,8,-5,"September, 1996"
1996-1997,6,1996-09-23,Wimbledon,Southampton,3,1,H,3,0,2,1,2,3,1,1,11,19,9,2,8,7,September,-1.0,-1.8369701987210287e-16,47,38,0,1,1,0.5,1.0,7,6,1,5,9,-4,"September, 1996"
1996-1997,7,1996-09-28,Southampton,Middlesbrough,4,0,H,3,0,3,1,1,1,3,1,20,9,2,11,11,9,September,-1.0,-1.8369701987210287e-16,38,29,1,1,0,1.0,0.5,6,12,-6,14,9,5,"September, 1996"
1996-1997,7,1996-09-28,Leicester,Leeds,1,0,H,3,0,2,1,2,0,4,1,15,17,8,7,2,1,September,-1.0,-1.8369701987210287e-16,24,23,0,0,0,0.0,0.0,5,9,-4,6,12,-6,"September, 1996"
1996-1997,7,1996-09-28,Everton,Sheffield Weds,2,0,H,3,0,1,2,2,1,1,3,17,7,6,13,10,7,September,-1.0,-1.8369701987210287e-16,18,37,1,1,0,3.5,2.0,6,10,-4,9,9,0,"September, 1996"
1996-1997,7,1996-09-28,Derby,Wimbledon,0,2,A,0,3,2,1,2,2,1,2,10,7,10,12,3,2,September,-1.0,-1.8369701987210287e-16,17,47,0,0,0,0.0,0.0,8,8,0,10,7,3,"September, 1996"
1996-1997,7,1996-09-28,Coventry,Blackburn,0,0,D,1,1,2,2,1,1,2,2,18,20,4,2,2,2,September,-1.0,-1.8369701987210287e-16,15,4,1,0,1,3.0,2.5,3,13,-10,5,11,-6,"September, 1996"
1996-1997,7,1996-09-28,Chelsea,Nott'm Forest,1,1,D,1,1,3,1,1,0,3,2,8,17,12,6,9,6,September,-1.0,-1.8369701987210287e-16,14,32,1,1,0,0.5,0.0,10,9,1,8,13,-5,"September, 1996"
1996-1997,7,1996-09-28,Arsenal,Sunderland,2,0,H,3,0,2,2,1,2,0,3,3,11,14,9,8,5,September,-1.0,-1.8369701987210287e-16,0,40,0,0,0,0.0,0.0,15,8,7,6,4,2,"September, 1996"
1996-1997,7,1996-09-29,Man United,Tottenham,2,0,H,3,0,2,3,0,1,1,3,5,14,13,8,9,5,September,-1.0,-1.8369701987210287e-16,28,42,1,0,1,1.0,2.0,16,6,10,6,6,0,"September, 1996"
1996-1997,7,1996-09-29,West Ham,Liverpool,1,2,A,0,3,2,2,1,1,2,2,15,1,8,17,14,9,September,-1.0,-1.8369701987210287e-16,45,25,0,1,1,0.0,1.0,6,10,-4,16,5,11,"September, 1996"
1996-1997,7,1996-09-30,Newcastle,Aston Villa,4,3,H,3,0,3,2,0,1,2,2,5,8,15,12,3,3,September,-1.0,-1.8369701987210287e-16,30,1,1,1,0,1.0,0.5,10,7,3,8,5,3,"September, 1996"
1996-1997,8,1996-10-12,Wimbledon,Sheffield Weds,4,2,H,3,0,2,1,2,1,1,3,6,7,15,13,1,2,October,-0.8660254037844386,0.5,47,37,0,1,1,1.5,2.0,12,7,5,9,11,-2,"October, 1996"
1996-1997,8,1996-10-12,Man United,Liverpool,1,0,H,3,0,2,3,0,1,2,2,4,2,16,20,2,4,October,-0.8660254037844386,0.5,28,25,0,1,1,1.0,2.0,18,6,12,18,6,12,"October, 1996"
1996-1997,8,1996-10-12,Leicester,Chelsea,1,3,A,0,3,2,1,2,3,1,1,11,6,11,13,5,2,October,-0.8660254037844386,0.5,24,14,0,0,0,0.0,0.0,6,9,-3,11,10,1,"October, 1996"
1996-1997,8,1996-10-12,Tottenham,Aston Villa,1,0,H,3,0,1,1,3,1,2,2,15,8,8,12,7,4,October,-0.8660254037844386,0.5,42,1,0,0,2,0.5,1.5,6,8,-2,11,9,2,"October, 1996"
1996-1997,8,1996-10-12,Everton,West Ham,2,1,H,3,0,1,2,2,2,2,1,13,15,9,8,2,1,October,-0.8660254037844386,0.5,18,45,1,0,1,2.0,1.0,8,10,-2,7,12,-5,"October, 1996"
1996-1997,8,1996-10-12,Derby,Newcastle,0,1,A,0,3,2,1,2,3,2,0,11,3,10,18,8,8,October,-0.8660254037844386,0.5,17,30,0,0,0,0.0,0.0,8,10,-2,14,10,4,"October, 1996"
1996-1997,8,1996-10-12,Blackburn,Arsenal,0,2,A,0,3,1,2,2,2,2,1,20,3,3,17,17,14,October,-0.8660254037844386,0.5,4,0,0,2,0,0.5,0.5,5,11,-6,17,8,9,"October, 1996"
1996-1997,8,1996-10-12,Leeds,Nott'm Forest,2,0,H,3,0,0,4,1,0,3,2,17,16,7,7,1,0,October,-0.8660254037844386,0.5,23,32,0,0,2,1.0,2.5,6,13,-7,9,14,-5,"October, 1996"
1996-1997,8,1996-10-13,Coventry,Southampton,1,1,D,1,1,2,2,1,3,1,1,19,18,5,5,1,0,October,-0.8660254037844386,0.5,15,38,0,1,1,0.5,1.0,3,13,-10,10,12,-2,"October, 1996"
1996-1997,8,1996-10-14,Sunderland,Middlesbrough,2,2,D,1,1,2,0,3,1,3,1,15,10,9,11,5,2,October,-0.8660254037844386,0.5,40,29,0,0,0,0.0,0.0,6,6,0,14,13,1,"October, 1996"
1996-1997,9,1996-10-19,West Ham,Leicester,1,0,H,3,0,2,2,1,2,1,2,17,13,8,11,4,3,October,-0.8660254037844386,0.5,45,24,0,0,0,0.0,0.0,8,14,-6,7,12,-5,"October, 1996"
1996-1997,9,1996-10-19,Southampton,Sunderland,3,0,H,3,0,3,1,1,2,0,3,19,14,6,10,5,4,October,-0.8660254037844386,0.5,38,40,0,0,0,0.0,0.0,11,13,-2,8,8,0,"October, 1996"
1996-1997,9,1996-10-19,Nott'm Forest,Derby,1,1,D,1,1,0,3,2,2,1,2,17,14,7,10,3,3,October,-0.8660254037844386,0.5,32,17,0,0,0,0.0,0.0,9,16,-7,8,11,-3,"October, 1996"
1996-1997,9,1996-10-19,Sheffield Weds,Blackburn,1,1,D,1,1,1,1,3,1,2,2,9,20,13,3,11,10,October,-0.8660254037844386,0.5,37,4,1,0,1,1.0,2.0,11,15,-4,5,13,-8,"October, 1996"
1996-1997,9,1996-10-19,Chelsea,Wimbledon,2,4,A,0,3,3,1,1,2,1,2,6,5,16,18,1,2,October,-0.8660254037844386,0.5,14,47,0,1,1,1.0,1.5,14,11,3,16,9,7,"October, 1996"
1996-1997,9,1996-10-19,Aston Villa,Leeds,2,0,H,3,0,1,2,2,0,4,1,9,15,12,10,6,2,October,-0.8660254037844386,0.5,1,23,1,0,1,1.5,1.0,11,10,1,8,13,-5,"October, 1996"
1996-1997,9,1996-10-19,Arsenal,Coventry,0,0,D,1,1,2,2,1,2,2,1,2,19,20,6,17,14,October,-0.8660254037844386,0.5,0,15,0,2,0,0.5,0.5,19,8,11,4,14,-10,"October, 1996"
1996-1997,9,1996-10-19,Middlesbrough,Tottenham,0,3,A,0,3,1,3,1,1,1,3,9,11,12,11,2,1,October,-0.8660254037844386,0.5,29,42,0,1,1,0.5,1.0,16,15,1,7,8,-1,"October, 1996"
1996-1997,9,1996-10-20,Newcastle,Man United,5,0,H,3,0,3,2,0,2,3,0,3,5,21,19,2,2,October,-0.8660254037844386,0.5,30,28,0,0,2,0.0,1.5,15,10,5,19,6,13,"October, 1996"
1996-1997,10,1996-10-26,West Ham,Blackburn,2,1,H,3,0,2,2,1,1,2,2,16,20,11,4,4,7,October,-0.8660254037844386,0.5,45,4,0,1,1,1.5,2.5,9,14,-5,6,14,-8,"October, 1996"
1996-1997,10,1996-10-26,Arsenal,Leeds,3,0,H,3,0,2,2,1,0,4,1,2,16,21,10,14,11,October,-0.8660254037844386,0.5,0,23,2,0,0,2.5,0.5,19,8,11,8,15,-7,"October, 1996"
1996-1997,10,1996-10-26,Chelsea,Tottenham,3,1,H,3,0,3,1,1,1,1,3,6,8,16,14,2,2,October,-0.8660254037844386,0.5,14,42,0,2,0,0.5,0.5,16,15,1,10,8,2,"October, 1996"
1996-1997,10,1996-10-26,Coventry,Sheffield Weds,0,0,D,1,1,2,2,1,1,1,3,19,9,7,14,10,7,October,-0.8660254037844386,0.5,15,37,0,0,2,1.5,2.5,4,14,-10,12,16,-4,"October, 1996"
1996-1997,10,1996-10-26,Leicester,Newcastle,2,0,H,3,0,2,1,2,3,2,0,14,2,11,24,12,13,October,-0.8660254037844386,0.5,24,30,0,0,0,0.0,0.0,7,13,-6,20,10,10,"October, 1996"
1996-1997,10,1996-10-26,Middlesbrough,Wimbledon,0,0,D,1,1,1,3,1,2,1,2,12,3,12,21,9,9,October,-0.8660254037844386,0.5,29,47,0,1,1,0.5,1.0,16,18,-2,20,11,9,"October, 1996"
1996-1997,10,1996-10-26,Southampton,Man United,6,3,H,3,0,3,1,1,2,3,0,17,5,9,19,12,10,October,-0.8660254037844386,0.5,38,28,1,0,1,2.0,2.5,14,13,1,19,11,8,"October, 1996"
1996-1997,10,1996-10-26,Sunderland,Aston Villa,1,0,H,3,0,2,0,3,1,2,2,16,7,10,15,9,5,October,-0.8660254037844386,0.5,40,1,0,0,0,0.0,0.0,8,11,-3,13,10,3,"October, 1996"
1996-1997,10,1996-10-27,Liverpool,Derby,2,1,H,3,0,1,2,2,2,1,2,4,16,20,11,12,9,October,-0.8660254037844386,0.5,25,17,0,0,0,0.0,0.0,18,7,11,9,12,-3,"October, 1996"
1996-1997,10,1996-10-28,Nott'm Forest,Everton,0,1,A,0,3,0,3,2,1,2,2,18,15,8,12,3,4,October,-0.8660254037844386,0.5,32,18,1,0,1,1.5,2.5,10,17,-7,10,11,-1,"October, 1996"
1996-1997,11,1996-11-02,Aston Villa,Nott'm Forest,2,0,H,3,0,1,2,2,0,3,2,7,18,15,8,11,7,November,-0.5000000000000004,0.8660254037844384,1,32,0,2,0,1.0,1.0,13,11,2,10,18,-8,"November, 1996"
1996-1997,11,1996-11-02,Derby,Leicester,2,0,H,3,0,2,1,2,2,1,2,16,12,11,14,4,3,November,-0.5000000000000004,0.8660254037844384,17,24,0,0,0,0.0,0.0,10,14,-4,9,13,-4,"November, 1996"
1996-1997,11,1996-11-02,Leeds,Sunderland,3,0,H,3,0,0,4,1,2,0,3,17,15,10,13,2,3,November,-0.5000000000000004,0.8660254037844384,23,40,0,0,0,0.0,0.0,8,18,-10,9,11,-2,"November, 1996"
1996-1997,11,1996-11-02,Man United,Chelsea,1,2,A,0,3,2,3,0,3,1,1,5,6,19,19,1,0,November,-0.5000000000000004,0.8660254037844384,28,14,1,1,0,2.5,1.0,22,17,5,19,16,3,"November, 1996"
1996-1997,11,1996-11-02,Sheffield Weds,Southampton,1,1,D,1,1,1,1,3,3,1,1,9,17,15,12,8,3,November,-0.5000000000000004,0.8660254037844384,37,38,1,1,0,1.5,1.0,12,16,-4,20,16,4,"November, 1996"
1996-1997,11,1996-11-02,Tottenham,West Ham,1,0,H,3,0,1,1,3,2,2,1,10,12,14,14,2,0,November,-0.5000000000000004,0.8660254037844384,42,45,0,1,1,0.5,1.0,11,11,0,11,15,-4,"November, 1996"
1996-1997,11,1996-11-02,Wimbledon,Arsenal,2,2,D,1,1,2,1,2,2,2,1,4,1,22,24,3,2,November,-0.5000000000000004,0.8660254037844384,47,0,1,0,1,1.5,2.0,20,11,9,22,8,14,"November, 1996"
1996-1997,11,1996-11-03,Blackburn,Liverpool,3,0,H,3,0,1,2,2,1,2,2,20,3,4,23,17,19,November,-0.5000000000000004,0.8660254037844384,4,25,0,0,2,1.0,3.0,7,16,-9,20,8,12,"November, 1996"
1996-1997,11,1996-11-03,Newcastle,Middlesbrough,3,1,H,3,0,3,2,0,1,3,1,2,15,24,13,13,11,November,-0.5000000000000004,0.8660254037844384,30,29,2,0,0,1.5,0.5,20,12,8,16,18,-2,"November, 1996"
1996-1997,11,1996-11-04,Everton,Coventry,1,1,D,1,1,1,2,2,2,2,1,10,19,15,8,9,7,November,-0.5000000000000004,0.8660254037844384,18,15,0,1,1,1.5,2.0,11,11,0,4,14,-10,"November, 1996"
1996-1997,12,1996-11-16,Wimbledon,Coventry,2,2,D,1,1,2,1,2,2,2,1,4,18,23,9,14,14,November,-0.5000000000000004,0.8660254037844384,47,15,0,1,1,1.5,2.5,22,13,9,5,15,-10,"November, 1996"
1996-1997,12,1996-11-16,Tottenham,Sunderland,2,0,H,3,0,1,1,3,2,0,3,9,16,17,13,7,4,November,-0.5000000000000004,0.8660254037844384,42,40,0,0,0,0.0,0.0,12,11,1,9,14,-5,"November, 1996"
1996-1997,12,1996-11-16,Newcastle,West Ham,1,1,D,1,1,3,2,0,2,2,1,1,13,27,14,12,13,November,-0.5000000000000004,0.8660254037844384,30,45,1,0,1,1.5,1.0,23,13,10,11,16,-5,"November, 1996"
1996-1997,12,1996-11-16,Man United,Arsenal,1,0,H,3,0,2,3,0,2,2,1,7,3,19,25,4,6,November,-0.5000000000000004,0.8660254037844384,28,0,1,0,1,0.5,0.5,23,19,4,24,10,14,"November, 1996"
1996-1997,12,1996-11-16,Everton,Southampton,7,1,H,3,0,1,2,2,3,1,1,10,14,16,13,4,3,November,-0.5000000000000004,0.8660254037844384,18,38,1,1,0,2.0,1.0,12,12,0,21,17,4,"November, 1996"
1996-1997,12,1996-11-16,Blackburn,Chelsea,1,1,D,1,1,1,2,2,3,1,1,20,5,7,22,15,15,November,-0.5000000000000004,0.8660254037844384,4,14,2,0,0,3.0,1.0,10,16,-6,21,17,4,"November, 1996"
1996-1997,12,1996-11-16,Aston Villa,Leicester,1,3,A,0,3,1,2,2,2,1,2,7,13,18,14,6,4,November,-0.5000000000000004,0.8660254037844384,1,24,0,0,0,0.0,0.0,15,11,4,9,15,-6,"November, 1996"
1996-1997,12,1996-11-16,Leeds,Liverpool,0,2,A,0,3,0,4,1,1,2,2,17,4,13,23,13,10,November,-0.5000000000000004,0.8660254037844384,23,25,1,0,1,0.5,2.5,11,18,-7,20,11,9,"November, 1996"
1996-1997,12,1996-11-17,Derby,Middlesbrough,2,1,H,3,0,2,1,2,1,3,1,13,15,14,13,2,1,November,-0.5000000000000004,0.8660254037844384,17,29,0,0,0,0.0,0.0,12,14,-2,17,21,-4,"November, 1996"
1996-1997,12,1996-11-18,Sheffield Weds,Nott'm Forest,2,0,H,3,0,1,1,3,0,3,2,12,20,16,8,8,8,November,-0.5000000000000004,0.8660254037844384,37,32,0,0,2,0.5,2.0,13,17,-4,10,20,-10,"November, 1996"
1996-1997,12,1996-11-20,Liverpool,Everton,1,1,D,1,1,1,2,2,1,2,2,2,8,26,19,6,7,November,-0.5000000000000004,0.8660254037844384,25,18,0,1,1,1.0,1.5,22,11,11,19,13,6,"November, 1996"
1996-1997,13,1996-11-23,Southampton,Leeds,0,2,A,0,3,3,1,1,0,4,1,15,17,13,13,2,0,November,-0.5000000000000004,0.8660254037844384,38,23,0,1,1,0.5,1.0,22,24,-2,11,20,-9,"November, 1996"
1996-1997,13,1996-11-23,West Ham,Derby,1,1,D,1,1,2,2,1,2,1,2,14,11,15,17,3,2,November,-0.5000000000000004,0.8660254037844384,45,17,0,0,0,0.0,0.0,12,17,-5,14,15,-1,"November, 1996"
1996-1997,13,1996-11-23,Sunderland,Sheffield Weds,1,1,D,1,1,2,0,3,1,1,3,17,10,13,19,7,6,November,-0.5000000000000004,0.8660254037844384,40,37,0,0,0,0.0,0.0,9,16,-7,15,17,-2,"November, 1996"
1996-1997,13,1996-11-23,Middlesbrough,Man United,2,2,D,1,1,1,3,1,2,3,0,15,7,13,22,8,9,November,-0.5000000000000004,0.8660254037844384,29,28,0,0,2,0.0,2.5,18,23,-5,24,19,5,"November, 1996"
1996-1997,13,1996-11-23,Chelsea,Newcastle,1,1,D,1,1,3,1,1,3,2,0,5,1,23,28,4,5,November,-0.5000000000000004,0.8660254037844384,14,30,1,0,1,0.5,1.0,22,18,4,24,14,10,"November, 1996"
1996-1997,13,1996-11-23,Leicester,Everton,1,2,A,0,3,2,1,2,1,2,2,12,8,17,20,4,3,November,-0.5000000000000004,0.8660254037844384,24,18,0,0,0,0.0,0.0,12,16,-4,20,14,6,"November, 1996"
1996-1997,13,1996-11-23,Coventry,Aston Villa,1,2,A,0,3,2,2,1,1,2,2,18,10,10,18,8,8,November,-0.5000000000000004,0.8660254037844384,15,1,0,0,2,0.5,3.5,7,17,-10,16,14,2,"November, 1996"
1996-1997,13,1996-11-23,Liverpool,Wimbledon,1,1,D,1,1,1,2,2,2,1,2,2,4,27,24,2,3,November,-0.5000000000000004,0.8660254037844384,25,47,0,1,1,1.0,1.5,23,12,11,24,15,9,"November, 1996"
1996-1997,13,1996-11-24,Arsenal,Tottenham,3,1,H,3,0,2,2,1,1,1,3,3,9,25,20,6,5,November,-0.5000000000000004,0.8660254037844384,0,42,0,1,1,0.5,1.0,24,11,13,14,11,3,"November, 1996"
1996-1997,13,1996-11-25,Nott'm Forest,Blackburn,2,2,D,1,1,0,3,2,1,2,2,20,19,8,8,1,0,November,-0.5000000000000004,0.8660254037844384,32,4,0,0,2,0.5,6.0,10,22,-12,11,17,-6,"November, 1996"
1996-1997,14,1996-11-30,Wimbledon,Nott'm Forest,1,0,H,3,0,2,1,2,0,3,2,5,20,25,9,15,16,November,-0.5000000000000004,0.8660254037844384,47,32,1,0,1,1.0,2.0,25,16,9,12,24,-12,"November, 1996"
1996-1997,14,1996-11-30,Sheffield Weds,West Ham,0,0,D,1,1,1,1,3,2,2,1,11,14,20,16,3,4,November,-0.5000000000000004,0.8660254037844384,37,45,0,1,1,0.5,1.0,16,18,-2,13,18,-5,"November, 1996"
1996-1997,14,1996-11-30,Newcastle,Arsenal,1,2,A,0,3,3,2,0,2,2,1,1,2,29,28,1,1,November,-0.5000000000000004,0.8660254037844384,30,0,1,0,1,1.0,1.0,25,15,10,27,12,15,"November, 1996"
1996-1997,14,1996-11-30,Man United,Leicester,3,1,H,3,0,2,3,0,2,1,2,7,12,23,17,5,6,November,-0.5000000000000004,0.8660254037844384,28,24,0,0,0,0.0,0.0,26,21,5,13,18,-5,"November, 1996"
1996-1997,14,1996-11-30,Everton,Sunderland,1,3,A,0,3,1,2,2,2,0,3,7,16,23,14,9,9,November,-0.5000000000000004,0.8660254037844384,18,40,0,0,0,0.0,0.0,22,15,7,10,17,-7,"November, 1996"
1996-1997,14,1996-11-30,Blackburn,Southampton,2,1,H,3,0,1,2,2,3,1,1,19,17,9,13,2,4,November,-0.5000000000000004,0.8660254037844384,4,38,1,0,1,1.0,1.0,13,19,-6,22,26,-4,"November, 1996"
1996-1997,14,1996-11-30,Aston Villa,Middlesbrough,1,0,H,3,0,1,2,2,1,3,1,8,15,21,14,7,7,November,-0.5000000000000004,0.8660254037844384,1,29,1,1,0,1.0,0.0,18,15,3,20,25,-5,"November, 1996"
1996-1997,14,1996-11-30,Derby,Coventry,2,1,H,3,0,2,1,2,2,2,1,11,19,18,10,8,8,November,-0.5000000000000004,0.8660254037844384,17,15,0,0,0,0.0,0.0,15,16,-1,8,19,-11,"November, 1996"
1996-1997,14,1996-12-01,Leeds,Chelsea,2,0,H,3,0,0,4,1,3,1,1,15,6,16,24,9,8,December,-2.4492935982947064e-16,1.0,23,14,1,0,1,1.0,2.0,13,20,-7,23,19,4,"December, 1996"
1996-1997,14,1996-12-02,Tottenham,Liverpool,0,2,A,0,3,1,1,3,1,2,2,11,3,20,28,8,8,December,-2.4492935982947064e-16,1.0,42,25,0,1,1,0.5,1.5,15,14,1,24,13,11,"December, 1996"
1996-1997,14,1996-12-03,Middlesbrough,Leicester,0,2,A,0,3,1,3,1,2,1,2,16,15,14,17,1,3,December,-2.4492935982947064e-16,1.0,29,24,0,0,0,0.0,0.0,20,26,-6,14,21,-7,"December, 1996"
1996-1997,14,1996-12-04,West Ham,Aston Villa,0,2,A,0,3,2,2,1,1,2,2,15,6,17,24,9,7,December,-2.4492935982947064e-16,1.0,45,1,0,1,1,1.0,2.5,13,18,-5,19,15,4,"December, 1996"
1996-1997,14,1996-12-04,Arsenal,Southampton,3,1,H,3,0,2,2,1,3,1,1,1,17,31,13,16,18,December,-2.4492935982947064e-16,1.0,0,38,1,1,0,2.0,1.0,29,13,16,23,28,-5,"December, 1996"
1996-1997,15,1996-12-07,Arsenal,Derby,2,2,D,1,1,2,2,1,2,1,2,1,9,34,21,8,13,December,-2.4492935982947064e-16,1.0,0,17,0,0,0,0.0,0.0,32,14,18,17,17,0,"December, 1996"
1996-1997,15,1996-12-07,Chelsea,Everton,2,2,D,1,1,3,1,1,1,2,2,7,8,24,23,1,1,December,-2.4492935982947064e-16,1.0,14,18,0,2,0,0.5,0.5,23,21,2,23,18,5,"December, 1996"
1996-1997,15,1996-12-07,Coventry,Tottenham,1,2,A,0,3,2,2,1,1,1,3,19,11,10,20,8,10,December,-2.4492935982947064e-16,1.0,15,42,0,0,2,1.5,3.0,9,21,-12,15,16,-1,"December, 1996"
1996-1997,15,1996-12-07,Leicester,Blackburn,1,1,D,1,1,2,1,2,1,2,2,12,18,20,12,6,8,December,-2.4492935982947064e-16,1.0,24,4,0,0,0,0.0,0.0,16,21,-5,15,20,-5,"December, 1996"
1996-1997,15,1996-12-07,Liverpool,Sheffield Weds,0,1,A,0,3,1,2,2,1,1,3,2,11,31,21,9,10,December,-2.4492935982947064e-16,1.0,25,37,1,1,0,1.0,0.5,26,13,13,16,18,-2,"December, 1996"
1996-1997,15,1996-12-07,Middlesbrough,Leeds,0,0,D,1,1,1,3,1,0,4,1,16,13,14,19,3,5,December,-2.4492935982947064e-16,1.0,29,23,1,1,0,1.0,0.5,20,28,-8,15,20,-5,"December, 1996"
1996-1997,15,1996-12-07,Southampton,Aston Villa,0,1,A,0,3,3,1,1,1,2,2,18,5,13,27,13,14,December,-2.4492935982947064e-16,1.0,38,1,0,0,2,0.0,2.0,24,31,-7,21,15,6,"December, 1996"
1996-1997,15,1996-12-07,Sunderland,Wimbledon,1,3,A,0,3,2,0,3,2,1,2,14,5,17,28,9,11,December,-2.4492935982947064e-16,1.0,40,47,0,0,0,0.0,0.0,13,18,-5,26,16,10,"December, 1996"
1996-1997,15,1996-12-08,West Ham,Man United,2,2,D,1,1,2,2,1,2,3,0,15,6,17,26,9,9,December,-2.4492935982947064e-16,1.0,45,28,0,0,2,0.5,1.5,13,20,-7,29,22,7,"December, 1996"
1996-1997,15,1996-12-09,Nott'm Forest,Newcastle,0,0,D,1,1,0,3,2,3,2,0,20,5,9,29,15,20,December,-2.4492935982947064e-16,1.0,32,30,0,1,1,1.0,2.0,12,25,-13,26,17,9,"December, 1996"
1996-1997,16,1996-12-14,Wimbledon,Blackburn,1,0,H,3,0,2,1,2,1,2,2,3,17,31,13,14,18,December,-2.4492935982947064e-16,1.0,47,4,0,1,1,1.5,2.0,29,17,12,16,21,-5,"December, 1996"
1996-1997,16,1996-12-14,Leeds,Tottenham,0,0,D,1,1,0,4,1,1,1,3,13,10,20,23,3,3,December,-2.4492935982947064e-16,1.0,23,42,0,0,2,1.0,2.5,15,20,-5,17,17,0,"December, 1996"
1996-1997,16,1996-12-14,Liverpool,Middlesbrough,5,1,H,3,0,1,2,2,1,3,1,3,16,31,15,13,16,December,-2.4492935982947064e-16,1.0,25,29,1,1,1,1.6666666666666667,1.6666666666666667,26,14,12,20,28,-8,"December, 1996"
1996-1997,16,1996-12-15,Sunderland,Chelsea,3,0,H,3,0,2,0,3,3,1,1,15,7,17,25,8,8,December,-2.4492935982947064e-16,1.0,40,14,0,0,0,0.0,0.0,14,21,-7,25,23,2,"December, 1996"
1996-1997,16,1996-12-16,Derby,Everton,0,1,A,0,3,2,1,2,1,2,2,11,8,22,24,3,2,December,-2.4492935982947064e-16,1.0,17,18,0,0,0,0.0,0.0,19,19,0,25,20,5,"December, 1996"
1996-1997,16,1996-12-17,Coventry,Newcastle,2,1,H,3,0,2,2,1,3,2,0,20,4,10,30,16,20,December,-2.4492935982947064e-16,1.0,15,30,0,0,2,0.0,2.0,10,23,-13,26,17,9,"December, 1996"
1996-1997,16,1996-12-17,Liverpool,Nott'm Forest,4,2,H,3,0,1,2,2,0,3,2,2,20,34,10,18,24,December,-2.4492935982947064e-16,1.0,25,32,1,0,1,2.0,1.5,31,15,16,12,25,-13,"December, 1996"
1996-1997,16,1996-12-18,Sheffield Weds,Man United,1,1,D,1,1,1,1,3,2,3,0,10,6,24,27,4,3,December,-2.4492935982947064e-16,1.0,37,28,0,2,0,1.0,1.0,17,18,-1,31,24,7,"December, 1996"
1996-1997,17,1996-12-21,Southampton,Derby,3,1,H,3,0,3,1,1,2,1,2,19,11,13,22,8,9,December,-2.4492935982947064e-16,1.0,38,17,0,0,0,0.0,0.0,24,32,-8,19,20,-1,"December, 1996"
1996-1997,17,1996-12-21,Tottenham,Sheffield Weds,1,1,D,1,1,1,1,3,1,1,3,10,9,24,25,1,1,December,-2.4492935982947064e-16,1.0,42,37,2,0,0,2.0,0.5,17,17,0,18,19,-1,"December, 1996"
1996-1997,17,1996-12-21,Nott'm Forest,Arsenal,2,1,H,3,0,0,3,2,2,2,1,20,2,10,35,18,25,December,-2.4492935982947064e-16,1.0,32,0,0,1,1,0.5,1.0,14,29,-15,34,16,18,"December, 1996"
1996-1997,17,1996-12-21,Everton,Leeds,0,0,D,1,1,1,2,2,0,4,1,8,13,27,21,5,6,December,-2.4492935982947064e-16,1.0,18,23,1,1,0,2.0,1.0,26,20,6,15,20,-5,"December, 1996"
1996-1997,17,1996-12-21,Leicester,Coventry,0,2,A,0,3,2,1,2,2,2,1,13,19,21,13,6,8,December,-2.4492935982947064e-16,1.0,24,15,0,0,0,0.0,0.0,17,22,-5,12,24,-12,"December, 1996"
1996-1997,17,1996-12-21,Chelsea,West Ham,3,1,H,3,0,3,1,1,2,2,1,8,15,25,18,7,7,December,-2.4492935982947064e-16,1.0,14,45,1,0,1,2.0,1.5,25,26,-1,15,22,-7,"December, 1996"
1996-1997,17,1996-12-21,Man United,Sunderland,5,0,H,3,0,2,3,0,2,0,3,6,14,28,20,8,8,December,-2.4492935982947064e-16,1.0,28,40,0,0,0,0.0,0.0,32,25,7,17,21,-4,"December, 1996"
1996-1997,17,1996-12-22,Aston Villa,Wimbledon,5,0,H,3,0,1,2,2,2,1,2,6,3,30,34,3,4,December,-2.4492935982947064e-16,1.0,1,47,1,1,0,2.5,1.5,22,15,7,30,17,13,"December, 1996"
1996-1997,17,1996-12-23,Newcastle,Liverpool,1,1,D,1,1,3,2,0,1,2,2,6,1,30,37,5,7,December,-2.4492935982947064e-16,1.0,30,25,1,0,1,2.5,2.5,27,19,8,35,17,18,"December, 1996"
1996-1997,18,1996-12-26,Tottenham,Southampton,3,1,H,3,0,1,1,3,3,1,1,10,19,25,16,9,9,December,-2.4492935982947064e-16,1.0,42,38,2,1,0,0.6666666666666666,0.0,18,18,0,27,33,-6,"December, 1996"
1996-1997,18,1996-12-26,Sunderland,Derby,2,0,H,3,0,2,0,3,2,1,2,14,11,20,22,3,2,December,-2.4492935982947064e-16,1.0,40,17,0,0,1,0.0,1.0,17,26,-9,20,23,-3,"December, 1996"
1996-1997,18,1996-12-26,Sheffield Weds,Arsenal,0,0,D,1,1,1,1,3,2,2,1,9,2,26,35,7,9,December,-2.4492935982947064e-16,1.0,37,0,1,0,2,1.3333333333333333,2.6666666666666665,19,20,-1,35,18,17,"December, 1996"
1996-1997,18,1996-12-26,Nott'm Forest,Man United,0,4,A,0,3,0,3,2,2,3,0,20,5,13,31,15,18,December,-2.4492935982947064e-16,1.0,32,28,0,1,2,0.6666666666666666,3.333333333333333,16,30,-14,37,25,12,"December, 1996"
1996-1997,18,1996-12-26,Liverpool,Leicester,1,1,D,1,1,1,2,2,2,1,2,1,13,38,21,12,17,December,-2.4492935982947064e-16,1.0,25,24,1,0,0,3.0,0.0,36,18,18,17,24,-7,"December, 1996"
1996-1997,18,1996-12-26,Leeds,Coventry,1,3,A,0,3,0,4,1,2,2,1,12,18,22,16,6,6,December,-2.4492935982947064e-16,1.0,23,15,1,1,1,1.3333333333333333,1.0,15,20,-5,14,24,-10,"December, 1996"
1996-1997,18,1996-12-26,Blackburn,Newcastle,1,0,H,3,0,1,2,2,3,2,0,19,6,13,31,13,18,December,-2.4492935982947064e-16,1.0,4,30,1,0,2,1.0,1.3333333333333333,16,22,-6,28,20,8,"December, 1996"
1996-1997,18,1996-12-26,Aston Villa,Chelsea,0,2,A,0,3,1,2,2,3,1,1,4,8,33,28,4,5,December,-2.4492935982947064e-16,1.0,1,14,1,1,1,1.0,1.0,27,15,12,28,27,1,"December, 1996"
1996-1997,18,1996-12-26,Middlesbrough,Everton,4,2,H,3,0,1,3,1,1,2,2,19,8,15,28,11,13,December,-2.4492935982947064e-16,1.0,29,18,1,0,2,0.6666666666666666,2.333333333333333,21,33,-12,26,20,6,"December, 1996"
1996-1997,19,1996-12-28,Leicester,Nott'm Forest,2,2,D,1,1,2,1,2,0,3,2,14,20,22,13,6,9,December,-2.4492935982947064e-16,1.0,24,32,0,1,0,0.0,0.0,18,25,-7,16,34,-18,"December, 1996"
1996-1997,19,1996-12-28,West Ham,Sunderland,2,0,H,3,0,2,2,1,2,0,3,16,13,18,23,3,5,December,-2.4492935982947064e-16,1.0,45,40,0,1,0,0.0,0.0,16,25,-9,19,26,-7,"December, 1996"
1996-1997,19,1996-12-28,Newcastle,Tottenham,7,1,H,3,0,3,2,0,1,1,3,7,9,31,28,2,3,December,-2.4492935982947064e-16,1.0,30,42,1,2,0,1.3333333333333333,1.0,28,21,7,21,19,2,"December, 1996"
1996-1997,19,1996-12-28,Everton,Wimbledon,1,3,A,0,3,1,2,2,2,1,2,8,5,28,34,3,6,December,-2.4492935982947064e-16,1.0,18,47,1,0,2,1.6666666666666667,3.333333333333333,28,24,4,30,22,8,"December, 1996"
1996-1997,19,1996-12-28,Man United,Leeds,1,0,H,3,0,2,3,0,0,4,1,4,15,34,22,11,12,December,-2.4492935982947064e-16,1.0,28,23,2,0,1,2.0,1.0,41,25,16,16,23,-7,"December, 1996"
1996-1997,19,1996-12-28,Coventry,Middlesbrough,3,0,H,3,0,2,2,1,1,3,1,15,17,19,18,2,1,December,-2.4492935982947064e-16,1.0,15,29,0,1,2,0.3333333333333333,2.0,17,25,-8,25,35,-10,"December, 1996"
1996-1997,19,1996-12-28,Derby,Blackburn,0,0,D,1,1,2,1,2,1,2,2,13,18,22,16,5,6,December,-2.4492935982947064e-16,1.0,17,4,1,0,0,2.0,1.0,20,25,-5,17,22,-5,"December, 1996"
1996-1997,19,1996-12-28,Chelsea,Sheffield Weds,2,2,D,1,1,3,1,1,1,1,3,7,10,31,27,3,4,December,-2.4492935982947064e-16,1.0,14,37,1,2,0,0.6666666666666666,0.0,30,27,3,19,20,-1,"December, 1996"
1996-1997,19,1996-12-28,Arsenal,Aston Villa,2,2,D,1,1,2,2,1,1,2,2,2,5,36,33,3,3,December,-2.4492935982947064e-16,1.0,0,1,1,2,0,1.6666666666666667,1.0,35,18,17,27,17,10,"December, 1996"
1996-1997,19,1996-12-29,Southampton,Liverpool,0,1,A,0,3,3,1,1,1,2,2,19,1,16,39,18,23,December,-2.4492935982947064e-16,1.0,38,25,0,1,2,1.0,2.0,28,36,-8,37,19,18,"December, 1996"
1996-1997,20,1997-01-01,West Ham,Nott'm Forest,0,1,A,0,3,2,2,1,0,3,2,16,20,21,14,4,7,January,0.4999999999999999,0.8660254037844387,45,32,2,1,0,1.3333333333333333,0.3333333333333333,18,25,-7,18,36,-18,"January, 1997"
1996-1997,20,1997-01-01,Man United,Aston Villa,0,0,D,1,1,2,3,0,1,2,2,3,7,37,34,4,3,January,0.4999999999999999,0.8660254037844387,28,1,0,2,1,0.3333333333333333,1.0,42,25,17,29,19,10,"January, 1997"
1996-1997,20,1997-01-01,Everton,Blackburn,0,2,A,0,3,1,2,2,1,2,2,8,18,28,17,10,11,January,0.4999999999999999,0.8660254037844387,18,4,2,1,0,1.6666666666666667,0.3333333333333333,29,27,2,17,22,-5,"January, 1997"
1996-1997,20,1997-01-01,Newcastle,Leeds,3,0,H,3,0,3,2,0,0,4,1,7,15,34,22,8,12,January,0.4999999999999999,0.8660254037844387,30,23,3,0,0,1.3333333333333333,0.3333333333333333,35,22,13,16,24,-8,"January, 1997"
1996-1997,20,1997-01-01,Chelsea,Liverpool,1,0,H,3,0,3,1,1,1,2,2,7,1,32,42,6,10,January,0.4999999999999999,0.8660254037844387,14,25,0,1,2,1.0,3.0,32,29,3,38,19,19,"January, 1997"
1996-1997,20,1997-01-01,Arsenal,Middlesbrough,2,0,H,3,0,2,2,1,1,3,1,3,17,37,18,14,19,January,0.4999999999999999,0.8660254037844387,0,29,2,1,0,2.0,1.0,37,20,17,25,38,-13,"January, 1997"
1996-1997,20,1997-01-01,Coventry,Sunderland,2,2,D,1,1,2,2,1,2,0,3,14,13,22,23,1,1,January,0.4999999999999999,0.8660254037844387,15,40,0,0,1,0.0,1.0,20,25,-5,19,28,-9,"January, 1997"
1996-1997,21,1997-01-11,Sunderland,Arsenal,1,0,H,3,0,2,0,3,2,2,1,12,2,24,40,10,16,January,0.4999999999999999,0.8660254037844387,40,0,0,0,1,0.0,2.0,21,30,-9,39,20,19,"January, 1997"
1996-1997,21,1997-01-11,Aston Villa,Newcastle,2,2,D,1,1,1,2,2,3,2,0,6,4,35,37,2,2,January,0.4999999999999999,0.8660254037844387,1,30,0,1,2,1.3333333333333333,2.0,29,19,10,38,22,16,"January, 1997"
1996-1997,21,1997-01-11,Blackburn,Coventry,4,0,H,3,0,1,2,2,2,2,1,17,12,20,23,5,3,January,0.4999999999999999,0.8660254037844387,4,15,1,1,1,1.6666666666666667,2.0,19,22,-3,22,27,-5,"January, 1997"
1996-1997,21,1997-01-11,Leeds,Leicester,3,0,H,3,0,0,4,1,2,1,2,16,14,22,23,2,1,January,0.4999999999999999,0.8660254037844387,23,24,0,0,1,0.0,1.0,16,27,-11,20,27,-7,"January, 1997"
1996-1997,21,1997-01-11,Liverpool,West Ham,0,0,D,1,1,1,2,2,2,2,1,1,17,42,21,16,21,January,0.4999999999999999,0.8660254037844387,25,45,2,1,0,1.3333333333333333,0.3333333333333333,38,20,18,18,26,-8,"January, 1997"
1996-1997,21,1997-01-11,Middlesbrough,Southampton,0,1,A,0,3,1,3,1,3,1,1,18,20,18,16,2,2,January,0.4999999999999999,0.8660254037844387,29,38,0,1,2,0.3333333333333333,2.0,25,40,-15,28,37,-9,"January, 1997"
1996-1997,21,1997-01-11,Nott'm Forest,Chelsea,2,0,H,3,0,0,3,2,3,1,1,20,7,17,35,13,18,January,0.4999999999999999,0.8660254037844387,32,14,0,2,1,0.3333333333333333,0.6666666666666666,19,36,-17,33,29,4,"January, 1997"
1996-1997,21,1997-01-11,Sheffield Weds,Everton,2,1,H,3,0,1,1,3,1,2,2,9,8,28,28,1,0,January,0.4999999999999999,0.8660254037844387,37,18,0,1,2,1.3333333333333333,3.0,21,22,-1,29,29,0,"January, 1997"
1996-1997,21,1997-01-11,Wimbledon,Derby,1,1,D,1,1,2,1,2,2,1,2,5,14,37,23,9,14,January,0.4999999999999999,0.8660254037844387,47,17,1,0,0,2.0,0.0,33,23,10,20,25,-5,"January, 1997"
1996-1997,21,1997-01-12,Tottenham,Man United,1,2,A,0,3,1,1,3,2,3,0,10,3,28,38,7,10,January,0.4999999999999999,0.8660254037844387,42,28,1,0,2,1.3333333333333333,1.3333333333333333,22,26,-4,42,25,17,"January, 1997"
1996-1997,22,1997-01-18,Chelsea,Derby,3,1,H,3,0,3,1,1,2,1,2,7,13,35,24,6,11,January,0.4999999999999999,0.8660254037844387,14,17,0,0,0,0.0,0.0,33,31,2,21,26,-5,"January, 1997"
1996-1997,22,1997-01-18,Coventry,Man United,0,2,A,0,3,2,2,1,2,3,0,15,2,23,41,13,18,January,0.4999999999999999,0.8660254037844387,15,28,0,0,2,0.0,2.5,22,31,-9,44,26,18,"January, 1997"
1996-1997,22,1997-01-18,Leicester,Wimbledon,1,0,H,3,0,2,1,2,2,1,2,15,5,23,38,10,15,January,0.4999999999999999,0.8660254037844387,24,47,0,0,0,0.0,0.0,20,30,-10,34,24,10,"January, 1997"
1996-1997,22,1997-01-18,Liverpool,Aston Villa,3,0,H,3,0,1,2,2,1,2,2,2,7,43,36,5,7,January,0.4999999999999999,0.8660254037844387,25,1,2,0,0,2.5,0.0,38,20,18,31,21,10,"January, 1997"
1996-1997,22,1997-01-18,Middlesbrough,Sheffield Weds,4,2,H,3,0,1,3,1,1,1,3,20,8,18,31,12,13,January,0.4999999999999999,0.8660254037844387,29,37,2,0,0,2.0,0.5,25,41,-16,23,23,0,"January, 1997"
1996-1997,22,1997-01-18,Southampton,Newcastle,2,2,D,1,1,3,1,1,3,2,0,20,4,19,38,16,19,January,0.4999999999999999,0.8660254037844387,38,30,1,0,1,0.5,0.5,29,37,-8,40,24,16,"January, 1997"
1996-1997,22,1997-01-18,Sunderland,Blackburn,0,0,D,1,1,2,0,3,1,2,2,11,15,27,23,4,4,January,0.4999999999999999,0.8660254037844387,40,4,0,0,0,0.0,0.0,22,30,-8,23,22,1,"January, 1997"
1996-1997,22,1997-01-19,Arsenal,Everton,3,1,H,3,0,2,2,1,1,2,2,3,9,40,28,6,12,January,0.4999999999999999,0.8660254037844387,0,18,1,0,1,1.5,1.0,39,21,18,30,31,-1,"January, 1997"
1996-1997,22,1997-01-19,Nott'm Forest,Tottenham,2,1,H,3,0,0,3,2,1,1,3,20,10,20,28,10,8,January,0.4999999999999999,0.8660254037844387,32,42,2,0,0,1.5,0.5,21,36,-15,23,28,-5,"January, 1997"
1996-1997,22,1997-01-20,West Ham,Leeds,0,2,A,0,3,2,2,1,0,4,1,18,13,22,25,5,3,January,0.4999999999999999,0.8660254037844387,45,23,0,0,2,0.5,2.0,18,26,-8,19,27,-8,"January, 1997"
1996-1997,23,1997-01-29,West Ham,Arsenal,1,2,A,0,3,2,2,1,2,2,1,18,3,22,43,15,21,January,0.4999999999999999,0.8660254037844387,45,0,0,0,3,0.0,1.3333333333333333,18,28,-10,42,22,20,"January, 1997"
1996-1997,23,1997-01-29,Tottenham,Blackburn,2,1,H,3,0,1,1,3,1,2,2,12,16,28,24,4,4,January,0.4999999999999999,0.8660254037844387,42,4,1,0,2,1.6666666666666667,1.6666666666666667,24,30,-6,23,22,1,"January, 1997"
1996-1997,23,1997-01-29,Nott'm Forest,Coventry,0,1,A,0,3,0,3,2,2,2,1,17,16,23,23,1,0,January,0.4999999999999999,0.8660254037844387,32,15,1,2,0,1.3333333333333333,0.3333333333333333,23,37,-14,22,33,-11,"January, 1997"
1996-1997,23,1997-01-29,Newcastle,Everton,4,1,H,3,0,3,2,0,1,2,2,4,11,39,28,7,11,January,0.4999999999999999,0.8660254037844387,30,18,2,0,1,1.3333333333333333,1.0,42,26,16,31,34,-3,"January, 1997"
1996-1997,23,1997-01-29,Aston Villa,Sheffield Weds,0,1,A,0,3,1,2,2,1,1,3,7,8,36,31,1,5,January,0.4999999999999999,0.8660254037844387,1,37,1,0,2,1.3333333333333333,2.0,31,24,7,25,27,-2,"January, 1997"
1996-1997,23,1997-01-29,Leicester,Sunderland,1,1,D,1,1,2,1,2,2,0,3,13,12,26,28,1,2,January,0.4999999999999999,0.8660254037844387,24,40,0,1,0,0.0,0.0,21,30,-9,22,30,-8,"January, 1997"
1996-1997,23,1997-01-29,Leeds,Derby,0,0,D,1,1,0,4,1,2,1,2,11,15,28,24,4,4,January,0.4999999999999999,0.8660254037844387,23,17,0,1,0,3.0,3.0,21,27,-6,22,29,-7,"January, 1997"
1996-1997,23,1997-01-29,Man United,Wimbledon,2,1,H,3,0,2,3,0,2,1,2,2,5,44,38,3,6,January,0.4999999999999999,0.8660254037844387,28,47,3,0,0,3.333333333333333,1.0,46,26,20,34,25,9,"January, 1997"
1996-1997,24,1997-02-01,Man United,Southampton,2,1,H,3,0,2,3,0,3,1,1,2,20,47,20,18,27,February,0.8660254037844386,0.5000000000000001,28,38,1,0,2,2.6666666666666665,3.333333333333333,48,27,21,31,39,-8,"February, 1997"
1996-1997,24,1997-02-01,Wimbledon,Middlesbrough,1,1,D,1,1,2,1,2,1,3,1,7,19,38,21,12,17,February,0.8660254037844386,0.5000000000000001,47,29,1,2,0,0.6666666666666666,0.3333333333333333,35,27,8,29,43,-14,"February, 1997"
1996-1997,24,1997-02-01,Tottenham,Chelsea,1,2,A,0,3,1,1,3,3,1,1,10,7,31,38,3,7,February,0.8660254037844386,0.5000000000000001,42,14,0,2,1,0.6666666666666666,1.3333333333333333,26,31,-5,36,32,4,"February, 1997"
1996-1997,24,1997-02-01,Leeds,Arsenal,0,0,D,1,1,0,4,1,2,2,1,11,3,29,46,8,17,February,0.8660254037844386,0.5000000000000001,23,0,0,0,3,0.3333333333333333,2.6666666666666665,21,27,-6,44,23,21,"February, 1997"
1996-1997,24,1997-02-01,Sheffield Weds,Coventry,0,0,D,1,1,1,1,3,2,2,1,8,15,34,26,7,8,February,0.8660254037844386,0.5000000000000001,37,15,2,1,0,1.6666666666666667,1.0,26,27,-1,23,33,-10,"February, 1997"
1996-1997,24,1997-02-01,Derby,Liverpool,0,1,A,0,3,2,1,2,1,2,2,16,3,25,46,13,21,February,0.8660254037844386,0.5000000000000001,17,25,0,0,1,1.0,2.0,22,29,-7,41,20,21,"February, 1997"
1996-1997,24,1997-02-01,Everton,Nott'm Forest,2,0,H,3,0,1,2,2,0,3,2,12,17,28,23,5,5,February,0.8660254037844386,0.5000000000000001,18,32,2,0,1,2.0,1.0,32,38,-6,23,38,-15,"February, 1997"
1996-1997,24,1997-02-01,Blackburn,West Ham,2,1,H,3,0,1,2,2,2,2,1,16,18,24,22,2,2,February,0.8660254037844386,0.5000000000000001,4,45,1,1,1,2.0,1.6666666666666667,24,24,0,19,30,-11,"February, 1997"
1996-1997,24,1997-02-01,Aston Villa,Sunderland,1,0,H,3,0,1,2,2,2,0,3,7,11,36,29,4,7,February,0.8660254037844386,0.5000000000000001,1,40,0,0,1,0.0,1.0,31,25,6,23,31,-8,"February, 1997"
1996-1997,24,1997-02-02,Newcastle,Leicester,4,3,H,3,0,3,2,0,2,1,2,4,14,42,27,10,15,February,0.8660254037844386,0.5000000000000001,30,24,0,0,1,0.0,2.0,46,27,19,22,31,-9,"February, 1997"
1996-1997,24,1997-02-15,Derby,West Ham,1,0,H,3,0,2,1,2,2,2,1,16,18,25,22,2,3,February,0.8660254037844386,0.5000000000000001,17,45,0,1,0,1.0,1.0,22,30,-8,20,32,-12,"February, 1997"
1996-1997,24,1997-02-15,Tottenham,Arsenal,0,0,D,1,1,1,1,3,2,2,1,10,3,31,47,7,16,February,0.8660254037844386,0.5000000000000001,42,0,1,1,1,1.0,1.3333333333333333,27,33,-6,44,23,21,"February, 1997"
1996-1997,25,1997-02-19,Derby,Sheffield Weds,2,2,D,1,1,2,1,2,1,1,3,13,8,28,35,5,7,February,0.8660254037844386,0.5000000000000001,17,37,0,1,0,0.0,0.0,23,30,-7,26,27,-1,"February, 1997"
1996-1997,25,1997-02-19,Liverpool,Leeds,4,0,H,3,0,1,2,2,0,4,1,2,11,49,30,9,19,February,0.8660254037844386,0.5000000000000001,25,23,2,0,1,2.333333333333333,0.3333333333333333,42,20,22,21,27,-6,"February, 1997"
1996-1997,25,1997-02-19,Arsenal,Man United,1,2,A,0,3,2,2,1,2,3,0,3,1,48,50,2,2,February,0.8660254037844386,0.5000000000000001,0,28,1,0,2,0.3333333333333333,0.6666666666666666,44,23,21,50,28,22,"February, 1997"
1996-1997,25,1997-02-19,Aston Villa,Coventry,2,1,H,3,0,1,2,2,2,2,1,7,16,39,27,9,12,February,0.8660254037844386,0.5000000000000001,1,15,3,0,0,3.0,0.6666666666666666,32,25,7,23,33,-10,"February, 1997"
1996-1997,26,1997-02-22,Chelsea,Man United,1,1,D,1,1,3,1,1,2,3,0,6,1,41,53,5,12,February,0.8660254037844386,0.5000000000000001,14,28,1,1,1,1.3333333333333333,2.0,38,33,5,52,29,23,"February, 1997"
1996-1997,26,1997-02-22,Coventry,Everton,0,0,D,1,1,2,2,1,1,2,2,16,10,27,31,6,4,February,0.8660254037844386,0.5000000000000001,15,18,1,2,0,1.6666666666666667,1.3333333333333333,24,35,-11,34,38,-4,"February, 1997"
1996-1997,26,1997-02-22,Leicester,Derby,4,2,H,3,0,2,1,2,2,1,2,16,12,27,29,4,2,February,0.8660254037844386,0.5000000000000001,24,17,0,0,1,0.0,2.0,25,35,-10,25,32,-7,"February, 1997"
1996-1997,26,1997-02-22,Liverpool,Blackburn,0,0,D,1,1,1,2,2,1,2,2,2,16,52,27,14,25,February,0.8660254037844386,0.5000000000000001,25,4,2,0,1,2.0,1.6666666666666667,46,20,26,26,25,1,"February, 1997"
1996-1997,26,1997-02-22,Middlesbrough,Newcastle,0,1,A,0,3,1,3,1,3,2,0,19,4,22,45,15,23,February,0.8660254037844386,0.5000000000000001,29,30,0,0,3,0.6666666666666666,2.0,30,44,-14,50,30,20,"February, 1997"
1996-1997,26,1997-02-22,Nott'm Forest,Aston Villa,0,0,D,1,1,0,3,2,1,2,2,17,5,23,42,12,19,February,0.8660254037844386,0.5000000000000001,32,1,0,2,1,0.6666666666666666,1.3333333333333333,23,40,-17,34,26,8,"February, 1997"
1996-1997,26,1997-02-22,Southampton,Sheffield Weds,2,3,A,0,3,3,1,1,1,1,3,20,8,20,36,12,16,February,0.8660254037844386,0.5000000000000001,38,37,0,2,1,1.0,1.3333333333333333,32,41,-9,28,29,-1,"February, 1997"
1996-1997,26,1997-02-22,Sunderland,Leeds,0,1,A,0,3,2,0,3,0,4,1,14,12,29,30,2,1,February,0.8660254037844386,0.5000000000000001,40,23,0,0,1,0.0,3.0,23,32,-9,21,31,-10,"February, 1997"
1996-1997,26,1997-02-23,Arsenal,Wimbledon,0,1,A,0,3,2,2,1,2,1,2,4,7,48,39,3,9,February,0.8660254037844386,0.5000000000000001,0,47,1,1,1,2.0,1.6666666666666667,45,25,20,36,28,8,"February, 1997"
1996-1997,26,1997-02-24,West Ham,Tottenham,4,3,H,3,0,2,2,1,1,1,3,18,11,22,32,7,10,February,0.8660254037844386,0.5000000000000001,45,42,1,1,1,0.6666666666666666,0.6666666666666666,20,33,-13,27,33,-6,"February, 1997"
1996-1997,26,1997-02-26,Southampton,Wimbledon,0,0,D,1,1,3,1,1,2,1,2,20,6,20,42,14,22,February,0.8660254037844386,0.5000000000000001,38,47,1,1,1,1.0,1.3333333333333333,34,44,-10,37,28,9,"February, 1997"
1996-1997,27,1997-03-01,Blackburn,Sunderland,1,0,H,3,0,1,2,2,2,0,3,15,14,28,29,1,1,March,1.0,6.123233995736766e-17,4,40,0,1,0,0.0,0.0,26,25,1,23,33,-10,"March, 1997"
1996-1997,27,1997-03-01,Derby,Chelsea,3,2,H,3,0,2,1,2,3,1,1,14,7,29,42,7,13,March,1.0,6.123233995736766e-17,17,14,0,0,1,1.0,3.0,27,36,-9,39,34,5,"March, 1997"
1996-1997,27,1997-03-01,Everton,Arsenal,0,2,A,0,3,1,2,2,2,2,1,10,4,32,48,6,16,March,1.0,6.123233995736766e-17,18,0,1,0,2,1.0,2.0,34,38,-4,45,26,19,"March, 1997"
1996-1997,27,1997-03-01,Leeds,West Ham,1,0,H,3,0,0,4,1,2,2,1,9,17,33,25,8,8,March,1.0,6.123233995736766e-17,23,45,3,0,0,2.0,0.3333333333333333,22,31,-9,24,36,-12,"March, 1997"
1996-1997,27,1997-03-01,Man United,Coventry,3,1,H,3,0,2,3,0,2,2,1,1,16,54,28,15,26,March,1.0,6.123233995736766e-17,28,15,3,0,0,2.333333333333333,0.0,53,30,23,24,35,-11,"March, 1997"
1996-1997,27,1997-03-01,Newcastle,Southampton,0,1,A,0,3,3,2,0,3,1,1,4,20,48,21,16,27,March,1.0,6.123233995736766e-17,30,38,1,1,1,1.0,1.0,51,30,21,34,44,-10,"March, 1997"
1996-1997,27,1997-03-01,Sheffield Weds,Middlesbrough,3,1,H,3,0,1,1,3,1,3,1,8,20,39,22,12,17,March,1.0,6.123233995736766e-17,37,29,0,0,3,1.0,2.6666666666666665,31,31,0,30,45,-15,"March, 1997"
1996-1997,27,1997-03-01,Tottenham,Nott'm Forest,0,1,A,0,3,1,1,3,0,3,2,11,19,32,24,8,8,March,1.0,6.123233995736766e-17,42,32,0,0,3,0.6666666666666666,1.6666666666666667,30,37,-7,23,40,-17,"March, 1997"
1996-1997,27,1997-03-01,Wimbledon,Leicester,1,3,A,0,3,2,1,2,2,1,2,5,14,43,30,9,13,March,1.0,6.123233995736766e-17,47,24,0,0,1,0.0,1.0,37,28,9,29,37,-8,"March, 1997"
1996-1997,27,1997-03-02,Aston Villa,Liverpool,1,0,H,3,0,1,2,2,1,2,2,5,2,43,53,3,10,March,1.0,6.123233995736766e-17,1,25,0,0,3,0.0,2.6666666666666665,34,26,8,46,20,26,"March, 1997"
1996-1997,27,1997-03-03,Coventry,Wimbledon,1,1,D,1,1,2,2,1,2,1,2,16,6,28,43,10,15,March,1.0,6.123233995736766e-17,15,47,1,2,0,2.333333333333333,1.6666666666666667,25,38,-13,38,31,7,"March, 1997"
1996-1997,27,1997-03-04,Sunderland,Tottenham,0,4,A,0,3,2,0,3,1,1,3,15,13,29,32,2,3,March,1.0,6.123233995736766e-17,40,42,0,0,1,0.0,2.0,23,34,-11,30,38,-8,"March, 1997"
1996-1997,27,1997-03-05,Chelsea,Blackburn,1,1,D,1,1,3,1,1,1,2,2,7,14,42,31,7,11,March,1.0,6.123233995736766e-17,14,4,0,1,2,1.0,2.333333333333333,41,37,4,27,25,2,"March, 1997"
1996-1997,27,1997-03-05,Leicester,Aston Villa,1,0,H,3,0,2,1,2,1,2,2,11,5,33,46,6,13,March,1.0,6.123233995736766e-17,24,1,1,0,0,3.0,1.0,32,38,-6,35,26,9,"March, 1997"
1996-1997,27,1997-03-05,Middlesbrough,Derby,6,1,H,3,0,1,3,1,2,1,2,20,14,22,32,6,10,March,1.0,6.123233995736766e-17,29,17,0,0,1,1.0,2.0,31,48,-17,30,38,-8,"March, 1997"
1996-1997,27,1997-03-05,Nott'm Forest,Sheffield Weds,0,3,A,0,3,0,3,2,1,1,3,17,8,27,42,9,15,March,1.0,6.123233995736766e-17,32,37,2,0,1,1.3333333333333333,1.0,24,40,-16,34,32,2,"March, 1997"
1996-1997,27,1997-03-05,Southampton,Everton,2,2,D,1,1,3,1,1,1,2,2,20,13,24,32,7,8,March,1.0,6.123233995736766e-17,38,18,0,1,2,1.0,3.6666666666666665,35,44,-9,34,40,-6,"March, 1997"
1996-1997,28,1997-03-08,Arsenal,Nott'm Forest,2,0,H,3,0,2,2,1,0,3,2,3,17,51,27,14,24,March,1.0,6.123233995736766e-17,0,32,1,1,1,1.0,1.0,47,26,21,24,43,-19,"March, 1997"
1996-1997,28,1997-03-08,Coventry,Leicester,0,0,D,1,1,2,2,1,2,1,2,15,9,29,36,6,7,March,1.0,6.123233995736766e-17,15,24,1,0,0,2.0,0.0,26,39,-13,33,38,-5,"March, 1997"
1996-1997,28,1997-03-08,Leeds,Everton,1,0,H,3,0,0,4,1,1,2,2,10,12,36,33,2,3,March,1.0,6.123233995736766e-17,23,18,0,2,1,0.6666666666666666,1.3333333333333333,23,31,-8,36,42,-6,"March, 1997"
1996-1997,28,1997-03-08,Sunderland,Man United,2,1,H,3,0,2,0,3,2,3,0,16,1,29,57,15,28,March,1.0,6.123233995736766e-17,40,28,0,0,1,0.0,5.0,23,38,-15,56,31,25,"March, 1997"
1996-1997,29,1997-03-10,Liverpool,Newcastle,4,3,H,3,0,1,2,2,3,2,0,3,4,53,48,1,5,March,1.0,6.123233995736766e-17,25,30,1,1,1,2.0,2.0,46,21,25,51,31,20,"March, 1997"
1996-1997,29,1997-03-11,Blackburn,Nott'm Forest,1,1,D,1,1,1,2,2,0,3,2,13,17,32,27,4,5,March,1.0,6.123233995736766e-17,4,32,2,1,0,4.666666666666667,1.0,28,26,2,24,45,-21,"March, 1997"
1996-1997,29,1997-03-12,Leeds,Southampton,0,0,D,1,1,0,4,1,3,1,1,9,18,39,25,9,14,March,1.0,6.123233995736766e-17,23,38,2,1,0,1.3333333333333333,0.3333333333333333,24,31,-7,37,46,-9,"March, 1997"
1996-1997,29,1997-03-12,Sheffield Weds,Sunderland,2,1,H,3,0,1,1,3,2,0,3,6,15,45,32,9,13,March,1.0,6.123233995736766e-17,37,40,0,1,0,1.0,1.0,37,32,5,25,39,-14,"March, 1997"
1996-1997,29,1997-03-12,West Ham,Chelsea,3,2,H,3,0,2,2,1,3,1,1,20,8,25,43,12,18,March,1.0,6.123233995736766e-17,45,14,1,0,2,1.3333333333333333,2.333333333333333,24,37,-13,42,38,4,"March, 1997"
1996-1997,30,1997-03-15,Tottenham,Leeds,1,0,H,3,0,1,1,3,0,4,1,13,9,35,40,4,5,March,1.0,6.123233995736766e-17,42,23,2,1,0,1.6666666666666667,0.6666666666666666,34,38,-4,24,31,-7,"March, 1997"
1996-1997,30,1997-03-15,Southampton,Arsenal,0,2,A,0,3,3,1,1,2,2,1,20,3,26,54,17,28,March,1.0,6.123233995736766e-17,38,0,0,1,2,1.0,2.333333333333333,37,46,-9,49,26,23,"March, 1997"
1996-1997,30,1997-03-15,Newcastle,Coventry,4,0,H,3,0,3,2,0,2,2,1,4,16,48,30,12,18,March,1.0,6.123233995736766e-17,30,15,2,0,1,1.6666666666666667,0.6666666666666666,54,35,19,26,39,-13,"March, 1997"
1996-1997,30,1997-03-15,Man United,Sheffield Weds,2,0,H,3,0,2,3,0,1,1,3,1,5,57,48,4,9,March,1.0,6.123233995736766e-17,28,37,0,3,0,1.0,1.0,57,33,24,39,33,6,"March, 1997"
1996-1997,30,1997-03-15,Nott'm Forest,Liverpool,1,1,D,1,1,0,3,2,1,2,2,19,2,28,56,17,28,March,1.0,6.123233995736766e-17,32,25,1,0,2,1.6666666666666667,2.6666666666666665,25,46,-21,50,24,26,"March, 1997"
1996-1997,30,1997-03-15,Everton,Derby,1,0,H,3,0,1,2,2,2,1,2,13,14,33,32,1,1,March,1.0,6.123233995736766e-17,18,17,1,0,0,1.0,0.0,36,43,-7,31,44,-13,"March, 1997"
1996-1997,30,1997-03-15,Blackburn,Wimbledon,3,1,H,3,0,1,2,2,2,1,2,12,7,33,44,5,11,March,1.0,6.123233995736766e-17,4,47,1,1,1,1.3333333333333333,1.3333333333333333,29,27,2,39,32,7,"March, 1997"
1996-1997,30,1997-03-15,Aston Villa,West Ham,0,0,D,1,1,1,2,2,2,2,1,6,17,46,28,11,18,March,1.0,6.123233995736766e-17,1,45,2,1,0,2.333333333333333,0.6666666666666666,35,27,8,27,39,-12,"March, 1997"
1996-1997,30,1997-03-15,Leicester,Middlesbrough,1,3,A,0,3,2,1,2,1,3,1,10,20,37,25,10,12,March,1.0,6.123233995736766e-17,24,29,1,0,0,2.0,0.0,33,38,-5,37,49,-12,"March, 1997"
1996-1997,30,1997-03-16,Chelsea,Sunderland,6,2,H,3,0,3,1,1,2,0,3,8,15,43,32,7,11,March,1.0,6.123233995736766e-17,14,40,0,0,1,0.0,3.0,44,41,3,26,41,-15,"March, 1997"
1996-1997,31,1997-03-18,Wimbledon,West Ham,1,1,D,1,1,2,1,2,2,2,1,8,17,44,29,9,15,March,1.0,6.123233995736766e-17,47,45,1,1,1,1.0,0.6666666666666666,40,35,5,27,39,-12,"March, 1997"
1996-1997,31,1997-03-19,Chelsea,Southampton,1,0,H,3,0,3,1,1,3,1,1,7,20,46,26,13,20,March,1.0,6.123233995736766e-17,14,38,2,1,0,2.0,0.6666666666666666,50,43,7,37,48,-11,"March, 1997"
1996-1997,31,1997-03-19,Leicester,Tottenham,1,1,D,1,1,2,1,2,1,1,3,11,10,37,38,1,1,March,1.0,6.123233995736766e-17,24,42,1,0,0,2.0,1.0,34,41,-7,35,38,-3,"March, 1997"
1996-1997,31,1997-03-19,Middlesbrough,Blackburn,2,1,H,3,0,1,3,1,1,2,2,19,12,28,36,7,8,March,1.0,6.123233995736766e-17,29,4,1,0,1,1.0,0.5,40,50,-10,32,28,4,"March, 1997"
1996-1997,32,1997-03-22,Southampton,Leicester,2,2,D,1,1,3,1,1,2,1,2,20,11,26,38,9,12,March,1.0,6.123233995736766e-17,38,24,0,0,1,1.0,2.0,37,49,-12,35,42,-7,"March, 1997"
1996-1997,32,1997-03-22,Sunderland,Nott'm Forest,1,1,D,1,1,2,0,3,0,3,2,17,19,32,29,2,3,March,1.0,6.123233995736766e-17,40,32,1,0,0,4.0,1.0,28,47,-19,26,47,-21,"March, 1997"
1996-1997,32,1997-03-22,Sheffield Weds,Leeds,2,2,D,1,1,1,1,3,0,4,1,7,9,48,40,2,8,March,1.0,6.123233995736766e-17,37,23,2,0,1,2.6666666666666665,1.3333333333333333,39,35,4,24,32,-8,"March, 1997"
1996-1997,32,1997-03-22,Middlesbrough,Chelsea,1,0,H,3,0,1,3,1,3,1,1,17,6,31,49,11,18,March,1.0,6.123233995736766e-17,29,14,1,0,2,0.6666666666666666,2.0,42,51,-9,51,43,8,"March, 1997"
1996-1997,32,1997-03-22,Derby,Tottenham,4,2,H,3,0,2,1,2,1,1,3,15,10,32,39,5,7,March,1.0,6.123233995736766e-17,17,42,0,1,0,1.0,1.0,31,45,-14,36,39,-3,"March, 1997"
1996-1997,32,1997-03-22,Coventry,West Ham,1,3,A,0,3,2,2,1,2,2,1,18,17,30,30,1,0,March,1.0,6.123233995736766e-17,15,45,0,2,1,1.6666666666666667,2.0,26,43,-17,28,40,-12,"March, 1997"
1996-1997,32,1997-03-22,Blackburn,Aston Villa,0,2,A,0,3,1,2,2,1,2,2,12,7,36,47,5,11,March,1.0,6.123233995736766e-17,4,1,0,1,2,0.3333333333333333,1.3333333333333333,33,30,3,35,27,8,"March, 1997"
1996-1997,32,1997-03-22,Everton,Man United,0,2,A,0,3,1,2,2,2,3,0,13,1,36,60,12,24,March,1.0,6.123233995736766e-17,18,28,0,1,2,1.3333333333333333,2.333333333333333,37,43,-6,59,33,26,"March, 1997"
1996-1997,32,1997-03-23,Wimbledon,Newcastle,1,1,D,1,1,2,1,2,3,2,0,8,4,45,51,4,6,March,1.0,6.123233995736766e-17,47,30,0,1,2,1.3333333333333333,3.6666666666666665,41,36,5,58,35,23,"March, 1997"
1996-1997,32,1997-03-24,Arsenal,Liverpool,1,2,A,0,3,2,2,1,1,2,2,3,2,57,57,1,0,March,1.0,6.123233995736766e-17,0,25,0,1,2,0.3333333333333333,1.6666666666666667,51,26,25,51,25,26,"March, 1997"
1996-1997,32,1997-03-24,Middlesbrough,Nott'm Forest,1,1,D,1,1,1,3,1,0,3,2,15,19,34,30,4,4,March,1.0,6.123233995736766e-17,29,32,0,2,1,0.6666666666666666,1.0,43,51,-8,27,48,-21,"March, 1997"
1996-1997,33,1997-04-05,Nott'm Forest,Southampton,1,3,A,0,3,0,3,2,3,1,1,18,20,31,27,2,4,April,0.8660254037844388,-0.4999999999999998,32,38,2,1,0,2.333333333333333,1.6666666666666667,28,49,-21,39,51,-12,"April, 1997"
1996-1997,33,1997-04-05,Tottenham,Wimbledon,1,0,H,3,0,1,1,3,2,1,2,10,8,39,46,2,7,April,0.8660254037844388,-0.4999999999999998,42,47,2,0,1,1.3333333333333333,0.6666666666666666,38,43,-5,42,37,5,"April, 1997"
1996-1997,33,1997-04-05,Newcastle,Sunderland,1,1,D,1,1,3,2,0,2,0,3,5,17,52,33,12,19,April,0.8660254037844388,-0.4999999999999998,30,40,1,0,0,2.0,1.0,59,36,23,29,48,-19,"April, 1997"
1996-1997,33,1997-04-05,Chelsea,Arsenal,0,3,A,0,3,3,1,1,2,2,1,6,3,49,57,3,8,April,0.8660254037844388,-0.4999999999999998,14,0,1,2,0,1.6666666666666667,1.3333333333333333,51,44,7,52,28,24,"April, 1997"
1996-1997,33,1997-04-05,Aston Villa,Everton,3,1,H,3,0,1,2,2,1,2,2,5,13,50,36,8,14,April,0.8660254037844388,-0.4999999999999998,1,18,2,0,1,0.6666666666666666,0.3333333333333333,37,27,10,37,45,-8,"April, 1997"
1996-1997,33,1997-04-05,Man United,Derby,2,3,A,0,3,2,3,0,2,1,2,1,15,63,35,14,28,April,0.8660254037844388,-0.4999999999999998,28,17,0,1,0,1.0,1.0,61,33,28,35,47,-12,"April, 1997"
1996-1997,33,1997-04-06,Liverpool,Coventry,1,2,A,0,3,1,2,2,2,2,1,3,20,60,30,17,30,April,0.8660254037844388,-0.4999999999999998,25,15,1,1,1,0.3333333333333333,0.3333333333333333,53,26,27,27,46,-19,"April, 1997"
1996-1997,33,1997-04-07,Leeds,Blackburn,0,0,D,1,1,0,4,1,1,2,2,10,13,41,36,3,5,April,0.8660254037844388,-0.4999999999999998,23,4,1,1,1,0.3333333333333333,0.3333333333333333,26,34,-8,33,32,1,"April, 1997"
1996-1997,34,1997-04-09,West Ham,Middlesbrough,0,0,D,1,1,2,2,1,1,3,1,18,16,33,35,2,2,April,0.8660254037844388,-0.4999999999999998,45,29,1,0,2,1.6666666666666667,2.6666666666666665,31,41,-10,44,52,-8,"April, 1997"
1996-1997,34,1997-04-09,Coventry,Chelsea,3,1,H,3,0,2,2,1,3,1,1,18,6,33,49,12,16,April,0.8660254037844388,-0.4999999999999998,15,14,1,1,1,1.0,1.3333333333333333,29,47,-18,51,47,4,"April, 1997"
1996-1997,34,1997-04-09,Derby,Southampton,1,1,D,1,1,2,1,2,3,1,1,12,20,38,30,8,8,April,0.8660254037844388,-0.4999999999999998,17,38,0,0,1,1.0,3.0,38,49,-11,42,52,-10,"April, 1997"
1996-1997,34,1997-04-09,Everton,Leicester,1,1,D,1,1,1,2,2,2,1,2,14,11,36,39,3,3,April,0.8660254037844388,-0.4999999999999998,18,24,1,0,0,2.0,1.0,38,48,-10,37,44,-7,"April, 1997"
1996-1997,34,1997-04-09,Sheffield Weds,Tottenham,2,1,H,3,0,1,1,3,1,1,3,6,9,49,42,3,7,April,0.8660254037844388,-0.4999999999999998,37,42,0,1,2,0.6666666666666666,1.6666666666666667,41,37,4,39,43,-4,"April, 1997"
1996-1997,34,1997-04-09,Wimbledon,Aston Villa,0,2,A,0,3,2,1,2,1,2,2,8,5,46,53,3,7,April,0.8660254037844388,-0.4999999999999998,47,1,0,1,2,1.0,3.333333333333333,42,38,4,40,28,12,"April, 1997"
1996-1997,35,1997-04-12,Everton,Tottenham,1,0,H,3,0,1,2,2,1,1,3,14,9,37,42,5,5,April,0.8660254037844388,-0.4999999999999998,18,42,0,3,0,0.3333333333333333,0.3333333333333333,39,49,-10,40,45,-5,"April, 1997"
1996-1997,35,1997-04-12,Derby,Aston Villa,2,1,H,3,0,2,1,2,1,2,2,12,4,39,56,8,17,April,0.8660254037844388,-0.4999999999999998,17,1,0,0,1,0.0,2.0,39,50,-11,42,28,14,"April, 1997"
1996-1997,35,1997-04-12,Southampton,West Ham,2,0,H,3,0,3,1,1,2,2,1,19,17,31,34,2,3,April,0.8660254037844388,-0.4999999999999998,38,45,0,1,2,0.6666666666666666,1.3333333333333333,43,53,-10,31,41,-10,"April, 1997"
1996-1997,35,1997-04-12,Arsenal,Leicester,2,0,H,3,0,2,2,1,2,1,2,2,11,60,40,9,20,April,0.8660254037844388,-0.4999999999999998,0,24,1,0,0,2.0,0.0,55,28,27,38,45,-7,"April, 1997"
1996-1997,35,1997-04-12,Blackburn,Man United,2,3,A,0,3,1,2,2,2,3,0,13,2,37,63,11,26,April,0.8660254037844388,-0.4999999999999998,4,28,0,1,2,1.0,1.6666666666666667,33,32,1,63,36,27,"April, 1997"
1996-1997,35,1997-04-13,Sheffield Weds,Newcastle,1,1,D,1,1,1,1,3,3,2,0,6,5,52,53,1,1,April,0.8660254037844388,-0.4999999999999998,37,30,1,0,2,0.6666666666666666,1.6666666666666667,43,38,5,60,37,23,"April, 1997"
1996-1997,35,1997-04-13,Sunderland,Liverpool,1,2,A,0,3,2,0,3,1,2,2,19,3,34,60,16,26,April,0.8660254037844388,-0.4999999999999998,40,25,0,1,0,0.0,0.0,30,49,-19,54,28,26,"April, 1997"
1996-1997,36,1997-04-16,Everton,Liverpool,1,1,D,1,1,1,2,2,1,2,2,12,3,40,63,9,23,April,0.8660254037844388,-0.4999999999999998,18,25,1,2,0,1.3333333333333333,1.0,40,49,-9,56,29,27,"April, 1997"
1996-1997,36,1997-04-16,Newcastle,Chelsea,3,1,H,3,0,3,2,0,3,1,1,5,7,54,49,2,5,April,0.8660254037844388,-0.4999999999999998,30,14,1,1,1,1.0,0.6666666666666666,61,38,23,52,50,2,"April, 1997"
1996-1997,36,1997-04-16,Wimbledon,Leeds,2,0,H,3,0,2,1,2,0,4,1,8,10,46,42,2,4,April,0.8660254037844388,-0.4999999999999998,47,23,0,1,2,1.0,2.0,42,40,2,26,34,-8,"April, 1997"
1996-1997,37,1997-04-19,West Ham,Everton,2,2,D,1,1,2,2,1,1,2,2,19,12,34,41,7,7,April,0.8660254037844388,-0.4999999999999998,45,18,1,0,2,1.0,2.0,31,43,-12,41,50,-9,"April, 1997"
1996-1997,37,1997-04-19,Southampton,Coventry,2,2,D,1,1,3,1,1,2,2,1,18,17,34,36,1,2,April,0.8660254037844388,-0.4999999999999998,38,15,1,2,0,1.0,0.6666666666666666,45,53,-8,32,48,-16,"April, 1997"
1996-1997,37,1997-04-19,Sheffield Weds,Wimbledon,3,1,H,3,0,1,1,3,2,1,2,6,8,53,49,2,4,April,0.8660254037844388,-0.4999999999999998,37,47,1,1,1,2.0,2.333333333333333,44,39,5,44,40,4,"April, 1997"
1996-1997,37,1997-04-19,Nott'm Forest,Leeds,1,1,D,1,1,0,3,2,0,4,1,20,10,31,42,10,11,April,0.8660254037844388,-0.4999999999999998,32,23,2,0,1,1.6666666666666667,1.3333333333333333,29,52,-23,26,36,-10,"April, 1997"
1996-1997,37,1997-04-19,Newcastle,Derby,3,1,H,3,0,3,2,0,2,1,2,4,10,57,42,6,15,April,0.8660254037844388,-0.4999999999999998,30,17,1,0,0,1.0,0.0,64,39,25,41,51,-10,"April, 1997"
1996-1997,37,1997-04-19,Middlesbrough,Sunderland,0,1,A,0,3,1,3,1,2,0,3,15,19,36,34,4,2,April,0.8660254037844388,-0.4999999999999998,29,40,0,1,0,2.0,2.0,44,52,-8,31,51,-20,"April, 1997"
1996-1997,37,1997-04-19,Liverpool,Man United,1,3,A,0,3,1,2,2,2,3,0,3,1,64,66,2,2,April,0.8660254037844388,-0.4999999999999998,25,28,1,1,1,1.3333333333333333,1.0,57,30,27,66,38,28,"April, 1997"
1996-1997,37,1997-04-19,Chelsea,Leicester,2,1,H,3,0,3,1,1,2,1,2,8,13,49,40,5,9,April,0.8660254037844388,-0.4999999999999998,14,24,1,0,0,3.0,1.0,53,53,0,38,47,-9,"April, 1997"
1996-1997,37,1997-04-19,Aston Villa,Tottenham,1,1,D,1,1,1,2,2,1,1,3,5,9,56,42,4,14,April,0.8660254037844388,-0.4999999999999998,1,42,2,0,1,1.0,0.6666666666666666,43,30,13,40,46,-6,"April, 1997"
1996-1997,37,1997-04-19,Arsenal,Blackburn,1,1,D,1,1,2,2,1,1,2,2,3,14,63,37,11,26,April,0.8660254037844388,-0.4999999999999998,0,4,1,2,0,1.0,0.3333333333333333,57,28,29,35,35,0,"April, 1997"
1996-1997,38,1997-04-21,Coventry,Arsenal,1,1,D,1,1,2,2,1,2,2,1,15,2,37,64,13,27,April,0.8660254037844388,-0.4999999999999998,15,0,0,3,0,0.3333333333333333,0.3333333333333333,34,50,-16,58,29,29,"April, 1997"
1996-1997,38,1997-04-22,Blackburn,Sheffield Weds,4,1,H,3,0,1,2,2,1,1,3,14,6,38,56,8,18,April,0.8660254037844388,-0.4999999999999998,4,37,1,1,1,1.6666666666666667,1.0,36,36,0,47,40,7,"April, 1997"
1996-1997,38,1997-04-22,Leeds,Aston Villa,0,0,D,1,1,0,4,1,1,2,2,10,5,43,57,5,14,April,0.8660254037844388,-0.4999999999999998,23,1,1,0,2,0.6666666666666666,1.6666666666666667,27,37,-10,44,31,13,"April, 1997"
1996-1997,38,1997-04-22,Sunderland,Southampton,0,1,A,0,3,2,0,3,3,1,1,16,18,37,35,2,2,April,0.8660254037844388,-0.4999999999999998,40,38,0,0,1,0.0,3.0,32,51,-19,47,55,-8,"April, 1997"
1996-1997,38,1997-04-22,Wimbledon,Chelsea,0,1,A,0,3,2,1,2,3,1,1,8,7,49,52,1,3,April,0.8660254037844388,-0.4999999999999998,47,14,2,1,0,2.333333333333333,1.3333333333333333,45,43,2,55,54,1,"April, 1997"
1996-1997,38,1997-04-23,Leicester,West Ham,0,1,A,0,3,2,1,2,2,2,1,14,19,40,35,5,5,April,0.8660254037844388,-0.4999999999999998,24,45,0,0,1,0.0,1.0,39,49,-10,33,45,-12,"April, 1997"
1996-1997,38,1997-04-23,Derby,Nott'm Forest,0,0,D,1,1,2,1,2,0,3,2,12,20,42,32,8,10,April,0.8660254037844388,-0.4999999999999998,17,32,0,1,0,1.0,1.0,42,54,-12,30,53,-23,"April, 1997"
1996-1997,38,1997-04-24,Tottenham,Middlesbrough,1,0,H,3,0,1,1,3,1,3,1,10,19,43,36,9,7,April,0.8660254037844388,-0.4999999999999998,42,29,2,1,0,1.6666666666666667,0.3333333333333333,41,47,-6,44,53,-9,"April, 1997"
1996-1997,39,1997-05-03,Sunderland,Everton,3,0,H,3,0,2,0,3,1,2,2,19,12,37,42,7,5,May,0.4999999999999999,-0.8660254037844387,40,18,1,0,0,3.0,1.0,32,52,-20,43,52,-9,"May, 1997"
1996-1997,39,1997-05-03,West Ham,Sheffield Weds,5,1,H,3,0,2,2,1,1,1,3,18,6,38,56,12,18,May,0.4999999999999999,-0.8660254037844387,45,37,1,2,0,0.6666666666666666,0.3333333333333333,34,45,-11,48,44,4,"May, 1997"
1996-1997,39,1997-05-03,Nott'm Forest,Wimbledon,1,1,D,1,1,0,3,2,2,1,2,20,8,33,49,12,16,May,0.4999999999999999,-0.8660254037844387,32,47,1,0,2,1.3333333333333333,1.0,30,53,-23,45,44,1,"May, 1997"
1996-1997,39,1997-05-03,Middlesbrough,Aston Villa,3,2,H,3,0,1,3,1,1,2,2,19,5,36,58,14,22,May,0.4999999999999999,-0.8660254037844387,29,1,0,1,2,0.0,1.0,44,54,-10,44,31,13,"May, 1997"
1996-1997,39,1997-05-03,Southampton,Blackburn,2,0,H,3,0,3,1,1,1,2,2,16,13,38,41,3,3,May,0.4999999999999999,-0.8660254037844387,38,4,1,0,2,1.0,1.3333333333333333,48,55,-7,40,37,3,"May, 1997"
1996-1997,39,1997-05-03,Leicester,Man United,2,2,D,1,1,2,1,2,2,3,0,14,1,40,69,13,29,May,0.4999999999999999,-0.8660254037844387,24,28,0,0,1,1.0,3.0,39,50,-11,69,39,30,"May, 1997"
1996-1997,39,1997-05-03,Coventry,Derby,1,2,A,0,3,2,2,1,2,1,2,17,11,38,43,6,5,May,0.4999999999999999,-0.8660254037844387,15,17,0,0,1,1.0,2.0,35,51,-16,42,54,-12,"May, 1997"
1996-1997,39,1997-05-03,Chelsea,Leeds,0,0,D,1,1,3,1,1,0,4,1,7,10,55,44,3,11,May,0.4999999999999999,-0.8660254037844387,14,23,1,0,2,1.3333333333333333,1.3333333333333333,56,54,2,27,37,-10,"May, 1997"
1996-1997,39,1997-05-03,Arsenal,Newcastle,0,1,A,0,3,2,2,1,3,2,0,2,4,65,60,2,5,May,0.4999999999999999,-0.8660254037844387,0,30,2,0,1,1.3333333333333333,1.0,59,30,29,67,40,27,"May, 1997"
1996-1997,39,1997-05-03,Liverpool,Tottenham,2,1,H,3,0,1,2,2,1,1,3,3,9,64,46,6,18,May,0.4999999999999999,-0.8660254037844387,25,42,2,1,0,1.6666666666666667,0.3333333333333333,58,33,25,42,47,-5,"May, 1997"
1996-1997,40,1997-05-05,Man United,Middlesbrough,3,3,D,1,1,2,3,0,1,3,1,1,18,70,39,17,31,May,0.4999999999999999,-0.8660254037844387,28,29,2,1,0,2.333333333333333,0.6666666666666666,71,41,30,47,56,-9,"May, 1997"
1996-1997,40,1997-05-06,West Ham,Newcastle,0,0,D,1,1,2,2,1,3,2,0,15,4,41,63,11,22,May,0.4999999999999999,-0.8660254037844387,45,30,1,1,1,1.0,1.3333333333333333,39,46,-7,68,40,28,"May, 1997"
1996-1997,40,1997-05-06,Wimbledon,Liverpool,2,1,H,3,0,2,1,2,1,2,2,8,2,50,67,6,17,May,0.4999999999999999,-0.8660254037844387,47,25,1,2,0,1.3333333333333333,1.0,46,45,1,60,34,26,"May, 1997"
1996-1997,40,1997-05-07,Leicester,Sheffield Weds,1,0,H,3,0,2,1,2,1,1,3,16,7,41,56,9,15,May,0.4999999999999999,-0.8660254037844387,24,37,0,0,1,1.0,2.0,41,52,-11,49,49,0,"May, 1997"
1996-1997,40,1997-05-08,Man United,Newcastle,0,0,D,1,1,2,3,0,3,2,0,1,4,71,64,3,7,May,0.4999999999999999,-0.8660254037844387,28,30,2,0,1,1.0,1.6666666666666667,74,44,30,68,40,28,"May, 1997"
1996-1997,40,1997-05-08,Blackburn,Middlesbrough,0,0,D,1,1,1,2,2,1,3,1,15,17,41,40,2,1,May,0.4999999999999999,-0.8660254037844387,4,29,1,0,2,0.6666666666666666,1.3333333333333333,40,39,1,50,59,-9,"May, 1997"
1996-1997,41,1997-05-11,Tottenham,Coventry,1,2,A,0,3,1,1,3,2,2,1,10,19,46,38,9,8,May,0.4999999999999999,-0.8660254037844387,42,15,3,0,0,2.6666666666666665,1.3333333333333333,43,49,-6,36,53,-17,"May, 1997"
1996-1997,41,1997-05-11,Sheffield Weds,Liverpool,1,1,D,1,1,1,1,3,1,2,2,7,4,56,67,3,11,May,0.4999999999999999,-0.8660254037844387,37,25,1,1,1,0.6666666666666666,0.6666666666666666,49,50,-1,61,36,25,"May, 1997"
1996-1997,41,1997-05-11,Wimbledon,Sunderland,1,0,H,3,0,2,1,2,2,0,3,8,19,53,40,11,13,May,0.4999999999999999,-0.8660254037844387,47,40,1,0,0,3.0,1.0,48,46,2,35,52,-17,"May, 1997"
1996-1997,41,1997-05-11,Newcastle,Nott'm Forest,5,0,H,3,0,3,2,0,0,3,2,4,20,65,34,16,31,May,0.4999999999999999,-0.8660254037844387,30,32,1,2,0,1.3333333333333333,0.6666666666666666,68,40,28,31,54,-23,"May, 1997"
1996-1997,41,1997-05-11,Man United,West Ham,2,0,H,3,0,2,3,0,2,2,1,1,14,72,42,13,30,May,0.4999999999999999,-0.8660254037844387,28,45,2,1,0,1.6666666666666667,1.0,74,44,30,39,46,-7,"May, 1997"
1996-1997,41,1997-05-11,Everton,Chelsea,1,2,A,0,3,1,2,2,3,1,1,15,6,42,56,9,14,May,0.4999999999999999,-0.8660254037844387,18,14,0,3,0,1.0,1.0,43,55,-12,56,54,2,"May, 1997"
1996-1997,41,1997-05-11,Derby,Arsenal,1,3,A,0,3,2,1,2,2,2,1,11,4,46,65,7,19,May,0.4999999999999999,-0.8660254037844387,17,0,0,1,0,2.0,2.0,44,55,-11,59,31,28,"May, 1997"
1996-1997,41,1997-05-11,Blackburn,Leicester,2,4,A,0,3,1,2,2,2,1,2,13,12,42,44,1,2,May,0.4999999999999999,-0.8660254037844387,4,24,0,1,0,1.0,1.0,40,39,1,42,52,-10,"May, 1997"
1996-1997,41,1997-05-11,Aston Villa,Southampton,1,0,H,3,0,1,2,2,3,1,1,5,16,58,41,11,17,May,0.4999999999999999,-0.8660254037844387,1,38,3,0,0,1.6666666666666667,0.0,46,34,12,50,55,-5,"May, 1997"
1996-1997,41,1997-05-11,Leeds,Middlesbrough,1,1,D,1,1,0,4,1,1,3,1,12,17,45,41,5,4,May,0.4999999999999999,-0.8660254037844387,23,29,0,2,1,0.3333333333333333,0.6666666666666666,27,37,-10,50,59,-9,"May, 1997"
1997-1998,1,1997-08-09,Southampton,Bolton,0,1,A,0,3,1,2,2,2,0,3,12,9,0,0,3,0,August,-0.8660254037844384,-0.5000000000000004,38,6,2,0,0,1.0,0.0,0,0,0,0,0,0,"August, 1997"
1997-1998,1,1997-08-09,Wimbledon,Liverpool,1,1,D,1,1,0,3,2,2,1,2,13,10,0,0,3,0,August,-0.8660254037844384,-0.5000000000000004,47,25,2,2,0,1.5,1.0,0,0,0,0,0,0,"August, 1997"
1997-1998,1,1997-08-09,Newcastle,Sheffield Weds,2,1,H,3,0,1,2,2,1,1,3,11,12,0,0,1,0,August,-0.8660254037844384,-0.5000000000000004,30,37,2,1,1,1.5,0.75,0,0,0,0,0,0,"August, 1997"
1997-1998,1,1997-08-09,Leicester,Aston Villa,1,0,H,3,0,2,2,1,4,0,1,9,7,0,0,2,0,August,-0.8660254037844384,-0.5000000000000004,24,1,2,0,0,2.0,0.5,0,0,0,0,0,0,"August, 1997"
1997-1998,1,1997-08-09,Leeds,Arsenal,1,1,D,1,1,1,2,2,3,0,2,8,5,0,0,3,0,August,-0.8660254037844384,-0.5000000000000004,23,0,0,1,3,0.25,2.0,0,0,0,0,0,0,"August, 1997"
1997-1998,1,1997-08-09,Everton,Crystal Palace,1,2,A,0,3,0,3,2,2,1,2,8,7,0,0,1,0,August,-0.8660254037844384,-0.5000000000000004,18,16,0,0,0,0.0,0.0,0,0,0,0,0,0,"August, 1997"
1997-1998,1,1997-08-09,Coventry,Chelsea,3,2,H,3,0,1,4,0,3,0,2,7,6,0,0,1,0,August,-0.8660254037844384,-0.5000000000000004,15,14,2,1,1,1.5,1.25,0,0,0,0,0,0,"August, 1997"
1997-1998,1,1997-08-09,Blackburn,Derby,1,0,H,3,0,2,1,2,2,0,3,4,9,0,0,5,0,August,-0.8660254037844384,-0.5000000000000004,4,17,0,1,1,0.5,1.0,0,0,0,0,0,0,"August, 1997"
1997-1998,1,1997-08-09,Barnsley,West Ham,1,2,A,0,3,0,1,4,2,1,2,3,19,0,0,16,0,August,-0.8660254037844384,-0.5000000000000004,2,45,0,0,0,0.0,0.0,0,0,0,0,0,0,"August, 1997"
1997-1998,1,1997-08-10,Tottenham,Man United,0,2,A,0,3,2,3,0,3,2,0,13,12,0,0,1,0,August,-0.8660254037844384,-0.5000000000000004,42,28,1,0,3,1.25,1.5,0,0,0,0,0,0,"August, 1997"
1997-1998,1,1997-08-11,Arsenal,Coventry,2,0,H,3,0,3,0,2,1,4,0,9,2,1,3,7,2,August,-0.8660254037844384,-0.5000000000000004,0,15,0,4,0,0.5,0.5,1,1,0,3,2,1,"August, 1997"
1997-1998,1,1997-08-12,Crystal Palace,Barnsley,0,1,A,0,3,2,1,2,0,1,4,3,14,3,0,11,3,August,-0.8660254037844384,-0.5000000000000004,16,2,0,0,0,0.0,0.0,2,1,1,1,2,-1,"August, 1997"
1997-1998,1,1997-08-13,West Ham,Tottenham,2,1,H,3,0,2,1,2,2,3,0,7,18,3,0,11,3,August,-0.8660254037844384,-0.5000000000000004,45,42,2,1,1,1.5,1.25,2,1,1,0,2,-2,"August, 1997"
1997-1998,1,1997-08-13,Man United,Southampton,1,0,H,3,0,3,2,0,1,2,2,4,18,3,0,14,3,August,-0.8660254037844384,-0.5000000000000004,28,38,2,0,2,2.5,2.75,2,0,2,0,1,-1,"August, 1997"
1997-1998,1,1997-08-13,Sheffield Weds,Leeds,1,3,A,0,3,1,1,3,1,2,2,16,11,0,1,5,1,August,-0.8660254037844384,-0.5000000000000004,37,23,2,1,1,2.5,1.5,1,2,-1,1,1,0,"August, 1997"
1997-1998,1,1997-08-13,Aston Villa,Blackburn,0,4,A,0,3,4,0,1,2,1,2,17,5,0,3,12,3,August,-0.8660254037844384,-0.5000000000000004,1,4,3,1,0,1.5,0.25,0,1,-1,1,0,1,"August, 1997"
1997-1998,1,1997-08-13,Liverpool,Leicester,1,2,A,0,3,2,1,2,2,2,1,12,7,1,3,5,2,August,-0.8660254037844384,-0.5000000000000004,25,24,1,1,0,2.0,0.5,1,1,0,1,0,1,"August, 1997"
1997-1998,2,1997-08-23,Wimbledon,Sheffield Weds,1,1,D,1,1,0,3,2,1,1,3,15,18,1,0,3,1,August,-0.8660254037844384,-0.5000000000000004,47,37,1,1,2,2.0,2.25,1,1,0,2,5,-3,"August, 1997"
1997-1998,2,1997-08-23,Southampton,Arsenal,1,3,A,0,3,1,2,2,3,0,2,17,7,0,4,10,4,August,-0.8660254037844384,-0.5000000000000004,38,0,0,1,3,0.75,2.25,0,2,-2,3,1,2,"August, 1997"
1997-1998,2,1997-08-23,Tottenham,Derby,1,0,H,3,0,2,3,0,2,0,3,18,16,0,0,2,0,August,-0.8660254037844384,-0.5000000000000004,42,17,0,1,1,1.5,2.5,1,4,-3,0,1,-1,"August, 1997"
1997-1998,2,1997-08-23,Newcastle,Aston Villa,1,0,H,3,0,1,2,2,4,0,1,10,20,3,0,10,3,August,-0.8660254037844384,-0.5000000000000004,30,1,2,2,0,2.0,1.5,2,1,1,0,5,-5,"August, 1997"
1997-1998,2,1997-08-23,Blackburn,Liverpool,1,1,D,1,1,2,1,2,2,1,2,1,13,6,1,12,5,August,-0.8660254037844384,-0.5000000000000004,4,25,1,1,2,1.25,1.5,5,0,5,2,3,-1,"August, 1997"
1997-1998,2,1997-08-23,Leeds,Crystal Palace,0,2,A,0,3,1,2,2,2,1,2,5,12,4,3,7,1,August,-0.8660254037844384,-0.5000000000000004,23,16,0,0,0,0.0,0.0,4,2,2,2,2,0,"August, 1997"
1997-1998,2,1997-08-23,Everton,West Ham,2,1,H,3,0,0,3,2,2,1,2,15,3,0,6,12,6,August,-0.8660254037844384,-0.5000000000000004,18,45,2,1,1,2.0,1.25,1,2,-1,4,2,2,"August, 1997"
1997-1998,2,1997-08-23,Coventry,Bolton,2,2,D,1,1,1,4,0,2,0,3,11,8,3,3,3,0,August,-0.8660254037844384,-0.5000000000000004,15,6,1,0,1,1.0,1.5,3,4,-1,1,0,1,"August, 1997"
1997-1998,2,1997-08-23,Leicester,Man United,0,0,D,1,1,2,2,1,3,2,0,4,2,6,6,2,0,August,-0.8660254037844384,-0.5000000000000004,24,28,0,1,1,1.5,2.5,3,1,2,3,0,3,"August, 1997"
1997-1998,2,1997-08-24,Barnsley,Chelsea,0,6,A,0,3,0,1,4,3,0,2,12,17,3,0,5,3,August,-0.8660254037844384,-0.5000000000000004,2,14,0,0,0,0.0,0.0,2,2,0,2,3,-1,"August, 1997"
1997-1998,2,1997-08-25,Blackburn,Sheffield Weds,7,2,H,3,0,2,1,2,1,1,3,1,17,7,1,16,6,August,-0.8660254037844384,-0.5000000000000004,4,37,2,1,1,2.25,1.0,6,1,5,3,6,-3,"August, 1997"
1997-1998,2,1997-08-26,Leeds,Liverpool,0,2,A,0,3,1,2,2,2,1,2,9,16,4,2,7,2,August,-0.8660254037844384,-0.5000000000000004,23,25,1,0,3,0.25,2.75,4,4,0,3,4,-1,"August, 1997"
1997-1998,2,1997-08-27,Wimbledon,Chelsea,0,2,A,0,3,0,3,2,3,0,2,17,14,2,3,3,1,August,-0.8660254037844384,-0.5000000000000004,47,14,2,1,1,1.75,1.25,2,2,0,8,3,5,"August, 1997"
1997-1998,2,1997-08-27,Barnsley,Bolton,2,1,H,3,0,0,1,4,2,0,3,15,9,3,4,6,1,August,-0.8660254037844384,-0.5000000000000004,2,6,0,0,0,0.0,0.0,2,8,-6,3,2,1,"August, 1997"
1997-1998,2,1997-08-27,Coventry,West Ham,1,1,D,1,1,1,4,0,2,1,2,11,7,4,6,4,2,August,-0.8660254037844384,-0.5000000000000004,15,45,0,2,2,1.5,2.25,5,6,-1,5,4,1,"August, 1997"
1997-1998,2,1997-08-27,Everton,Man United,0,2,A,0,3,0,3,2,3,2,0,14,3,3,7,11,4,August,-0.8660254037844384,-0.5000000000000004,18,28,0,1,3,1.0,2.25,3,3,0,3,0,3,"August, 1997"
1997-1998,2,1997-08-27,Leicester,Arsenal,3,3,D,1,1,2,2,1,3,0,2,4,3,7,7,1,0,August,-0.8660254037844384,-0.5000000000000004,24,0,0,0,2,0.0,2.0,3,1,2,6,2,4,"August, 1997"
1997-1998,2,1997-08-27,Southampton,Crystal Palace,1,0,H,3,0,1,2,2,2,1,2,19,6,0,6,13,6,August,-0.8660254037844384,-0.5000000000000004,38,16,0,0,0,0.0,0.0,1,5,-4,4,2,2,"August, 1997"
1997-1998,2,1997-08-27,Tottenham,Aston Villa,3,2,H,3,0,2,3,0,4,0,1,15,20,3,0,5,3,August,-0.8660254037844384,-0.5000000000000004,42,1,1,1,2,0.75,1.0,2,4,-2,0,6,-6,"August, 1997"
1997-1998,3,1997-08-30,Sheffield Weds,Leicester,1,0,H,3,0,1,1,3,2,2,1,20,5,1,8,15,7,August,-0.8660254037844384,-0.5000000000000004,37,24,1,0,1,1.0,1.0,5,13,-8,6,4,2,"August, 1997"
1997-1998,3,1997-08-30,Man United,Coventry,3,0,H,3,0,3,2,0,1,4,0,2,12,10,5,10,5,August,-0.8660254037844384,-0.5000000000000004,28,15,4,0,0,2.5,0.25,5,0,5,6,7,-1,"August, 1997"
1997-1998,3,1997-08-30,West Ham,Wimbledon,3,1,H,3,0,2,1,2,0,3,2,6,20,7,2,14,5,August,-0.8660254037844384,-0.5000000000000004,45,47,1,2,1,0.75,1.0,6,5,1,2,4,-2,"August, 1997"
1997-1998,3,1997-08-30,Derby,Barnsley,1,0,H,3,0,2,0,3,0,1,4,20,10,0,6,10,6,August,-0.8660254037844384,-0.5000000000000004,17,2,0,0,0,0.0,0.0,0,2,-2,4,9,-5,"August, 1997"
1997-1998,3,1997-08-30,Crystal Palace,Blackburn,1,2,A,0,3,2,1,2,2,1,2,9,1,6,10,8,4,August,-0.8660254037844384,-0.5000000000000004,16,4,0,0,0,0.0,0.0,4,3,1,13,3,10,"August, 1997"
1997-1998,3,1997-08-30,Chelsea,Southampton,4,2,H,3,0,3,0,2,1,2,2,7,16,6,3,9,3,August,-0.8660254037844384,-0.5000000000000004,14,38,3,1,0,1.75,0.5,10,3,7,2,5,-3,"August, 1997"
1997-1998,3,1997-08-30,Aston Villa,Leeds,1,0,H,3,0,4,0,1,1,2,2,20,14,0,4,6,4,August,-0.8660254037844384,-0.5000000000000004,1,23,2,1,1,1.25,0.5,2,9,-7,4,6,-2,"August, 1997"
1997-1998,3,1997-08-30,Arsenal,Tottenham,0,0,D,1,1,3,0,2,2,3,0,3,9,8,6,6,2,August,-0.8660254037844384,-0.5000000000000004,0,42,1,2,1,1.0,0.75,9,5,4,5,6,-1,"August, 1997"
1997-1998,3,1997-09-01,Bolton,Everton,0,0,D,1,1,2,0,3,0,3,2,13,17,4,3,4,1,September,-1.0,-1.8369701987210287e-16,6,18,0,1,1,0.5,2.0,4,4,0,3,5,-2,"September, 1997"
1997-1998,4,1997-09-13,Newcastle,Wimbledon,1,3,A,0,3,1,2,2,0,3,2,10,20,6,2,10,4,September,-1.0,-1.8369701987210287e-16,30,47,2,2,0,3.0,1.25,3,1,2,3,7,-4,"September, 1997"
1997-1998,4,1997-09-13,Man United,West Ham,2,1,H,3,0,3,2,0,2,1,2,2,6,13,10,4,3,September,-1.0,-1.8369701987210287e-16,28,45,3,1,0,1.75,0.75,8,0,8,9,6,3,"September, 1997"
1997-1998,4,1997-09-13,Liverpool,Sheffield Weds,2,1,H,3,0,2,1,2,1,1,3,14,18,5,4,4,1,September,-1.0,-1.8369701987210287e-16,25,37,1,2,1,0.75,0.75,5,4,1,6,13,-7,"September, 1997"
1997-1998,4,1997-09-13,Leicester,Tottenham,3,0,H,3,0,2,2,1,2,3,0,6,8,8,7,2,1,September,-1.0,-1.8369701987210287e-16,24,42,1,1,0,1.5,1.0,6,5,1,5,6,-1,"September, 1997"
1997-1998,4,1997-09-13,Derby,Everton,3,1,H,3,0,2,0,3,0,3,2,18,15,3,4,3,1,September,-1.0,-1.8369701987210287e-16,17,18,0,0,2,0.0,1.0,1,2,-1,3,5,-2,"September, 1997"
1997-1998,4,1997-09-13,Crystal Palace,Chelsea,0,3,A,0,3,2,1,2,3,0,2,10,5,6,9,5,3,September,-1.0,-1.8369701987210287e-16,16,14,0,0,0,0.0,0.0,5,5,0,14,5,9,"September, 1997"
1997-1998,4,1997-09-13,Coventry,Southampton,1,0,H,3,0,1,4,0,1,2,2,14,19,5,3,5,2,September,-1.0,-1.8369701987210287e-16,15,38,0,3,1,1.0,1.25,6,10,-4,4,9,-5,"September, 1997"
1997-1998,4,1997-09-13,Barnsley,Aston Villa,0,3,A,0,3,0,1,4,4,0,1,10,19,6,3,9,3,September,-1.0,-1.8369701987210287e-16,2,1,0,0,0,0.0,0.0,4,10,-6,3,9,-6,"September, 1997"
1997-1998,4,1997-09-13,Arsenal,Bolton,4,1,H,3,0,3,0,2,2,0,3,5,12,9,5,7,4,September,-1.0,-1.8369701987210287e-16,0,6,1,0,1,1.0,1.0,9,5,4,4,4,0,"September, 1997"
1997-1998,4,1997-09-14,Blackburn,Leeds,3,4,A,0,3,2,1,2,1,2,2,2,17,13,4,15,9,September,-1.0,-1.8369701987210287e-16,4,23,1,2,1,0.25,0.25,15,4,11,4,7,-3,"September, 1997"
1997-1998,5,1997-09-20,Wimbledon,Crystal Palace,0,1,A,0,3,0,3,2,2,1,2,18,16,5,6,2,1,September,-1.0,-1.8369701987210287e-16,47,16,0,0,0,0.0,0.0,6,8,-2,5,8,-3,"September, 1997"
1997-1998,5,1997-09-20,Tottenham,Blackburn,0,0,D,1,1,2,3,0,2,1,2,12,3,7,13,9,6,September,-1.0,-1.8369701987210287e-16,42,4,2,0,2,1.75,1.5,5,9,-4,18,8,10,"September, 1997"
1997-1998,5,1997-09-20,Southampton,Liverpool,1,1,D,1,1,1,2,2,2,1,2,20,9,3,8,11,5,September,-1.0,-1.8369701987210287e-16,38,25,0,1,3,0.75,1.75,4,10,-6,7,5,2,"September, 1997"
1997-1998,5,1997-09-20,Sheffield Weds,Coventry,0,0,D,1,1,1,1,3,1,4,0,19,9,4,8,10,4,September,-1.0,-1.8369701987210287e-16,37,15,2,2,0,1.25,0.75,7,15,-8,7,10,-3,"September, 1997"
1997-1998,5,1997-09-20,West Ham,Newcastle,0,1,A,0,3,2,1,2,1,2,2,6,14,10,6,8,4,September,-1.0,-1.8369701987210287e-16,45,30,1,2,1,0.75,1.0,10,8,2,4,4,0,"September, 1997"
1997-1998,5,1997-09-20,Everton,Barnsley,4,2,H,3,0,0,3,2,0,1,4,18,16,4,6,2,2,September,-1.0,-1.8369701987210287e-16,18,2,0,0,0,0.0,0.0,4,8,-4,4,13,-9,"September, 1997"
1997-1998,5,1997-09-20,Bolton,Man United,0,0,D,1,1,2,0,3,3,2,0,17,1,5,16,16,11,September,-1.0,-1.8369701987210287e-16,6,28,0,0,2,0.0,4.5,5,8,-3,10,1,9,"September, 1997"
1997-1998,5,1997-09-20,Aston Villa,Derby,2,1,H,3,0,4,0,1,2,0,3,13,11,6,6,2,0,September,-1.0,-1.8369701987210287e-16,1,17,1,0,1,1.5,1.0,6,9,-3,4,3,1,"September, 1997"
1997-1998,5,1997-09-20,Leeds,Leicester,0,1,A,0,3,1,2,2,2,2,1,11,5,7,11,6,4,September,-1.0,-1.8369701987210287e-16,23,24,1,0,1,1.5,0.5,8,10,-2,9,5,4,"September, 1997"
1997-1998,5,1997-09-21,Chelsea,Arsenal,2,3,A,0,3,3,0,2,3,0,2,4,5,12,12,1,0,September,-1.0,-1.8369701987210287e-16,14,0,1,2,1,1.25,1.75,17,5,12,13,6,7,"September, 1997"
1997-1998,5,1997-09-22,Liverpool,Aston Villa,3,0,H,3,0,2,1,2,4,0,1,7,9,9,9,2,0,September,-1.0,-1.8369701987210287e-16,25,1,3,0,1,2.0,0.25,8,6,2,8,10,-2,"September, 1997"
1997-1998,5,1997-09-23,Bolton,Tottenham,1,1,D,1,1,2,0,3,2,3,0,16,12,6,8,4,2,September,-1.0,-1.8369701987210287e-16,6,42,0,1,1,2.0,2.5,5,8,-3,5,9,-4,"September, 1997"
1997-1998,5,1997-09-23,Wimbledon,Barnsley,4,1,H,3,0,0,3,2,0,1,4,18,17,5,6,1,1,September,-1.0,-1.8369701987210287e-16,47,2,0,0,0,0.0,0.0,6,9,-3,6,17,-11,"September, 1997"
1997-1998,5,1997-09-24,Southampton,Leeds,0,2,A,0,3,1,2,2,1,2,2,20,16,4,7,4,3,September,-1.0,-1.8369701987210287e-16,38,23,0,2,2,0.25,1.0,5,11,-6,8,11,-3,"September, 1997"
1997-1998,5,1997-09-24,Sheffield Weds,Derby,2,5,A,0,3,1,1,3,2,0,3,19,17,5,6,2,1,September,-1.0,-1.8369701987210287e-16,37,17,0,2,0,1.0,1.0,7,15,-8,5,5,0,"September, 1997"
1997-1998,5,1997-09-24,Newcastle,Everton,1,0,H,3,0,1,2,2,0,3,2,10,14,9,7,4,2,September,-1.0,-1.8369701987210287e-16,30,18,3,0,1,2.0,1.0,5,4,1,8,10,-2,"September, 1997"
1997-1998,5,1997-09-24,Man United,Chelsea,2,2,D,1,1,3,2,0,3,0,2,2,5,17,12,3,5,September,-1.0,-1.8369701987210287e-16,28,14,1,2,1,1.75,1.25,10,1,9,19,8,11,"September, 1997"
1997-1998,5,1997-09-24,Coventry,Crystal Palace,1,1,D,1,1,1,4,0,2,1,2,10,9,9,9,1,0,September,-1.0,-1.8369701987210287e-16,15,16,0,0,0,0.0,0.0,7,10,-3,6,8,-2,"September, 1997"
1997-1998,5,1997-09-24,Arsenal,West Ham,4,0,H,3,0,3,0,2,2,1,2,2,7,15,10,5,5,September,-1.0,-1.8369701987210287e-16,0,45,4,0,0,1.5,0.25,16,8,8,10,9,1,"September, 1997"
1997-1998,5,1997-09-24,Leicester,Blackburn,1,1,D,1,1,2,2,1,2,1,2,4,3,14,14,1,0,September,-1.0,-1.8369701987210287e-16,24,4,1,1,0,2.5,1.5,10,5,5,18,8,10,"September, 1997"
1997-1998,6,1997-09-27,Tottenham,Wimbledon,0,0,D,1,1,2,3,0,0,3,2,14,15,9,8,1,1,September,-1.0,-1.8369701987210287e-16,42,47,3,0,1,1.25,0.5,6,10,-4,10,10,0,"September, 1997"
1997-1998,6,1997-09-27,Aston Villa,Sheffield Weds,2,2,D,1,1,4,0,1,1,1,3,14,19,9,5,5,4,September,-1.0,-1.8369701987210287e-16,1,37,1,0,3,1.0,1.75,8,13,-5,9,20,-11,"September, 1997"
1997-1998,6,1997-09-27,Barnsley,Leicester,0,2,A,0,3,0,1,4,2,2,1,19,4,6,15,15,9,September,-1.0,-1.8369701987210287e-16,2,24,0,0,0,0.0,0.0,7,21,-14,11,6,5,"September, 1997"
1997-1998,6,1997-09-27,Chelsea,Newcastle,1,0,H,3,0,3,0,2,1,2,2,5,7,13,12,2,1,September,-1.0,-1.8369701987210287e-16,14,30,1,1,2,0.75,1.5,21,10,11,6,4,2,"September, 1997"
1997-1998,6,1997-09-27,Crystal Palace,Bolton,2,2,D,1,1,2,1,2,2,0,3,9,17,10,7,8,3,September,-1.0,-1.8369701987210287e-16,16,6,0,0,0,0.0,0.0,7,9,-2,6,9,-3,"September, 1997"
1997-1998,6,1997-09-27,Derby,Southampton,4,0,H,3,0,2,0,3,1,2,2,13,20,9,4,7,5,September,-1.0,-1.8369701987210287e-16,17,38,0,1,1,1.0,2.0,10,7,3,5,13,-8,"September, 1997"
1997-1998,6,1997-09-27,Everton,Arsenal,2,2,D,1,1,0,3,2,3,0,2,17,1,7,18,16,11,September,-1.0,-1.8369701987210287e-16,18,0,1,0,3,0.75,2.0,8,11,-3,20,8,12,"September, 1997"
1997-1998,6,1997-09-27,Leeds,Man United,1,0,H,3,0,1,2,2,3,2,0,10,2,10,18,8,8,September,-1.0,-1.8369701987210287e-16,23,28,1,0,3,0.75,1.75,10,11,-1,12,3,9,"September, 1997"
1997-1998,6,1997-09-27,West Ham,Liverpool,2,1,H,3,0,2,1,2,2,1,2,11,8,10,12,3,2,September,-1.0,-1.8369701987210287e-16,45,25,0,2,2,0.25,1.0,10,13,-3,11,6,5,"September, 1997"
1997-1998,6,1997-09-28,Blackburn,Coventry,0,0,D,1,1,2,1,2,1,4,0,5,12,15,10,7,5,September,-1.0,-1.8369701987210287e-16,4,15,2,1,1,2.25,1.5,19,9,10,8,11,-3,"September, 1997"
1997-1998,7,1997-10-04,Arsenal,Barnsley,5,0,H,3,0,3,0,2,0,1,4,1,19,19,6,18,13,October,-0.8660254037844386,0.5,0,2,0,0,0,0.0,0.0,22,10,12,7,23,-16,"October, 1997"
1997-1998,7,1997-10-04,Bolton,Aston Villa,0,1,A,0,3,2,0,3,4,0,1,17,14,8,10,3,2,October,-0.8660254037844386,0.5,6,1,0,0,2,0.0,1.5,8,11,-3,10,15,-5,"October, 1997"
1997-1998,7,1997-10-04,Coventry,Leeds,0,0,D,1,1,1,4,0,1,2,2,13,6,11,13,7,2,October,-0.8660254037844386,0.5,15,23,2,1,1,1.5,1.25,8,11,-3,11,11,0,"October, 1997"
1997-1998,7,1997-10-04,Man United,Crystal Palace,2,0,H,3,0,3,2,0,2,1,2,2,13,18,11,11,7,October,-0.8660254037844386,0.5,28,16,0,0,0,0.0,0.0,12,4,8,9,11,-2,"October, 1997"
1997-1998,7,1997-10-04,Newcastle,Tottenham,1,0,H,3,0,1,2,2,2,3,0,11,14,12,10,3,2,October,-0.8660254037844386,0.5,30,42,2,2,0,2.75,1.0,6,5,1,6,10,-4,"October, 1997"
1997-1998,7,1997-10-04,Sheffield Weds,Everton,3,1,H,3,0,1,1,3,0,3,2,18,16,6,8,2,2,October,-0.8660254037844386,0.5,37,18,1,1,2,1.5,2.5,11,22,-11,10,13,-3,"October, 1997"
1997-1998,7,1997-10-04,Southampton,West Ham,3,0,H,3,0,1,2,2,2,1,2,20,8,4,13,12,9,October,-0.8660254037844386,0.5,38,45,1,1,2,1.0,1.0,5,17,-12,12,14,-2,"October, 1997"
1997-1998,7,1997-10-04,Wimbledon,Blackburn,0,1,A,0,3,0,3,2,2,1,2,15,5,9,16,10,7,October,-0.8660254037844386,0.5,47,4,1,1,2,1.25,1.75,10,10,0,19,9,10,"October, 1997"
1997-1998,7,1997-10-05,Liverpool,Chelsea,4,2,H,3,0,2,1,2,3,0,2,11,5,12,16,6,4,October,-0.8660254037844386,0.5,25,14,2,1,1,2.25,1.0,12,8,4,22,10,12,"October, 1997"
1997-1998,7,1997-10-06,Leicester,Derby,1,2,A,0,3,2,2,1,2,0,3,4,11,18,12,7,6,October,-0.8660254037844386,0.5,24,17,1,0,1,2.0,2.0,13,6,7,14,7,7,"October, 1997"
1997-1998,8,1997-10-18,West Ham,Bolton,3,0,H,3,0,2,1,2,2,0,3,11,18,13,8,7,5,October,-0.8660254037844386,0.5,45,6,2,0,0,2.0,0.0,12,17,-5,8,12,-4,"October, 1997"
1997-1998,8,1997-10-18,Leeds,Newcastle,4,1,H,3,0,1,2,2,1,2,2,9,8,14,15,1,1,October,-0.8660254037844386,0.5,23,30,0,0,4,0.25,1.75,11,11,0,7,5,2,"October, 1997"
1997-1998,8,1997-10-18,Everton,Liverpool,2,0,H,3,0,0,3,2,2,1,2,18,7,8,15,11,7,October,-0.8660254037844386,0.5,18,25,1,3,0,1.25,1.0,11,16,-5,16,10,6,"October, 1997"
1997-1998,8,1997-10-18,Derby,Man United,2,2,D,1,1,2,0,3,3,2,0,6,3,15,21,3,6,October,-0.8660254037844386,0.5,17,28,1,1,0,2.0,1.5,16,8,8,14,4,10,"October, 1997"
1997-1998,8,1997-10-18,Blackburn,Southampton,1,0,H,3,0,2,1,2,1,2,2,3,19,19,7,16,12,October,-0.8660254037844386,0.5,4,38,2,0,2,1.0,1.25,20,9,11,8,17,-9,"October, 1997"
1997-1998,8,1997-10-18,Chelsea,Leicester,1,0,H,3,0,3,0,2,2,2,1,5,4,16,18,1,2,October,-0.8660254037844386,0.5,14,24,2,0,0,2.5,1.0,24,14,10,14,8,6,"October, 1997"
1997-1998,8,1997-10-18,Aston Villa,Wimbledon,1,2,A,0,3,4,0,1,0,3,2,10,15,13,9,5,4,October,-0.8660254037844386,0.5,1,47,3,1,0,3.0,0.75,11,15,-4,10,11,-1,"October, 1997"
1997-1998,8,1997-10-18,Crystal Palace,Arsenal,0,0,D,1,1,2,1,2,3,0,2,14,1,11,22,13,11,October,-0.8660254037844386,0.5,16,0,0,0,0,0.0,0.0,9,13,-4,27,10,17,"October, 1997"
1997-1998,8,1997-10-19,Tottenham,Sheffield Weds,3,2,H,3,0,2,3,0,1,1,3,16,17,10,9,1,1,October,-0.8660254037844386,0.5,42,37,2,1,1,1.5,1.0,6,11,-5,14,23,-9,"October, 1997"
1997-1998,8,1997-10-20,Barnsley,Coventry,2,0,H,3,0,0,1,4,1,4,0,20,14,6,12,6,6,October,-0.8660254037844386,0.5,2,15,0,0,0,0.0,0.0,7,28,-21,8,11,-3,"October, 1997"
1997-1998,8,1997-10-22,Derby,Wimbledon,1,1,D,1,1,2,0,3,0,3,2,7,13,16,12,6,4,October,-0.8660254037844386,0.5,17,47,0,1,1,0.5,1.5,18,10,8,12,12,0,"October, 1997"
1997-1998,9,1997-10-25,Southampton,Tottenham,3,2,H,3,0,1,2,2,2,3,0,20,13,7,13,7,6,October,-0.8660254037844386,0.5,38,42,0,1,3,0.25,1.25,8,18,-10,9,13,-4,"October, 1997"
1997-1998,9,1997-10-25,Wimbledon,Leeds,1,0,H,3,0,0,3,2,1,2,2,12,8,13,17,4,4,October,-0.8660254037844386,0.5,47,23,1,1,2,1.25,1.5,13,13,0,15,12,3,"October, 1997"
1997-1998,9,1997-10-25,Sheffield Weds,Crystal Palace,1,3,A,0,3,1,1,3,2,1,2,17,16,9,12,1,3,October,-0.8660254037844386,0.5,37,16,0,0,0,0.0,0.0,16,26,-10,9,13,-4,"October, 1997"
1997-1998,9,1997-10-25,Coventry,Everton,0,0,D,1,1,1,4,0,0,3,2,15,16,12,11,1,1,October,-0.8660254037844386,0.5,15,18,1,3,0,1.25,1.0,8,13,-5,13,16,-3,"October, 1997"
1997-1998,9,1997-10-25,Man United,Barnsley,7,0,H,3,0,3,2,0,0,1,4,3,18,22,9,15,13,October,-0.8660254037844386,0.5,28,2,0,0,0,0.0,0.0,16,6,10,9,28,-19,"October, 1997"
1997-1998,9,1997-10-25,Liverpool,Derby,4,0,H,3,0,2,1,2,2,0,3,9,6,15,17,3,2,October,-0.8660254037844386,0.5,25,17,2,0,0,1.5,0.5,16,12,4,19,11,8,"October, 1997"
1997-1998,9,1997-10-25,Newcastle,Blackburn,1,1,D,1,1,1,2,2,2,1,2,10,3,15,22,7,7,October,-0.8660254037844386,0.5,30,4,2,0,2,1.0,1.0,8,9,-1,21,9,12,"October, 1997"
1997-1998,9,1997-10-26,Arsenal,Aston Villa,0,0,D,1,1,3,0,2,4,0,1,2,13,23,13,11,10,October,-0.8660254037844386,0.5,0,1,1,3,0,1.75,1.25,27,10,17,12,17,-5,"October, 1997"
1997-1998,9,1997-10-26,Bolton,Chelsea,1,0,H,3,0,2,0,3,3,0,2,20,4,8,19,16,11,October,-0.8660254037844386,0.5,6,14,1,0,1,2.0,2.0,8,15,-7,25,14,11,"October, 1997"
1997-1998,9,1997-10-27,Leicester,West Ham,2,1,H,3,0,2,2,1,2,1,2,6,11,18,16,5,2,October,-0.8660254037844386,0.5,24,45,0,0,2,0.0,1.0,14,9,5,15,17,-2,"October, 1997"
1997-1998,10,1997-11-01,Wimbledon,Coventry,1,2,A,0,3,0,3,2,1,4,0,10,14,16,13,4,3,November,-0.5000000000000004,0.8660254037844384,47,15,0,3,1,1.5,2.0,14,13,1,8,13,-5,"November, 1997"
1997-1998,10,1997-11-01,Tottenham,Leeds,0,1,A,0,3,2,3,0,1,2,2,14,8,13,17,6,4,November,-0.5000000000000004,0.8660254037844384,42,23,3,1,0,1.5,0.5,11,16,-5,15,13,2,"November, 1997"
1997-1998,10,1997-11-01,Newcastle,Leicester,3,3,D,1,1,1,2,2,2,2,1,10,5,16,21,5,5,November,-0.5000000000000004,0.8660254037844384,30,24,1,0,1,2.0,2.5,9,10,-1,16,10,6,"November, 1997"
1997-1998,10,1997-11-01,Man United,Sheffield Weds,6,1,H,3,0,3,2,0,1,1,3,1,20,25,9,19,16,November,-0.5000000000000004,0.8660254037844384,28,37,1,3,0,1.25,0.75,23,6,17,17,29,-12,"November, 1997"
1997-1998,10,1997-11-01,Bolton,Liverpool,1,1,D,1,1,2,0,3,2,1,2,17,6,11,18,11,7,November,-0.5000000000000004,0.8660254037844384,6,25,0,0,2,1.0,3.0,9,15,-6,20,12,8,"November, 1997"
1997-1998,10,1997-11-01,Barnsley,Blackburn,1,1,D,1,1,0,1,4,2,1,2,20,3,9,23,17,14,November,-0.5000000000000004,0.8660254037844384,2,4,0,0,0,0.0,0.0,9,35,-26,22,10,12,"November, 1997"
1997-1998,10,1997-11-01,Aston Villa,Chelsea,0,2,A,0,3,4,0,1,3,0,2,13,5,14,19,8,5,November,-0.5000000000000004,0.8660254037844384,1,14,1,1,2,0.75,1.25,12,17,-5,25,15,10,"November, 1997"
1997-1998,10,1997-11-01,Derby,Arsenal,3,0,H,3,0,2,0,3,3,0,2,7,2,17,24,5,7,November,-0.5000000000000004,0.8660254037844384,17,0,0,1,1,1.5,2.5,19,15,4,27,10,17,"November, 1997"
1997-1998,10,1997-11-02,Everton,Southampton,0,2,A,0,3,0,3,2,1,2,2,16,18,12,10,2,2,November,-0.5000000000000004,0.8660254037844384,18,38,2,2,0,3.25,1.25,13,16,-3,11,20,-9,"November, 1997"
1997-1998,11,1997-11-08,Sheffield Weds,Bolton,5,0,H,3,0,1,1,3,2,0,3,20,18,9,12,2,3,November,-0.5000000000000004,0.8660254037844384,37,6,1,0,1,2.5,2.0,18,35,-17,10,16,-6,"November, 1997"
1997-1998,11,1997-11-08,Southampton,Barnsley,4,1,H,3,0,1,2,2,0,1,4,15,20,13,10,5,3,November,-0.5000000000000004,0.8660254037844384,38,2,0,0,0,0.0,0.0,13,20,-7,10,36,-26,"November, 1997"
1997-1998,11,1997-11-08,Liverpool,Tottenham,4,0,H,3,0,2,1,2,2,3,0,8,15,19,13,7,6,November,-0.5000000000000004,0.8660254037844384,25,42,3,1,0,1.75,0.5,21,13,8,11,17,-6,"November, 1997"
1997-1998,11,1997-11-08,Crystal Palace,Aston Villa,1,1,D,1,1,2,1,2,4,0,1,13,14,15,14,1,1,November,-0.5000000000000004,0.8660254037844384,16,1,0,0,0,0.0,0.0,12,14,-2,12,19,-7,"November, 1997"
1997-1998,11,1997-11-08,Coventry,Newcastle,2,2,D,1,1,1,4,0,1,2,2,12,9,16,17,3,1,November,-0.5000000000000004,0.8660254037844384,15,30,1,0,3,0.5,2.25,10,14,-4,12,13,-1,"November, 1997"
1997-1998,11,1997-11-08,Leeds,Derby,4,3,H,3,0,1,2,2,2,0,3,7,6,20,20,1,0,November,-0.5000000000000004,0.8660254037844384,23,17,0,2,0,1.5,1.5,16,13,3,22,15,7,"November, 1997"
1997-1998,11,1997-11-08,Blackburn,Everton,3,2,H,3,0,2,1,2,0,3,2,3,17,24,12,14,12,November,-0.5000000000000004,0.8660254037844384,4,18,1,1,2,0.75,1.25,23,11,12,13,18,-5,"November, 1997"
1997-1998,11,1997-11-09,Arsenal,Man United,3,2,H,3,0,3,0,2,3,2,0,3,1,24,28,2,4,November,-0.5000000000000004,0.8660254037844384,0,28,1,0,3,0.5,1.0,27,13,14,29,7,22,"November, 1997"
1997-1998,11,1997-11-09,Chelsea,West Ham,2,1,H,3,0,3,0,2,2,1,2,5,13,22,16,8,6,November,-0.5000000000000004,0.8660254037844384,14,45,2,0,2,2.25,1.75,27,15,12,16,19,-3,"November, 1997"
1997-1998,11,1997-11-10,Leicester,Wimbledon,0,1,A,0,3,2,2,1,0,3,2,7,11,22,16,4,6,November,-0.5000000000000004,0.8660254037844384,24,47,2,0,0,2.0,0.5,19,13,6,15,15,0,"November, 1997"
1997-1998,12,1997-11-22,Wimbledon,Man United,2,5,A,0,3,0,3,2,3,2,0,10,2,19,28,8,9,November,-0.5000000000000004,0.8660254037844384,47,28,0,0,4,1.0,3.0,16,15,1,31,10,21,"November, 1997"
1997-1998,12,1997-11-22,Sheffield Weds,Arsenal,2,0,H,3,0,1,1,3,3,0,2,20,3,12,27,17,15,November,-0.5000000000000004,0.8660254037844384,37,0,1,1,2,1.0,2.0,23,35,-12,30,15,15,"November, 1997"
1997-1998,12,1997-11-22,Newcastle,Southampton,2,1,H,3,0,1,2,2,1,2,2,10,14,18,16,4,2,November,-0.5000000000000004,0.8660254037844384,30,38,1,1,2,0.75,1.0,14,15,-1,17,21,-4,"November, 1997"
1997-1998,12,1997-11-22,Liverpool,Barnsley,0,1,A,0,3,2,1,2,0,1,4,8,20,22,10,12,12,November,-0.5000000000000004,0.8660254037844384,25,2,0,0,0,0.0,0.0,25,13,12,11,40,-29,"November, 1997"
1997-1998,12,1997-11-22,Leicester,Bolton,0,0,D,1,1,2,2,1,2,0,3,8,18,22,12,10,10,November,-0.5000000000000004,0.8660254037844384,24,6,0,0,0,0.0,0.0,19,14,5,10,21,-11,"November, 1997"
1997-1998,12,1997-11-22,Derby,Coventry,3,1,H,3,0,2,0,3,1,4,0,8,12,20,17,4,3,November,-0.5000000000000004,0.8660254037844384,17,15,2,0,0,2.0,1.0,25,19,6,12,16,-4,"November, 1997"
1997-1998,12,1997-11-22,Blackburn,Chelsea,1,0,H,3,0,2,1,2,3,0,2,3,4,27,25,1,2,November,-0.5000000000000004,0.8660254037844384,4,14,2,2,0,2.0,1.0,26,13,13,29,16,13,"November, 1997"
1997-1998,12,1997-11-22,Aston Villa,Everton,2,1,H,3,0,4,0,1,0,3,2,15,17,15,12,2,3,November,-0.5000000000000004,0.8660254037844384,1,18,3,0,1,1.25,0.5,13,20,-7,15,21,-6,"November, 1997"
1997-1998,12,1997-11-23,Leeds,West Ham,3,1,H,3,0,1,2,2,2,1,2,7,14,23,16,7,7,November,-0.5000000000000004,0.8660254037844384,23,45,4,0,0,1.75,0.25,20,16,4,17,21,-4,"November, 1997"
1997-1998,12,1997-11-24,Tottenham,Crystal Palace,0,1,A,0,3,2,3,0,2,1,2,17,13,13,16,4,3,November,-0.5000000000000004,0.8660254037844384,42,16,0,0,0,0.0,0.0,11,21,-10,13,15,-2,"November, 1997"
1997-1998,12,1997-11-26,Chelsea,Everton,2,0,H,3,0,3,0,2,0,3,2,5,20,25,12,15,13,November,-0.5000000000000004,0.8660254037844384,14,18,1,3,0,1.25,1.0,29,17,12,16,23,-7,"November, 1997"
1997-1998,13,1997-11-29,West Ham,Aston Villa,2,1,H,3,0,2,1,2,4,0,1,16,12,16,18,4,2,November,-0.5000000000000004,0.8660254037844384,45,1,0,2,2,0.5,1.75,18,24,-6,15,21,-6,"November, 1997"
1997-1998,13,1997-11-29,Southampton,Sheffield Weds,2,3,A,0,3,1,2,2,1,1,3,14,18,16,15,4,1,November,-0.5000000000000004,0.8660254037844384,38,37,0,2,2,1.25,1.75,18,23,-5,25,35,-10,"November, 1997"
1997-1998,13,1997-11-29,Everton,Tottenham,0,2,A,0,3,0,3,2,2,3,0,20,18,12,13,2,1,November,-0.5000000000000004,0.8660254037844384,18,42,1,3,0,0.5,0.25,16,25,-9,11,22,-11,"November, 1997"
1997-1998,13,1997-11-29,Crystal Palace,Newcastle,1,2,A,0,3,2,1,2,1,2,2,10,9,19,21,1,2,November,-0.5000000000000004,0.8660254037844384,16,30,0,0,0,0.0,0.0,14,15,-1,16,16,0,"November, 1997"
1997-1998,13,1997-11-29,Chelsea,Derby,4,0,H,3,0,3,0,2,2,0,3,4,6,28,23,2,5,November,-0.5000000000000004,0.8660254037844384,14,17,1,0,1,2.5,2.0,31,17,14,28,20,8,"November, 1997"
1997-1998,13,1997-11-29,Bolton,Wimbledon,1,0,H,3,0,2,0,3,0,3,2,18,11,13,19,7,6,November,-0.5000000000000004,0.8660254037844384,6,47,1,0,1,1.5,1.5,10,21,-11,18,20,-2,"November, 1997"
1997-1998,13,1997-11-29,Barnsley,Leeds,2,3,A,0,3,0,1,4,1,2,2,19,5,13,26,14,13,November,-0.5000000000000004,0.8660254037844384,2,23,0,0,0,0.0,0.0,12,40,-28,23,17,6,"November, 1997"
1997-1998,13,1997-11-29,Coventry,Leicester,0,2,A,0,3,1,4,0,2,2,1,13,6,17,23,7,6,November,-0.5000000000000004,0.8660254037844384,15,24,1,1,0,1.0,0.0,13,19,-6,19,14,5,"November, 1997"
1997-1998,13,1997-11-30,Arsenal,Liverpool,0,1,A,0,3,3,0,2,2,1,2,5,9,27,22,4,5,November,-0.5000000000000004,0.8660254037844384,0,25,0,1,3,0.5,1.75,30,17,13,25,14,11,"November, 1997"
1997-1998,13,1997-11-30,Man United,Blackburn,4,0,H,3,0,3,2,0,2,1,2,1,3,31,30,2,1,November,-0.5000000000000004,0.8660254037844384,28,4,3,1,0,2.0,1.25,36,12,24,27,13,14,"November, 1997"
1997-1998,13,1997-12-01,Bolton,Newcastle,1,0,H,3,0,2,0,3,1,2,2,18,8,16,24,10,8,December,-2.4492935982947064e-16,1.0,6,30,0,0,2,1.0,2.5,11,21,-10,18,17,1,"December, 1997"
1997-1998,13,1997-12-03,West Ham,Crystal Palace,4,1,H,3,0,2,1,2,2,1,2,12,10,19,19,2,0,December,-2.4492935982947064e-16,1.0,45,16,0,0,0,0.0,0.0,20,25,-5,15,17,-2,"December, 1997"
1997-1998,14,1997-12-06,Derby,West Ham,2,0,H,3,0,2,0,3,2,1,2,9,10,23,22,1,1,December,-2.4492935982947064e-16,1.0,17,45,1,1,0,1.0,0.5,28,24,4,24,26,-2,"December, 1997"
1997-1998,14,1997-12-06,Tottenham,Chelsea,1,6,A,0,3,2,3,0,3,0,2,18,3,16,31,15,15,December,-2.4492935982947064e-16,1.0,42,14,0,2,2,0.75,1.5,13,22,-9,35,17,18,"December, 1997"
1997-1998,14,1997-12-06,Newcastle,Arsenal,0,1,A,0,3,1,2,2,3,0,2,9,5,24,27,4,3,December,-2.4492935982947064e-16,1.0,30,0,2,0,2,1.0,1.0,18,18,0,30,18,12,"December, 1997"
1997-1998,14,1997-12-06,Liverpool,Man United,1,3,A,0,3,2,1,2,3,2,0,8,1,25,34,7,9,December,-2.4492935982947064e-16,1.0,25,28,1,1,2,1.25,1.5,26,14,12,40,12,28,"December, 1997"
1997-1998,14,1997-12-06,Blackburn,Bolton,3,1,H,3,0,2,1,2,2,0,3,3,14,30,19,11,11,December,-2.4492935982947064e-16,1.0,4,6,1,0,1,2.0,1.5,27,17,10,12,21,-9,"December, 1997"
1997-1998,14,1997-12-06,Leeds,Everton,0,0,D,1,1,1,2,2,0,3,2,4,20,29,12,16,17,December,-2.4492935982947064e-16,1.0,23,18,1,2,1,0.75,1.0,26,19,7,16,27,-11,"December, 1997"
1997-1998,14,1997-12-06,Aston Villa,Coventry,3,0,H,3,0,4,0,1,1,4,0,14,16,18,17,2,1,December,-2.4492935982947064e-16,1.0,1,15,4,0,0,2.75,0.75,16,23,-7,13,21,-8,"December, 1997"
1997-1998,14,1997-12-06,Leicester,Crystal Palace,1,1,D,1,1,2,2,1,2,1,2,6,13,26,19,7,7,December,-2.4492935982947064e-16,1.0,24,16,0,0,0,0.0,0.0,21,14,7,16,21,-5,"December, 1997"
1997-1998,14,1997-12-07,Wimbledon,Southampton,1,0,H,3,0,0,3,2,1,2,2,13,17,19,16,4,3,December,-2.4492935982947064e-16,1.0,47,38,1,2,1,1.0,0.75,18,21,-3,20,26,-6,"December, 1997"
1997-1998,14,1997-12-08,Sheffield Weds,Barnsley,2,1,H,3,0,1,1,3,0,1,4,15,20,18,13,5,5,December,-2.4492935982947064e-16,1.0,37,2,0,0,0,0.0,0.0,28,37,-9,14,43,-29,"December, 1997"
1997-1998,15,1997-12-13,Southampton,Leicester,2,1,H,3,0,1,2,2,2,2,1,17,7,16,27,10,11,December,-2.4492935982947064e-16,1.0,38,24,0,1,1,1.5,2.0,20,27,-7,22,15,7,"December, 1997"
1997-1998,15,1997-12-13,Everton,Wimbledon,0,0,D,1,1,0,3,2,0,3,2,20,10,13,22,10,9,December,-2.4492935982947064e-16,1.0,18,47,1,0,3,1.5,3.25,16,27,-11,19,21,-2,"December, 1997"
1997-1998,15,1997-12-13,West Ham,Sheffield Weds,1,0,H,3,0,2,1,2,1,1,3,11,13,22,21,2,1,December,-2.4492935982947064e-16,1.0,45,37,2,2,0,1.75,0.5,24,28,-4,30,38,-8,"December, 1997"
1997-1998,15,1997-12-13,Crystal Palace,Liverpool,0,3,A,0,3,2,1,2,2,1,2,14,8,20,25,6,5,December,-2.4492935982947064e-16,1.0,16,25,0,0,0,0.0,0.0,17,22,-5,27,17,10,"December, 1997"
1997-1998,15,1997-12-13,Chelsea,Leeds,0,0,D,1,1,3,0,2,1,2,2,3,5,34,30,2,4,December,-2.4492935982947064e-16,1.0,14,23,1,1,2,1.0,1.0,41,18,23,26,19,7,"December, 1997"
1997-1998,15,1997-12-13,Coventry,Tottenham,4,0,H,3,0,1,4,0,2,3,0,16,18,17,16,2,1,December,-2.4492935982947064e-16,1.0,15,42,1,0,3,1.5,2.25,13,24,-11,14,28,-14,"December, 1997"
1997-1998,15,1997-12-13,Barnsley,Newcastle,2,2,D,1,1,0,1,4,1,2,2,20,9,13,24,11,11,December,-2.4492935982947064e-16,1.0,2,30,0,0,0,0.0,0.0,15,45,-30,18,19,-1,"December, 1997"
1997-1998,15,1997-12-13,Arsenal,Blackburn,1,3,A,0,3,3,0,2,2,1,2,4,3,30,33,1,3,December,-2.4492935982947064e-16,1.0,0,4,1,3,0,1.0,0.5,31,18,13,30,18,12,"December, 1997"
1997-1998,15,1997-12-14,Bolton,Derby,3,3,D,1,1,2,0,3,2,0,3,17,8,19,26,9,7,December,-2.4492935982947064e-16,1.0,6,17,0,0,0,0.0,0.0,13,24,-11,30,24,6,"December, 1997"
1997-1998,15,1997-12-15,Man United,Aston Villa,1,0,H,3,0,3,2,0,4,0,1,1,12,37,21,11,16,December,-2.4492935982947064e-16,1.0,28,1,0,3,1,0.25,0.75,43,13,30,19,23,-4,"December, 1997"
1997-1998,15,1997-12-17,Newcastle,Derby,0,0,D,1,1,1,2,2,2,0,3,9,7,25,27,2,2,December,-2.4492935982947064e-16,1.0,30,17,2,0,0,2.0,0.5,20,21,-1,33,27,6,"December, 1997"
1997-1998,16,1997-12-20,Tottenham,Barnsley,3,0,H,3,0,2,3,0,0,1,4,19,20,16,14,1,2,December,-2.4492935982947064e-16,1.0,42,2,0,0,0,0.0,0.0,14,32,-18,17,47,-30,"December, 1997"
1997-1998,16,1997-12-20,Sheffield Weds,Chelsea,1,4,A,0,3,1,1,3,3,0,2,14,3,21,35,11,14,December,-2.4492935982947064e-16,1.0,37,14,0,3,1,0.5,1.0,30,39,-9,41,18,23,"December, 1997"
1997-1998,16,1997-12-20,Liverpool,Coventry,1,0,H,3,0,2,1,2,1,4,0,7,16,28,20,9,8,December,-2.4492935982947064e-16,1.0,25,15,1,1,2,0.5,0.75,30,17,13,17,24,-7,"December, 1997"
1997-1998,16,1997-12-20,Leicester,Everton,0,1,A,0,3,2,2,1,0,3,2,8,19,27,14,11,13,December,-2.4492935982947064e-16,1.0,24,18,0,1,1,1.0,1.5,23,17,6,16,27,-11,"December, 1997"
1997-1998,16,1997-12-20,Leeds,Bolton,2,0,H,3,0,1,2,2,2,0,3,4,17,31,20,13,11,December,-2.4492935982947064e-16,1.0,23,6,1,0,1,1.0,0.5,26,19,7,16,27,-11,"December, 1997"
1997-1998,16,1997-12-20,Derby,Crystal Palace,0,0,D,1,1,2,0,3,2,1,2,7,16,28,20,9,8,December,-2.4492935982947064e-16,1.0,17,16,0,0,0,0.0,0.0,33,27,6,17,25,-8,"December, 1997"
1997-1998,16,1997-12-20,Blackburn,West Ham,3,0,H,3,0,2,1,2,2,1,2,2,10,36,25,8,11,December,-2.4492935982947064e-16,1.0,4,45,2,1,1,2.0,1.5,33,19,14,25,28,-3,"December, 1997"
1997-1998,16,1997-12-20,Aston Villa,Southampton,1,1,D,1,1,4,0,1,1,2,2,12,17,21,19,5,2,December,-2.4492935982947064e-16,1.0,1,38,4,0,0,1.5,0.0,19,24,-5,22,28,-6,"December, 1997"
1997-1998,16,1997-12-21,Newcastle,Man United,0,1,A,0,3,1,2,2,3,2,0,9,1,26,40,8,14,December,-2.4492935982947064e-16,1.0,30,28,1,1,2,1.25,0.75,20,21,-1,44,13,31,"December, 1997"
1997-1998,17,1997-12-26,West Ham,Coventry,1,0,H,3,0,2,1,2,1,4,0,11,17,25,20,6,5,December,-2.4492935982947064e-16,1.0,45,15,2,3,0,2.0,1.4,25,31,-6,17,25,-8,"December, 1997"
1997-1998,17,1997-12-26,Sheffield Weds,Blackburn,0,0,D,1,1,1,1,3,2,1,2,15,3,21,39,12,18,December,-2.4492935982947064e-16,1.0,37,4,1,1,3,1.2,3.2,31,43,-12,36,19,17,"December, 1997"
1997-1998,17,1997-12-26,Man United,Everton,2,0,H,3,0,3,2,0,0,3,2,1,19,43,17,18,26,December,-2.4492935982947064e-16,1.0,28,18,4,1,0,2.2,0.8,45,13,32,17,27,-10,"December, 1997"
1997-1998,17,1997-12-26,Liverpool,Leeds,3,1,H,3,0,2,1,2,1,2,2,7,4,31,34,3,3,December,-2.4492935982947064e-16,1.0,25,23,4,0,1,2.6,0.2,31,17,14,28,19,9,"December, 1997"
1997-1998,17,1997-12-26,Crystal Palace,Southampton,1,1,D,1,1,2,1,2,1,2,2,13,16,21,20,3,1,December,-2.4492935982947064e-16,1.0,16,38,0,0,1,0.0,1.0,17,25,-8,23,29,-6,"December, 1997"
1997-1998,17,1997-12-26,Bolton,Barnsley,1,1,D,1,1,2,0,3,0,1,4,17,20,20,14,3,6,December,-2.4492935982947064e-16,1.0,6,2,0,0,1,1.0,2.0,16,29,-13,17,50,-33,"December, 1997"
1997-1998,17,1997-12-26,Chelsea,Wimbledon,1,1,D,1,1,3,0,2,0,3,2,3,12,38,23,9,15,December,-2.4492935982947064e-16,1.0,14,47,2,1,2,1.4,1.4,45,19,26,19,21,-2,"December, 1997"
1997-1998,17,1997-12-26,Aston Villa,Tottenham,4,1,H,3,0,4,0,1,2,3,0,12,18,22,19,6,3,December,-2.4492935982947064e-16,1.0,1,42,2,1,2,1.2,1.2,20,25,-5,17,32,-15,"December, 1997"
1997-1998,17,1997-12-26,Arsenal,Leicester,2,1,H,3,0,3,0,2,2,2,1,6,8,30,27,2,3,December,-2.4492935982947064e-16,1.0,0,24,2,1,0,2.333333333333333,1.0,32,21,11,23,18,5,"December, 1997"
1997-1998,17,1997-12-26,Derby,Newcastle,1,0,H,3,0,2,0,3,1,2,2,7,9,29,26,2,3,December,-2.4492935982947064e-16,1.0,17,30,0,1,2,0.3333333333333333,1.3333333333333333,33,27,6,20,22,-2,"December, 1997"
1997-1998,18,1997-12-28,Barnsley,Derby,1,0,H,3,0,0,1,4,2,0,3,20,7,15,32,13,17,December,-2.4492935982947064e-16,1.0,2,17,0,0,1,0.0,1.0,18,51,-33,34,27,7,"December, 1997"
1997-1998,18,1997-12-28,Blackburn,Crystal Palace,2,2,D,1,1,2,1,2,2,1,2,2,13,40,22,11,18,December,-2.4492935982947064e-16,1.0,4,16,1,0,0,2.0,1.0,36,19,17,18,26,-8,"December, 1997"
1997-1998,18,1997-12-28,Coventry,Man United,3,2,H,3,0,1,4,0,3,2,0,17,1,20,46,16,26,December,-2.4492935982947064e-16,1.0,15,28,0,0,5,0.2,2.6,17,26,-9,47,13,34,"December, 1997"
1997-1998,18,1997-12-28,Everton,Bolton,3,2,H,3,0,0,3,2,2,0,3,20,17,17,21,3,4,December,-2.4492935982947064e-16,1.0,18,6,1,2,0,1.3333333333333333,0.3333333333333333,17,29,-12,17,30,-13,"December, 1997"
1997-1998,18,1997-12-28,Leeds,Aston Villa,1,1,D,1,1,1,2,2,4,0,1,5,11,34,25,6,9,December,-2.4492935982947064e-16,1.0,23,1,1,1,3,0.4,1.2,29,22,7,24,26,-2,"December, 1997"
1997-1998,18,1997-12-28,Leicester,Sheffield Weds,1,1,D,1,1,2,2,1,1,1,3,9,15,27,22,6,5,December,-2.4492935982947064e-16,1.0,24,37,1,0,2,0.6666666666666666,1.0,24,20,4,31,43,-12,"December, 1997"
1997-1998,18,1997-12-28,Newcastle,Liverpool,1,2,A,0,3,1,2,2,2,1,2,11,5,26,34,6,8,December,-2.4492935982947064e-16,1.0,30,25,1,1,2,2.25,2.5,20,23,-3,34,18,16,"December, 1997"
1997-1998,18,1997-12-28,Tottenham,Arsenal,1,1,D,1,1,2,3,0,3,0,2,19,6,19,33,13,14,December,-2.4492935982947064e-16,1.0,42,0,1,3,1,0.6,0.8,18,36,-18,34,22,12,"December, 1997"
1997-1998,18,1997-12-28,Wimbledon,West Ham,1,2,A,0,3,0,3,2,2,1,2,12,9,24,28,3,4,December,-2.4492935982947064e-16,1.0,47,45,1,2,2,1.0,1.2,20,22,-2,26,31,-5,"December, 1997"
1997-1998,18,1997-12-29,Southampton,Chelsea,1,0,H,3,0,1,2,2,3,0,2,16,3,21,39,13,18,December,-2.4492935982947064e-16,1.0,38,14,0,1,4,0.8,2.2,24,30,-6,46,20,26,"December, 1997"
1997-1998,19,1998-01-10,Man United,Tottenham,2,0,H,3,0,3,2,0,2,3,0,1,19,46,20,18,26,January,0.4999999999999999,0.8660254037844387,28,42,4,0,1,1.6,1.0,49,16,33,19,37,-18,"January, 1998"
1997-1998,19,1998-01-10,Liverpool,Wimbledon,2,0,H,3,0,2,1,2,0,3,2,4,13,37,24,9,13,January,0.4999999999999999,0.8660254037844387,25,47,0,3,2,1.0,1.4,36,19,17,21,24,-3,"January, 1998"
1997-1998,19,1998-01-10,Sheffield Weds,Newcastle,2,1,H,3,0,1,1,3,1,2,2,17,11,23,26,6,3,January,0.4999999999999999,0.8660254037844387,37,30,1,1,3,0.8,1.6,32,44,-12,21,25,-4,"January, 1998"
1997-1998,19,1998-01-10,Crystal Palace,Everton,1,3,A,0,3,2,1,2,0,3,2,14,18,23,20,4,3,January,0.4999999999999999,0.8660254037844387,16,18,1,0,0,2.0,1.0,20,28,-8,20,31,-11,"January, 1998"
1997-1998,19,1998-01-10,West Ham,Barnsley,6,0,H,3,0,2,1,2,0,1,4,8,20,31,18,12,13,January,0.4999999999999999,0.8660254037844387,45,2,1,0,0,2.0,1.0,28,32,-4,19,51,-32,"January, 1998"
1997-1998,19,1998-01-10,Bolton,Southampton,0,0,D,1,1,2,0,3,1,2,2,17,13,21,24,4,3,January,0.4999999999999999,0.8660254037844387,6,38,1,0,2,0.3333333333333333,0.6666666666666666,19,33,-14,25,30,-5,"January, 1998"
1997-1998,19,1998-01-10,Arsenal,Leeds,2,1,H,3,0,3,0,2,1,2,2,6,5,34,35,1,1,January,0.4999999999999999,0.8660254037844387,0,23,3,2,0,1.8,0.4,35,23,12,30,23,7,"January, 1998"
1997-1998,19,1998-01-10,Chelsea,Coventry,3,1,H,3,0,3,0,2,1,4,0,3,14,39,23,11,16,January,0.4999999999999999,0.8660254037844387,14,15,1,1,3,1.4,1.8,46,21,25,20,28,-8,"January, 1998"
1997-1998,19,1998-01-10,Aston Villa,Leicester,1,1,D,1,1,4,0,1,2,2,1,10,9,26,28,1,2,January,0.4999999999999999,0.8660254037844387,1,24,0,0,3,0.3333333333333333,1.6666666666666667,25,27,-2,25,21,4,"January, 1998"
1997-1998,19,1998-01-11,Derby,Blackburn,3,1,H,3,0,2,0,3,2,1,2,8,3,32,41,5,9,January,0.4999999999999999,0.8660254037844387,17,4,1,1,1,0.6666666666666666,0.6666666666666666,34,28,6,38,21,17,"January, 1998"
1997-1998,20,1998-01-17,Tottenham,West Ham,1,0,H,3,0,2,3,0,2,1,2,20,8,20,34,12,14,January,0.4999999999999999,0.8660254037844387,42,45,1,1,3,1.2,1.6,19,39,-20,34,32,2,"January, 1998"
1997-1998,20,1998-01-17,Barnsley,Crystal Palace,1,0,H,3,0,0,1,4,2,1,2,20,17,18,23,3,5,January,0.4999999999999999,0.8660254037844387,2,16,1,0,0,1.0,0.0,19,57,-38,21,31,-10,"January, 1998"
1997-1998,20,1998-01-17,Blackburn,Aston Villa,5,0,H,3,0,2,1,2,4,0,1,3,10,41,27,7,14,January,0.4999999999999999,0.8660254037844387,4,1,1,1,3,1.0,1.2,39,24,15,26,28,-2,"January, 1998"
1997-1998,20,1998-01-17,Coventry,Arsenal,2,2,D,1,1,1,4,0,3,0,2,16,5,23,37,11,14,January,0.4999999999999999,0.8660254037844387,15,0,0,4,1,0.4,0.8,21,31,-10,37,24,13,"January, 1998"
1997-1998,20,1998-01-17,Leeds,Sheffield Weds,1,2,A,0,3,1,2,2,1,1,3,7,12,35,26,5,9,January,0.4999999999999999,0.8660254037844387,23,37,2,1,2,1.8,2.2,31,25,6,34,45,-11,"January, 1998"
1997-1998,20,1998-01-17,Leicester,Liverpool,0,0,D,1,1,2,2,1,2,1,2,9,4,29,40,5,11,January,0.4999999999999999,0.8660254037844387,24,25,1,1,1,1.0,1.6666666666666667,26,22,4,38,19,19,"January, 1998"
1997-1998,20,1998-01-17,Newcastle,Bolton,2,1,H,3,0,1,2,2,2,0,3,12,18,26,22,6,4,January,0.4999999999999999,0.8660254037844387,30,6,2,0,1,1.6666666666666667,1.0,22,27,-5,19,33,-14,"January, 1998"
1997-1998,20,1998-01-17,Wimbledon,Derby,0,0,D,1,1,0,3,2,2,0,3,14,6,24,35,8,11,January,0.4999999999999999,0.8660254037844387,47,17,1,2,0,1.3333333333333333,0.6666666666666666,21,26,-5,37,29,8,"January, 1998"
1997-1998,20,1998-01-18,Everton,Chelsea,3,1,H,3,0,0,3,2,3,0,2,16,3,23,42,13,19,January,0.4999999999999999,0.8660254037844387,18,14,0,3,2,0.8,1.4,23,32,-9,49,22,27,"January, 1998"
1997-1998,20,1998-01-19,Southampton,Man United,1,0,H,3,0,1,2,2,3,2,0,14,1,25,49,13,24,January,0.4999999999999999,0.8660254037844387,38,28,2,0,3,2.2,2.2,25,30,-5,51,16,35,"January, 1998"
1997-1998,20,1998-01-20,Liverpool,Newcastle,1,0,H,3,0,2,1,2,1,2,2,4,10,41,29,6,12,January,0.4999999999999999,0.8660254037844387,25,30,3,1,1,2.4,2.0,38,19,19,24,28,-4,"January, 1998"
1997-1998,21,1998-01-31,Sheffield Weds,Wimbledon,1,1,D,1,1,1,1,3,0,3,2,11,16,29,25,5,4,January,0.4999999999999999,0.8660254037844387,37,47,2,2,1,2.0,1.8,36,46,-10,21,26,-5,"January, 1998"
1997-1998,21,1998-01-31,Man United,Leicester,0,1,A,0,3,3,2,0,2,2,1,1,9,49,30,8,19,January,0.4999999999999999,0.8660254037844387,28,24,1,2,0,1.6666666666666667,1.0,51,17,34,26,22,4,"January, 1998"
1997-1998,21,1998-01-31,West Ham,Everton,2,2,D,1,1,2,1,2,0,3,2,8,16,34,26,8,8,January,0.4999999999999999,0.8660254037844387,45,18,1,1,3,1.2,2.0,34,33,1,26,33,-7,"January, 1998"
1997-1998,21,1998-01-31,Derby,Tottenham,2,1,H,3,0,2,0,3,2,3,0,7,18,36,23,11,13,January,0.4999999999999999,0.8660254037844387,17,42,1,1,1,1.6666666666666667,1.3333333333333333,37,29,8,20,39,-19,"January, 1998"
1997-1998,21,1998-01-31,Liverpool,Blackburn,0,0,D,1,1,2,1,2,2,1,2,4,3,44,44,1,0,January,0.4999999999999999,0.8660254037844387,25,4,2,2,1,1.4,1.2,39,19,20,44,24,20,"January, 1998"
1997-1998,21,1998-01-31,Chelsea,Barnsley,2,0,H,3,0,3,0,2,0,1,4,4,20,42,21,16,21,January,0.4999999999999999,0.8660254037844387,14,2,1,0,0,6.0,0.0,50,25,25,20,57,-37,"January, 1998"
1997-1998,21,1998-01-31,Bolton,Coventry,1,5,A,0,3,2,0,3,1,4,0,19,16,22,24,3,2,January,0.4999999999999999,0.8660254037844387,6,15,1,1,1,1.6666666666666667,1.3333333333333333,20,35,-15,23,33,-10,"January, 1998"
1997-1998,21,1998-01-31,Arsenal,Southampton,3,0,H,3,0,3,0,2,1,2,2,5,12,38,28,7,10,January,0.4999999999999999,0.8660254037844387,0,38,4,1,0,2.4,0.8,39,26,13,26,30,-4,"January, 1998"
1997-1998,21,1998-01-31,Crystal Palace,Leeds,0,2,A,0,3,2,1,2,1,2,2,17,7,23,35,10,12,January,0.4999999999999999,0.8660254037844387,16,23,1,0,0,2.0,0.0,21,32,-11,32,27,5,"January, 1998"
1997-1998,21,1998-02-01,Aston Villa,Newcastle,0,1,A,0,3,4,0,1,1,2,2,15,11,27,29,4,2,February,0.8660254037844386,0.5000000000000001,1,30,0,2,3,1.2,1.8,26,33,-7,24,29,-5,"February, 1998"
1997-1998,22,1998-02-07,Man United,Bolton,1,1,D,1,1,3,2,0,2,0,3,1,19,49,22,18,27,February,0.8660254037844386,0.5000000000000001,28,6,2,1,0,3.0,0.0,51,18,33,21,40,-19,"February, 1998"
1997-1998,22,1998-02-07,Newcastle,West Ham,0,1,A,0,3,1,2,2,2,1,2,10,9,32,35,1,3,February,0.8660254037844386,0.5000000000000001,30,45,2,2,1,1.0,0.6,25,29,-4,36,35,1,"February, 1998"
1997-1998,22,1998-02-07,Liverpool,Southampton,2,3,A,0,3,2,1,2,1,2,2,3,15,45,28,12,17,February,0.8660254037844386,0.5000000000000001,25,38,3,2,0,1.6,0.8,39,19,20,26,33,-7,"February, 1998"
1997-1998,22,1998-02-07,Leicester,Leeds,1,0,H,3,0,2,2,1,1,2,2,9,7,33,38,2,5,February,0.8660254037844386,0.5000000000000001,24,23,2,0,1,0.6666666666666666,1.0,27,22,5,34,27,7,"February, 1998"
1997-1998,22,1998-02-07,Coventry,Sheffield Weds,1,0,H,3,0,1,4,0,1,1,3,14,11,27,30,3,3,February,0.8660254037844386,0.5000000000000001,15,37,0,3,2,0.6,1.0,28,34,-6,37,47,-10,"February, 1998"
1997-1998,22,1998-02-07,Blackburn,Tottenham,0,3,A,0,3,2,1,2,2,3,0,3,18,45,23,15,22,February,0.8660254037844386,0.5000000000000001,4,42,2,1,2,1.2,1.4,44,24,20,21,41,-20,"February, 1998"
1997-1998,22,1998-02-07,Barnsley,Everton,2,2,D,1,1,0,1,4,0,3,2,20,14,21,27,6,6,February,0.8660254037844386,0.5000000000000001,2,18,0,0,1,2.0,4.0,20,59,-39,28,35,-7,"February, 1998"
1997-1998,22,1998-02-07,Derby,Aston Villa,0,1,A,0,3,2,0,3,4,0,1,6,15,39,27,9,12,February,0.8660254037844386,0.5000000000000001,17,1,1,0,2,1.0,1.6666666666666667,39,30,9,26,34,-8,"February, 1998"
1997-1998,22,1998-02-08,Arsenal,Chelsea,2,0,H,3,0,3,0,2,3,0,2,5,2,41,45,3,4,February,0.8660254037844386,0.5000000000000001,0,14,2,2,1,2.0,1.4,42,26,16,52,25,27,"February, 1998"
1997-1998,22,1998-02-09,Crystal Palace,Wimbledon,0,3,A,0,3,2,1,2,0,3,2,18,16,23,26,2,3,February,0.8660254037844386,0.5000000000000001,16,47,1,0,0,1.0,0.0,21,34,-13,22,27,-5,"February, 1998"
1997-1998,23,1998-02-14,Everton,Derby,1,2,A,0,3,0,3,2,2,0,3,16,6,28,39,10,11,February,0.8660254037844386,0.5000000000000001,18,17,2,0,1,1.0,1.0,30,37,-7,39,31,8,"February, 1998"
1997-1998,23,1998-02-14,Sheffield Weds,Liverpool,3,3,D,1,1,1,1,3,2,1,2,14,3,30,45,11,15,February,0.8660254037844386,0.5000000000000001,37,25,1,2,2,0.8,1.0,37,48,-11,41,22,19,"February, 1998"
1997-1998,23,1998-02-14,Tottenham,Leicester,1,1,D,1,1,2,3,0,2,2,1,17,9,26,36,8,10,February,0.8660254037844386,0.5000000000000001,42,24,0,1,2,0.6666666666666666,2.0,24,41,-17,28,22,6,"February, 1998"
1997-1998,23,1998-02-18,Aston Villa,Man United,0,2,A,0,3,4,0,1,3,2,0,14,1,30,50,13,20,February,0.8660254037844386,0.5000000000000001,1,28,1,3,1,0.6,0.4,27,34,-7,52,19,33,"February, 1998"
1997-1998,23,1998-02-18,Southampton,Coventry,1,2,A,0,3,1,2,2,1,4,0,11,13,31,30,2,1,February,0.8660254037844386,0.5000000000000001,38,15,1,3,1,1.0,1.0,29,35,-6,29,34,-5,"February, 1998"
1997-1998,24,1998-02-21,Sheffield Weds,Tottenham,1,0,H,3,0,1,1,3,2,3,0,13,17,31,27,4,4,February,0.8660254037844386,0.5000000000000001,37,42,1,1,3,1.2,1.8,40,51,-11,25,42,-17,"February, 1998"
1997-1998,24,1998-02-21,Southampton,Blackburn,3,0,H,3,0,1,2,2,2,1,2,13,5,31,45,8,14,February,0.8660254037844386,0.5000000000000001,38,4,2,0,3,1.0,1.0,30,37,-7,44,27,17,"February, 1998"
1997-1998,24,1998-02-21,Wimbledon,Aston Villa,2,1,H,3,0,0,3,2,4,0,1,15,14,29,30,1,1,February,0.8660254037844386,0.5000000000000001,47,1,1,1,3,1.0,2.6,25,27,-2,27,36,-9,"February, 1998"
1997-1998,24,1998-02-21,Man United,Derby,2,0,H,3,0,3,2,0,2,0,3,1,6,53,42,5,11,February,0.8660254037844386,0.5000000000000001,28,17,0,2,1,1.6666666666666667,2.0,54,19,35,41,32,9,"February, 1998"
1997-1998,24,1998-02-21,Coventry,Barnsley,1,0,H,3,0,1,4,0,0,1,4,10,20,33,22,10,11,February,0.8660254037844386,0.5000000000000001,15,2,0,0,1,0.0,2.0,31,35,-4,22,61,-39,"February, 1998"
1997-1998,24,1998-02-21,Arsenal,Crystal Palace,1,0,H,3,0,3,0,2,2,1,2,5,18,44,23,13,21,February,0.8660254037844386,0.5000000000000001,0,16,0,1,0,0.0,0.0,44,26,18,21,37,-16,"February, 1998"
1997-1998,24,1998-02-21,Leicester,Chelsea,2,0,H,3,0,2,2,1,3,0,2,9,4,37,45,5,8,February,0.8660254037844386,0.5000000000000001,24,14,0,0,3,0.6666666666666666,2.0,29,23,6,52,27,25,"February, 1998"
1997-1998,24,1998-02-21,Bolton,West Ham,1,1,D,1,1,2,0,3,2,1,2,19,8,23,38,11,15,February,0.8660254037844386,0.5000000000000001,6,45,0,0,3,0.0,2.333333333333333,22,41,-19,37,35,2,"February, 1998"
1997-1998,24,1998-02-22,Newcastle,Leeds,1,1,D,1,1,1,2,2,1,2,2,14,9,32,38,5,6,February,0.8660254037844386,0.5000000000000001,30,23,4,0,1,1.6,1.0,25,30,-5,34,28,6,"February, 1998"
1997-1998,24,1998-02-23,Liverpool,Everton,1,1,D,1,1,2,1,2,0,3,2,3,16,46,28,13,18,February,0.8660254037844386,0.5000000000000001,25,18,0,3,2,0.8,1.4,44,25,19,31,39,-8,"February, 1998"
1997-1998,25,1998-02-28,Everton,Newcastle,0,0,D,1,1,0,3,2,1,2,2,16,13,29,33,3,4,February,0.8660254037844386,0.5000000000000001,18,30,1,0,4,0.8,1.8,32,40,-8,26,31,-5,"February, 1998"
1997-1998,25,1998-02-28,Leeds,Southampton,0,1,A,0,3,1,2,2,1,2,2,8,11,39,34,3,5,February,0.8660254037844386,0.5000000000000001,23,38,3,2,0,1.2,0.2,35,29,6,33,37,-4,"February, 1998"
1997-1998,25,1998-02-28,Crystal Palace,Coventry,0,3,A,0,3,2,1,2,1,4,0,20,10,23,36,10,13,February,0.8660254037844386,0.5000000000000001,16,15,0,1,0,1.0,1.0,21,38,-17,32,35,-3,"February, 1998"
1997-1998,25,1998-02-28,Derby,Sheffield Weds,3,0,H,3,0,2,0,3,1,1,3,6,12,42,34,6,8,February,0.8660254037844386,0.5000000000000001,17,37,1,2,0,2.333333333333333,1.3333333333333333,41,34,7,41,51,-10,"February, 1998"
1997-1998,25,1998-02-28,Blackburn,Leicester,5,3,H,3,0,2,1,2,2,2,1,5,7,45,40,2,5,February,0.8660254037844386,0.5000000000000001,4,24,0,2,1,1.3333333333333333,2.0,44,30,14,31,23,8,"February, 1998"
1997-1998,25,1998-02-28,Barnsley,Wimbledon,2,1,H,3,0,0,1,4,0,3,2,20,15,22,32,5,10,February,0.8660254037844386,0.5000000000000001,2,47,0,0,1,1.0,4.0,22,62,-40,27,28,-1,"February, 1998"
1997-1998,25,1998-02-28,Aston Villa,Liverpool,2,1,H,3,0,4,0,1,2,1,2,15,3,30,47,12,17,February,0.8660254037844386,0.5000000000000001,1,25,1,0,4,0.2,2.2,28,38,-10,45,26,19,"February, 1998"
1997-1998,25,1998-02-28,Chelsea,Man United,0,1,A,0,3,3,0,2,3,2,0,5,1,45,56,4,11,February,0.8660254037844386,0.5000000000000001,14,28,1,3,1,1.4,1.8,52,29,23,56,19,37,"February, 1998"
1997-1998,25,1998-03-01,Tottenham,Bolton,1,0,H,3,0,2,3,0,2,0,3,17,19,27,24,2,3,March,1.0,6.123233995736766e-17,42,6,1,2,0,2.0,1.6666666666666667,25,43,-18,23,42,-19,"March, 1998"
1997-1998,25,1998-03-02,West Ham,Arsenal,0,0,D,1,1,2,1,2,3,0,2,9,3,39,47,6,8,March,1.0,6.123233995736766e-17,45,0,0,0,5,0.2,2.0,38,36,2,45,26,19,"March, 1998"
1997-1998,25,1998-03-04,Leeds,Tottenham,1,0,H,3,0,1,2,2,2,3,0,9,17,39,30,8,9,March,1.0,6.123233995736766e-17,23,42,1,1,3,0.6,1.2,35,30,5,26,43,-17,"March, 1998"
1997-1998,26,1998-03-07,Liverpool,Bolton,2,1,H,3,0,2,1,2,2,0,3,4,19,47,24,15,23,March,1.0,6.123233995736766e-17,25,6,2,1,0,2.333333333333333,1.0,46,28,18,23,43,-20,"March, 1998"
1997-1998,26,1998-03-07,Sheffield Weds,Man United,2,0,H,3,0,1,1,3,3,2,0,13,1,34,59,12,25,March,1.0,6.123233995736766e-17,37,28,0,3,2,0.8,2.2,41,54,-13,57,19,38,"March, 1998"
1997-1998,26,1998-03-07,Southampton,Everton,2,1,H,3,0,1,2,2,0,3,2,11,16,37,30,5,7,March,1.0,6.123233995736766e-17,38,18,1,2,2,1.4,2.6,34,37,-3,32,40,-8,"March, 1998"
1997-1998,26,1998-03-08,Chelsea,Aston Villa,0,1,A,0,3,3,0,2,4,0,1,5,14,45,33,9,12,March,1.0,6.123233995736766e-17,14,1,3,1,1,1.4,0.6,52,30,22,30,39,-9,"March, 1998"
1997-1998,27,1998-03-11,West Ham,Man United,1,1,D,1,1,2,1,2,3,2,0,9,1,40,59,8,19,March,1.0,6.123233995736766e-17,45,28,0,1,4,0.8,1.8,38,36,2,57,21,36,"March, 1998"
1997-1998,27,1998-03-11,Wimbledon,Arsenal,0,1,A,0,3,0,3,2,3,0,2,15,4,32,48,11,16,March,1.0,6.123233995736766e-17,47,0,2,1,1,1.5,1.5,28,30,-2,45,26,19,"March, 1998"
1997-1998,27,1998-03-11,Leeds,Blackburn,4,0,H,3,0,1,2,2,2,1,2,7,5,42,48,2,6,March,1.0,6.123233995736766e-17,23,4,2,2,1,1.0,0.8,36,30,6,49,33,16,"March, 1998"
1997-1998,27,1998-03-11,Aston Villa,Barnsley,0,1,A,0,3,4,0,1,0,1,4,13,18,36,25,5,11,March,1.0,6.123233995736766e-17,1,2,1,0,0,3.0,0.0,31,39,-8,24,63,-39,"March, 1998"
1997-1998,27,1998-03-11,Chelsea,Crystal Palace,6,2,H,3,0,3,0,2,2,1,2,5,20,45,23,15,22,March,1.0,6.123233995736766e-17,14,16,1,0,0,3.0,0.0,52,31,21,21,41,-20,"March, 1998"
1997-1998,28,1998-03-14,Aston Villa,Crystal Palace,3,1,H,3,0,4,0,1,2,1,2,13,20,36,23,7,13,March,1.0,6.123233995736766e-17,1,16,0,1,0,1.0,1.0,31,40,-9,23,47,-24,"March, 1998"
1997-1998,28,1998-03-14,Barnsley,Southampton,4,3,H,3,0,0,1,4,1,2,2,18,10,28,40,8,12,March,1.0,6.123233995736766e-17,2,38,0,0,1,1.0,4.0,25,63,-38,36,38,-2,"March, 1998"
1997-1998,28,1998-03-14,Bolton,Sheffield Weds,3,2,H,3,0,2,0,3,1,1,3,19,13,24,37,6,13,March,1.0,6.123233995736766e-17,6,37,1,0,2,1.3333333333333333,3.333333333333333,24,45,-21,43,54,-11,"March, 1998"
1997-1998,28,1998-03-14,Everton,Blackburn,1,0,H,3,0,0,3,2,2,1,2,17,5,30,48,12,18,March,1.0,6.123233995736766e-17,18,4,2,1,2,1.4,1.2,33,42,-9,49,37,12,"March, 1998"
1997-1998,28,1998-03-14,Man United,Arsenal,0,1,A,0,3,3,2,0,3,0,2,1,2,60,51,1,9,March,1.0,6.123233995736766e-17,28,0,3,0,2,1.2,1.0,58,22,36,46,26,20,"March, 1998"
1997-1998,28,1998-03-14,Newcastle,Coventry,0,0,D,1,1,1,2,2,1,4,0,14,11,34,39,3,5,March,1.0,6.123233995736766e-17,30,15,3,1,1,2.2,0.8,26,31,-5,35,35,0,"March, 1998"
1997-1998,28,1998-03-14,Tottenham,Liverpool,3,3,D,1,1,2,3,0,2,1,2,18,3,30,50,15,20,March,1.0,6.123233995736766e-17,42,25,0,1,4,0.4,2.2,26,44,-18,48,29,19,"March, 1998"
1997-1998,28,1998-03-14,West Ham,Chelsea,2,1,H,3,0,2,1,2,3,0,2,8,4,41,48,4,7,March,1.0,6.123233995736766e-17,45,14,2,0,3,1.6,2.2,39,37,2,58,33,25,"March, 1998"
1997-1998,28,1998-03-14,Wimbledon,Leicester,2,1,H,3,0,0,3,2,2,2,1,16,9,32,40,7,8,March,1.0,6.123233995736766e-17,47,24,1,0,2,0.6666666666666666,1.3333333333333333,28,31,-3,34,28,6,"March, 1998"
1997-1998,28,1998-03-15,Derby,Leeds,0,5,A,0,3,2,0,3,1,2,2,6,7,45,45,1,0,March,1.0,6.123233995736766e-17,17,23,0,2,1,2.0,2.333333333333333,44,34,10,40,30,10,"March, 1998"
1997-1998,28,1998-03-18,Newcastle,Crystal Palace,1,2,A,0,3,1,2,2,2,1,2,15,20,35,23,5,12,March,1.0,6.123233995736766e-17,30,16,1,0,0,2.0,1.0,26,31,-5,24,50,-26,"March, 1998"
1997-1998,29,1998-03-28,Arsenal,Sheffield Weds,1,0,H,3,0,3,0,2,1,1,3,2,13,54,37,11,17,March,1.0,6.123233995736766e-17,0,37,2,1,2,1.6,1.2,47,26,21,45,57,-12,"March, 1998"
1997-1998,29,1998-03-28,Barnsley,Liverpool,2,3,A,0,3,0,1,4,2,1,2,18,3,31,51,15,20,March,1.0,6.123233995736766e-17,2,25,1,0,0,1.0,0.0,29,66,-37,51,32,19,"March, 1998"
1997-1998,29,1998-03-28,Bolton,Leicester,2,0,H,3,0,2,0,3,2,2,1,19,9,27,40,10,13,March,1.0,6.123233995736766e-17,6,24,0,1,0,0.0,0.0,27,47,-20,35,30,5,"March, 1998"
1997-1998,29,1998-03-28,Coventry,Derby,1,0,H,3,0,1,4,0,2,0,3,10,7,40,45,3,5,March,1.0,6.123233995736766e-17,15,17,0,0,3,1.0,2.333333333333333,35,35,0,44,39,5,"March, 1998"
1997-1998,29,1998-03-28,Crystal Palace,Tottenham,1,3,A,0,3,2,1,2,2,3,0,20,17,26,31,3,5,March,1.0,6.123233995736766e-17,16,42,1,0,0,1.0,0.0,26,51,-25,29,47,-18,"March, 1998"
1997-1998,29,1998-03-28,Everton,Aston Villa,1,4,A,0,3,0,3,2,4,0,1,17,12,33,39,5,6,March,1.0,6.123233995736766e-17,18,1,1,0,4,0.6,1.4,34,42,-8,34,41,-7,"March, 1998"
1997-1998,29,1998-03-28,Man United,Wimbledon,2,0,H,3,0,3,2,0,0,3,2,1,14,60,35,13,25,March,1.0,6.123233995736766e-17,28,47,5,0,0,3.4,1.2,58,23,35,30,32,-2,"March, 1998"
1997-1998,29,1998-03-28,Southampton,Newcastle,2,1,H,3,0,1,2,2,1,2,2,12,15,40,35,3,5,March,1.0,6.123233995736766e-17,38,30,2,1,2,1.0,1.0,39,42,-3,27,33,-6,"March, 1998"
1997-1998,30,1998-03-30,West Ham,Leeds,3,0,H,3,0,2,1,2,1,2,2,8,5,44,48,3,4,March,1.0,6.123233995736766e-17,45,23,0,0,5,0.4,2.0,41,38,3,45,30,15,"March, 1998"
1997-1998,30,1998-03-31,Wimbledon,Newcastle,0,0,D,1,1,0,3,2,1,2,2,14,15,35,35,1,0,March,1.0,6.123233995736766e-17,47,30,1,2,2,1.6,2.6,30,34,-4,28,35,-7,"March, 1998"
1997-1998,30,1998-03-31,Bolton,Arsenal,0,1,A,0,3,2,0,3,3,0,2,19,2,30,57,17,27,March,1.0,6.123233995736766e-17,6,0,1,0,2,1.0,2.0,29,47,-18,48,26,22,"March, 1998"
1997-1998,30,1998-03-31,Blackburn,Barnsley,2,1,H,3,0,2,1,2,0,1,4,6,18,48,31,12,17,March,1.0,6.123233995736766e-17,4,2,0,1,0,1.0,1.0,49,38,11,31,69,-38,"March, 1998"
1997-1998,31,1998-04-04,Aston Villa,West Ham,2,0,H,3,0,4,0,1,2,1,2,11,7,42,47,4,5,April,0.8660254037844388,-0.4999999999999998,1,45,2,2,1,1.6,0.8,38,42,-4,44,38,6,"April, 1998"
1997-1998,31,1998-04-04,Leeds,Barnsley,2,1,H,3,0,1,2,2,0,1,4,6,18,48,31,12,17,April,0.8660254037844388,-0.4999999999999998,23,2,1,0,0,3.0,2.0,45,33,12,32,71,-39,"April, 1998"
1997-1998,31,1998-04-04,Leicester,Coventry,1,1,D,1,1,2,2,1,1,4,0,12,10,40,43,2,3,April,0.8660254037844388,-0.4999999999999998,24,15,1,1,1,0.6666666666666666,0.6666666666666666,35,32,3,36,35,1,"April, 1998"
1997-1998,31,1998-04-04,Sheffield Weds,Southampton,1,0,H,3,0,1,1,3,1,2,2,13,11,37,43,2,6,April,0.8660254037844388,-0.4999999999999998,37,38,3,2,0,2.0,1.4,45,58,-13,41,43,-2,"April, 1998"
1997-1998,31,1998-04-04,Tottenham,Everton,1,1,D,1,1,2,3,0,0,3,2,16,17,34,33,1,1,April,0.8660254037844388,-0.4999999999999998,42,18,1,3,1,0.6,0.4,32,48,-16,35,46,-11,"April, 1998"
1997-1998,31,1998-04-04,Wimbledon,Bolton,0,0,D,1,1,0,3,2,2,0,3,14,19,36,30,5,6,April,0.8660254037844388,-0.4999999999999998,47,6,1,0,2,1.0,1.3333333333333333,30,34,-4,29,48,-19,"April, 1998"
1997-1998,31,1998-04-05,Derby,Chelsea,0,1,A,0,3,2,0,3,3,0,2,8,6,45,48,2,3,April,0.8660254037844388,-0.4999999999999998,17,14,1,0,2,1.3333333333333333,3.0,44,40,4,59,35,24,"April, 1998"
1997-1998,31,1998-04-06,Blackburn,Man United,1,3,A,0,3,2,1,2,3,2,0,6,1,51,63,5,12,April,0.8660254037844388,-0.4999999999999998,4,28,0,1,4,1.0,2.4,51,39,12,60,23,37,"April, 1998"
1997-1998,31,1998-04-08,Leeds,Chelsea,3,1,H,3,0,1,2,2,3,0,2,5,4,51,51,1,0,April,0.8660254037844388,-0.4999999999999998,23,14,2,2,1,0.8,0.8,47,34,13,60,35,25,"April, 1998"
1997-1998,32,1998-04-10,Man United,Liverpool,1,1,D,1,1,3,2,0,2,1,2,1,3,66,54,2,12,April,0.8660254037844388,-0.4999999999999998,28,25,3,1,1,1.8,1.2,63,24,39,54,34,20,"April, 1998"
1997-1998,32,1998-04-11,West Ham,Derby,0,0,D,1,1,2,1,2,2,0,3,8,9,47,45,1,2,April,0.8660254037844388,-0.4999999999999998,45,17,0,1,2,0.3333333333333333,1.3333333333333333,44,40,4,44,41,3,"April, 1998"
1997-1998,32,1998-04-11,Southampton,Wimbledon,0,1,A,0,3,1,2,2,0,3,2,12,14,43,37,2,6,April,0.8660254037844388,-0.4999999999999998,38,47,1,2,2,0.6,1.0,41,44,-3,30,34,-4,"April, 1998"
1997-1998,32,1998-04-11,Everton,Leeds,2,0,H,3,0,0,3,2,1,2,2,17,5,34,54,12,20,April,0.8660254037844388,-0.4999999999999998,18,23,1,3,1,0.8,0.6,36,47,-11,50,35,15,"April, 1998"
1997-1998,32,1998-04-11,Crystal Palace,Leicester,0,3,A,0,3,2,1,2,2,2,1,20,12,26,41,8,15,April,0.8660254037844388,-0.4999999999999998,16,24,0,1,0,1.0,1.0,27,54,-27,36,33,3,"April, 1998"
1997-1998,32,1998-04-11,Arsenal,Newcastle,3,1,H,3,0,3,0,2,1,2,2,2,15,60,36,13,24,April,0.8660254037844388,-0.4999999999999998,0,30,3,0,2,1.0,0.8,49,26,23,28,35,-7,"April, 1998"
1997-1998,32,1998-04-11,Chelsea,Tottenham,2,0,H,3,0,3,0,2,2,3,0,5,16,51,35,11,16,April,0.8660254037844388,-0.4999999999999998,14,42,3,2,0,2.4,0.8,61,38,23,33,49,-16,"April, 1998"
1997-1998,32,1998-04-11,Bolton,Blackburn,2,1,H,3,0,2,0,3,2,1,2,19,6,31,51,13,20,April,0.8660254037844388,-0.4999999999999998,6,4,1,0,2,1.3333333333333333,2.333333333333333,29,48,-19,52,42,10,"April, 1998"
1997-1998,32,1998-04-11,Barnsley,Sheffield Weds,2,1,H,3,0,0,1,4,1,1,3,19,13,31,40,6,9,April,0.8660254037844388,-0.4999999999999998,2,37,0,0,1,1.0,2.0,33,73,-40,46,58,-12,"April, 1998"
1997-1998,32,1998-04-11,Coventry,Aston Villa,1,2,A,0,3,1,4,0,4,0,1,10,9,44,45,1,1,April,0.8660254037844388,-0.4999999999999998,15,1,0,0,5,0.6,2.8,37,36,1,40,42,-2,"April, 1998"
1997-1998,33,1998-04-13,Tottenham,Coventry,1,1,D,1,1,2,3,0,1,4,0,17,11,35,44,6,9,April,0.8660254037844388,-0.4999999999999998,42,15,3,0,2,1.8,2.0,33,51,-18,38,38,0,"April, 1998"
1997-1998,33,1998-04-13,Wimbledon,Everton,0,0,D,1,1,0,3,2,0,3,2,14,16,40,37,2,3,April,0.8660254037844388,-0.4999999999999998,47,18,3,1,1,2.6,1.2,31,34,-3,38,47,-9,"April, 1998"
1997-1998,33,1998-04-13,Sheffield Weds,West Ham,1,1,D,1,1,1,1,3,2,1,2,14,8,40,48,6,8,April,0.8660254037844388,-0.4999999999999998,37,45,0,2,3,0.4,1.6,47,60,-13,44,40,4,"April, 1998"
1997-1998,33,1998-04-13,Blackburn,Arsenal,1,4,A,0,3,2,1,2,3,0,2,6,2,51,63,4,12,April,0.8660254037844388,-0.4999999999999998,4,0,1,3,1,1.0,1.0,53,44,9,52,27,25,"April, 1998"
1997-1998,33,1998-04-13,Liverpool,Crystal Palace,2,1,H,3,0,2,1,2,2,1,2,3,20,55,26,17,29,April,0.8660254037844388,-0.4999999999999998,25,16,1,0,0,3.0,0.0,55,35,20,27,57,-30,"April, 1998"
1997-1998,33,1998-04-13,Derby,Bolton,4,0,H,3,0,2,0,3,2,0,3,9,18,46,34,9,12,April,0.8660254037844388,-0.4999999999999998,17,6,0,1,0,3.0,3.0,44,41,3,31,49,-18,"April, 1998"
1997-1998,33,1998-04-13,Newcastle,Barnsley,2,1,H,3,0,1,2,2,0,1,4,16,19,36,34,3,2,April,0.8660254037844388,-0.4999999999999998,30,2,0,1,0,2.0,2.0,29,38,-9,35,74,-39,"April, 1998"
1997-1998,33,1998-04-14,Leicester,Southampton,3,3,D,1,1,2,2,1,1,2,2,11,12,44,43,1,1,April,0.8660254037844388,-0.4999999999999998,24,38,1,1,1,1.6666666666666667,1.6666666666666667,39,33,6,41,45,-4,"April, 1998"
1997-1998,34,1998-04-18,West Ham,Blackburn,2,1,H,3,0,2,1,2,2,1,2,9,6,49,51,3,2,April,0.8660254037844388,-0.4999999999999998,45,4,1,1,3,1.2,2.2,45,41,4,54,48,6,"April, 1998"
1997-1998,34,1998-04-18,Southampton,Aston Villa,1,2,A,0,3,1,2,2,4,0,1,12,9,44,48,3,4,April,0.8660254037844388,-0.4999999999999998,38,1,0,1,4,0.2,1.4,44,48,-4,42,43,-1,"April, 1998"
1997-1998,34,1998-04-18,Man United,Newcastle,1,1,D,1,1,3,2,0,1,2,2,2,15,67,39,13,28,April,0.8660254037844388,-0.4999999999999998,28,30,3,1,1,0.8,1.0,64,25,39,31,39,-8,"April, 1998"
1997-1998,34,1998-04-18,Everton,Leicester,1,1,D,1,1,0,3,2,2,2,1,16,10,38,45,6,7,April,0.8660254037844388,-0.4999999999999998,18,24,2,1,0,1.3333333333333333,0.6666666666666666,38,47,-9,42,36,6,"April, 1998"
1997-1998,34,1998-04-18,Bolton,Leeds,2,3,A,0,3,2,0,3,1,2,2,19,5,34,54,14,20,April,0.8660254037844388,-0.4999999999999998,6,23,1,0,2,0.3333333333333333,1.3333333333333333,31,53,-22,50,37,13,"April, 1998"
1997-1998,34,1998-04-18,Barnsley,Tottenham,1,1,D,1,1,0,1,4,2,3,0,19,17,34,36,2,2,April,0.8660254037844388,-0.4999999999999998,2,42,0,0,1,0.0,3.0,36,76,-40,34,52,-18,"April, 1998"
1997-1998,34,1998-04-18,Arsenal,Wimbledon,5,0,H,3,0,3,0,2,0,3,2,2,13,66,41,11,25,April,0.8660254037844388,-0.4999999999999998,0,47,2,1,2,1.4,1.2,56,28,28,31,34,-3,"April, 1998"
1997-1998,34,1998-04-18,Crystal Palace,Derby,3,1,H,3,0,2,1,2,2,0,3,20,7,26,49,13,23,April,0.8660254037844388,-0.4999999999999998,16,17,0,1,0,0.0,0.0,28,59,-31,48,41,7,"April, 1998"
1997-1998,34,1998-04-19,Chelsea,Sheffield Weds,1,0,H,3,0,3,0,2,1,1,3,5,14,54,41,9,13,April,0.8660254037844388,-0.4999999999999998,14,37,2,3,0,1.6,0.6,63,38,25,48,61,-13,"April, 1998"
1997-1998,34,1998-04-19,Coventry,Liverpool,1,1,D,1,1,1,4,0,2,1,2,11,3,45,58,8,13,April,0.8660254037844388,-0.4999999999999998,15,25,2,1,2,0.6,0.6,39,39,0,57,36,21,"April, 1998"
1997-1998,35,1998-04-25,Tottenham,Newcastle,2,0,H,3,0,2,3,0,1,2,2,17,15,37,40,2,3,April,0.8660254037844388,-0.4999999999999998,42,30,0,2,3,0.8,2.4,35,53,-18,32,40,-8,"April, 1998"
1997-1998,35,1998-04-25,West Ham,Southampton,2,4,A,0,3,2,1,2,1,2,2,7,12,52,44,5,8,April,0.8660254037844388,-0.4999999999999998,45,38,2,1,2,0.8,1.4,47,42,5,45,50,-5,"April, 1998"
1997-1998,35,1998-04-25,Everton,Sheffield Weds,1,3,A,0,3,0,3,2,1,1,3,16,14,39,41,2,2,April,0.8660254037844388,-0.4999999999999998,18,37,2,1,2,2.2,1.8,39,48,-9,48,62,-14,"April, 1998"
1997-1998,35,1998-04-25,Leeds,Coventry,3,3,D,1,1,1,2,2,1,4,0,5,11,57,46,6,11,April,0.8660254037844388,-0.4999999999999998,23,15,1,2,2,1.0,1.2,53,39,14,40,40,0,"April, 1998"
1997-1998,35,1998-04-25,Blackburn,Wimbledon,0,0,D,1,1,2,1,2,0,3,2,7,13,51,41,6,10,April,0.8660254037844388,-0.4999999999999998,4,47,3,1,1,1.6,1.0,55,50,5,31,39,-8,"April, 1998"
1997-1998,35,1998-04-25,Chelsea,Liverpool,4,1,H,3,0,3,0,2,2,1,2,4,3,57,59,1,2,April,0.8660254037844388,-0.4999999999999998,14,25,1,1,3,1.2,2.6,64,38,26,58,37,21,"April, 1998"
1997-1998,35,1998-04-25,Barnsley,Arsenal,0,2,A,0,3,0,1,4,3,0,2,19,1,35,69,18,34,April,0.8660254037844388,-0.4999999999999998,2,0,0,0,1,0.0,5.0,37,77,-40,61,28,33,"April, 1998"
1997-1998,35,1998-04-25,Aston Villa,Bolton,1,3,A,0,3,4,0,1,2,0,3,8,19,51,34,11,17,April,0.8660254037844388,-0.4999999999999998,1,6,3,0,0,1.3333333333333333,0.0,44,44,0,33,56,-23,"April, 1998"
1997-1998,35,1998-04-26,Derby,Leicester,0,4,A,0,3,2,0,3,2,2,1,9,12,49,46,3,3,April,0.8660254037844388,-0.4999999999999998,17,24,2,0,1,2.0,1.6666666666666667,49,44,5,43,37,6,"April, 1998"
1997-1998,35,1998-04-27,Crystal Palace,Man United,0,3,A,0,3,2,1,2,3,2,0,20,2,29,68,18,39,April,0.8660254037844388,-0.4999999999999998,16,28,0,0,1,0.0,2.0,31,60,-29,65,26,39,"April, 1998"
1997-1998,36,1998-04-29,Arsenal,Derby,1,0,H,3,0,3,0,2,2,0,3,1,10,72,49,9,23,April,0.8660254037844388,-0.4999999999999998,0,17,1,1,1,1.6666666666666667,2.0,63,28,35,49,48,1,"April, 1998"
1997-1998,36,1998-04-29,Chelsea,Blackburn,0,1,A,0,3,3,0,2,2,1,2,3,6,60,52,3,8,April,0.8660254037844388,-0.4999999999999998,14,4,0,2,3,0.8,1.8,68,39,29,55,50,5,"April, 1998"
1997-1998,36,1998-04-29,Coventry,Wimbledon,0,0,D,1,1,1,4,0,0,3,2,11,14,47,42,3,5,April,0.8660254037844388,-0.4999999999999998,15,47,2,3,0,2.0,1.4,43,43,0,31,39,-8,"April, 1998"
1997-1998,36,1998-04-29,Leicester,Newcastle,0,0,D,1,1,2,2,1,1,2,2,9,15,49,40,6,9,April,0.8660254037844388,-0.4999999999999998,24,30,1,1,1,2.6666666666666665,2.333333333333333,47,37,10,32,42,-10,"April, 1998"
1997-1998,37,1998-05-02,Wimbledon,Tottenham,2,6,A,0,3,0,3,2,2,3,0,15,16,43,40,1,3,May,0.4999999999999999,-0.8660254037844387,47,42,1,1,3,0.4,1.0,31,39,-8,37,53,-16,"May, 1998"
1997-1998,37,1998-05-02,Southampton,Derby,0,2,A,0,3,1,2,2,2,0,3,12,11,47,49,1,2,May,0.4999999999999999,-0.8660254037844387,38,17,1,1,1,1.3333333333333333,2.0,49,52,-3,49,49,0,"May, 1998"
1997-1998,37,1998-05-02,Sheffield Weds,Aston Villa,1,3,A,0,3,1,1,3,4,0,1,14,10,44,51,4,7,May,0.4999999999999999,-0.8660254037844387,37,1,3,1,1,1.8,1.2,51,63,-12,45,47,-2,"May, 1998"
1997-1998,37,1998-05-02,Newcastle,Chelsea,3,1,H,3,0,1,2,2,3,0,2,15,4,41,60,11,19,May,0.4999999999999999,-0.8660254037844387,30,14,2,1,2,1.2,0.8,32,42,-10,68,40,28,"May, 1998"
1997-1998,37,1998-05-02,Liverpool,West Ham,5,0,H,3,0,2,1,2,2,1,2,4,8,59,52,4,7,May,0.4999999999999999,-0.8660254037844387,25,45,2,2,1,1.0,0.6,59,41,18,49,46,3,"May, 1998"
1997-1998,37,1998-05-02,Leicester,Barnsley,1,0,H,3,0,2,2,1,0,1,4,10,19,50,35,9,15,May,0.4999999999999999,-0.8660254037844387,24,2,1,0,0,2.0,0.0,47,37,10,37,79,-42,"May, 1998"
1997-1998,37,1998-05-02,Coventry,Blackburn,2,0,H,3,0,1,4,0,2,1,2,11,6,48,55,5,7,May,0.4999999999999999,-0.8660254037844387,15,4,1,2,2,1.2,1.8,43,43,0,56,50,6,"May, 1998"
1997-1998,37,1998-05-02,Bolton,Crystal Palace,5,2,H,3,0,2,0,3,2,1,2,18,20,37,29,2,8,May,0.4999999999999999,-0.8660254037844387,6,16,0,1,0,2.0,2.0,36,57,-21,31,63,-32,"May, 1998"
1997-1998,37,1998-05-03,Arsenal,Everton,4,0,H,3,0,3,0,2,0,3,2,1,18,75,39,17,36,May,0.4999999999999999,-0.8660254037844387,0,18,3,1,1,2.0,1.0,64,28,36,40,51,-11,"May, 1998"
1997-1998,37,1998-05-04,Man United,Leeds,3,0,H,3,0,3,2,0,1,2,2,2,5,71,58,3,13,May,0.4999999999999999,-0.8660254037844387,28,23,3,0,2,1.4,0.8,68,26,42,56,42,14,"May, 1998"
1997-1998,37,1998-05-05,Crystal Palace,West Ham,3,3,D,1,1,2,1,2,2,1,2,20,10,29,52,10,23,May,0.4999999999999999,-0.8660254037844387,16,45,0,0,1,1.0,4.0,33,68,-35,49,51,-2,"May, 1998"
1997-1998,37,1998-05-06,Liverpool,Arsenal,4,0,H,3,0,2,1,2,3,0,2,3,1,62,78,2,16,May,0.4999999999999999,-0.8660254037844387,25,0,4,1,0,1.6,0.4,64,41,23,68,28,40,"May, 1998"
1997-1998,38,1998-05-10,West Ham,Leicester,4,3,H,3,0,2,1,2,2,2,1,10,9,53,53,1,0,May,0.4999999999999999,-0.8660254037844387,45,24,2,0,1,1.0,0.6666666666666666,52,54,-2,48,37,11,"May, 1998"
1997-1998,38,1998-05-10,Tottenham,Southampton,1,1,D,1,1,2,3,0,1,2,2,16,12,43,47,4,4,May,0.4999999999999999,-0.8660254037844387,42,38,3,1,1,1.4,0.8,43,55,-12,49,54,-5,"May, 1998"
1997-1998,38,1998-05-10,Leeds,Wimbledon,1,1,D,1,1,1,2,2,0,3,2,5,16,58,43,11,15,May,0.4999999999999999,-0.8660254037844387,23,47,2,1,2,1.2,1.2,56,45,11,33,45,-12,"May, 1998"
1997-1998,38,1998-05-10,Everton,Coventry,1,1,D,1,1,0,3,2,1,4,0,18,11,39,51,7,12,May,0.4999999999999999,-0.8660254037844387,18,15,0,4,1,0.8,1.0,40,55,-15,45,43,2,"May, 1998"
1997-1998,38,1998-05-10,Derby,Liverpool,1,0,H,3,0,2,0,3,2,1,2,10,3,52,65,7,13,May,0.4999999999999999,-0.8660254037844387,17,25,0,0,3,0.3333333333333333,2.333333333333333,51,49,2,68,41,27,"May, 1998"
1997-1998,38,1998-05-10,Aston Villa,Arsenal,1,0,H,3,0,4,0,1,3,0,2,7,1,54,78,6,24,May,0.4999999999999999,-0.8660254037844387,1,0,0,4,1,1.0,1.4,48,48,0,68,32,36,"May, 1998"
1997-1998,38,1998-05-10,Chelsea,Bolton,2,0,H,3,0,3,0,2,2,0,3,4,17,60,40,13,20,May,0.4999999999999999,-0.8660254037844387,14,6,1,0,2,1.3333333333333333,1.6666666666666667,69,43,26,41,59,-18,"May, 1998"
1997-1998,38,1998-05-10,Blackburn,Newcastle,1,0,H,3,0,2,1,2,1,2,2,7,13,55,44,6,11,May,0.4999999999999999,-0.8660254037844387,4,30,2,1,2,1.0,1.0,56,52,4,35,43,-8,"May, 1998"
1997-1998,38,1998-05-10,Barnsley,Man United,0,2,A,0,3,0,1,4,3,2,0,19,2,35,74,17,39,May,0.4999999999999999,-0.8660254037844387,2,28,0,0,1,0.0,7.0,37,80,-43,71,26,45,"May, 1998"
1997-1998,38,1998-05-10,Crystal Palace,Sheffield Weds,1,0,H,3,0,2,1,2,1,1,3,20,14,30,44,6,14,May,0.4999999999999999,-0.8660254037844387,16,37,1,0,0,3.0,1.0,36,71,-35,52,66,-14,"May, 1998"
1998-1999,1,1998-08-15,Wimbledon,Tottenham,3,1,H,3,0,0,1,4,0,1,4,18,17,0,0,1,0,August,-0.8660254037844384,-0.5000000000000004,47,42,1,1,3,0.6,1.6,0,0,0,0,0,0,"August, 1998"
1998-1999,1,1998-08-15,Sheffield Weds,West Ham,0,1,A,0,3,2,2,1,3,0,2,15,18,0,0,3,0,August,-0.8660254037844384,-0.5000000000000004,37,45,0,3,2,0.6,1.6,0,0,0,0,0,0,"August, 1998"
1998-1999,1,1998-08-15,Newcastle,Charlton,0,0,D,1,1,0,4,1,1,1,3,13,11,0,0,2,0,August,-0.8660254037844384,-0.5000000000000004,30,13,0,0,0,0.0,0.0,0,0,0,0,0,0,"August, 1998"
1998-1999,1,1998-08-15,Middlesbrough,Leeds,0,0,D,1,1,1,1,3,2,2,1,12,10,0,0,2,0,August,-0.8660254037844384,-0.5000000000000004,29,23,1,3,0,0.75,0.5,0,0,0,0,0,0,"August, 1998"
1998-1999,1,1998-08-15,Everton,Aston Villa,0,0,D,1,1,3,0,2,2,0,3,7,5,0,0,2,0,August,-0.8660254037844384,-0.5000000000000004,18,1,1,0,4,0.8,2.0,0,0,0,0,0,0,"August, 1998"
1998-1999,1,1998-08-15,Coventry,Chelsea,2,1,H,3,0,1,2,2,3,2,0,7,6,0,0,1,0,August,-0.8660254037844384,-0.5000000000000004,15,14,3,0,2,1.6,1.6,0,0,0,0,0,0,"August, 1998"
1998-1999,1,1998-08-15,Blackburn,Derby,0,0,D,1,1,0,3,2,1,2,2,3,7,0,0,4,0,August,-0.8660254037844384,-0.5000000000000004,4,17,1,1,2,0.75,1.25,0,0,0,0,0,0,"August, 1998"
1998-1999,1,1998-08-15,Man United,Leicester,2,2,D,1,1,3,2,0,2,0,3,11,9,0,0,2,0,August,-0.8660254037844384,-0.5000000000000004,28,24,1,2,1,1.25,1.0,0,0,0,0,0,0,"August, 1998"
1998-1999,1,1998-08-16,Southampton,Liverpool,1,2,A,0,3,3,2,0,3,1,1,17,15,0,0,2,0,August,-0.8660254037844384,-0.5000000000000004,38,25,1,2,2,1.2,1.4,0,0,0,0,0,0,"August, 1998"
1998-1999,1,1998-08-17,Arsenal,Nott'm Forest,2,1,H,3,0,4,0,1,3,0,2,15,16,0,0,1,0,August,-0.8660254037844384,-0.5000000000000004,0,32,2,1,1,1.25,0.75,0,0,0,0,0,0,"August, 1998"
1998-1999,2,1998-08-22,Nott'm Forest,Coventry,1,0,H,3,0,3,0,2,1,2,2,17,6,0,3,11,3,August,-0.8660254037844384,-0.5000000000000004,32,15,1,2,1,1.0,0.5,1,2,-1,2,1,1,"August, 1998"
1998-1999,2,1998-08-22,West Ham,Man United,0,0,D,1,1,3,0,2,3,2,0,7,12,3,1,5,2,August,-0.8660254037844384,-0.5000000000000004,45,28,0,2,3,0.8,1.6,1,0,1,2,2,0,"August, 1998"
1998-1999,2,1998-08-22,Tottenham,Sheffield Weds,0,3,A,0,3,0,1,4,2,2,1,19,18,0,0,1,0,August,-0.8660254037844384,-0.5000000000000004,42,37,2,1,2,1.2,1.2,1,3,-2,0,1,-1,"August, 1998"
1998-1999,2,1998-08-22,Liverpool,Arsenal,0,0,D,1,1,3,1,1,4,0,1,6,4,3,3,2,0,August,-0.8660254037844384,-0.5000000000000004,25,0,4,1,0,1.8,0.2,2,1,1,2,1,1,"August, 1998"
1998-1999,2,1998-08-22,Leicester,Everton,2,0,H,3,0,2,0,3,3,0,2,9,13,1,1,4,0,August,-0.8660254037844384,-0.5000000000000004,24,18,0,2,2,0.75,1.25,2,2,0,0,0,0,"August, 1998"
1998-1999,2,1998-08-22,Derby,Wimbledon,0,0,D,1,1,1,2,2,0,1,4,12,2,1,3,10,2,August,-0.8660254037844384,-0.5000000000000004,17,47,0,3,1,0.5,1.0,0,0,0,3,1,2,"August, 1998"
1998-1999,2,1998-08-22,Chelsea,Newcastle,1,1,D,1,1,3,2,0,0,4,1,16,15,0,1,1,1,August,-0.8660254037844384,-0.5000000000000004,14,30,2,1,2,1.0,1.4,1,2,-1,0,0,0,"August, 1998"
1998-1999,2,1998-08-22,Charlton,Southampton,5,0,H,3,0,1,1,3,3,2,0,10,18,1,0,8,1,August,-0.8660254037844384,-0.5000000000000004,13,38,0,0,0,0.0,0.0,0,0,0,1,2,-1,"August, 1998"
1998-1999,2,1998-08-23,Aston Villa,Middlesbrough,3,1,H,3,0,2,0,3,1,1,3,13,16,1,1,3,0,August,-0.8660254037844384,-0.5000000000000004,1,29,2,1,1,1.25,0.75,0,0,0,0,0,0,"August, 1998"
1998-1999,2,1998-08-24,Leeds,Blackburn,1,0,H,3,0,2,2,1,0,3,2,15,14,1,1,1,0,August,-0.8660254037844384,-0.5000000000000004,23,4,3,1,1,1.8,0.8,0,0,0,0,0,0,"August, 1998"
1998-1999,3,1998-08-29,Wimbledon,Leeds,1,1,D,1,1,0,1,4,2,2,1,6,9,4,4,3,0,August,-0.8660254037844384,-0.5000000000000004,47,23,2,2,1,1.0,0.6,3,1,2,1,0,1,"August, 1998"
1998-1999,3,1998-08-29,Southampton,Nott'm Forest,1,2,A,0,3,3,2,0,3,0,2,20,12,0,3,8,3,August,-0.8660254037844384,-0.5000000000000004,38,32,1,1,2,2.0,2.0,1,7,-6,2,2,0,"August, 1998"
1998-1999,3,1998-08-29,Sheffield Weds,Aston Villa,0,1,A,0,3,2,2,1,2,0,3,11,4,3,4,7,1,August,-0.8660254037844384,-0.5000000000000004,37,1,3,1,1,1.6,1.2,3,1,2,3,1,2,"August, 1998"
1998-1999,3,1998-08-29,Middlesbrough,Derby,1,1,D,1,1,1,1,3,1,2,2,18,16,1,2,2,1,August,-0.8660254037844384,-0.5000000000000004,29,17,1,0,1,3.5,1.5,1,3,-2,0,0,0,"August, 1998"
1998-1999,3,1998-08-29,Coventry,West Ham,0,0,D,1,1,1,2,2,3,0,2,11,8,3,4,3,1,August,-0.8660254037844384,-0.5000000000000004,15,45,0,3,2,1.0,1.6,2,2,0,1,0,1,"August, 1998"
1998-1999,3,1998-08-29,Blackburn,Leicester,1,0,H,3,0,0,3,2,2,0,3,16,3,1,4,13,3,August,-0.8660254037844384,-0.5000000000000004,4,24,1,2,1,2.25,2.25,0,1,-1,4,2,2,"August, 1998"
1998-1999,3,1998-08-29,Arsenal,Charlton,0,0,D,1,1,4,0,1,1,1,3,5,1,4,4,4,0,August,-0.8660254037844384,-0.5000000000000004,0,13,0,0,0,0.0,0.0,2,1,1,5,0,5,"August, 1998"
1998-1999,3,1998-08-29,Everton,Tottenham,0,1,A,0,3,3,0,2,0,1,4,18,19,1,0,1,1,August,-0.8660254037844384,-0.5000000000000004,18,42,1,3,1,0.4,0.6,0,2,-2,1,6,-5,"August, 1998"
1998-1999,3,1998-08-30,Newcastle,Liverpool,1,4,A,0,3,0,4,1,3,1,1,16,9,2,4,7,2,August,-0.8660254037844384,-0.5000000000000004,30,25,0,1,4,1.6,2.4,1,1,0,2,1,1,"August, 1998"
1998-1999,4,1998-09-08,Leeds,Southampton,3,0,H,3,0,2,2,1,3,2,0,7,20,5,0,13,5,September,-1.0,-1.8369701987210287e-16,23,38,3,1,1,1.0,0.2,2,1,1,2,9,-7,"September, 1998"
1998-1999,4,1998-09-08,Nott'm Forest,Everton,0,2,A,0,3,3,0,2,3,0,2,4,19,6,1,15,5,September,-1.0,-1.8369701987210287e-16,32,18,1,0,3,0.75,2.0,4,3,1,0,3,-3,"September, 1998"
1998-1999,4,1998-09-09,Tottenham,Blackburn,2,1,H,3,0,0,1,4,0,3,2,17,13,3,4,4,1,September,-1.0,-1.8369701987210287e-16,42,4,3,1,1,1.8,0.8,2,6,-4,1,1,0,"September, 1998"
1998-1999,4,1998-09-09,West Ham,Wimbledon,3,4,A,0,3,3,0,2,0,1,4,11,10,5,5,1,0,September,-1.0,-1.8369701987210287e-16,45,47,2,2,1,1.4,1.2,1,0,1,4,2,2,"September, 1998"
1998-1999,4,1998-09-09,Liverpool,Coventry,2,0,H,3,0,3,1,1,1,2,2,3,12,7,4,9,3,September,-1.0,-1.8369701987210287e-16,25,15,2,1,2,0.8,0.8,6,2,4,2,2,0,"September, 1998"
1998-1999,4,1998-09-09,Man United,Charlton,4,1,H,3,0,3,2,0,1,1,3,17,7,2,5,10,3,September,-1.0,-1.8369701987210287e-16,28,13,0,0,0,0.0,0.0,2,2,0,5,0,5,"September, 1998"
1998-1999,4,1998-09-09,Derby,Sheffield Weds,1,0,H,3,0,1,2,2,2,2,1,14,13,3,3,1,0,September,-1.0,-1.8369701987210287e-16,17,37,2,2,0,2.5,1.0,1,1,0,3,2,1,"September, 1998"
1998-1999,4,1998-09-09,Chelsea,Arsenal,0,0,D,1,1,3,2,0,4,0,1,19,7,1,5,12,4,September,-1.0,-1.8369701987210287e-16,14,0,0,2,3,1.2,2.4,2,3,-1,2,1,1,"September, 1998"
1998-1999,4,1998-09-09,Aston Villa,Newcastle,1,0,H,3,0,2,0,3,0,4,1,3,18,7,2,15,5,September,-1.0,-1.8369701987210287e-16,1,30,0,1,4,1.0,1.8,4,1,3,2,5,-3,"September, 1998"
1998-1999,4,1998-09-09,Leicester,Middlesbrough,0,1,A,0,3,2,0,3,1,1,3,10,18,4,2,8,2,September,-1.0,-1.8369701987210287e-16,24,29,1,0,1,1.5,1.5,4,3,1,2,4,-2,"September, 1998"
1998-1999,5,1998-09-12,West Ham,Liverpool,2,1,H,3,0,3,0,2,3,1,1,15,2,5,10,13,5,September,-1.0,-1.8369701987210287e-16,45,25,1,1,3,0.6,2.0,4,4,0,8,2,6,"September, 1998"
1998-1999,5,1998-09-12,Newcastle,Southampton,4,0,H,3,0,0,4,1,3,2,0,19,20,2,0,1,2,September,-1.0,-1.8369701987210287e-16,30,38,2,1,2,1.2,1.2,2,6,-4,2,12,-10,"September, 1998"
1998-1999,5,1998-09-12,Man United,Coventry,2,0,H,3,0,3,2,0,1,2,2,9,17,5,4,8,1,September,-1.0,-1.8369701987210287e-16,28,15,4,0,1,2.2,0.8,6,3,3,2,4,-2,"September, 1998"
1998-1999,5,1998-09-12,Leicester,Arsenal,1,1,D,1,1,2,0,3,4,0,1,15,6,4,6,9,2,September,-1.0,-1.8369701987210287e-16,24,0,0,1,3,1.0,2.25,4,4,0,2,1,1,"September, 1998"
1998-1999,5,1998-09-12,Sheffield Weds,Blackburn,3,0,H,3,0,2,2,1,0,3,2,19,17,3,4,2,1,September,-1.0,-1.8369701987210287e-16,37,4,0,2,3,0.8,3.0,3,3,0,2,3,-1,"September, 1998"
1998-1999,5,1998-09-12,Chelsea,Nott'm Forest,2,1,H,3,0,3,2,0,3,0,2,18,7,2,6,11,4,September,-1.0,-1.8369701987210287e-16,14,32,1,2,1,0.5,0.75,2,3,-1,4,5,-1,"September, 1998"
1998-1999,5,1998-09-12,Charlton,Derby,1,2,A,0,3,1,1,3,1,2,2,10,6,5,6,4,1,September,-1.0,-1.8369701987210287e-16,13,17,0,0,0,0.0,0.0,6,4,2,2,1,1,"September, 1998"
1998-1999,5,1998-09-12,Aston Villa,Wimbledon,2,0,H,3,0,2,0,3,0,1,4,2,4,10,8,2,2,September,-1.0,-1.8369701987210287e-16,1,47,2,1,2,2.4,1.4,5,1,4,8,5,3,"September, 1998"
1998-1999,5,1998-09-12,Everton,Leeds,0,0,D,1,1,3,0,2,2,2,1,16,4,4,8,12,4,September,-1.0,-1.8369701987210287e-16,18,23,1,3,1,0.8,0.6,2,3,-1,5,1,4,"September, 1998"
1998-1999,5,1998-09-13,Tottenham,Middlesbrough,0,3,A,0,3,0,1,4,1,1,3,11,16,6,5,5,1,September,-1.0,-1.8369701987210287e-16,42,29,3,1,0,1.5,0.25,4,7,-3,3,4,-1,"September, 1998"
1998-1999,6,1998-09-19,Wimbledon,Sheffield Weds,2,1,H,3,0,0,1,4,2,2,1,9,13,8,6,4,2,September,-1.0,-1.8369701987210287e-16,47,37,1,2,2,1.6,1.8,8,7,1,6,3,3,"September, 1998"
1998-1999,6,1998-09-19,Coventry,Newcastle,1,5,A,0,3,1,2,2,0,4,1,19,14,4,5,5,1,September,-1.0,-1.8369701987210287e-16,15,30,1,2,2,0.8,1.6,2,6,-4,6,6,0,"September, 1998"
1998-1999,6,1998-09-19,Derby,Leicester,2,0,H,3,0,1,2,2,2,0,3,4,15,9,5,11,4,September,-1.0,-1.8369701987210287e-16,17,24,2,0,2,1.5,2.25,4,2,2,5,5,0,"September, 1998"
1998-1999,6,1998-09-19,Leeds,Aston Villa,0,0,D,1,1,2,2,1,2,0,3,4,1,9,13,3,4,September,-1.0,-1.8369701987210287e-16,23,1,0,2,3,0.2,1.4,5,1,4,7,1,6,"September, 1998"
1998-1999,6,1998-09-19,Liverpool,Charlton,3,3,D,1,1,3,1,1,1,1,3,3,14,10,5,11,5,September,-1.0,-1.8369701987210287e-16,25,13,0,0,0,0.0,0.0,9,4,5,7,6,1,"September, 1998"
1998-1999,6,1998-09-19,Middlesbrough,Everton,2,2,D,1,1,1,1,3,3,0,2,7,16,8,5,9,3,September,-1.0,-1.8369701987210287e-16,29,18,2,0,2,1.5,2.25,6,4,2,2,3,-1,"September, 1998"
1998-1999,6,1998-09-19,Nott'm Forest,West Ham,0,0,D,1,1,3,0,2,3,0,2,14,9,6,8,5,2,September,-1.0,-1.8369701987210287e-16,32,45,1,1,2,0.5,1.0,5,7,-2,6,5,1,"September, 1998"
1998-1999,6,1998-09-19,Southampton,Tottenham,1,1,D,1,1,3,2,0,0,1,4,20,15,0,6,5,6,September,-1.0,-1.8369701987210287e-16,38,42,1,1,3,1.0,1.6,2,16,-14,4,10,-6,"September, 1998"
1998-1999,6,1998-09-20,Arsenal,Man United,3,0,H,3,0,4,0,1,3,2,0,10,8,7,8,2,1,September,-1.0,-1.8369701987210287e-16,0,28,2,0,3,1.0,1.2,3,2,1,8,3,5,"September, 1998"
1998-1999,6,1998-09-21,Blackburn,Chelsea,3,4,A,0,3,0,3,2,3,2,0,18,16,4,5,2,1,September,-1.0,-1.8369701987210287e-16,4,14,3,2,0,1.4,0.8,2,6,-4,4,4,0,"September, 1998"
1998-1999,6,1998-09-24,Man United,Liverpool,2,0,H,3,0,3,2,0,3,1,1,10,3,8,11,7,3,September,-1.0,-1.8369701987210287e-16,28,25,3,1,1,1.6,1.0,8,6,2,12,7,5,"September, 1998"
1998-1999,7,1998-09-26,Aston Villa,Derby,1,0,H,3,0,2,0,3,1,2,2,1,2,14,12,1,2,September,-1.0,-1.8369701987210287e-16,1,17,3,0,1,1.5,0.75,7,1,6,6,2,4,"September, 1998"
1998-1999,7,1998-09-26,Charlton,Coventry,1,1,D,1,1,1,1,3,1,2,2,15,19,6,4,4,2,September,-1.0,-1.8369701987210287e-16,13,15,0,0,0,0.0,0.0,10,9,1,3,11,-8,"September, 1998"
1998-1999,7,1998-09-26,Chelsea,Middlesbrough,2,0,H,3,0,3,2,0,1,1,3,11,8,8,9,3,1,September,-1.0,-1.8369701987210287e-16,14,29,2,0,2,1.5,0.75,8,7,1,8,6,2,"September, 1998"
1998-1999,7,1998-09-26,Everton,Blackburn,0,0,D,1,1,3,0,2,0,3,2,16,19,6,4,3,2,September,-1.0,-1.8369701987210287e-16,18,4,2,1,2,1.4,1.2,4,5,-1,5,10,-5,"September, 1998"
1998-1999,7,1998-09-26,Newcastle,Nott'm Forest,2,0,H,3,0,0,4,1,3,0,2,11,14,8,7,3,1,September,-1.0,-1.8369701987210287e-16,30,32,2,2,0,2.25,0.5,11,7,4,5,7,-2,"September, 1998"
1998-1999,7,1998-09-26,Sheffield Weds,Arsenal,1,0,H,3,0,2,2,1,4,0,1,16,8,6,10,8,4,September,-1.0,-1.8369701987210287e-16,37,0,2,1,2,0.8,1.0,7,5,2,6,2,4,"September, 1998"
1998-1999,7,1998-09-26,Tottenham,Leeds,3,3,D,1,1,0,1,4,2,2,1,16,8,7,10,8,3,September,-1.0,-1.8369701987210287e-16,42,23,2,1,2,0.8,0.6,5,11,-6,5,1,4,"September, 1998"
1998-1999,7,1998-09-27,Leicester,Wimbledon,1,1,D,1,1,2,0,3,0,1,4,17,8,5,11,9,6,September,-1.0,-1.8369701987210287e-16,24,47,2,0,2,1.25,1.0,5,7,-2,10,8,2,"September, 1998"
1998-1999,7,1998-09-28,West Ham,Southampton,1,0,H,3,0,3,0,2,3,2,0,11,20,9,1,9,8,September,-1.0,-1.8369701987210287e-16,45,38,2,0,3,1.2,2.2,6,5,1,3,17,-14,"September, 1998"
1998-1999,8,1998-10-03,Wimbledon,Everton,1,2,A,0,3,0,1,4,3,0,2,4,17,12,7,13,5,October,-0.8660254037844386,0.5,47,18,3,2,0,2.2,0.6,11,9,2,4,5,-1,"October, 1998"
1998-1999,8,1998-10-03,Southampton,Man United,0,3,A,0,3,3,2,0,3,2,0,20,7,1,11,13,10,October,-0.8660254037844386,0.5,38,28,3,0,2,2.2,1.4,3,18,-15,10,6,4,"October, 1998"
1998-1999,8,1998-10-03,Nott'm Forest,Charlton,0,1,A,0,3,3,0,2,1,1,3,18,16,7,7,2,0,October,-0.8660254037844386,0.5,32,13,0,0,0,0.0,0.0,5,9,-4,11,10,1,"October, 1998"
1998-1999,8,1998-10-03,Middlesbrough,Sheffield Weds,4,0,H,3,0,1,1,3,2,2,1,13,12,9,9,1,0,October,-0.8660254037844386,0.5,29,37,3,0,1,2.25,1.5,8,8,0,8,5,3,"October, 1998"
1998-1999,8,1998-10-03,Coventry,Aston Villa,1,2,A,0,3,1,2,2,2,0,3,19,1,5,17,18,12,October,-0.8660254037844386,0.5,15,1,0,0,5,0.8,2.6,4,12,-8,8,1,7,"October, 1998"
1998-1999,8,1998-10-03,Derby,Tottenham,0,1,A,0,3,1,2,2,0,1,4,2,14,12,8,12,4,October,-0.8660254037844386,0.5,17,42,2,1,1,1.75,1.25,6,3,3,8,14,-6,"October, 1998"
1998-1999,8,1998-10-03,Blackburn,West Ham,3,0,H,3,0,0,3,2,3,0,2,18,4,5,12,14,7,October,-0.8660254037844386,0.5,4,45,3,0,2,2.2,1.4,5,10,-5,7,5,2,"October, 1998"
1998-1999,8,1998-10-03,Leeds,Leicester,0,1,A,0,3,2,2,1,2,0,3,7,18,11,6,11,5,October,-0.8660254037844386,0.5,23,24,1,0,3,0.75,0.75,8,4,4,6,8,-2,"October, 1998"
1998-1999,8,1998-10-04,Arsenal,Newcastle,3,0,H,3,0,4,0,1,0,4,1,12,7,10,11,5,1,October,-0.8660254037844386,0.5,0,30,4,0,1,1.6,0.6,6,3,3,13,7,6,"October, 1998"
1998-1999,8,1998-10-04,Liverpool,Chelsea,1,1,D,1,1,3,1,1,3,2,0,9,10,11,11,1,0,October,-0.8660254037844386,0.5,25,14,3,0,2,2.4,1.6,12,9,3,10,7,3,"October, 1998"
1998-1999,9,1998-10-17,Newcastle,Derby,2,1,H,3,0,0,4,1,1,2,2,10,7,11,12,3,1,October,-0.8660254037844386,0.5,30,17,2,1,1,1.0,0.5,13,10,3,6,4,2,"October, 1998"
1998-1999,9,1998-10-17,West Ham,Aston Villa,0,0,D,1,1,3,0,2,2,0,3,10,1,12,20,9,8,October,-0.8660254037844386,0.5,45,1,1,2,2,0.6,1.2,7,8,-1,10,2,8,"October, 1998"
1998-1999,9,1998-10-17,Nott'm Forest,Leeds,1,1,D,1,1,3,0,2,2,2,1,18,11,7,11,7,4,October,-0.8660254037844386,0.5,32,23,2,1,1,1.5,1.25,5,10,-5,8,5,3,"October, 1998"
1998-1999,9,1998-10-17,Middlesbrough,Blackburn,2,1,H,3,0,1,1,3,0,3,2,6,17,12,8,11,4,October,-0.8660254037844386,0.5,29,4,2,1,1,1.0,0.5,12,8,4,8,10,-2,"October, 1998"
1998-1999,9,1998-10-17,Chelsea,Charlton,2,1,H,3,0,3,2,0,1,1,3,6,13,12,10,7,2,October,-0.8660254037844386,0.5,14,13,0,0,0,0.0,0.0,11,8,3,12,10,2,"October, 1998"
1998-1999,9,1998-10-17,Everton,Liverpool,0,0,D,1,1,3,0,2,3,1,1,14,6,10,12,8,2,October,-0.8660254037844386,0.5,18,25,1,4,0,1.2,0.8,6,6,0,13,10,3,"October, 1998"
1998-1999,9,1998-10-17,Arsenal,Southampton,1,1,D,1,1,4,0,1,3,2,0,3,20,13,1,17,12,October,-0.8660254037844386,0.5,0,38,4,1,0,2.2,0.4,9,3,6,3,21,-18,"October, 1998"
1998-1999,9,1998-10-17,Man United,Wimbledon,5,1,H,3,0,3,2,0,0,1,4,3,8,14,12,5,2,October,-0.8660254037844386,0.5,28,47,5,0,0,3.2,1.0,13,6,7,12,11,1,"October, 1998"
1998-1999,9,1998-10-18,Coventry,Sheffield Weds,1,0,H,3,0,1,2,2,2,2,1,19,15,5,9,4,4,October,-0.8660254037844386,0.5,15,37,1,3,1,0.8,0.8,5,14,-9,8,9,-1,"October, 1998"
1998-1999,9,1998-10-19,Leicester,Tottenham,2,1,H,3,0,2,0,3,0,1,4,15,13,9,11,2,2,October,-0.8660254037844386,0.5,24,42,2,2,0,1.75,0.75,7,8,-1,9,14,-5,"October, 1998"
1998-1999,10,1998-10-24,Wimbledon,Middlesbrough,2,2,D,1,1,0,1,4,1,1,3,15,4,12,15,11,3,October,-0.8660254037844386,0.5,47,29,1,3,0,0.75,0.5,13,16,-3,14,9,5,"October, 1998"
1998-1999,10,1998-10-24,Tottenham,Newcastle,2,0,H,3,0,0,1,4,0,4,1,15,7,11,14,8,3,October,-0.8660254037844386,0.5,42,30,1,1,3,1.0,2.2,10,16,-6,15,11,4,"October, 1998"
1998-1999,10,1998-10-24,Southampton,Coventry,2,1,H,3,0,3,2,0,1,2,2,20,18,2,8,2,6,October,-0.8660254037844386,0.5,38,15,1,2,2,1.0,1.2,4,22,-18,6,14,-8,"October, 1998"
1998-1999,10,1998-10-24,Sheffield Weds,Everton,0,0,D,1,1,2,2,1,3,0,2,16,14,9,11,2,2,October,-0.8660254037844386,0.5,37,18,3,0,2,2.0,2.0,8,10,-2,6,6,0,"October, 1998"
1998-1999,10,1998-10-24,Liverpool,Nott'm Forest,5,1,H,3,0,3,1,1,3,0,2,8,18,13,8,10,5,October,-0.8660254037844386,0.5,25,32,2,1,1,2.25,1.5,13,10,3,6,11,-5,"October, 1998"
1998-1999,10,1998-10-24,Charlton,West Ham,4,2,H,3,0,1,1,3,3,0,2,15,9,10,13,6,3,October,-0.8660254037844386,0.5,13,45,0,0,0,0.0,0.0,13,12,1,7,8,-1,"October, 1998"
1998-1999,10,1998-10-24,Aston Villa,Leicester,1,1,D,1,1,2,0,3,2,0,3,1,11,21,12,10,9,October,-0.8660254037844386,0.5,1,24,0,1,3,0.5,1.5,10,2,8,9,9,0,"October, 1998"
1998-1999,10,1998-10-24,Derby,Man United,1,1,D,1,1,1,2,2,3,2,0,12,2,12,17,10,5,October,-0.8660254037844386,0.5,17,28,1,2,1,1.5,1.75,7,6,1,18,7,11,"October, 1998"
1998-1999,10,1998-10-25,Blackburn,Arsenal,1,2,A,0,3,0,3,2,4,0,1,17,6,8,14,11,6,October,-0.8660254037844386,0.5,4,0,1,2,2,1.2,1.8,9,12,-3,10,4,6,"October, 1998"
1998-1999,10,1998-10-25,Leeds,Chelsea,0,0,D,1,1,2,2,1,3,2,0,14,6,12,15,8,3,October,-0.8660254037844386,0.5,23,14,2,2,1,1.2,1.0,9,6,3,13,9,4,"October, 1998"
1998-1999,11,1998-10-31,Sheffield Weds,Southampton,0,0,D,1,1,2,2,1,3,2,0,16,20,10,5,4,5,October,-0.8660254037844386,0.5,37,38,4,1,0,1.8,1.0,8,10,-2,6,23,-17,"October, 1998"
1998-1999,11,1998-10-31,Wimbledon,Blackburn,1,1,D,1,1,0,1,4,0,3,2,14,17,13,8,3,5,October,-0.8660254037844386,0.5,47,4,1,1,3,0.8,1.4,15,18,-3,10,14,-4,"October, 1998"
1998-1999,11,1998-10-31,Newcastle,West Ham,0,3,A,0,3,0,4,1,3,0,2,9,14,14,13,5,1,October,-0.8660254037844386,0.5,30,45,2,2,1,1.0,0.4,15,13,2,9,12,-3,"October, 1998"
1998-1999,11,1998-10-31,Leicester,Liverpool,1,0,H,3,0,2,0,3,3,1,1,12,4,13,16,8,3,October,-0.8660254037844386,0.5,24,25,1,2,1,0.75,1.25,10,10,0,18,11,7,"October, 1998"
1998-1999,11,1998-10-31,Everton,Man United,1,4,A,0,3,3,0,2,3,2,0,15,3,12,18,12,6,October,-0.8660254037844386,0.5,18,28,0,1,4,0.4,2.0,6,6,0,19,8,11,"October, 1998"
1998-1999,11,1998-10-31,Derby,Leeds,2,2,D,1,1,1,2,2,2,2,1,11,10,13,13,1,0,October,-0.8660254037844386,0.5,17,23,0,2,2,1.5,3.0,8,7,1,9,6,3,"October, 1998"
1998-1999,11,1998-10-31,Coventry,Arsenal,0,1,A,0,3,1,2,2,4,0,1,18,3,8,17,15,9,October,-0.8660254037844386,0.5,15,0,0,4,1,0.8,1.2,7,16,-9,12,5,7,"October, 1998"
1998-1999,11,1998-11-01,Middlesbrough,Nott'm Forest,1,1,D,1,1,1,1,3,3,0,2,5,18,16,8,13,8,November,-0.5000000000000004,0.8660254037844384,29,32,0,3,1,0.75,1.0,16,11,5,7,16,-9,"November, 1998"
1998-1999,11,1998-11-02,Tottenham,Charlton,2,2,D,1,1,0,1,4,1,1,3,13,14,14,13,1,1,November,-0.5000000000000004,0.8660254037844384,42,13,0,0,0,0.0,0.0,12,16,-4,17,14,3,"November, 1998"
1998-1999,12,1998-11-07,Aston Villa,Tottenham,3,2,H,3,0,2,0,3,0,1,4,1,9,22,15,8,7,November,-0.5000000000000004,0.8660254037844384,1,42,2,1,2,1.8,1.4,11,3,8,14,18,-4,"November, 1998"
1998-1999,12,1998-11-07,Blackburn,Coventry,1,2,A,0,3,0,3,2,1,2,2,17,19,9,8,2,1,November,-0.5000000000000004,0.8660254037844384,4,15,1,2,2,0.8,1.4,11,15,-4,7,17,-10,"November, 1998"
1998-1999,12,1998-11-07,Charlton,Leicester,0,0,D,1,1,1,1,3,2,0,3,10,7,14,16,3,2,November,-0.5000000000000004,0.8660254037844384,13,24,0,0,0,0.0,0.0,19,16,3,11,10,1,"November, 1998"
1998-1999,12,1998-11-07,Liverpool,Derby,1,2,A,0,3,3,1,1,1,2,2,6,12,16,14,6,2,November,-0.5000000000000004,0.8660254037844384,25,17,3,0,1,1.75,0.5,18,12,6,10,9,1,"November, 1998"
1998-1999,12,1998-11-07,Nott'm Forest,Wimbledon,0,1,A,0,3,3,0,2,0,1,4,19,14,9,14,5,5,November,-0.5000000000000004,0.8660254037844384,32,47,1,1,2,1.25,1.0,8,17,-9,16,19,-3,"November, 1998"
1998-1999,12,1998-11-07,Southampton,Middlesbrough,3,3,D,1,1,3,2,0,1,1,3,20,4,6,17,16,11,November,-0.5000000000000004,0.8660254037844384,38,29,3,1,0,1.75,0.25,6,23,-17,17,12,5,"November, 1998"
1998-1999,12,1998-11-08,West Ham,Chelsea,1,1,D,1,1,3,0,2,3,2,0,11,10,16,16,1,0,November,-0.5000000000000004,0.8660254037844384,45,14,3,0,2,1.8,1.8,12,12,0,13,9,4,"November, 1998"
1998-1999,12,1998-11-08,Man United,Newcastle,0,0,D,1,1,3,2,0,0,4,1,3,14,21,14,11,7,November,-0.5000000000000004,0.8660254037844384,28,30,2,2,1,0.6,1.2,23,9,14,15,16,-1,"November, 1998"
1998-1999,12,1998-11-08,Arsenal,Everton,1,0,H,3,0,4,0,1,3,0,2,3,15,20,12,12,8,November,-0.5000000000000004,0.8660254037844384,0,18,3,1,1,2.4,1.0,13,5,8,7,10,-3,"November, 1998"
1998-1999,12,1998-11-08,Leeds,Sheffield Weds,2,1,H,3,0,2,2,1,2,2,1,13,16,14,11,3,3,November,-0.5000000000000004,0.8660254037844384,23,37,1,1,3,1.6,2.6,11,8,3,8,10,-2,"November, 1998"
1998-1999,13,1998-11-14,West Ham,Leicester,3,2,H,3,0,3,0,2,2,0,3,9,8,17,17,1,0,November,-0.5000000000000004,0.8660254037844384,45,24,3,0,1,1.75,1.25,13,13,0,11,10,1,"November, 1998"
1998-1999,13,1998-11-14,Arsenal,Tottenham,0,0,D,1,1,4,0,1,0,1,4,2,14,23,15,12,8,November,-0.5000000000000004,0.8660254037844384,0,42,1,4,0,0.8,0.4,14,5,9,16,21,-5,"November, 1998"
1998-1999,13,1998-11-14,Charlton,Middlesbrough,1,1,D,1,1,1,1,3,1,1,3,13,4,15,18,9,3,November,-0.5000000000000004,0.8660254037844384,13,29,0,0,0,0.0,0.0,19,16,3,20,15,5,"November, 1998"
1998-1999,13,1998-11-14,Chelsea,Wimbledon,3,0,H,3,0,3,2,0,0,1,4,5,10,17,17,5,0,November,-0.5000000000000004,0.8660254037844384,14,47,2,2,1,1.4,1.2,14,10,4,17,19,-2,"November, 1998"
1998-1999,13,1998-11-14,Liverpool,Leeds,1,3,A,0,3,3,1,1,2,2,1,11,6,16,17,5,1,November,-0.5000000000000004,0.8660254037844384,25,23,5,0,0,3.2,0.2,19,14,5,13,9,4,"November, 1998"
1998-1999,13,1998-11-14,Man United,Blackburn,3,2,H,3,0,3,2,0,0,3,2,3,18,22,9,15,13,November,-0.5000000000000004,0.8660254037844384,28,4,4,1,0,2.6,1.0,23,9,14,12,17,-5,"November, 1998"
1998-1999,13,1998-11-14,Newcastle,Sheffield Weds,1,1,D,1,1,0,4,1,2,2,1,14,16,15,11,2,4,November,-0.5000000000000004,0.8660254037844384,30,37,2,1,2,1.4,1.2,15,16,-1,9,12,-3,"November, 1998"
1998-1999,13,1998-11-14,Southampton,Aston Villa,1,4,A,0,3,3,2,0,2,0,3,20,2,7,25,18,18,November,-0.5000000000000004,0.8660254037844384,38,1,0,1,4,0.4,1.6,9,26,-17,14,5,9,"November, 1998"
1998-1999,13,1998-11-15,Coventry,Everton,3,0,H,3,0,1,2,2,3,0,2,17,16,11,12,1,1,November,-0.5000000000000004,0.8660254037844384,15,18,0,5,0,0.8,0.8,9,18,-9,7,11,-4,"November, 1998"
1998-1999,13,1998-11-16,Nott'm Forest,Derby,2,2,D,1,1,3,0,2,1,2,2,19,8,9,17,11,8,November,-0.5000000000000004,0.8660254037844384,32,17,0,2,0,0.5,0.5,8,18,-10,12,10,2,"November, 1998"
1998-1999,14,1998-11-21,Aston Villa,Liverpool,2,4,A,0,3,2,0,3,3,1,1,1,12,28,16,11,12,November,-0.5000000000000004,0.8660254037844384,1,25,2,0,3,0.6,2.0,18,6,12,20,17,3,"November, 1998"
1998-1999,14,1998-11-21,Blackburn,Southampton,0,2,A,0,3,0,3,2,3,2,0,19,20,9,7,1,2,November,-0.5000000000000004,0.8660254037844384,4,38,2,0,3,0.6,1.4,14,20,-6,10,30,-20,"November, 1998"
1998-1999,14,1998-11-21,Leeds,Charlton,4,1,H,3,0,2,2,1,1,1,3,5,12,20,16,7,4,November,-0.5000000000000004,0.8660254037844384,23,13,0,0,0,0.0,0.0,16,10,6,20,17,3,"November, 1998"
1998-1999,14,1998-11-21,Leicester,Chelsea,2,4,A,0,3,2,0,3,3,2,0,10,5,17,20,5,3,November,-0.5000000000000004,0.8660254037844384,24,14,1,0,3,1.0,1.5,13,13,0,17,10,7,"November, 1998"
1998-1999,14,1998-11-21,Middlesbrough,Coventry,2,0,H,3,0,1,1,3,1,2,2,8,15,19,14,7,5,November,-0.5000000000000004,0.8660254037844384,29,15,2,1,1,1.5,1.0,21,16,5,12,18,-6,"November, 1998"
1998-1999,14,1998-11-21,Sheffield Weds,Man United,3,1,H,3,0,2,2,1,3,2,0,16,2,12,25,14,13,November,-0.5000000000000004,0.8660254037844384,37,28,1,2,2,1.2,2.2,10,13,-3,26,11,15,"November, 1998"
1998-1999,14,1998-11-21,Tottenham,Nott'm Forest,2,0,H,3,0,0,1,4,3,0,2,14,18,16,10,4,6,November,-0.5000000000000004,0.8660254037844384,42,32,0,0,4,0.5,1.5,16,21,-5,10,20,-10,"November, 1998"
1998-1999,14,1998-11-21,Wimbledon,Arsenal,1,0,H,3,0,0,1,4,4,0,1,12,3,17,24,9,7,November,-0.5000000000000004,0.8660254037844384,47,0,1,1,3,0.6,2.2,17,22,-5,14,5,9,"November, 1998"
1998-1999,14,1998-11-22,Derby,West Ham,0,2,A,0,3,1,2,2,3,0,2,11,7,18,20,4,2,November,-0.5000000000000004,0.8660254037844384,17,45,2,2,0,1.0,0.25,14,12,2,16,15,1,"November, 1998"
1998-1999,14,1998-11-23,Everton,Newcastle,1,0,H,3,0,3,0,2,0,4,1,17,14,12,16,3,4,November,-0.5000000000000004,0.8660254037844384,18,30,1,1,3,0.6,1.2,7,14,-7,16,17,-1,"November, 1998"
1998-1999,15,1998-11-28,West Ham,Tottenham,2,1,H,3,0,3,0,2,0,1,4,6,12,23,19,6,4,November,-0.5000000000000004,0.8660254037844384,45,42,3,0,2,1.4,1.2,18,15,3,18,21,-3,"November, 1998"
1998-1999,15,1998-11-28,Southampton,Derby,0,1,A,0,3,3,2,0,1,2,2,19,12,10,18,7,8,November,-0.5000000000000004,0.8660254037844384,38,17,1,1,2,1.0,2.0,12,30,-18,14,14,0,"November, 1998"
1998-1999,15,1998-11-28,Nott'm Forest,Aston Villa,2,2,D,1,1,3,0,2,2,0,3,18,1,10,28,17,18,November,-0.5000000000000004,0.8660254037844384,32,1,0,3,1,0.5,1.0,10,22,-12,20,10,10,"November, 1998"
1998-1999,15,1998-11-28,Chelsea,Sheffield Weds,1,1,D,1,1,3,2,0,2,2,1,4,16,23,15,12,8,November,-0.5000000000000004,0.8660254037844384,14,37,3,2,0,1.8,0.6,21,12,9,13,14,-1,"November, 1998"
1998-1999,15,1998-11-28,Coventry,Leicester,1,1,D,1,1,1,2,2,2,0,3,17,13,14,17,4,3,November,-0.5000000000000004,0.8660254037844384,15,24,1,2,1,0.75,0.75,12,20,-8,15,17,-2,"November, 1998"
1998-1999,15,1998-11-28,Charlton,Everton,1,2,A,0,3,1,1,3,3,0,2,13,16,16,15,3,1,November,-0.5000000000000004,0.8660254037844384,13,18,0,0,0,0.0,0.0,21,21,0,8,14,-6,"November, 1998"
1998-1999,15,1998-11-28,Newcastle,Wimbledon,3,1,H,3,0,0,4,1,0,1,4,16,8,16,20,8,4,November,-0.5000000000000004,0.8660254037844384,30,47,1,3,1,1.4,1.4,16,18,-2,18,22,-4,"November, 1998"
1998-1999,15,1998-11-29,Arsenal,Middlesbrough,1,1,D,1,1,4,0,1,1,1,3,5,7,24,22,2,2,November,-0.5000000000000004,0.8660254037844384,0,29,3,1,0,2.0,0.75,14,6,8,23,16,7,"November, 1998"
1998-1999,15,1998-11-29,Liverpool,Blackburn,2,0,H,3,0,3,1,1,0,3,2,10,20,19,9,10,10,November,-0.5000000000000004,0.8660254037844384,25,4,1,3,1,0.8,1.2,24,19,5,14,22,-8,"November, 1998"
1998-1999,15,1998-11-29,Man United,Leeds,3,2,H,3,0,3,2,0,2,2,1,3,6,25,23,3,2,November,-0.5000000000000004,0.8660254037844384,28,23,4,0,1,1.8,0.2,27,14,13,20,11,9,"November, 1998"
1998-1999,16,1998-12-05,Leicester,Southampton,2,0,H,3,0,2,0,3,3,2,0,14,20,18,10,6,8,December,-2.4492935982947064e-16,1.0,24,38,1,2,1,2.0,2.0,16,18,-2,12,31,-19,"December, 1998"
1998-1999,16,1998-12-05,Wimbledon,Coventry,2,1,H,3,0,0,1,4,1,2,2,12,17,20,15,5,5,December,-2.4492935982947064e-16,1.0,47,15,0,3,2,0.8,1.4,19,25,-6,13,21,-8,"December, 1998"
1998-1999,16,1998-12-05,Tottenham,Liverpool,2,1,H,3,0,0,1,4,3,1,1,13,8,19,22,5,3,December,-2.4492935982947064e-16,1.0,42,25,0,2,3,0.8,2.2,19,23,-4,26,19,7,"December, 1998"
1998-1999,16,1998-12-05,Leeds,West Ham,4,0,H,3,0,2,2,1,3,0,2,6,4,23,26,2,3,December,-2.4492935982947064e-16,1.0,23,45,4,0,1,1.6,0.8,22,14,8,20,16,4,"December, 1998"
1998-1999,16,1998-12-05,Aston Villa,Man United,1,1,D,1,1,2,0,3,3,2,0,1,2,29,28,1,1,December,-2.4492935982947064e-16,1.0,1,28,0,3,2,0.0,0.6,22,12,10,30,16,14,"December, 1998"
1998-1999,16,1998-12-05,Derby,Arsenal,0,0,D,1,1,1,2,2,4,0,1,9,4,21,25,5,4,December,-2.4492935982947064e-16,1.0,17,0,1,1,2,1.5,1.5,15,14,1,15,7,8,"December, 1998"
1998-1999,16,1998-12-05,Everton,Chelsea,0,0,D,1,1,3,0,2,3,2,0,14,5,18,24,9,6,December,-2.4492935982947064e-16,1.0,18,14,1,2,2,1.4,1.6,10,15,-5,22,13,9,"December, 1998"
1998-1999,16,1998-12-05,Blackburn,Charlton,1,0,H,3,0,0,3,2,1,1,3,20,15,9,16,5,7,December,-2.4492935982947064e-16,1.0,4,13,0,0,0,0.0,0.0,14,24,-10,22,23,-1,"December, 1998"
1998-1999,16,1998-12-06,Middlesbrough,Newcastle,2,2,D,1,1,1,1,3,0,4,1,7,13,23,19,6,4,December,-2.4492935982947064e-16,1.0,29,30,0,0,4,0.5,1.75,24,17,7,19,19,0,"December, 1998"
1998-1999,16,1998-12-07,Sheffield Weds,Nott'm Forest,3,2,H,3,0,2,2,1,3,0,2,15,19,16,11,4,5,December,-2.4492935982947064e-16,1.0,37,32,2,0,2,1.5,1.0,14,15,-1,12,24,-12,"December, 1998"
1998-1999,16,1998-12-09,Chelsea,Aston Villa,2,1,H,3,0,3,2,0,2,0,3,6,1,25,30,5,5,December,-2.4492935982947064e-16,1.0,14,1,2,1,2,1.2,0.8,22,13,9,23,13,10,"December, 1998"
1998-1999,17,1998-12-12,Sheffield Weds,Charlton,3,0,H,3,0,2,2,1,1,1,3,15,16,19,16,1,3,December,-2.4492935982947064e-16,1.0,37,13,0,0,0,0.0,0.0,17,17,0,22,24,-2,"December, 1998"
1998-1999,17,1998-12-12,Tottenham,Man United,2,2,D,1,1,0,1,4,3,2,0,13,2,22,29,11,7,December,-2.4492935982947064e-16,1.0,42,28,0,0,5,0.2,1.8,21,24,-3,31,17,14,"December, 1998"
1998-1999,17,1998-12-12,Leicester,Nott'm Forest,3,1,H,3,0,2,0,3,3,0,2,14,19,21,11,5,10,December,-2.4492935982947064e-16,1.0,24,32,0,2,0,1.0,1.0,18,18,0,14,27,-13,"December, 1998"
1998-1999,17,1998-12-12,Middlesbrough,West Ham,1,0,H,3,0,1,1,3,3,0,2,7,6,24,26,1,2,December,-2.4492935982947064e-16,1.0,29,45,2,1,1,2.0,1.25,26,19,7,20,20,0,"December, 1998"
1998-1999,17,1998-12-12,Derby,Chelsea,2,2,D,1,1,1,2,2,3,2,0,10,3,22,28,7,6,December,-2.4492935982947064e-16,1.0,17,14,1,0,3,1.0,2.5,15,14,1,24,14,10,"December, 1998"
1998-1999,17,1998-12-12,Blackburn,Newcastle,0,0,D,1,1,0,3,2,0,4,1,18,13,12,20,5,8,December,-2.4492935982947064e-16,1.0,4,30,3,1,1,1.2,0.8,15,24,-9,21,21,0,"December, 1998"
1998-1999,17,1998-12-12,Everton,Southampton,1,0,H,3,0,3,0,2,3,2,0,15,20,19,10,5,9,December,-2.4492935982947064e-16,1.0,18,38,1,2,2,2.4,1.8,10,15,-5,12,33,-21,"December, 1998"
1998-1999,17,1998-12-13,Aston Villa,Arsenal,3,2,H,3,0,2,0,3,4,0,1,2,6,30,26,4,4,December,-2.4492935982947064e-16,1.0,1,0,1,4,0,1.2,1.0,24,15,9,15,7,8,"December, 1998"
1998-1999,17,1998-12-13,Wimbledon,Liverpool,1,0,H,3,0,0,1,4,3,1,1,11,12,23,22,1,1,December,-2.4492935982947064e-16,1.0,47,25,1,3,1,1.2,1.4,21,26,-5,27,21,6,"December, 1998"
1998-1999,17,1998-12-14,Leeds,Coventry,2,0,H,3,0,2,2,1,1,2,2,5,17,26,15,12,11,December,-2.4492935982947064e-16,1.0,23,15,0,3,2,1.0,1.6,26,14,12,14,23,-9,"December, 1998"
1998-1999,17,1998-12-16,Man United,Chelsea,1,1,D,1,1,3,2,0,3,2,0,2,4,30,29,2,1,December,-2.4492935982947064e-16,1.0,28,14,1,3,1,1.2,1.2,33,19,14,26,16,10,"December, 1998"
1998-1999,18,1998-12-19,Newcastle,Leicester,1,0,H,3,0,0,4,1,2,0,3,15,10,21,24,5,3,December,-2.4492935982947064e-16,1.0,30,24,1,2,1,1.75,2.0,21,21,0,21,19,2,"December, 1998"
1998-1999,18,1998-12-19,Southampton,Wimbledon,3,1,H,3,0,3,2,0,0,1,4,20,8,10,26,12,16,December,-2.4492935982947064e-16,1.0,38,47,0,2,3,0.2,1.0,12,34,-22,22,26,-4,"December, 1998"
1998-1999,18,1998-12-19,Nott'm Forest,Blackburn,2,2,D,1,1,3,0,2,0,3,2,19,18,11,13,1,2,December,-2.4492935982947064e-16,1.0,32,4,0,2,2,1.0,3.75,15,30,-15,15,24,-9,"December, 1998"
1998-1999,18,1998-12-19,West Ham,Everton,2,1,H,3,0,3,0,2,3,0,2,7,15,26,22,8,4,December,-2.4492935982947064e-16,1.0,45,18,0,2,3,1.2,2.2,20,21,-1,11,15,-4,"December, 1998"
1998-1999,18,1998-12-19,Man United,Middlesbrough,2,3,A,0,3,3,2,0,1,1,3,3,5,31,27,2,4,December,-2.4492935982947064e-16,1.0,28,29,2,2,0,2.5,1.25,34,20,14,27,19,8,"December, 1998"
1998-1999,18,1998-12-19,Coventry,Derby,1,1,D,1,1,1,2,2,1,2,2,17,10,15,23,7,8,December,-2.4492935982947064e-16,1.0,15,17,1,0,3,1.0,1.75,14,25,-11,17,16,1,"December, 1998"
1998-1999,18,1998-12-19,Chelsea,Tottenham,2,0,H,3,0,3,2,0,0,1,4,3,11,30,23,8,7,December,-2.4492935982947064e-16,1.0,14,42,4,1,0,2.8,0.8,27,17,10,23,26,-3,"December, 1998"
1998-1999,18,1998-12-19,Liverpool,Sheffield Weds,2,0,H,3,0,3,1,1,2,2,1,12,13,22,22,1,0,December,-2.4492935982947064e-16,1.0,25,37,1,3,1,1.4,1.4,27,22,5,20,17,3,"December, 1998"
1998-1999,18,1998-12-20,Arsenal,Leeds,3,1,H,3,0,4,0,1,2,2,1,7,5,26,29,2,3,December,-2.4492935982947064e-16,1.0,0,23,3,2,0,1.6,0.6,17,10,7,28,14,14,"December, 1998"
1998-1999,18,1998-12-21,Charlton,Aston Villa,0,1,A,0,3,1,1,3,2,0,3,16,2,16,33,14,17,December,-2.4492935982947064e-16,1.0,13,1,0,0,0,0.0,0.0,22,27,-5,27,17,10,"December, 1998"
1998-1999,19,1998-12-26,Wimbledon,Charlton,2,1,H,3,0,0,1,4,1,1,3,10,18,26,16,8,10,December,-2.4492935982947064e-16,1.0,47,13,0,0,0,0.0,0.0,23,29,-6,22,28,-6,"December, 1998"
1998-1999,19,1998-12-26,Southampton,Chelsea,0,2,A,0,3,3,2,0,3,2,0,19,3,13,33,16,20,December,-2.4492935982947064e-16,1.0,38,14,1,1,3,1.0,1.6,15,35,-20,29,17,12,"December, 1998"
1998-1999,19,1998-12-26,Sheffield Weds,Leicester,0,1,A,0,3,2,2,1,2,0,3,15,11,22,24,4,2,December,-2.4492935982947064e-16,1.0,37,24,2,1,1,1.0,0.75,20,19,1,21,20,1,"December, 1998"
1998-1999,19,1998-12-26,Newcastle,Leeds,0,3,A,0,3,0,4,1,2,2,1,11,6,24,29,5,5,December,-2.4492935982947064e-16,1.0,30,23,3,1,1,1.4,1.0,22,21,1,29,17,12,"December, 1998"
1998-1999,19,1998-12-26,Middlesbrough,Liverpool,1,3,A,0,3,1,1,3,3,1,1,5,9,30,25,4,5,December,-2.4492935982947064e-16,1.0,29,25,1,1,2,1.5,2.5,30,21,9,29,22,7,"December, 1998"
1998-1999,19,1998-12-26,Man United,Nott'm Forest,3,0,H,3,0,3,2,0,3,0,2,4,20,31,12,16,19,December,-2.4492935982947064e-16,1.0,28,32,3,1,0,3.5,0.5,36,23,13,17,32,-15,"December, 1998"
1998-1999,19,1998-12-26,Coventry,Tottenham,1,1,D,1,1,1,2,2,0,1,4,18,13,16,23,5,7,December,-2.4492935982947064e-16,1.0,15,42,2,1,2,1.8,1.4,15,26,-11,23,28,-5,"December, 1998"
1998-1999,19,1998-12-26,Blackburn,Aston Villa,2,1,H,3,0,0,3,2,2,0,3,18,1,14,36,17,22,December,-2.4492935982947064e-16,1.0,4,1,2,0,3,1.8,1.0,17,26,-9,28,17,11,"December, 1998"
1998-1999,19,1998-12-26,Arsenal,West Ham,1,0,H,3,0,4,0,1,3,0,2,6,7,29,29,1,0,December,-2.4492935982947064e-16,1.0,0,45,4,1,0,1.8,0.2,20,11,9,22,22,0,"December, 1998"
1998-1999,19,1998-12-26,Everton,Derby,0,0,D,1,1,3,0,2,1,2,2,15,12,22,24,3,2,December,-2.4492935982947064e-16,1.0,18,17,2,0,2,1.0,1.25,12,17,-5,18,17,1,"December, 1998"
1998-1999,20,1998-12-28,Nott'm Forest,Southampton,1,1,D,1,1,3,0,2,3,2,0,20,19,12,13,1,1,December,-2.4492935982947064e-16,1.0,32,38,3,1,1,2.0,1.8,17,35,-18,15,37,-22,"December, 1998"
1998-1999,20,1998-12-28,West Ham,Coventry,2,0,H,3,0,3,0,2,1,2,2,8,17,29,17,9,12,December,-2.4492935982947064e-16,1.0,45,15,2,3,0,1.2,0.6,22,23,-1,16,27,-11,"December, 1998"
1998-1999,20,1998-12-28,Tottenham,Everton,4,1,H,3,0,0,1,4,3,0,2,13,14,24,23,1,1,December,-2.4492935982947064e-16,1.0,42,18,2,2,1,0.8,0.4,24,29,-5,12,17,-5,"December, 1998"
1998-1999,20,1998-12-28,Liverpool,Newcastle,4,2,H,3,0,3,1,1,0,4,1,9,12,28,24,3,4,December,-2.4492935982947064e-16,1.0,25,30,4,1,0,2.4,1.2,32,23,9,22,24,-2,"December, 1998"
1998-1999,20,1998-12-28,Aston Villa,Sheffield Weds,2,1,H,3,0,2,0,3,2,2,1,2,15,36,22,13,14,December,-2.4492935982947064e-16,1.0,1,37,2,1,2,1.4,1.2,29,19,10,20,20,0,"December, 1998"
1998-1999,20,1998-12-28,Derby,Middlesbrough,2,1,H,3,0,1,2,2,1,1,3,11,6,25,30,5,5,December,-2.4492935982947064e-16,1.0,17,29,1,1,1,1.3333333333333333,2.6666666666666665,18,17,1,31,24,7,"December, 1998"
1998-1999,20,1998-12-28,Leicester,Blackburn,1,1,D,1,1,2,0,3,0,3,2,11,16,27,17,5,10,December,-2.4492935982947064e-16,1.0,24,4,1,2,2,1.8,2.0,22,20,2,19,27,-8,"December, 1998"
1998-1999,20,1998-12-28,Charlton,Arsenal,0,1,A,0,3,1,1,3,4,0,1,18,5,16,32,13,16,December,-2.4492935982947064e-16,1.0,13,0,0,1,0,0.0,0.0,23,30,-7,21,11,10,"December, 1998"
1998-1999,20,1998-12-29,Chelsea,Man United,0,0,D,1,1,3,2,0,3,2,0,2,4,36,34,2,2,December,-2.4492935982947064e-16,1.0,14,28,1,3,1,1.2,1.2,31,17,14,39,23,16,"December, 1998"
1998-1999,20,1998-12-29,Leeds,Wimbledon,2,2,D,1,1,2,2,1,0,1,4,5,9,32,29,4,3,December,-2.4492935982947064e-16,1.0,23,47,1,2,2,0.6,1.0,32,17,15,25,30,-5,"December, 1998"
1998-1999,21,1999-01-09,Arsenal,Liverpool,0,0,D,1,1,4,0,1,3,1,1,4,7,35,31,3,4,January,0.4999999999999999,0.8660254037844387,0,25,0,1,4,0.2,1.8,22,11,11,36,25,11,"January, 1999"
1998-1999,21,1999-01-09,Blackburn,Leeds,1,0,H,3,0,0,3,2,2,2,1,16,5,18,33,11,15,January,0.4999999999999999,0.8660254037844387,4,23,0,1,4,0.6,2.0,20,28,-8,34,19,15,"January, 1999"
1998-1999,21,1999-01-09,Coventry,Nott'm Forest,4,0,H,3,0,1,2,2,3,0,2,17,20,17,13,3,4,January,0.4999999999999999,0.8660254037844387,15,32,1,2,2,0.4,1.0,16,29,-13,18,36,-18,"January, 1999"
1998-1999,21,1999-01-09,Middlesbrough,Aston Villa,0,0,D,1,1,1,1,3,2,0,3,8,1,30,39,7,9,January,0.4999999999999999,0.8660254037844387,29,1,1,1,3,0.8,1.6,32,26,6,31,20,11,"January, 1999"
1998-1999,21,1999-01-09,Newcastle,Chelsea,0,1,A,0,3,0,4,1,3,2,0,13,2,24,37,11,13,January,0.4999999999999999,0.8660254037844387,30,14,2,2,1,1.6,1.0,24,28,-4,31,17,14,"January, 1999"
1998-1999,21,1999-01-09,Sheffield Weds,Tottenham,0,0,D,1,1,2,2,1,0,1,4,15,12,22,27,3,5,January,0.4999999999999999,0.8660254037844387,37,42,3,1,1,1.8,1.0,21,22,-1,28,30,-2,"January, 1999"
1998-1999,21,1999-01-09,Southampton,Charlton,3,1,H,3,0,3,2,0,1,1,3,19,18,14,16,1,2,January,0.4999999999999999,0.8660254037844387,38,13,0,0,1,0.0,5.0,16,38,-22,23,31,-8,"January, 1999"
1998-1999,21,1999-01-09,Wimbledon,Derby,2,1,H,3,0,0,1,4,1,2,2,9,11,30,28,2,2,January,0.4999999999999999,0.8660254037844387,47,17,1,4,0,0.8,0.4,27,32,-5,20,18,2,"January, 1999"
1998-1999,21,1999-01-09,Everton,Leicester,0,0,D,1,1,3,0,2,2,0,3,14,10,23,28,4,5,January,0.4999999999999999,0.8660254037844387,18,24,2,2,1,1.0,1.0,13,21,-8,23,21,2,"January, 1999"
1998-1999,21,1999-01-10,Man United,West Ham,4,1,H,3,0,3,2,0,3,0,2,4,8,35,32,4,3,January,0.4999999999999999,0.8660254037844387,28,45,2,3,0,1.4,0.8,39,23,16,24,23,1,"January, 1999"
1998-1999,22,1999-01-16,West Ham,Sheffield Weds,0,4,A,0,3,3,0,2,2,2,1,8,15,32,23,7,9,January,0.4999999999999999,0.8660254037844387,45,37,3,2,0,1.6,0.4,25,27,-2,21,22,-1,"January, 1999"
1998-1999,22,1999-01-16,Nott'm Forest,Arsenal,0,1,A,0,3,3,0,2,4,0,1,20,5,13,36,15,23,January,0.4999999999999999,0.8660254037844387,32,0,1,1,3,0.8,1.4,18,40,-22,22,11,11,"January, 1999"
1998-1999,22,1999-01-16,Tottenham,Wimbledon,0,0,D,1,1,0,1,4,0,1,4,12,7,28,33,5,5,January,0.4999999999999999,0.8660254037844387,42,47,2,1,2,1.6,1.2,28,30,-2,29,33,-4,"January, 1999"
1998-1999,22,1999-01-16,Liverpool,Southampton,7,1,H,3,0,3,1,1,3,2,0,7,18,32,17,11,15,January,0.4999999999999999,0.8660254037844387,25,38,3,1,1,1.6,1.2,36,25,11,19,39,-20,"January, 1999"
1998-1999,22,1999-01-16,Leeds,Middlesbrough,2,0,H,3,0,2,2,1,1,1,3,5,9,33,31,4,2,January,0.4999999999999999,0.8660254037844387,23,29,0,4,1,0.4,0.6,34,20,14,32,26,6,"January, 1999"
1998-1999,22,1999-01-16,Derby,Blackburn,1,0,H,3,0,1,2,2,0,3,2,11,16,28,21,5,7,January,0.4999999999999999,0.8660254037844387,17,4,2,2,1,1.0,0.6,21,20,1,21,28,-7,"January, 1999"
1998-1999,22,1999-01-16,Chelsea,Coventry,2,1,H,3,0,3,2,0,1,2,2,1,17,40,20,16,20,January,0.4999999999999999,0.8660254037844387,14,15,2,0,3,1.8,1.8,32,17,15,20,29,-9,"January, 1999"
1998-1999,22,1999-01-16,Leicester,Man United,2,6,A,0,3,2,0,3,3,2,0,11,3,29,38,8,9,January,0.4999999999999999,0.8660254037844387,24,28,1,3,1,1.2,1.4,23,21,2,43,24,19,"January, 1999"
1998-1999,22,1999-01-17,Charlton,Newcastle,2,2,D,1,1,1,1,3,0,4,1,19,14,16,24,5,8,January,0.4999999999999999,0.8660254037844387,13,30,0,1,0,0.0,0.0,24,34,-10,24,29,-5,"January, 1999"
1998-1999,22,1999-01-18,Aston Villa,Everton,3,0,H,3,0,2,0,3,3,0,2,3,15,40,24,12,16,January,0.4999999999999999,0.8660254037844387,1,18,4,1,0,2.0,0.6,31,20,11,13,21,-8,"January, 1999"
1998-1999,23,1999-01-30,Wimbledon,West Ham,0,0,D,1,1,0,1,4,3,0,2,8,10,34,32,2,2,January,0.4999999999999999,0.8660254037844387,47,45,2,1,2,1.8,1.8,29,33,-4,25,31,-6,"January, 1999"
1998-1999,23,1999-01-30,Southampton,Leeds,3,0,H,3,0,3,2,0,2,2,1,19,5,17,36,14,19,January,0.4999999999999999,0.8660254037844387,38,23,1,1,3,0.2,1.4,20,46,-26,36,20,16,"January, 1999"
1998-1999,23,1999-01-30,Sheffield Weds,Derby,0,1,A,0,3,2,2,1,1,2,2,14,10,26,31,4,5,January,0.4999999999999999,0.8660254037844387,37,17,0,2,3,0.8,2.2,25,22,3,22,20,2,"January, 1999"
1998-1999,23,1999-01-30,Newcastle,Aston Villa,2,1,H,3,0,0,4,1,2,0,3,14,2,25,43,12,18,January,0.4999999999999999,0.8660254037844387,30,1,3,1,1,1.6,1.2,26,31,-5,34,20,14,"January, 1999"
1998-1999,23,1999-01-30,Middlesbrough,Leicester,0,0,D,1,1,1,1,3,2,0,3,9,12,31,29,3,2,January,0.4999999999999999,0.8660254037844387,29,24,2,0,1,1.3333333333333333,1.0,32,28,4,25,27,-2,"January, 1999"
1998-1999,23,1999-01-30,Coventry,Liverpool,2,1,H,3,0,1,2,2,3,1,1,17,6,20,35,11,15,January,0.4999999999999999,0.8660254037844387,15,25,1,1,3,0.6,1.2,21,31,-10,43,26,17,"January, 1999"
1998-1999,23,1999-01-30,Blackburn,Tottenham,1,1,D,1,1,0,3,2,0,1,4,16,11,21,29,5,8,January,0.4999999999999999,0.8660254037844387,4,42,0,1,4,0.4,1.8,21,29,-8,28,30,-2,"January, 1999"
1998-1999,23,1999-01-30,Everton,Nott'm Forest,0,1,A,0,3,3,0,2,3,0,2,15,20,24,13,5,11,January,0.4999999999999999,0.8660254037844387,18,32,4,0,1,2.0,0.6,13,24,-11,18,41,-23,"January, 1999"
1998-1999,23,1999-01-31,Arsenal,Chelsea,1,0,H,3,0,4,0,1,3,2,0,4,1,39,43,3,4,January,0.4999999999999999,0.8660254037844387,0,14,3,2,0,2.2,1.0,23,11,12,34,18,16,"January, 1999"
1998-1999,23,1999-01-31,Charlton,Man United,0,1,A,0,3,1,1,3,3,2,0,19,4,17,41,15,24,January,0.4999999999999999,0.8660254037844387,13,28,0,0,1,1.0,4.0,26,36,-10,49,26,23,"January, 1999"
1998-1999,23,1999-02-02,Man United,Derby,1,0,H,3,0,3,2,0,1,2,2,1,8,44,34,7,10,February,0.8660254037844386,0.5000000000000001,28,17,1,3,1,1.6,1.4,50,26,24,23,20,3,"February, 1999"
1998-1999,24,1999-02-06,West Ham,Arsenal,0,4,A,0,3,3,0,2,4,0,1,9,4,33,42,5,9,February,0.8660254037844386,0.5000000000000001,45,0,0,1,4,0.2,1.8,25,31,-6,24,11,13,"February, 1999"
1998-1999,24,1999-02-06,Tottenham,Coventry,0,0,D,1,1,0,1,4,1,2,2,12,17,30,23,5,7,February,0.8660254037844386,0.5000000000000001,42,15,1,2,2,1.0,1.8,29,31,-2,23,32,-9,"February, 1999"
1998-1999,24,1999-02-06,Liverpool,Middlesbrough,3,1,H,3,0,3,1,1,1,1,3,6,10,35,32,4,3,February,0.8660254037844386,0.5000000000000001,25,29,3,1,1,2.6,1.4,44,28,16,32,28,4,"February, 1999"
1998-1999,24,1999-02-06,Nott'm Forest,Man United,1,8,A,0,3,3,0,2,3,2,0,20,1,16,47,19,31,February,0.8660254037844386,0.5000000000000001,32,28,0,1,4,0.4,3.4,19,41,-22,51,26,25,"February, 1999"
1998-1999,24,1999-02-06,Leeds,Newcastle,0,1,A,0,3,2,2,1,0,4,1,5,13,36,28,8,8,February,0.8660254037844386,0.5000000000000001,23,30,2,1,2,1.6,1.2,36,23,13,28,32,-4,"February, 1999"
1998-1999,24,1999-02-06,Chelsea,Southampton,1,0,H,3,0,3,2,0,3,2,0,2,18,43,20,16,23,February,0.8660254037844386,0.5000000000000001,14,38,3,1,1,1.4,0.6,34,19,15,23,46,-23,"February, 1999"
1998-1999,24,1999-02-06,Aston Villa,Blackburn,1,3,A,0,3,2,0,3,0,3,2,3,17,43,22,14,21,February,0.8660254037844386,0.5000000000000001,1,4,2,0,3,0.8,2.2,35,22,13,22,30,-8,"February, 1999"
1998-1999,24,1999-02-06,Leicester,Sheffield Weds,0,2,A,0,3,2,0,3,2,2,1,13,14,30,26,1,4,February,0.8660254037844386,0.5000000000000001,24,37,2,1,2,0.8,0.8,25,27,-2,25,23,2,"February, 1999"
1998-1999,24,1999-02-07,Derby,Everton,2,1,H,3,0,1,2,2,3,0,2,8,17,34,24,9,10,February,0.8660254037844386,0.5000000000000001,17,18,2,1,2,1.0,0.8,23,21,2,13,25,-12,"February, 1999"
1998-1999,24,1999-02-08,Charlton,Wimbledon,2,0,H,3,0,1,1,3,0,1,4,19,8,17,35,11,18,February,0.8660254037844386,0.5000000000000001,13,47,0,0,1,1.0,2.0,26,37,-11,29,33,-4,"February, 1999"
1998-1999,24,1999-02-13,Charlton,Liverpool,1,0,H,3,0,1,1,3,3,1,1,18,5,20,38,13,18,February,0.8660254037844386,0.5000000000000001,13,25,0,1,0,3.0,3.0,28,37,-9,47,29,18,"February, 1999"
1998-1999,25,1999-02-13,West Ham,Nott'm Forest,2,1,H,3,0,3,0,2,3,0,2,9,20,33,16,11,17,February,0.8660254037844386,0.5000000000000001,45,32,2,2,1,0.8,0.4,25,35,-10,20,49,-29,"February, 1999"
1998-1999,25,1999-02-17,Newcastle,Coventry,4,1,H,3,0,0,4,1,1,2,2,12,17,31,24,5,7,February,0.8660254037844386,0.5000000000000001,30,15,2,2,1,2.4,1.0,29,32,-3,23,32,-9,"February, 1999"
1998-1999,25,1999-02-17,Man United,Arsenal,1,1,D,1,1,3,2,0,4,0,1,1,3,50,45,2,5,February,0.8660254037844386,0.5000000000000001,28,0,2,0,3,1.0,1.6,59,27,32,28,11,17,"February, 1999"
1998-1999,25,1999-02-17,Aston Villa,Leeds,1,2,A,0,3,2,0,3,2,2,1,4,7,43,36,3,7,February,0.8660254037844386,0.5000000000000001,1,23,2,3,0,0.8,0.2,36,25,11,36,24,12,"February, 1999"
1998-1999,25,1999-02-17,Chelsea,Blackburn,1,1,D,1,1,3,2,0,0,3,2,2,15,46,25,13,21,February,0.8660254037844386,0.5000000000000001,14,4,1,2,2,1.2,1.4,35,19,16,25,31,-6,"February, 1999"
1998-1999,25,1999-02-17,Everton,Middlesbrough,5,0,H,3,0,3,0,2,1,1,3,17,10,24,32,7,8,February,0.8660254037844386,0.5000000000000001,18,29,2,1,2,2.2,1.6,14,27,-13,33,31,2,"February, 1999"
1998-1999,26,1999-02-20,Liverpool,West Ham,2,2,D,1,1,3,1,1,3,0,2,6,8,38,36,2,2,February,0.8660254037844386,0.5000000000000001,25,45,2,1,2,1.8,1.0,47,30,17,27,36,-9,"February, 1999"
1998-1999,26,1999-02-20,Nott'm Forest,Chelsea,1,3,A,0,3,3,0,2,3,2,0,20,3,16,47,17,31,February,0.8660254037844386,0.5000000000000001,32,14,1,2,2,0.8,0.8,21,51,-30,36,20,16,"February, 1999"
1998-1999,26,1999-02-20,Middlesbrough,Tottenham,0,0,D,1,1,1,1,3,0,1,4,12,13,32,31,1,1,February,0.8660254037844386,0.5000000000000001,29,42,1,1,3,0.8,1.2,33,36,-3,29,31,-2,"February, 1999"
1998-1999,26,1999-02-20,Leeds,Everton,1,0,H,3,0,2,2,1,3,0,2,5,15,39,27,10,12,February,0.8660254037844386,0.5000000000000001,23,18,1,3,1,0.2,0.4,38,25,13,19,27,-8,"February, 1999"
1998-1999,26,1999-02-20,Southampton,Newcastle,2,1,H,3,0,3,2,0,0,4,1,19,10,20,34,9,14,February,0.8660254037844386,0.5000000000000001,38,30,2,1,2,1.2,1.8,23,47,-24,33,33,0,"February, 1999"
1998-1999,26,1999-02-20,Coventry,Man United,0,1,A,0,3,1,2,2,3,2,0,17,1,24,51,16,27,February,0.8660254037844386,0.5000000000000001,15,28,1,0,4,0.8,2.4,24,36,-12,60,28,32,"February, 1999"
1998-1999,26,1999-02-20,Blackburn,Sheffield Weds,1,4,A,0,3,0,3,2,2,2,1,16,14,26,29,2,3,February,0.8660254037844386,0.5000000000000001,4,37,2,2,1,2.4,1.4,26,32,-6,27,23,4,"February, 1999"
1998-1999,26,1999-02-20,Arsenal,Leicester,5,0,H,3,0,4,0,1,2,0,3,3,13,46,30,10,16,February,0.8660254037844386,0.5000000000000001,0,24,3,2,0,2.0,1.0,29,12,17,25,29,-4,"February, 1999"
1998-1999,26,1999-02-20,Derby,Charlton,0,2,A,0,3,1,2,2,1,1,3,7,18,37,23,11,14,February,0.8660254037844386,0.5000000000000001,17,13,1,0,0,2.0,1.0,25,22,3,29,37,-8,"February, 1999"
1998-1999,26,1999-02-21,Wimbledon,Aston Villa,0,0,D,1,1,0,1,4,2,0,3,9,4,35,43,5,8,February,0.8660254037844386,0.5000000000000001,47,1,2,0,3,0.8,2.2,29,35,-6,37,27,10,"February, 1999"
1998-1999,27,1999-02-27,Tottenham,Derby,1,1,D,1,1,0,1,4,1,2,2,13,7,32,37,6,5,February,0.8660254037844386,0.5000000000000001,42,17,2,1,2,1.2,1.4,29,31,-2,25,24,1,"February, 1999"
1998-1999,27,1999-02-27,Sheffield Weds,Middlesbrough,3,1,H,3,0,2,2,1,1,1,3,12,11,32,33,1,1,February,0.8660254037844386,0.5000000000000001,37,29,1,0,4,1.2,2.6,31,24,7,33,36,-3,"February, 1999"
1998-1999,27,1999-02-27,Man United,Southampton,2,1,H,3,0,3,2,0,3,2,0,1,19,54,23,18,31,February,0.8660254037844386,0.5000000000000001,28,38,3,0,2,1.8,1.6,61,28,33,25,48,-23,"February, 1999"
1998-1999,27,1999-02-27,West Ham,Blackburn,2,0,H,3,0,3,0,2,0,3,2,9,18,37,26,9,11,February,0.8660254037844386,0.5000000000000001,45,4,2,0,3,1.0,2.0,29,38,-9,27,36,-9,"February, 1999"
1998-1999,27,1999-02-27,Chelsea,Liverpool,2,1,H,3,0,3,2,0,3,1,1,2,6,50,39,4,11,February,0.8660254037844386,0.5000000000000001,14,25,2,1,2,1.8,2.2,39,21,18,49,32,17,"February, 1999"
1998-1999,27,1999-02-27,Charlton,Nott'm Forest,0,0,D,1,1,1,1,3,3,0,2,17,20,26,16,3,10,February,0.8660254037844386,0.5000000000000001,13,32,1,0,0,1.0,0.0,31,37,-6,22,54,-32,"February, 1999"
1998-1999,27,1999-02-27,Aston Villa,Coventry,1,4,A,0,3,2,0,3,1,2,2,4,18,44,24,14,20,February,0.8660254037844386,0.5000000000000001,1,15,5,0,0,2.2,0.8,37,27,10,24,37,-13,"February, 1999"
1998-1999,27,1999-02-27,Everton,Wimbledon,1,1,D,1,1,3,0,2,0,1,4,16,9,27,36,7,9,February,0.8660254037844386,0.5000000000000001,18,47,1,2,2,0.6,1.6,19,28,-9,29,35,-6,"February, 1999"
1998-1999,27,1999-02-28,Newcastle,Arsenal,1,1,D,1,1,0,4,1,4,0,1,11,3,34,49,8,15,February,0.8660254037844386,0.5000000000000001,30,0,1,0,4,0.6,1.8,34,35,-1,34,12,22,"February, 1999"
1998-1999,27,1999-03-01,Leicester,Leeds,1,2,A,0,3,2,0,3,2,2,1,14,5,30,42,9,12,March,1.0,6.123233995736766e-17,24,23,4,0,1,0.8,0.6,25,34,-9,39,25,14,"March, 1999"
1998-1999,27,1999-03-02,Tottenham,Southampton,3,0,H,3,0,0,1,4,3,2,0,12,19,33,23,7,10,March,1.0,6.123233995736766e-17,42,38,2,2,1,1.6,1.2,30,32,-2,26,50,-24,"March, 1999"
1998-1999,27,1999-03-03,Sheffield Weds,Wimbledon,1,2,A,0,3,2,2,1,0,1,4,11,9,35,37,2,2,March,1.0,6.123233995736766e-17,37,47,1,2,2,1.6,1.8,34,25,9,30,36,-6,"March, 1999"
1998-1999,28,1999-03-06,Wimbledon,Leicester,0,1,A,0,3,0,1,4,2,0,3,6,15,40,30,9,10,March,1.0,6.123233995736766e-17,47,24,2,1,2,1.0,1.2,32,37,-5,26,36,-10,"March, 1999"
1998-1999,28,1999-03-06,Coventry,Charlton,2,1,H,3,0,1,2,2,1,1,3,17,16,27,27,1,0,March,1.0,6.123233995736766e-17,15,13,0,1,0,1.0,1.0,28,38,-10,31,37,-6,"March, 1999"
1998-1999,28,1999-03-06,Southampton,West Ham,1,0,H,3,0,3,2,0,3,0,2,19,7,23,40,12,17,March,1.0,6.123233995736766e-17,38,45,3,0,2,2.0,1.0,26,53,-27,31,38,-7,"March, 1999"
1998-1999,29,1999-03-09,Arsenal,Sheffield Weds,3,0,H,3,0,4,0,1,2,2,1,3,11,50,35,8,15,March,1.0,6.123233995736766e-17,0,37,2,1,2,1.0,0.8,35,13,22,35,27,8,"March, 1999"
1998-1999,29,1999-03-10,Nott'm Forest,Newcastle,1,2,A,0,3,3,0,2,0,4,1,20,12,17,35,8,18,March,1.0,6.123233995736766e-17,32,30,0,2,3,0.4,2.2,22,54,-32,35,36,-1,"March, 1999"
1998-1999,29,1999-03-10,Blackburn,Everton,1,2,A,0,3,0,3,2,3,0,2,18,16,26,28,2,2,March,1.0,6.123233995736766e-17,4,18,2,2,1,1.2,0.8,27,38,-11,20,29,-9,"March, 1999"
1998-1999,29,1999-03-10,Derby,Aston Villa,2,1,H,3,0,1,2,2,2,0,3,9,5,38,44,4,6,March,1.0,6.123233995736766e-17,17,1,1,0,4,0.6,1.4,26,25,1,38,31,7,"March, 1999"
1998-1999,29,1999-03-10,Leeds,Tottenham,2,0,H,3,0,2,2,1,0,1,4,4,10,45,36,6,9,March,1.0,6.123233995736766e-17,23,42,2,2,1,1.0,0.8,41,26,15,33,32,1,"March, 1999"
1998-1999,30,1999-03-13,Tottenham,Aston Villa,1,0,H,3,0,0,1,4,2,0,3,11,5,36,44,6,8,March,1.0,6.123233995736766e-17,42,1,2,1,2,1.6,2.0,33,34,-1,39,33,6,"March, 1999"
1998-1999,30,1999-03-13,Sheffield Weds,Leeds,0,2,A,0,3,2,2,1,2,2,1,12,4,35,48,8,13,March,1.0,6.123233995736766e-17,37,23,2,1,2,1.6,1.6,35,30,5,43,26,17,"March, 1999"
1998-1999,30,1999-03-13,Wimbledon,Nott'm Forest,1,3,A,0,3,0,1,4,3,0,2,8,20,40,17,12,23,March,1.0,6.123233995736766e-17,47,32,3,1,1,1.0,1.0,32,38,-6,23,56,-33,"March, 1999"
1998-1999,30,1999-03-13,Leicester,Charlton,1,1,D,1,1,2,0,3,1,1,3,14,17,33,27,3,6,March,1.0,6.123233995736766e-17,24,13,0,1,0,0.0,0.0,27,36,-9,32,39,-7,"March, 1999"
1998-1999,30,1999-03-13,Newcastle,Man United,1,2,A,0,3,0,4,1,3,2,0,10,1,38,57,9,19,March,1.0,6.123233995736766e-17,30,28,1,3,1,1.2,0.4,37,37,0,63,29,34,"March, 1999"
1998-1999,30,1999-03-13,Derby,Liverpool,3,2,H,3,0,1,2,2,3,1,1,7,9,41,39,2,2,March,1.0,6.123233995736766e-17,17,25,2,0,3,0.8,1.6,28,26,2,50,34,16,"March, 1999"
1998-1999,30,1999-03-13,Coventry,Blackburn,1,1,D,1,1,1,2,2,0,3,2,16,18,30,26,2,4,March,1.0,6.123233995736766e-17,15,4,2,2,1,0.8,1.0,30,39,-9,28,40,-12,"March, 1999"
1998-1999,30,1999-03-13,Chelsea,West Ham,0,1,A,0,3,3,2,0,3,0,2,3,8,53,40,5,13,March,1.0,6.123233995736766e-17,14,45,2,1,2,1.8,1.6,41,22,19,31,39,-8,"March, 1999"
1998-1999,30,1999-03-13,Everton,Arsenal,0,2,A,0,3,3,0,2,4,0,1,15,2,31,53,13,22,March,1.0,6.123233995736766e-17,18,0,0,1,4,0.6,2.4,22,30,-8,38,13,25,"March, 1999"
1998-1999,30,1999-03-14,Middlesbrough,Southampton,3,0,H,3,0,1,1,3,3,2,0,14,19,33,26,5,7,March,1.0,6.123233995736766e-17,29,38,0,2,3,0.8,2.0,34,39,-5,27,53,-26,"March, 1999"
1998-1999,31,1999-03-20,Nott'm Forest,Middlesbrough,1,2,A,0,3,3,0,2,1,1,3,20,12,20,36,8,16,March,1.0,6.123233995736766e-17,32,29,1,4,0,1.0,0.8,26,57,-31,37,39,-2,"March, 1999"
1998-1999,31,1999-03-20,Arsenal,Coventry,2,0,H,3,0,4,0,1,1,2,2,2,15,56,31,13,25,March,1.0,6.123233995736766e-17,0,15,2,3,0,1.2,0.6,40,13,27,31,40,-9,"March, 1999"
1998-1999,31,1999-03-20,Blackburn,Wimbledon,3,1,H,3,0,0,3,2,0,1,4,18,8,27,40,10,13,March,1.0,6.123233995736766e-17,4,47,2,2,1,1.0,0.6,29,41,-12,33,41,-8,"March, 1999"
1998-1999,31,1999-03-20,Leeds,Derby,4,1,H,3,0,2,2,1,1,2,2,4,6,51,44,2,7,March,1.0,6.123233995736766e-17,23,17,2,3,0,2.8,1.6,45,26,19,31,28,3,"March, 1999"
1998-1999,31,1999-03-20,Southampton,Sheffield Weds,1,0,H,3,0,3,2,0,2,2,1,19,13,26,35,6,9,March,1.0,6.123233995736766e-17,38,37,0,2,3,1.0,1.6,27,56,-29,35,32,3,"March, 1999"
1998-1999,31,1999-03-20,West Ham,Newcastle,2,0,H,3,0,3,0,2,0,4,1,7,12,43,38,5,5,March,1.0,6.123233995736766e-17,45,30,2,2,1,1.0,0.4,32,39,-7,38,39,-1,"March, 1999"
1998-1999,31,1999-03-21,Aston Villa,Chelsea,0,3,A,0,3,2,0,3,3,2,0,6,4,44,53,2,9,March,1.0,6.123233995736766e-17,1,14,1,1,3,0.6,1.4,39,34,5,41,23,18,"March, 1999"
1998-1999,31,1999-03-21,Man United,Everton,3,1,H,3,0,3,2,0,3,0,2,1,15,60,31,14,29,March,1.0,6.123233995736766e-17,28,18,4,1,0,2.4,0.6,65,30,35,22,32,-10,"March, 1999"
1998-1999,32,1999-04-02,Aston Villa,West Ham,0,0,D,1,1,2,0,3,3,0,2,6,5,44,46,1,2,April,0.8660254037844388,-0.4999999999999998,1,45,2,2,1,1.0,0.4,39,37,2,34,39,-5,"April, 1999"
1998-1999,32,1999-04-03,Tottenham,Leicester,0,2,A,0,3,0,1,4,2,0,3,12,14,39,34,2,5,April,0.8660254037844388,-0.4999999999999998,42,24,0,2,3,0.8,1.8,34,34,0,28,37,-9,"April, 1999"
1998-1999,32,1999-04-03,Southampton,Arsenal,0,0,D,1,1,3,2,0,4,0,1,18,2,29,59,16,30,April,0.8660254037844388,-0.4999999999999998,38,0,0,1,4,0.6,2.4,28,56,-28,42,13,29,"April, 1999"
1998-1999,32,1999-04-03,Wimbledon,Man United,1,1,D,1,1,0,1,4,3,2,0,11,1,40,63,10,23,April,0.8660254037844388,-0.4999999999999998,47,28,0,0,5,0.8,3.4,34,44,-10,68,31,37,"April, 1999"
1998-1999,32,1999-04-03,Liverpool,Everton,3,2,H,3,0,3,1,1,3,0,2,11,17,39,31,6,8,April,0.8660254037844388,-0.4999999999999998,25,18,0,4,1,0.6,1.0,52,37,15,23,35,-12,"April, 1999"
1998-1999,32,1999-04-03,Sheffield Weds,Coventry,1,2,A,0,3,2,2,1,1,2,2,13,16,35,31,3,4,April,0.8660254037844388,-0.4999999999999998,37,15,0,3,2,0.0,0.4,35,33,2,31,42,-11,"April, 1999"
1998-1999,32,1999-04-03,Derby,Newcastle,3,4,A,0,3,1,2,2,0,4,1,7,12,44,38,5,6,April,0.8660254037844388,-0.4999999999999998,17,30,1,1,3,0.6,1.2,32,32,0,38,41,-3,"April, 1999"
1998-1999,32,1999-04-03,Charlton,Chelsea,0,1,A,0,3,1,1,3,3,2,0,19,3,28,56,16,28,April,0.8660254037844388,-0.4999999999999998,13,14,0,0,1,1.0,2.0,33,40,-7,44,23,21,"April, 1999"
1998-1999,32,1999-04-03,Blackburn,Middlesbrough,0,0,D,1,1,0,3,2,1,1,3,17,11,30,39,6,9,April,0.8660254037844388,-0.4999999999999998,4,29,1,1,3,0.6,1.2,32,42,-10,39,40,-1,"April, 1999"
1998-1999,32,1999-04-03,Leeds,Nott'm Forest,3,1,H,3,0,2,2,1,3,0,2,4,20,54,20,16,34,April,0.8660254037844388,-0.4999999999999998,23,32,1,2,2,1.2,1.4,49,27,22,27,59,-32,"April, 1999"
1998-1999,33,1999-04-05,West Ham,Charlton,0,1,A,0,3,3,0,2,1,1,3,5,19,47,28,14,19,April,0.8660254037844388,-0.4999999999999998,45,13,0,0,1,2.0,4.0,34,39,-5,33,41,-8,"April, 1999"
1998-1999,33,1999-04-05,Newcastle,Tottenham,1,1,D,1,1,0,4,1,0,1,4,10,12,41,39,2,2,April,0.8660254037844388,-0.4999999999999998,30,42,3,0,2,2.0,1.2,42,44,-2,34,36,-2,"April, 1999"
1998-1999,33,1999-04-05,Nott'm Forest,Liverpool,2,2,D,1,1,3,0,2,3,1,1,20,9,20,42,11,22,April,0.8660254037844388,-0.4999999999999998,32,25,1,1,3,1.4,2.8,28,62,-34,55,39,16,"April, 1999"
1998-1999,33,1999-04-05,Everton,Sheffield Weds,1,2,A,0,3,3,0,2,2,2,1,17,15,31,35,2,4,April,0.8660254037844388,-0.4999999999999998,18,37,1,1,3,1.0,1.6,25,38,-13,36,35,1,"April, 1999"
1998-1999,33,1999-04-05,Coventry,Southampton,1,0,H,3,0,1,2,2,3,2,0,15,18,34,30,3,4,April,0.8660254037844388,-0.4999999999999998,15,38,2,2,1,1.4,1.2,33,43,-10,28,56,-28,"April, 1999"
1998-1999,33,1999-04-05,Middlesbrough,Wimbledon,3,1,H,3,0,1,1,3,0,1,4,11,10,40,41,1,1,April,0.8660254037844388,-0.4999999999999998,29,47,0,4,1,0.8,1.0,39,40,-1,35,45,-10,"April, 1999"
1998-1999,33,1999-04-06,Arsenal,Blackburn,1,0,H,3,0,4,0,1,0,3,2,2,17,60,31,15,29,April,0.8660254037844388,-0.4999999999999998,0,4,3,1,1,2.0,1.2,42,13,29,32,42,-10,"April, 1999"
1998-1999,33,1999-04-06,Leicester,Aston Villa,2,2,D,1,1,2,0,3,2,0,3,14,6,37,45,8,8,April,0.8660254037844388,-0.4999999999999998,24,1,3,2,0,1.4,0.6,30,37,-7,39,37,2,"April, 1999"
1998-1999,34,1999-04-10,Aston Villa,Southampton,3,0,H,3,0,2,0,3,3,2,0,6,19,46,30,13,16,April,0.8660254037844388,-0.4999999999999998,1,38,4,1,0,1.8,0.6,41,39,2,28,57,-29,"April, 1999"
1998-1999,34,1999-04-10,Derby,Nott'm Forest,1,0,H,3,0,1,2,2,3,0,2,7,20,44,21,13,23,April,0.8660254037844388,-0.4999999999999998,17,32,0,3,0,1.0,1.0,35,36,-1,30,64,-34,"April, 1999"
1998-1999,34,1999-04-10,Leicester,West Ham,0,0,D,1,1,2,0,3,3,0,2,14,7,38,47,7,9,April,0.8660254037844388,-0.4999999999999998,24,45,1,0,4,1.4,2.0,32,39,-7,34,40,-6,"April, 1999"
1998-1999,34,1999-04-10,Middlesbrough,Charlton,2,0,H,3,0,1,1,3,1,1,3,9,16,43,31,7,12,April,0.8660254037844388,-0.4999999999999998,29,13,0,1,0,1.0,1.0,42,41,1,34,41,-7,"April, 1999"
1998-1999,34,1999-04-11,Everton,Coventry,2,0,H,3,0,3,0,2,1,2,2,18,15,31,37,3,6,April,0.8660254037844388,-0.4999999999999998,18,15,0,4,1,0.4,1.0,26,40,-14,34,43,-9,"April, 1999"
1998-1999,34,1999-04-11,Wimbledon,Chelsea,1,2,A,0,3,0,1,4,3,2,0,11,3,41,59,8,18,April,0.8660254037844388,-0.4999999999999998,47,14,1,1,3,1.0,1.8,36,48,-12,45,23,22,"April, 1999"
1998-1999,34,1999-04-12,Leeds,Liverpool,0,0,D,1,1,2,2,1,3,1,1,4,9,57,43,5,14,April,0.8660254037844388,-0.4999999999999998,23,25,1,0,4,0.8,2.4,52,28,24,57,41,16,"April, 1999"
1998-1999,34,1999-04-14,Middlesbrough,Chelsea,0,0,D,1,1,1,1,3,3,2,0,8,3,46,62,5,16,April,0.8660254037844388,-0.4999999999999998,29,14,2,0,3,0.6,1.6,44,41,3,47,24,23,"April, 1999"
1998-1999,35,1999-04-17,Southampton,Blackburn,3,3,D,1,1,3,2,0,0,3,2,19,18,30,31,1,1,April,0.8660254037844388,-0.4999999999999998,38,4,3,0,2,1.6,0.6,28,60,-32,32,43,-11,"April, 1999"
1998-1999,35,1999-04-17,Nott'm Forest,Tottenham,0,1,A,0,3,3,0,2,0,1,4,20,12,21,40,8,19,April,0.8660254037844388,-0.4999999999999998,32,42,4,0,1,1.2,0.8,30,65,-35,35,37,-2,"April, 1999"
1998-1999,35,1999-04-17,West Ham,Derby,5,1,H,3,0,3,0,2,1,2,2,7,8,48,47,1,1,April,0.8660254037844388,-0.4999999999999998,45,17,1,2,2,0.6,0.8,34,40,-6,36,36,0,"April, 1999"
1998-1999,35,1999-04-17,Newcastle,Everton,1,3,A,0,3,0,4,1,3,0,2,10,16,42,34,6,8,April,0.8660254037844388,-0.4999999999999998,30,18,2,1,2,1.0,0.8,43,45,-2,28,40,-12,"April, 1999"
1998-1999,35,1999-04-17,Man United,Sheffield Weds,3,0,H,3,0,3,2,0,2,2,1,1,14,64,38,13,26,April,0.8660254037844388,-0.4999999999999998,28,37,2,1,2,2.0,1.4,69,32,37,38,36,2,"April, 1999"
1998-1999,35,1999-04-17,Liverpool,Aston Villa,0,1,A,0,3,3,1,1,2,0,3,9,6,44,49,3,5,April,0.8660254037844388,-0.4999999999999998,25,1,3,0,2,2.2,1.0,57,41,16,44,39,5,"April, 1999"
1998-1999,35,1999-04-17,Coventry,Middlesbrough,1,2,A,0,3,1,2,2,1,1,3,15,7,37,47,8,10,April,0.8660254037844388,-0.4999999999999998,15,29,1,1,3,0.8,1.6,34,45,-11,44,41,3,"April, 1999"
1998-1999,35,1999-04-17,Charlton,Leeds,1,1,D,1,1,1,1,3,2,2,1,17,4,31,58,13,27,April,0.8660254037844388,-0.4999999999999998,13,23,0,0,1,1.0,4.0,34,43,-9,52,28,24,"April, 1999"
1998-1999,35,1999-04-18,Chelsea,Leicester,2,2,D,1,1,3,2,0,2,0,3,3,13,63,39,10,24,April,0.8660254037844388,-0.4999999999999998,14,24,4,0,1,2.0,1.2,47,24,23,32,39,-7,"April, 1999"
1998-1999,35,1999-04-19,Arsenal,Wimbledon,5,1,H,3,0,4,0,1,0,1,4,3,12,63,41,9,22,April,0.8660254037844388,-0.4999999999999998,0,47,2,1,2,1.6,0.8,43,13,30,37,50,-13,"April, 1999"
1998-1999,35,1999-04-20,Charlton,Tottenham,1,4,A,0,3,1,1,3,0,1,4,17,10,32,43,7,11,April,0.8660254037844388,-0.4999999999999998,13,42,0,1,0,2.0,2.0,35,44,-9,36,37,-1,"April, 1999"
1998-1999,35,1999-04-21,Liverpool,Leicester,0,1,A,0,3,3,1,1,2,0,3,10,13,44,40,3,4,April,0.8660254037844388,-0.4999999999999998,25,24,1,2,2,1.0,0.8,57,42,15,34,41,-7,"April, 1999"
1998-1999,35,1999-04-21,Sheffield Weds,Newcastle,1,1,D,1,1,2,2,1,0,4,1,14,12,38,42,2,4,April,0.8660254037844388,-0.4999999999999998,37,30,2,2,1,1.4,1.2,38,39,-1,44,48,-4,"April, 1999"
1998-1999,36,1999-04-24,Wimbledon,Newcastle,1,1,D,1,1,0,1,4,0,4,1,13,12,41,43,1,2,April,0.8660254037844388,-0.4999999999999998,47,30,1,2,2,1.0,1.4,38,55,-17,45,49,-4,"April, 1999"
1998-1999,36,1999-04-24,Tottenham,West Ham,1,2,A,0,3,0,1,4,3,0,2,10,6,46,51,4,5,April,0.8660254037844388,-0.4999999999999998,42,45,2,0,3,1.4,1.6,40,38,2,39,41,-2,"April, 1999"
1998-1999,36,1999-04-24,Middlesbrough,Arsenal,1,6,A,0,3,1,1,3,4,0,1,7,2,50,66,5,16,April,0.8660254037844388,-0.4999999999999998,29,0,0,2,3,0.8,1.8,46,42,4,48,14,34,"April, 1999"
1998-1999,36,1999-04-24,Leicester,Coventry,1,0,H,3,0,2,0,3,1,2,2,12,16,43,37,4,6,April,0.8660254037844388,-0.4999999999999998,24,15,1,3,1,0.8,0.8,35,41,-6,35,47,-12,"April, 1999"
1998-1999,36,1999-04-24,Derby,Southampton,0,0,D,1,1,1,2,2,3,2,0,9,19,47,31,10,16,April,0.8660254037844388,-0.4999999999999998,17,38,3,1,1,1.8,0.8,37,41,-4,31,63,-32,"April, 1999"
1998-1999,36,1999-04-24,Blackburn,Liverpool,1,3,A,0,3,0,3,2,3,1,1,17,10,32,44,7,12,April,0.8660254037844388,-0.4999999999999998,4,25,1,3,1,0.8,0.6,35,46,-11,57,43,14,"April, 1999"
1998-1999,36,1999-04-24,Aston Villa,Nott'm Forest,2,0,H,3,0,2,0,3,3,0,2,5,20,52,21,15,31,April,0.8660254037844388,-0.4999999999999998,1,32,1,4,0,1.2,0.8,45,39,6,30,66,-36,"April, 1999"
1998-1999,36,1999-04-24,Everton,Charlton,4,1,H,3,0,3,0,2,1,1,3,15,17,37,32,2,5,April,0.8660254037844388,-0.4999999999999998,18,13,1,0,0,2.0,1.0,31,41,-10,36,48,-12,"April, 1999"
1998-1999,36,1999-04-25,Leeds,Man United,1,1,D,1,1,2,2,1,3,2,0,4,2,59,67,2,8,April,0.8660254037844388,-0.4999999999999998,23,28,1,0,4,0.6,2.2,53,29,24,72,32,40,"April, 1999"
1998-1999,36,1999-04-25,Sheffield Weds,Chelsea,0,0,D,1,1,2,2,1,3,2,0,15,3,39,64,12,25,April,0.8660254037844388,-0.4999999999999998,37,14,0,2,3,0.8,2.0,39,40,-1,49,26,23,"April, 1999"
1998-1999,37,1999-05-01,Nott'm Forest,Sheffield Weds,2,0,H,3,0,3,0,2,2,2,1,20,14,21,40,6,19,May,0.4999999999999999,-0.8660254037844387,32,37,2,0,3,1.2,1.8,30,68,-38,39,40,-1,"May, 1999"
1998-1999,37,1999-05-01,West Ham,Leeds,1,5,A,0,3,3,0,2,2,2,1,6,4,54,60,2,6,May,0.4999999999999999,-0.8660254037844387,45,23,1,0,4,0.8,2.0,41,42,-1,54,30,24,"May, 1999"
1998-1999,37,1999-05-01,Southampton,Leicester,2,1,H,3,0,3,2,0,2,0,3,19,11,32,46,8,14,May,0.4999999999999999,-0.8660254037844387,38,24,1,2,2,1.6,2.0,31,63,-32,36,41,-5,"May, 1999"
1998-1999,37,1999-05-01,Newcastle,Middlesbrough,1,1,D,1,1,0,4,1,1,1,3,12,8,44,50,4,6,May,0.4999999999999999,-0.8660254037844387,30,29,4,1,0,1.8,0.8,46,50,-4,47,48,-1,"May, 1999"
1998-1999,37,1999-05-01,Coventry,Wimbledon,2,1,H,3,0,1,2,2,0,1,4,16,13,37,42,3,5,May,0.4999999999999999,-0.8660254037844387,15,47,1,3,1,1.2,1.2,35,48,-13,39,56,-17,"May, 1999"
1998-1999,37,1999-05-01,Liverpool,Tottenham,3,2,H,3,0,3,1,1,0,1,4,9,10,47,46,1,1,May,0.4999999999999999,-0.8660254037844387,25,42,3,1,1,2.4,1.2,60,44,16,41,40,1,"May, 1999"
1998-1999,37,1999-05-01,Chelsea,Everton,3,1,H,3,0,3,2,0,3,0,2,3,15,65,40,12,25,May,0.4999999999999999,-0.8660254037844387,14,18,2,2,1,1.4,1.2,49,26,23,35,42,-7,"May, 1999"
1998-1999,37,1999-05-01,Charlton,Blackburn,0,0,D,1,1,1,1,3,0,3,2,18,17,32,32,1,0,May,0.4999999999999999,-0.8660254037844387,13,4,0,0,1,0.0,1.0,37,52,-15,36,49,-13,"May, 1999"
1998-1999,37,1999-05-01,Man United,Aston Villa,2,1,H,3,0,3,2,0,2,0,3,2,5,68,55,3,13,May,0.4999999999999999,-0.8660254037844387,28,1,2,3,0,0.8,0.2,73,33,40,47,39,8,"May, 1999"
1998-1999,37,1999-05-02,Arsenal,Derby,1,0,H,3,0,4,0,1,1,2,2,2,9,69,48,7,21,May,0.4999999999999999,-0.8660254037844387,0,17,2,2,1,1.2,1.2,54,15,39,37,41,-4,"May, 1999"
1998-1999,38,1999-05-05,Chelsea,Leeds,1,0,H,3,0,3,2,0,2,2,1,3,4,68,63,1,5,May,0.4999999999999999,-0.8660254037844387,14,23,0,3,2,0.2,1.0,52,27,25,59,31,28,"May, 1999"
1998-1999,38,1999-05-05,Leicester,Derby,1,2,A,0,3,2,0,3,1,2,2,11,9,46,48,2,2,May,0.4999999999999999,-0.8660254037844387,24,17,2,0,3,1.8,1.6,37,43,-6,37,42,-5,"May, 1999"
1998-1999,38,1999-05-05,Liverpool,Man United,2,2,D,1,1,3,1,1,3,2,0,9,2,50,71,7,21,May,0.4999999999999999,-0.8660254037844387,25,28,0,1,4,0.6,2.0,63,46,17,75,34,41,"May, 1999"
1998-1999,38,1999-05-05,Tottenham,Arsenal,1,3,A,0,3,0,1,4,4,0,1,10,2,46,72,8,26,May,0.4999999999999999,-0.8660254037844387,42,0,0,4,1,0.4,0.8,43,43,0,55,15,40,"May, 1999"
1998-1999,39,1999-05-08,Wimbledon,Southampton,0,2,A,0,3,0,1,4,3,2,0,15,18,42,35,3,7,May,0.4999999999999999,-0.8660254037844387,47,38,3,1,1,1.2,0.8,40,58,-18,33,64,-31,"May, 1999"
1998-1999,39,1999-05-08,Sheffield Weds,Liverpool,1,0,H,3,0,2,2,1,3,1,1,16,8,40,51,8,11,May,0.4999999999999999,-0.8660254037844387,37,25,1,2,2,1.2,1.6,39,42,-3,65,48,17,"May, 1999"
1998-1999,39,1999-05-08,Leicester,Newcastle,2,0,H,3,0,2,0,3,0,4,1,11,12,46,45,1,1,May,0.4999999999999999,-0.8660254037844387,24,30,1,2,2,1.6,1.6,38,45,-7,47,51,-4,"May, 1999"
1998-1999,39,1999-05-08,Aston Villa,Charlton,3,4,A,0,3,2,0,3,1,1,3,5,19,55,33,14,22,May,0.4999999999999999,-0.8660254037844387,1,13,1,0,0,1.0,0.0,48,41,7,37,52,-15,"May, 1999"
1998-1999,39,1999-05-08,Derby,Coventry,0,0,D,1,1,1,2,2,1,2,2,9,16,51,40,7,11,May,0.4999999999999999,-0.8660254037844387,17,15,3,1,1,1.6,1.0,39,43,-4,37,49,-12,"May, 1999"
1998-1999,39,1999-05-08,Blackburn,Nott'm Forest,1,2,A,0,3,0,3,2,3,0,2,19,20,33,24,1,9,May,0.4999999999999999,-0.8660254037844387,4,32,2,3,0,3.4,1.2,36,49,-13,32,68,-36,"May, 1999"
1998-1999,39,1999-05-08,Everton,West Ham,6,0,H,3,0,3,0,2,3,0,2,16,6,40,54,10,14,May,0.4999999999999999,-0.8660254037844387,18,45,2,2,1,1.8,1.6,36,45,-9,42,47,-5,"May, 1999"
1998-1999,39,1999-05-09,Middlesbrough,Man United,0,1,A,0,3,1,1,3,3,2,0,9,2,51,72,7,21,May,0.4999999999999999,-0.8660254037844387,29,28,1,2,2,1.6,2.4,48,49,-1,77,36,41,"May, 1999"
1998-1999,39,1999-05-10,Tottenham,Chelsea,2,2,D,1,1,0,1,4,3,2,0,11,3,46,71,8,25,May,0.4999999999999999,-0.8660254037844387,42,14,0,0,5,0.6,3.0,44,46,-2,53,27,26,"May, 1999"
1998-1999,39,1999-05-11,Leeds,Arsenal,1,0,H,3,0,2,2,1,4,0,1,4,2,63,75,2,12,May,0.4999999999999999,-0.8660254037844387,23,0,0,2,3,0.6,1.8,59,32,27,58,16,42,"May, 1999"
1998-1999,39,1999-05-12,Blackburn,Man United,0,0,D,1,1,0,3,2,3,2,0,19,1,33,75,18,42,May,0.4999999999999999,-0.8660254037844387,4,28,0,1,4,1.4,3.0,37,51,-14,78,36,42,"May, 1999"
1998-1999,40,1999-05-16,Southampton,Everton,2,0,H,3,0,3,2,0,3,0,2,17,14,38,43,3,5,May,0.4999999999999999,-0.8660254037844387,38,18,2,1,2,1.4,2.2,35,64,-29,42,45,-3,"May, 1999"
1998-1999,40,1999-05-16,Newcastle,Blackburn,1,1,D,1,1,0,4,1,0,3,2,13,19,45,34,6,11,May,0.4999999999999999,-0.8660254037844387,30,4,1,2,2,0.6,0.8,47,53,-6,37,51,-14,"May, 1999"
1998-1999,40,1999-05-16,Nott'm Forest,Leicester,1,0,H,3,0,3,0,2,2,0,3,20,10,27,49,10,22,May,0.4999999999999999,-0.8660254037844387,32,24,0,2,1,1.0,1.6666666666666667,34,69,-35,40,45,-5,"May, 1999"
1998-1999,40,1999-05-16,West Ham,Middlesbrough,4,0,H,3,0,3,0,2,1,1,3,7,9,54,51,2,3,May,0.4999999999999999,-0.8660254037844387,45,29,1,1,3,1.0,1.8,42,53,-11,48,50,-2,"May, 1999"
1998-1999,40,1999-05-16,Man United,Tottenham,2,1,H,3,0,3,2,0,0,1,4,2,11,76,47,9,29,May,0.4999999999999999,-0.8660254037844387,28,42,4,1,0,2.0,0.6,78,36,42,46,48,-2,"May, 1999"
1998-1999,40,1999-05-16,Charlton,Sheffield Weds,0,1,A,0,3,1,1,3,2,2,1,18,13,36,43,5,7,May,0.4999999999999999,-0.8660254037844387,13,37,0,0,1,0.0,3.0,41,55,-14,40,42,-2,"May, 1999"
1998-1999,40,1999-05-16,Coventry,Leeds,2,2,D,1,1,1,2,2,2,2,1,16,4,41,66,12,25,May,0.4999999999999999,-0.8660254037844387,15,23,2,2,1,1.6,1.4,37,49,-12,60,32,28,"May, 1999"
1998-1999,40,1999-05-16,Chelsea,Derby,2,1,H,3,0,3,2,0,1,2,2,3,7,72,52,4,20,May,0.4999999999999999,-0.8660254037844387,14,17,3,1,1,2.4,1.2,55,29,26,39,43,-4,"May, 1999"
1998-1999,40,1999-05-16,Arsenal,Aston Villa,1,0,H,3,0,4,0,1,2,0,3,2,5,75,55,3,20,May,0.4999999999999999,-0.8660254037844387,0,1,0,3,2,1.2,1.6,58,17,41,51,45,6,"May, 1999"
1998-1999,40,1999-05-16,Liverpool,Wimbledon,3,0,H,3,0,3,1,1,0,1,4,8,16,51,42,8,9,May,0.4999999999999999,-0.8660254037844387,25,47,1,2,2,1.0,1.0,65,49,16,40,60,-20,"May, 1999"
1999-2000,1,1999-08-07,Arsenal,Leicester,2,1,H,3,0,3,1,1,3,1,1,1,9,0,0,8,0,August,-0.8660254037844384,-0.5000000000000004,0,24,3,2,0,2.6,1.0,0,0,0,0,0,0,"August, 1999"
1999-2000,1,1999-08-07,Chelsea,Sunderland,4,0,H,3,0,2,1,2,2,1,2,4,15,0,0,11,0,August,-0.8660254037844384,-0.5000000000000004,14,40,1,0,1,3.0,2.5,0,0,0,0,0,0,"August, 1999"
1999-2000,1,1999-08-07,Coventry,Southampton,0,1,A,0,3,2,0,3,1,1,3,5,14,0,0,9,0,August,-0.8660254037844384,-0.5000000000000004,15,38,3,1,1,1.4,1.0,0,0,0,0,0,0,"August, 1999"
1999-2000,1,1999-08-07,Leeds,Derby,0,0,D,1,1,2,3,0,1,3,1,8,6,0,0,2,0,August,-0.8660254037844384,-0.5000000000000004,23,17,3,2,0,3.0,1.2,0,0,0,0,0,0,"August, 1999"
1999-2000,1,1999-08-07,Middlesbrough,Bradford,0,1,A,0,3,2,3,0,3,1,1,11,7,0,0,4,0,August,-0.8660254037844384,-0.5000000000000004,29,8,0,0,0,0.0,0.0,0,0,0,0,0,0,"August, 1999"
1999-2000,1,1999-08-07,Newcastle,Aston Villa,0,1,A,0,3,2,3,0,1,3,1,11,7,0,0,4,0,August,-0.8660254037844384,-0.5000000000000004,30,1,3,1,1,1.2,0.8,0,0,0,0,0,0,"August, 1999"
1999-2000,1,1999-08-07,Sheffield Weds,Liverpool,1,2,A,0,3,1,1,3,0,2,3,11,9,0,0,2,0,August,-0.8660254037844384,-0.5000000000000004,37,25,1,2,2,1.2,1.6,0,0,0,0,0,0,"August, 1999"
1999-2000,1,1999-08-07,Watford,Wimbledon,2,3,A,0,3,1,1,3,0,1,4,12,14,0,0,2,0,August,-0.8660254037844384,-0.5000000000000004,43,47,0,0,0,0.0,0.0,0,0,0,0,0,0,"August, 1999"
1999-2000,1,1999-08-07,West Ham,Tottenham,1,0,H,3,0,1,1,3,3,1,1,13,12,0,0,1,0,August,-0.8660254037844384,-0.5000000000000004,45,42,4,0,1,2.0,1.4,0,0,0,0,0,0,"August, 1999"
1999-2000,1,1999-08-08,Everton,Man United,1,1,D,1,1,1,2,2,5,0,0,11,12,0,0,1,0,August,-0.8660254037844384,-0.5000000000000004,18,28,0,0,5,0.4,2.6,0,0,0,0,0,0,"August, 1999"
1999-2000,1,1999-08-09,Tottenham,Newcastle,3,1,H,3,0,3,1,1,2,3,0,19,18,0,0,1,0,August,-0.8660254037844384,-0.5000000000000004,42,30,2,1,2,1.2,1.8,0,1,-1,0,1,-1,"August, 1999"
1999-2000,1,1999-08-10,Sunderland,Watford,2,0,H,3,0,2,1,2,1,1,3,20,14,0,0,6,0,August,-0.8660254037844384,-0.5000000000000004,40,43,0,0,0,0.0,0.0,0,4,-4,2,3,-1,"August, 1999"
1999-2000,1,1999-08-10,Wimbledon,Middlesbrough,2,3,A,0,3,0,1,4,2,3,0,4,18,3,0,14,3,August,-0.8660254037844384,-0.5000000000000004,47,29,1,3,1,1.2,1.4,3,2,1,0,1,-1,"August, 1999"
1999-2000,1,1999-08-10,Derby,Arsenal,1,2,A,0,3,1,3,1,3,1,1,12,4,1,3,8,2,August,-0.8660254037844384,-0.5000000000000004,17,0,1,1,3,0.8,1.0,0,0,0,2,1,1,"August, 1999"
1999-2000,1,1999-08-11,Aston Villa,Everton,3,0,H,3,0,1,3,1,1,2,2,5,12,3,1,7,2,August,-0.8660254037844384,-0.5000000000000004,1,18,4,1,0,2.4,0.6,1,0,1,1,1,0,"August, 1999"
1999-2000,1,1999-08-11,Leicester,Coventry,1,0,H,3,0,3,1,1,2,0,3,16,18,0,0,2,0,August,-0.8660254037844384,-0.5000000000000004,24,15,2,3,0,1.0,0.4,1,2,-1,0,1,-1,"August, 1999"
1999-2000,1,1999-08-11,Man United,Sheffield Weds,4,0,H,3,0,5,0,0,1,1,3,13,17,1,0,4,1,August,-0.8660254037844384,-0.5000000000000004,28,37,3,0,2,2.4,1.2,1,1,0,1,2,-1,"August, 1999"
1999-2000,1,1999-08-11,Southampton,Leeds,0,3,A,0,3,1,1,3,2,3,0,8,14,3,1,6,2,August,-0.8660254037844384,-0.5000000000000004,38,23,2,1,2,0.8,1.0,1,0,1,0,0,0,"August, 1999"
1999-2000,2,1999-08-14,Man United,Leeds,2,0,H,3,0,5,0,0,2,3,0,5,6,4,4,1,0,August,-0.8660254037844384,-0.5000000000000004,28,23,3,1,1,1.6,0.8,5,1,4,3,0,3,"August, 1999"
1999-2000,2,1999-08-14,Bradford,Sheffield Weds,1,1,D,1,1,3,1,1,1,1,3,8,20,3,0,12,3,August,-0.8660254037844384,-0.5000000000000004,8,37,0,0,0,0.0,0.0,1,0,1,1,6,-5,"August, 1999"
1999-2000,2,1999-08-14,Derby,Middlesbrough,1,3,A,0,3,1,3,1,2,3,0,15,11,1,3,4,2,August,-0.8660254037844384,-0.5000000000000004,17,29,2,1,1,1.5,2.25,1,2,-1,3,3,0,"August, 1999"
1999-2000,2,1999-08-14,Leicester,Chelsea,2,2,D,1,1,3,1,1,2,1,2,12,7,3,3,5,0,August,-0.8660254037844384,-0.5000000000000004,24,14,1,1,3,1.4,1.8,2,2,0,4,0,4,"August, 1999"
1999-2000,2,1999-08-14,Liverpool,Watford,0,1,A,0,3,0,2,3,1,1,3,10,19,3,0,9,3,August,-0.8660254037844384,-0.5000000000000004,25,43,0,0,0,0.0,0.0,2,1,1,2,5,-3,"August, 1999"
1999-2000,2,1999-08-14,Sunderland,Arsenal,0,0,D,1,1,2,1,2,3,1,1,14,4,3,6,10,3,August,-0.8660254037844384,-0.5000000000000004,40,0,1,0,1,0.5,1.0,2,4,-2,4,2,2,"August, 1999"
1999-2000,2,1999-08-14,Tottenham,Everton,3,2,H,3,0,3,1,1,1,2,2,10,17,3,1,7,2,August,-0.8660254037844384,-0.5000000000000004,42,18,3,1,1,1.6,0.6,3,2,1,1,4,-3,"August, 1999"
1999-2000,2,1999-08-14,Wimbledon,Coventry,1,1,D,1,1,0,1,4,2,0,3,12,19,3,0,7,3,August,-0.8660254037844384,-0.5000000000000004,47,15,1,2,2,1.0,1.2,5,5,0,0,2,-2,"August, 1999"
1999-2000,2,1999-08-15,Southampton,Newcastle,4,2,H,3,0,1,1,3,2,3,0,15,20,3,0,5,3,August,-0.8660254037844384,-0.5000000000000004,38,30,3,0,2,1.2,1.6,1,3,-2,1,4,-3,"August, 1999"
1999-2000,2,1999-08-16,Aston Villa,West Ham,2,2,D,1,1,1,3,1,1,1,3,3,13,6,3,10,3,August,-0.8660254037844384,-0.5000000000000004,1,45,1,3,1,0.6,0.4,4,0,4,1,0,1,"August, 1999"
1999-2000,3,1999-08-21,Sheffield Weds,Tottenham,1,2,A,0,3,1,1,3,3,1,1,20,7,1,6,13,5,August,-0.8660254037844384,-0.5000000000000004,37,42,3,1,1,1.6,0.8,2,7,-5,6,4,2,"August, 1999"
1999-2000,3,1999-08-21,Newcastle,Wimbledon,3,3,D,1,1,2,3,0,0,1,4,20,11,0,4,9,4,August,-0.8660254037844384,-0.5000000000000004,30,47,1,3,1,1.2,1.2,3,8,-5,6,6,0,"August, 1999"
1999-2000,3,1999-08-21,Watford,Bradford,1,0,H,3,0,1,1,3,3,1,1,17,11,3,4,6,1,August,-0.8660254037844384,-0.5000000000000004,43,8,0,0,0,0.0,0.0,3,5,-2,2,1,1,"August, 1999"
1999-2000,3,1999-08-21,Middlesbrough,Liverpool,1,0,H,3,0,2,3,0,0,2,3,6,16,6,3,10,3,August,-0.8660254037844384,-0.5000000000000004,29,25,0,1,4,1.2,3.0,6,4,2,2,2,0,"August, 1999"
1999-2000,3,1999-08-21,West Ham,Leicester,2,1,H,3,0,1,1,3,3,1,1,11,12,4,4,1,0,August,-0.8660254037844384,-0.5000000000000004,45,24,3,1,1,1.8,1.4,3,2,1,4,4,0,"August, 1999"
1999-2000,3,1999-08-21,Everton,Southampton,4,1,H,3,0,1,2,2,1,1,3,17,7,1,6,10,5,August,-0.8660254037844384,-0.5000000000000004,18,38,1,1,3,0.8,1.6,3,7,-4,5,5,0,"August, 1999"
1999-2000,3,1999-08-21,Chelsea,Aston Villa,1,0,H,3,0,2,1,2,1,3,1,7,2,4,7,5,3,August,-0.8660254037844384,-0.5000000000000004,14,1,4,0,1,1.8,0.4,6,2,4,6,2,4,"August, 1999"
1999-2000,3,1999-08-21,Leeds,Sunderland,2,1,H,3,0,2,3,0,2,1,2,8,15,4,4,7,0,August,-0.8660254037844384,-0.5000000000000004,23,40,2,0,0,2.0,0.0,3,2,1,2,4,-2,"August, 1999"
1999-2000,3,1999-08-21,Coventry,Derby,2,0,H,3,0,2,0,3,1,3,1,16,17,1,1,1,0,August,-0.8660254037844384,-0.5000000000000004,15,17,1,2,2,0.8,1.2,1,3,-2,2,5,-3,"August, 1999"
1999-2000,3,1999-08-22,Arsenal,Man United,1,2,A,0,3,3,1,1,5,0,0,8,3,7,7,5,0,August,-0.8660254037844384,-0.5000000000000004,0,28,3,1,1,1.8,1.0,4,2,2,7,1,6,"August, 1999"
1999-2000,3,1999-08-23,Leeds,Liverpool,1,2,A,0,3,2,3,0,0,2,3,6,17,7,3,11,4,August,-0.8660254037844384,-0.5000000000000004,23,25,1,1,3,0.8,2.0,5,3,2,2,3,-1,"August, 1999"
1999-2000,3,1999-08-24,Middlesbrough,Leicester,0,3,A,0,3,2,3,0,3,1,1,3,16,9,4,13,5,August,-0.8660254037844384,-0.5000000000000004,29,24,2,1,1,1.0,0.75,7,4,3,5,6,-1,"August, 1999"
1999-2000,3,1999-08-24,Watford,Aston Villa,0,1,A,0,3,1,1,3,1,3,1,11,5,6,7,6,1,August,-0.8660254037844384,-0.5000000000000004,43,1,0,0,0,0.0,0.0,4,5,-1,6,3,3,"August, 1999"
1999-2000,3,1999-08-25,Sheffield Weds,Derby,0,2,A,0,3,1,1,3,1,3,1,20,18,1,1,2,0,August,-0.8660254037844384,-0.5000000000000004,37,17,0,1,4,0.8,2.4,3,9,-6,2,7,-5,"August, 1999"
1999-2000,3,1999-08-25,Newcastle,Sunderland,1,2,A,0,3,2,3,0,2,1,2,18,17,1,4,1,3,August,-0.8660254037844384,-0.5000000000000004,30,40,1,1,0,1.5,1.0,6,11,-5,3,6,-3,"August, 1999"
1999-2000,3,1999-08-25,Everton,Wimbledon,4,0,H,3,0,1,2,2,0,1,4,14,13,4,5,1,1,August,-0.8660254037844384,-0.5000000000000004,18,47,1,3,1,0.8,1.0,7,8,-1,9,9,0,"August, 1999"
1999-2000,3,1999-08-25,Coventry,Man United,1,2,A,0,3,2,0,3,5,0,0,14,1,4,10,13,6,August,-0.8660254037844384,-0.5000000000000004,15,28,1,0,4,0.8,2.2,3,3,0,9,2,7,"August, 1999"
1999-2000,3,1999-08-25,Arsenal,Bradford,2,0,H,3,0,3,1,1,3,1,1,9,15,7,4,6,3,August,-0.8660254037844384,-0.5000000000000004,0,8,0,0,0,0.0,0.0,5,4,1,2,2,0,"August, 1999"
1999-2000,4,1999-08-28,Aston Villa,Middlesbrough,1,0,H,3,0,1,3,1,2,3,0,2,5,10,9,3,1,August,-0.8660254037844384,-0.5000000000000004,1,29,2,2,1,1.2,0.8,7,3,4,7,7,0,"August, 1999"
1999-2000,4,1999-08-28,Bradford,West Ham,0,3,A,0,3,3,1,1,1,1,3,17,9,4,7,8,3,August,-0.8660254037844384,-0.5000000000000004,8,45,0,0,0,0.0,0.0,2,4,-2,5,3,2,"August, 1999"
1999-2000,4,1999-08-28,Derby,Everton,1,0,H,3,0,1,3,1,1,2,2,17,8,4,7,9,3,August,-0.8660254037844384,-0.5000000000000004,17,18,3,1,1,1.4,0.8,4,7,-3,11,8,3,"August, 1999"
1999-2000,4,1999-08-28,Liverpool,Arsenal,2,0,H,3,0,0,2,3,3,1,1,13,4,6,10,9,4,August,-0.8660254037844384,-0.5000000000000004,25,0,3,2,0,1.4,0.2,4,4,0,7,4,3,"August, 1999"
1999-2000,4,1999-08-28,Southampton,Sheffield Weds,2,0,H,3,0,1,1,3,1,1,3,15,20,6,1,5,5,August,-0.8660254037844384,-0.5000000000000004,38,37,1,1,3,1.0,1.4,6,9,-3,3,11,-8,"August, 1999"
1999-2000,4,1999-08-28,Tottenham,Leeds,1,2,A,0,3,3,1,1,2,3,0,5,12,9,7,7,2,August,-0.8660254037844384,-0.5000000000000004,42,23,1,1,3,0.8,1.4,8,5,3,6,5,1,"August, 1999"
1999-2000,4,1999-08-28,Wimbledon,Chelsea,0,1,A,0,3,0,1,4,2,1,2,16,10,5,7,6,2,August,-0.8660254037844384,-0.5000000000000004,47,14,0,1,4,0.4,1.8,9,13,-4,7,2,5,"August, 1999"
1999-2000,4,1999-08-29,Sunderland,Coventry,1,1,D,1,1,2,1,2,2,0,3,14,17,7,4,3,3,August,-0.8660254037844384,-0.5000000000000004,40,15,1,1,0,1.5,1.0,5,7,-2,4,5,-1,"August, 1999"
1999-2000,4,1999-08-30,Man United,Newcastle,5,1,H,3,0,5,0,0,2,3,0,1,19,13,1,18,12,August,-0.8660254037844384,-0.5000000000000004,28,30,2,3,0,0.8,0.4,11,3,8,7,13,-6,"August, 1999"
1999-2000,4,1999-08-30,Leicester,Watford,1,0,H,3,0,3,1,1,1,1,3,13,15,7,6,2,1,August,-0.8660254037844384,-0.5000000000000004,24,43,0,0,0,0.0,0.0,8,6,2,4,6,-2,"August, 1999"
1999-2000,5,1999-09-11,Arsenal,Aston Villa,3,1,H,3,0,3,1,1,1,3,1,7,2,10,13,5,3,September,-1.0,-1.8369701987210287e-16,0,1,1,2,2,1.0,1.2,7,6,1,8,3,5,"September, 1999"
1999-2000,5,1999-09-11,Chelsea,Newcastle,1,0,H,3,0,2,1,2,2,3,0,4,19,10,1,15,9,September,-1.0,-1.8369701987210287e-16,14,30,2,1,2,1.0,1.4,8,2,6,8,18,-10,"September, 1999"
1999-2000,5,1999-09-11,Coventry,Leeds,3,4,A,0,3,2,0,3,2,3,0,16,7,5,10,9,5,September,-1.0,-1.8369701987210287e-16,15,23,1,3,1,1.6,1.6,5,6,-1,8,6,2,"September, 1999"
1999-2000,5,1999-09-11,Liverpool,Man United,2,3,A,0,3,0,2,3,5,0,0,9,1,9,16,8,7,September,-1.0,-1.8369701987210287e-16,25,28,0,2,3,1.0,2.2,6,4,2,16,4,12,"September, 1999"
1999-2000,5,1999-09-11,Middlesbrough,Southampton,3,2,H,3,0,2,3,0,1,1,3,11,10,9,9,1,0,September,-1.0,-1.8369701987210287e-16,29,38,1,1,3,1.4,2.0,7,8,-1,8,9,-1,"September, 1999"
1999-2000,5,1999-09-11,Sheffield Weds,Everton,0,2,A,0,3,1,1,3,1,2,2,19,13,1,7,6,6,September,-1.0,-1.8369701987210287e-16,37,18,4,1,0,2.0,0.8,3,13,-10,11,9,2,"September, 1999"
1999-2000,5,1999-09-11,Sunderland,Leicester,2,0,H,3,0,2,1,2,3,1,1,13,9,8,10,4,2,September,-1.0,-1.8369701987210287e-16,40,24,0,2,0,0.5,0.5,6,8,-2,9,6,3,"September, 1999"
1999-2000,5,1999-09-11,West Ham,Watford,1,0,H,3,0,1,1,3,1,1,3,8,15,10,6,7,4,September,-1.0,-1.8369701987210287e-16,45,43,0,0,0,0.0,0.0,8,3,5,4,7,-3,"September, 1999"
1999-2000,5,1999-09-11,Wimbledon,Derby,2,2,D,1,1,0,1,4,1,3,1,17,14,5,7,3,2,September,-1.0,-1.8369701987210287e-16,47,17,1,4,0,0.8,0.6,9,14,-5,5,7,-2,"September, 1999"
1999-2000,5,1999-09-12,Bradford,Tottenham,1,1,D,1,1,3,1,1,3,1,1,18,11,4,9,7,5,September,-1.0,-1.8369701987210287e-16,8,42,0,0,0,0.0,0.0,2,7,-5,9,7,2,"September, 1999"
1999-2000,6,1999-09-18,Watford,Chelsea,1,0,H,3,0,1,1,3,2,1,2,16,5,6,13,11,7,September,-1.0,-1.8369701987210287e-16,43,14,0,0,0,0.0,0.0,4,8,-4,9,2,7,"September, 1999"
1999-2000,6,1999-09-18,Southampton,Arsenal,0,1,A,0,3,1,1,3,3,1,1,13,7,9,13,6,4,September,-1.0,-1.8369701987210287e-16,38,0,0,2,3,0.4,1.8,10,12,-2,10,7,3,"September, 1999"
1999-2000,6,1999-09-18,Man United,Wimbledon,1,1,D,1,1,5,0,0,0,1,4,1,16,19,6,15,13,September,-1.0,-1.8369701987210287e-16,28,47,4,1,0,3.0,1.0,19,6,13,11,16,-5,"September, 1999"
1999-2000,6,1999-09-18,Aston Villa,Bradford,1,0,H,3,0,1,3,1,3,1,1,6,18,13,5,12,8,September,-1.0,-1.8369701987210287e-16,1,8,0,0,0,0.0,0.0,9,6,3,3,8,-5,"September, 1999"
1999-2000,6,1999-09-18,Derby,Sunderland,0,5,A,0,3,1,3,1,2,1,2,14,8,8,11,6,3,September,-1.0,-1.8369701987210287e-16,17,40,1,0,1,0.5,1.0,7,9,-2,8,8,0,"September, 1999"
1999-2000,6,1999-09-18,Leicester,Liverpool,2,2,D,1,1,3,1,1,0,2,3,11,12,10,9,1,1,September,-1.0,-1.8369701987210287e-16,24,25,3,2,0,1.0,0.4,9,8,1,8,7,1,"September, 1999"
1999-2000,6,1999-09-19,Tottenham,Coventry,3,2,H,3,0,3,1,1,2,0,3,11,17,10,5,6,5,September,-1.0,-1.8369701987210287e-16,42,15,0,3,2,0.6,1.6,10,8,2,8,10,-2,"September, 1999"
1999-2000,6,1999-09-19,Everton,West Ham,1,0,H,3,0,1,2,2,1,1,3,10,6,10,13,4,3,September,-1.0,-1.8369701987210287e-16,18,45,2,2,1,2.6,1.4,13,9,4,9,3,6,"September, 1999"
1999-2000,6,1999-09-19,Leeds,Middlesbrough,2,0,H,3,0,2,3,0,2,3,0,8,9,13,12,1,1,September,-1.0,-1.8369701987210287e-16,23,29,1,3,1,0.6,0.4,12,9,3,10,10,0,"September, 1999"
1999-2000,6,1999-09-19,Newcastle,Sheffield Weds,8,0,H,3,0,2,3,0,1,1,3,19,20,1,1,1,0,September,-1.0,-1.8369701987210287e-16,30,37,1,3,1,1.2,1.2,8,19,-11,3,15,-12,"September, 1999"
1999-2000,7,1999-09-25,Middlesbrough,Chelsea,0,1,A,0,3,2,3,0,2,1,2,11,7,12,13,4,1,September,-1.0,-1.8369701987210287e-16,29,14,1,1,3,0.2,1.6,10,12,-2,9,3,6,"September, 1999"
1999-2000,7,1999-09-25,Man United,Southampton,3,3,D,1,1,5,0,0,1,1,3,1,13,20,9,12,11,September,-1.0,-1.8369701987210287e-16,28,38,4,0,1,1.6,0.6,20,7,13,10,13,-3,"September, 1999"
1999-2000,7,1999-09-25,Sunderland,Sheffield Weds,1,0,H,3,0,2,1,2,1,1,3,6,20,14,1,14,13,September,-1.0,-1.8369701987210287e-16,40,37,0,1,1,1.0,1.5,13,8,5,3,23,-20,"September, 1999"
1999-2000,7,1999-09-25,Leicester,Aston Villa,3,1,H,3,0,3,1,1,1,3,1,11,4,11,16,7,5,September,-1.0,-1.8369701987210287e-16,24,1,2,3,0,1.2,0.8,11,10,1,10,6,4,"September, 1999"
1999-2000,7,1999-09-25,Coventry,West Ham,1,0,H,3,0,2,0,3,1,1,3,17,8,5,13,9,8,September,-1.0,-1.8369701987210287e-16,15,45,0,2,3,0.4,1.4,10,13,-3,9,4,5,"September, 1999"
1999-2000,7,1999-09-25,Derby,Bradford,0,1,A,0,3,1,3,1,3,1,1,16,18,8,5,2,3,September,-1.0,-1.8369701987210287e-16,17,8,0,0,0,0.0,0.0,7,14,-7,3,9,-6,"September, 1999"
1999-2000,7,1999-09-25,Leeds,Newcastle,3,2,H,3,0,2,3,0,2,3,0,3,19,16,4,16,12,September,-1.0,-1.8369701987210287e-16,23,30,2,1,2,1.6,1.2,14,9,5,16,19,-3,"September, 1999"
1999-2000,7,1999-09-25,Arsenal,Watford,1,0,H,3,0,3,1,1,1,1,3,3,14,16,9,11,7,September,-1.0,-1.8369701987210287e-16,0,43,0,0,0,0.0,0.0,11,7,4,5,8,-3,"September, 1999"
1999-2000,7,1999-09-26,Wimbledon,Tottenham,1,1,D,1,1,0,1,4,3,1,1,18,10,7,13,8,6,September,-1.0,-1.8369701987210287e-16,47,42,1,2,2,1.0,1.6,12,17,-5,13,10,3,"September, 1999"
1999-2000,7,1999-09-27,Liverpool,Everton,0,1,A,0,3,0,2,3,1,2,2,12,9,10,13,3,3,September,-1.0,-1.8369701987210287e-16,25,18,1,3,1,1.0,1.2,10,9,1,14,9,5,"September, 1999"
1999-2000,8,1999-10-02,Everton,Coventry,1,1,D,1,1,1,2,2,2,0,3,7,15,16,8,8,8,October,-0.8660254037844386,0.5,18,15,1,3,1,0.6,0.8,15,9,6,11,13,-2,"October, 1999"
1999-2000,8,1999-10-02,Sheffield Weds,Wimbledon,5,1,H,3,0,1,1,3,0,1,4,20,16,1,8,4,7,October,-0.8660254037844386,0.5,37,47,1,2,2,1.4,1.4,3,24,-21,13,18,-5,"October, 1999"
1999-2000,8,1999-10-02,Aston Villa,Liverpool,0,0,D,1,1,1,3,1,0,2,3,7,12,16,10,5,6,October,-0.8660254037844386,0.5,1,25,3,0,2,1.2,1.6,11,9,2,10,10,0,"October, 1999"
1999-2000,8,1999-10-02,Bradford,Sunderland,0,4,A,0,3,3,1,1,2,1,2,17,4,8,17,13,9,October,-0.8660254037844386,0.5,8,40,0,0,0,0.0,0.0,4,9,-5,14,8,6,"October, 1999"
1999-2000,8,1999-10-03,Chelsea,Man United,5,0,H,3,0,2,1,2,5,0,0,7,1,16,21,6,5,October,-0.8660254037844386,0.5,14,28,0,4,1,0.8,1.0,10,3,7,23,10,13,"October, 1999"
1999-2000,8,1999-10-03,Newcastle,Middlesbrough,2,1,H,3,0,2,3,0,2,3,0,19,11,4,12,8,8,October,-0.8660254037844386,0.5,30,29,3,2,0,1.8,1.0,18,22,-4,10,13,-3,"October, 1999"
1999-2000,8,1999-10-03,Tottenham,Leicester,2,3,A,0,3,3,1,1,3,1,1,9,8,14,14,1,0,October,-0.8660254037844386,0.5,42,24,0,2,3,0.6,1.8,14,11,3,14,11,3,"October, 1999"
1999-2000,8,1999-10-03,Watford,Leeds,1,2,A,0,3,1,1,3,2,3,0,15,4,9,19,11,10,October,-0.8660254037844386,0.5,43,23,0,0,0,0.0,0.0,5,9,-4,17,11,6,"October, 1999"
1999-2000,8,1999-10-03,West Ham,Arsenal,2,1,H,3,0,1,1,3,3,1,1,10,5,13,19,5,6,October,-0.8660254037844386,0.5,45,0,0,1,4,0.2,2.2,9,5,4,12,7,5,"October, 1999"
1999-2000,8,1999-10-04,Southampton,Derby,3,3,D,1,1,1,1,3,1,3,1,13,16,10,8,3,2,October,-0.8660254037844386,0.5,38,17,0,2,3,0.2,1.6,13,16,-3,7,15,-8,"October, 1999"
1999-2000,9,1999-10-16,Liverpool,Chelsea,1,0,H,3,0,0,2,3,2,1,2,13,6,11,19,7,8,October,-0.8660254037844386,0.5,25,14,1,1,3,1.4,2.0,10,10,0,15,3,12,"October, 1999"
1999-2000,9,1999-10-16,Wimbledon,Bradford,3,2,H,3,0,0,1,4,3,1,1,17,18,8,8,1,0,October,-0.8660254037844386,0.5,47,8,0,0,0,0.0,0.0,14,23,-9,4,13,-9,"October, 1999"
1999-2000,9,1999-10-16,Leicester,Southampton,2,1,H,3,0,3,1,1,1,1,3,6,14,17,11,8,6,October,-0.8660254037844386,0.5,24,38,1,2,2,1.8,1.8,17,13,4,16,19,-3,"October, 1999"
1999-2000,9,1999-10-16,Man United,Watford,4,1,H,3,0,5,0,0,1,1,3,3,15,21,9,12,12,October,-0.8660254037844386,0.5,28,43,0,0,0,0.0,0.0,23,15,8,6,11,-5,"October, 1999"
1999-2000,9,1999-10-16,Derby,Tottenham,0,1,A,0,3,1,3,1,3,1,1,16,10,9,14,6,5,October,-0.8660254037844386,0.5,17,42,2,1,2,1.4,1.2,10,18,-8,16,14,2,"October, 1999"
1999-2000,9,1999-10-16,Coventry,Newcastle,4,1,H,3,0,2,0,3,2,3,0,14,19,9,7,5,2,October,-0.8660254037844386,0.5,15,30,0,2,3,0.8,3.0,12,14,-2,20,23,-3,"October, 1999"
1999-2000,9,1999-10-16,Leeds,Sheffield Weds,2,0,H,3,0,2,3,0,1,1,3,1,20,22,4,19,18,October,-0.8660254037844386,0.5,23,37,3,1,1,2.0,1.2,19,12,7,8,25,-17,"October, 1999"
1999-2000,9,1999-10-16,Arsenal,Everton,4,1,H,3,0,3,1,1,1,2,2,5,6,19,17,1,2,October,-0.8660254037844386,0.5,0,18,4,1,0,2.2,0.4,13,9,4,16,10,6,"October, 1999"
1999-2000,9,1999-10-17,Middlesbrough,West Ham,2,0,H,3,0,2,3,0,1,1,3,13,10,12,16,3,4,October,-0.8660254037844386,0.5,29,45,2,1,2,1.0,1.4,11,15,-4,11,6,5,"October, 1999"
1999-2000,9,1999-10-18,Sunderland,Aston Villa,2,1,H,3,0,2,1,2,1,3,1,4,9,20,17,5,3,October,-0.8660254037844386,0.5,40,1,1,0,1,0.5,0.5,18,8,10,11,9,2,"October, 1999"
1999-2000,10,1999-10-23,Southampton,Liverpool,1,1,D,1,1,1,1,3,0,2,3,15,12,11,14,3,3,October,-0.8660254037844386,0.5,38,25,1,1,3,1.2,2.6,17,21,-4,11,10,1,"October, 1999"
1999-2000,10,1999-10-23,Sheffield Weds,Coventry,0,0,D,1,1,1,1,3,2,0,3,20,13,4,12,7,8,October,-0.8660254037844386,0.5,37,15,0,2,3,0.2,0.8,8,27,-19,16,15,1,"October, 1999"
1999-2000,10,1999-10-23,Tottenham,Man United,3,1,H,3,0,3,1,1,5,0,0,9,3,17,24,6,7,October,-0.8660254037844386,0.5,42,28,0,1,4,0.8,2.0,17,14,3,27,16,11,"October, 1999"
1999-2000,10,1999-10-23,Bradford,Leicester,3,1,H,3,0,3,1,1,3,1,1,18,5,8,20,13,12,October,-0.8660254037844386,0.5,8,24,0,0,0,0.0,0.0,6,16,-10,19,14,5,"October, 1999"
1999-2000,10,1999-10-23,Aston Villa,Wimbledon,1,1,D,1,1,1,3,1,0,1,4,9,15,17,11,6,6,October,-0.8660254037844386,0.5,1,47,2,1,2,1.2,0.8,12,11,1,17,25,-8,"October, 1999"
1999-2000,10,1999-10-23,Chelsea,Arsenal,2,3,A,0,3,2,1,2,3,1,1,6,4,19,22,2,3,October,-0.8660254037844386,0.5,14,0,0,1,4,0.4,1.8,15,4,11,17,10,7,"October, 1999"
1999-2000,10,1999-10-24,Everton,Leeds,4,4,D,1,1,1,2,2,2,3,0,9,1,17,25,8,8,October,-0.8660254037844386,0.5,18,23,1,2,2,0.4,0.4,17,14,3,21,12,9,"October, 1999"
1999-2000,10,1999-10-24,Watford,Middlesbrough,1,3,A,0,3,1,1,3,2,3,0,17,12,9,15,5,6,October,-0.8660254037844386,0.5,43,29,0,0,0,0.0,0.0,7,15,-8,13,15,-2,"October, 1999"
1999-2000,10,1999-10-24,West Ham,Sunderland,1,1,D,1,1,1,1,3,2,1,2,11,4,16,23,7,7,October,-0.8660254037844386,0.5,45,40,1,1,0,1.0,0.0,11,8,3,20,9,11,"October, 1999"
1999-2000,10,1999-10-25,Newcastle,Derby,2,0,H,3,0,2,3,0,1,3,1,19,17,7,9,2,2,October,-0.8660254037844386,0.5,30,17,3,1,1,1.8,1.2,21,27,-6,10,19,-9,"October, 1999"
1999-2000,10,1999-10-27,Liverpool,West Ham,1,0,H,3,0,0,2,3,1,1,3,12,11,15,17,1,2,October,-0.8660254037844386,0.5,25,45,1,2,2,1.8,1.2,12,11,1,12,9,3,"October, 1999"
1999-2000,11,1999-10-30,Middlesbrough,Everton,2,1,H,3,0,2,3,0,1,2,2,10,8,18,18,2,0,October,-0.8660254037844386,0.5,29,18,2,1,2,1.6,2.4,16,16,0,21,18,3,"October, 1999"
1999-2000,11,1999-10-30,Arsenal,Newcastle,0,0,D,1,1,3,1,1,2,3,0,2,17,25,10,15,15,October,-0.8660254037844386,0.5,0,30,3,1,1,1.6,0.6,20,12,8,23,27,-4,"October, 1999"
1999-2000,11,1999-10-30,Derby,Chelsea,3,1,H,3,0,1,3,1,2,1,2,19,7,9,19,12,10,October,-0.8660254037844386,0.5,17,14,1,1,3,1.2,2.2,10,21,-11,17,7,10,"October, 1999"
1999-2000,11,1999-10-30,Leeds,West Ham,1,0,H,3,0,2,3,0,1,1,3,1,12,26,17,11,9,October,-0.8660254037844386,0.5,23,45,4,0,1,2.6,1.0,25,16,9,12,10,2,"October, 1999"
1999-2000,11,1999-10-30,Leicester,Sheffield Weds,3,0,H,3,0,3,1,1,1,1,3,6,20,20,5,14,15,October,-0.8660254037844386,0.5,24,37,2,1,2,0.6,0.8,20,17,3,8,27,-19,"October, 1999"
1999-2000,11,1999-10-30,Man United,Aston Villa,3,0,H,3,0,5,0,0,1,3,1,4,10,24,18,6,6,October,-0.8660254037844386,0.5,28,1,3,2,0,1.2,0.4,28,19,9,13,12,1,"October, 1999"
1999-2000,11,1999-10-30,Wimbledon,Southampton,1,1,D,1,1,0,1,4,1,1,3,15,14,12,12,1,0,October,-0.8660254037844386,0.5,47,38,2,1,2,0.6,1.0,18,26,-8,18,22,-4,"October, 1999"
1999-2000,11,1999-10-31,Sunderland,Tottenham,2,1,H,3,0,2,1,2,3,1,1,4,7,24,20,3,4,October,-0.8660254037844386,0.5,40,42,0,0,2,0.0,3.0,21,10,11,20,15,5,"October, 1999"
1999-2000,11,1999-10-31,Coventry,Watford,4,0,H,3,0,2,0,3,1,1,3,13,19,13,9,6,4,October,-0.8660254037844386,0.5,15,43,0,0,0,0.0,0.0,16,15,1,8,18,-10,"October, 1999"
1999-2000,11,1999-11-01,Liverpool,Bradford,3,1,H,3,0,0,2,3,3,1,1,10,18,18,11,8,7,November,-0.5000000000000004,0.8660254037844384,25,8,0,0,0,0.0,0.0,13,11,2,9,17,-8,"November, 1999"
1999-2000,12,1999-11-06,Aston Villa,Southampton,0,1,A,0,3,1,3,1,1,1,3,11,14,18,13,3,5,November,-0.5000000000000004,0.8660254037844384,1,38,4,1,0,2.2,0.6,13,15,-2,19,23,-4,"November, 1999"
1999-2000,12,1999-11-06,Bradford,Coventry,1,1,D,1,1,3,1,1,2,0,3,18,13,11,16,5,5,November,-0.5000000000000004,0.8660254037844384,8,15,0,0,0,0.0,0.0,10,20,-10,20,15,5,"November, 1999"
1999-2000,12,1999-11-06,Liverpool,Derby,2,0,H,3,0,0,2,3,1,3,1,6,16,21,12,10,9,November,-0.5000000000000004,0.8660254037844384,25,17,2,0,3,1.6,1.2,16,12,4,13,22,-9,"November, 1999"
1999-2000,12,1999-11-06,Man United,Leicester,2,0,H,3,0,5,0,0,3,1,1,2,6,27,23,4,4,November,-0.5000000000000004,0.8660254037844384,28,24,1,3,1,2.0,1.4,31,19,12,23,17,6,"November, 1999"
1999-2000,12,1999-11-06,Middlesbrough,Sunderland,1,1,D,1,1,2,3,0,2,1,2,7,3,21,27,4,6,November,-0.5000000000000004,0.8660254037844384,29,40,0,1,1,1.0,1.5,18,17,1,23,11,12,"November, 1999"
1999-2000,12,1999-11-06,Sheffield Weds,Watford,2,2,D,1,1,1,1,3,1,1,3,20,19,5,9,1,4,November,-0.5000000000000004,0.8660254037844384,37,43,0,0,0,0.0,0.0,8,30,-22,8,22,-14,"November, 1999"
1999-2000,12,1999-11-07,Wimbledon,Leeds,2,0,H,3,0,0,1,4,2,3,0,15,2,13,29,13,16,November,-0.5000000000000004,0.8660254037844384,47,23,2,3,0,1.4,0.8,19,27,-8,26,16,10,"November, 1999"
1999-2000,12,1999-11-07,Tottenham,Arsenal,2,1,H,3,0,3,1,1,3,1,1,9,4,20,26,5,6,November,-0.5000000000000004,0.8660254037844384,42,0,0,4,1,0.4,0.8,21,17,4,20,12,8,"November, 1999"
1999-2000,12,1999-11-07,Newcastle,Everton,1,1,D,1,1,2,3,0,1,2,2,18,10,11,18,8,7,November,-0.5000000000000004,0.8660254037844384,30,18,2,1,2,1.2,1.0,23,27,-4,22,20,2,"November, 1999"
1999-2000,12,1999-11-07,Chelsea,West Ham,0,0,D,1,1,2,1,2,1,1,3,9,13,19,17,4,2,November,-0.5000000000000004,0.8660254037844384,14,45,1,1,3,1.2,1.6,18,10,8,12,11,1,"November, 1999"
1999-2000,13,1999-11-20,Arsenal,Middlesbrough,5,1,H,3,0,3,1,1,2,3,0,4,8,26,22,4,4,November,-0.5000000000000004,0.8660254037844384,0,29,4,1,0,2.8,0.8,21,14,7,19,18,1,"November, 1999"
1999-2000,13,1999-11-20,Derby,Man United,1,2,A,0,3,1,3,1,5,0,0,18,1,12,30,17,18,November,-0.5000000000000004,0.8660254037844384,17,28,1,2,2,1.2,1.6,13,24,-11,33,19,14,"November, 1999"
1999-2000,13,1999-11-20,Everton,Chelsea,1,1,D,1,1,1,2,2,2,1,2,10,9,19,20,1,1,November,-0.5000000000000004,0.8660254037844384,18,14,1,1,3,1.0,1.6,23,21,2,18,10,8,"November, 1999"
1999-2000,13,1999-11-20,Leeds,Bradford,2,1,H,3,0,2,3,0,3,1,1,3,17,29,12,14,17,November,-0.5000000000000004,0.8660254037844384,23,8,0,0,0,0.0,0.0,26,18,8,11,21,-10,"November, 1999"
1999-2000,13,1999-11-20,Leicester,Wimbledon,2,1,H,3,0,3,1,1,0,1,4,7,15,23,16,8,7,November,-0.5000000000000004,0.8660254037844384,24,47,2,1,2,1.2,1.0,23,19,4,21,27,-6,"November, 1999"
1999-2000,13,1999-11-20,Southampton,Tottenham,0,1,A,0,3,1,1,3,3,1,1,14,7,16,23,7,7,November,-0.5000000000000004,0.8660254037844384,38,42,1,2,2,1.2,2.0,20,23,-3,23,18,5,"November, 1999"
1999-2000,13,1999-11-20,Sunderland,Liverpool,0,2,A,0,3,2,1,2,0,2,3,4,7,28,24,3,4,November,-0.5000000000000004,0.8660254037844384,40,25,0,1,1,0.5,1.0,24,12,12,18,12,6,"November, 1999"
1999-2000,13,1999-11-20,Watford,Newcastle,1,1,D,1,1,1,1,3,2,3,0,19,16,10,12,3,2,November,-0.5000000000000004,0.8660254037844384,43,30,0,0,0,0.0,0.0,10,24,-14,24,28,-4,"November, 1999"
1999-2000,13,1999-11-21,West Ham,Sheffield Weds,4,3,H,3,0,1,1,3,1,1,3,11,20,18,6,9,12,November,-0.5000000000000004,0.8660254037844384,45,37,3,1,1,1.6,1.2,12,11,1,10,32,-22,"November, 1999"
1999-2000,13,1999-11-22,Coventry,Aston Villa,2,1,H,3,0,2,0,3,1,3,1,13,12,17,18,1,1,November,-0.5000000000000004,0.8660254037844384,15,1,1,0,4,1.4,2.0,21,16,5,13,16,-3,"November, 1999"
1999-2000,14,1999-11-27,West Ham,Liverpool,1,0,H,3,0,1,1,3,0,2,3,11,6,21,27,5,6,November,-0.5000000000000004,0.8660254037844384,45,25,2,1,2,1.2,2.0,16,14,2,20,12,8,"November, 1999"
1999-2000,14,1999-11-27,Watford,Sunderland,2,3,A,0,3,1,1,3,2,1,2,19,5,11,28,14,17,November,-0.5000000000000004,0.8660254037844384,43,40,0,0,1,0.0,2.0,11,25,-14,24,14,10,"November, 1999"
1999-2000,14,1999-11-27,Coventry,Leicester,0,1,A,0,3,2,0,3,3,1,1,11,7,20,26,4,6,November,-0.5000000000000004,0.8660254037844384,15,24,0,2,3,0.4,1.2,23,17,6,25,20,5,"November, 1999"
1999-2000,14,1999-11-27,Everton,Aston Villa,0,0,D,1,1,1,2,2,1,3,1,12,13,20,18,1,2,November,-0.5000000000000004,0.8660254037844384,18,1,0,1,4,0.4,2.4,24,22,2,14,18,-4,"November, 1999"
1999-2000,14,1999-11-27,Middlesbrough,Wimbledon,0,0,D,1,1,2,3,0,0,1,4,8,15,22,16,7,6,November,-0.5000000000000004,0.8660254037844384,29,47,2,3,0,1.8,1.2,20,23,-3,22,29,-7,"November, 1999"
1999-2000,14,1999-11-28,Arsenal,Derby,2,1,H,3,0,3,1,1,1,3,1,4,18,29,12,14,17,November,-0.5000000000000004,0.8660254037844384,0,17,3,1,1,0.8,0.8,26,15,11,14,26,-12,"November, 1999"
1999-2000,14,1999-11-28,Chelsea,Bradford,1,0,H,3,0,2,1,2,3,1,1,10,17,21,12,7,9,November,-0.5000000000000004,0.8660254037844384,14,8,0,0,0,0.0,0.0,19,11,8,12,23,-11,"November, 1999"
1999-2000,14,1999-11-28,Leeds,Southampton,1,0,H,3,0,2,3,0,1,1,3,3,15,32,16,12,16,November,-0.5000000000000004,0.8660254037844384,23,38,3,0,2,1.6,0.8,28,19,9,20,24,-4,"November, 1999"
1999-2000,14,1999-11-28,Newcastle,Tottenham,2,1,H,3,0,2,3,0,3,1,1,16,7,13,26,9,13,November,-0.5000000000000004,0.8660254037844384,30,42,1,1,3,0.6,1.6,25,29,-4,24,18,6,"November, 1999"
1999-2000,15,1999-12-04,Wimbledon,Watford,5,0,H,3,0,0,1,4,1,1,3,16,19,17,11,3,6,December,-2.4492935982947064e-16,1.0,47,43,1,0,0,3.0,2.0,22,29,-7,13,28,-15,"December, 1999"
1999-2000,15,1999-12-04,Sunderland,Chelsea,4,1,H,3,0,2,1,2,2,1,2,4,8,31,24,4,7,December,-2.4492935982947064e-16,1.0,40,14,1,0,2,1.6666666666666667,3.333333333333333,27,16,11,20,11,9,"December, 1999"
1999-2000,15,1999-12-04,Southampton,Coventry,0,0,D,1,1,1,1,3,2,0,3,16,12,16,20,4,4,December,-2.4492935982947064e-16,1.0,38,15,2,0,3,0.8,1.0,20,25,-5,23,18,5,"December, 1999"
1999-2000,15,1999-12-04,Leicester,Arsenal,0,3,A,0,3,3,1,1,3,1,1,5,3,29,32,2,3,December,-2.4492935982947064e-16,1.0,24,0,0,2,3,1.2,2.6,26,20,6,28,16,12,"December, 1999"
1999-2000,15,1999-12-04,Bradford,Middlesbrough,1,1,D,1,1,3,1,1,2,3,0,17,10,12,23,7,11,December,-2.4492935982947064e-16,1.0,8,29,1,0,0,1.0,0.0,12,24,-12,20,23,-3,"December, 1999"
1999-2000,15,1999-12-04,Aston Villa,Newcastle,0,1,A,0,3,1,3,1,2,3,0,13,15,19,16,2,3,December,-2.4492935982947064e-16,1.0,1,30,2,0,3,0.6,0.8,14,18,-4,27,30,-3,"December, 1999"
1999-2000,15,1999-12-04,Man United,Everton,5,1,H,3,0,5,0,0,1,2,2,3,11,33,21,8,12,December,-2.4492935982947064e-16,1.0,28,18,4,1,0,2.4,0.6,35,20,15,24,22,2,"December, 1999"
1999-2000,15,1999-12-05,Derby,Leeds,0,1,A,0,3,1,3,1,2,3,0,18,3,12,35,15,23,December,-2.4492935982947064e-16,1.0,17,23,0,2,3,1.2,3.0,15,28,-13,29,19,10,"December, 1999"
1999-2000,15,1999-12-05,Liverpool,Sheffield Weds,4,1,H,3,0,0,2,3,1,1,3,6,20,27,6,14,21,December,-2.4492935982947064e-16,1.0,25,37,3,1,1,1.8,1.2,20,13,7,13,36,-23,"December, 1999"
1999-2000,15,1999-12-06,Tottenham,West Ham,0,0,D,1,1,3,1,1,1,1,3,7,9,26,24,2,2,December,-2.4492935982947064e-16,1.0,42,45,1,0,4,0.8,1.4,25,20,5,17,14,3,"December, 1999"
1999-2000,16,1999-12-18,Watford,Everton,1,3,A,0,3,1,1,3,1,2,2,19,14,11,21,5,10,December,-2.4492935982947064e-16,1.0,43,18,0,0,0,0.0,0.0,13,33,-20,25,27,-2,"December, 1999"
1999-2000,16,1999-12-18,Sunderland,Southampton,2,0,H,3,0,2,1,2,1,1,3,4,16,34,17,12,17,December,-2.4492935982947064e-16,1.0,40,38,0,0,2,0.0,2.0,31,17,14,20,25,-5,"December, 1999"
1999-2000,16,1999-12-18,West Ham,Man United,2,4,A,0,3,1,1,3,5,0,0,9,3,25,36,6,11,December,-2.4492935982947064e-16,1.0,45,28,0,2,3,0.6,1.8,17,14,3,40,21,19,"December, 1999"
1999-2000,16,1999-12-18,Middlesbrough,Tottenham,2,1,H,3,0,2,3,0,3,1,1,10,7,24,27,3,3,December,-2.4492935982947064e-16,1.0,29,42,1,2,2,0.8,1.0,21,24,-3,25,20,5,"December, 1999"
1999-2000,16,1999-12-18,Arsenal,Wimbledon,1,1,D,1,1,3,1,1,0,1,4,3,13,35,20,10,15,December,-2.4492935982947064e-16,1.0,0,47,3,0,2,2.2,0.6,31,16,15,27,29,-2,"December, 1999"
1999-2000,16,1999-12-18,Leicester,Derby,0,1,A,0,3,3,1,1,1,3,1,6,18,29,12,12,17,December,-2.4492935982947064e-16,1.0,24,17,2,0,3,2.0,1.6,26,23,3,15,29,-14,"December, 1999"
1999-2000,16,1999-12-18,Aston Villa,Sheffield Weds,2,1,H,3,0,1,3,1,1,1,3,15,20,19,6,5,13,December,-2.4492935982947064e-16,1.0,1,37,3,1,1,1.6,1.0,14,19,-5,14,40,-26,"December, 1999"
1999-2000,16,1999-12-18,Liverpool,Coventry,2,0,H,3,0,0,2,3,2,0,3,5,12,30,21,7,9,December,-2.4492935982947064e-16,1.0,25,15,2,1,2,1.2,1.0,24,14,10,23,18,5,"December, 1999"
1999-2000,16,1999-12-18,Bradford,Newcastle,2,0,H,3,0,3,1,1,2,3,0,17,15,13,19,2,6,December,-2.4492935982947064e-16,1.0,8,30,0,0,0,0.0,0.0,13,25,-12,28,30,-2,"December, 1999"
1999-2000,16,1999-12-19,Chelsea,Leeds,0,2,A,0,3,2,1,2,2,3,0,10,2,24,38,8,14,December,-2.4492935982947064e-16,1.0,14,23,1,3,1,0.4,0.6,21,15,6,30,19,11,"December, 1999"
1999-2000,17,1999-12-26,Coventry,Arsenal,3,2,H,3,0,2,0,3,3,1,1,13,4,21,36,9,15,December,-2.4492935982947064e-16,1.0,15,0,0,2,3,0.6,1.6,23,20,3,32,17,15,"December, 1999"
1999-2000,17,1999-12-26,Derby,Aston Villa,0,2,A,0,3,1,3,1,1,3,1,18,13,15,22,5,7,December,-2.4492935982947064e-16,1.0,17,1,2,0,3,1.0,1.2,16,29,-13,16,20,-4,"December, 1999"
1999-2000,17,1999-12-26,Everton,Sunderland,5,0,H,3,0,1,2,2,2,1,2,13,3,24,37,10,13,December,-2.4492935982947064e-16,1.0,18,40,0,0,2,0.5,3.0,28,28,0,33,17,16,"December, 1999"
1999-2000,17,1999-12-26,Man United,Bradford,4,0,H,3,0,5,0,0,3,1,1,2,17,39,16,15,23,December,-2.4492935982947064e-16,1.0,28,8,0,0,0,0.0,0.0,44,23,21,15,25,-10,"December, 1999"
1999-2000,17,1999-12-26,Newcastle,Liverpool,2,2,D,1,1,2,3,0,0,2,3,15,5,19,33,10,14,December,-2.4492935982947064e-16,1.0,30,25,0,0,5,1.4,3.0,28,32,-4,26,14,12,"December, 1999"
1999-2000,17,1999-12-26,Sheffield Weds,Middlesbrough,1,0,H,3,0,1,1,3,2,3,0,20,9,6,27,11,21,December,-2.4492935982947064e-16,1.0,37,29,2,0,3,1.8,2.6,15,42,-27,23,25,-2,"December, 1999"
1999-2000,17,1999-12-26,Southampton,Chelsea,1,2,A,0,3,1,1,3,2,1,2,16,13,17,24,3,7,December,-2.4492935982947064e-16,1.0,38,14,1,0,4,0.6,1.6,20,27,-7,21,17,4,"December, 1999"
1999-2000,17,1999-12-26,Tottenham,Watford,4,0,H,3,0,3,1,1,1,1,3,9,19,27,11,10,16,December,-2.4492935982947064e-16,1.0,42,43,0,0,0,0.0,0.0,26,22,4,14,36,-22,"December, 1999"
1999-2000,17,1999-12-26,Wimbledon,West Ham,2,2,D,1,1,0,1,4,1,1,3,14,11,21,25,3,4,December,-2.4492935982947064e-16,1.0,47,45,1,2,2,1.4,1.8,28,30,-2,19,18,1,"December, 1999"
1999-2000,17,1999-12-26,Leeds,Leicester,2,1,H,3,0,2,3,0,3,1,1,1,6,41,29,5,12,December,-2.4492935982947064e-16,1.0,23,24,2,0,3,1.0,0.8,32,19,13,26,24,2,"December, 1999"
1999-2000,18,1999-12-28,West Ham,Derby,1,1,D,1,1,1,1,3,1,3,1,11,18,26,15,7,11,December,-2.4492935982947064e-16,1.0,45,17,2,1,2,1.4,0.8,21,20,1,16,31,-15,"December, 1999"
1999-2000,18,1999-12-28,Sunderland,Man United,2,2,D,1,1,2,1,2,5,0,0,5,2,37,42,3,5,December,-2.4492935982947064e-16,1.0,40,28,1,0,1,1.0,3.0,33,22,11,48,23,25,"December, 1999"
1999-2000,18,1999-12-28,Watford,Southampton,3,2,H,3,0,1,1,3,1,1,3,19,16,11,17,3,6,December,-2.4492935982947064e-16,1.0,43,38,0,0,0,0.0,0.0,14,40,-26,21,29,-8,"December, 1999"
1999-2000,18,1999-12-28,Liverpool,Wimbledon,3,1,H,3,0,0,2,3,0,1,4,5,15,34,22,10,12,December,-2.4492935982947064e-16,1.0,25,47,2,1,2,1.4,0.8,28,16,12,30,32,-2,"December, 1999"
1999-2000,18,1999-12-28,Bradford,Everton,0,0,D,1,1,3,1,1,1,2,2,17,8,16,27,9,11,December,-2.4492935982947064e-16,1.0,8,18,0,0,0,0.0,0.0,15,29,-14,33,28,5,"December, 1999"
1999-2000,18,1999-12-28,Arsenal,Leeds,2,0,H,3,0,3,1,1,2,3,0,4,1,36,44,3,8,December,-2.4492935982947064e-16,1.0,0,23,2,2,1,1.2,0.8,34,20,14,34,20,14,"December, 1999"
1999-2000,18,1999-12-28,Leicester,Newcastle,1,2,A,0,3,3,1,1,2,3,0,7,15,29,20,8,9,December,-2.4492935982947064e-16,1.0,24,30,1,2,2,1.6,1.6,27,26,1,30,34,-4,"December, 1999"
1999-2000,18,1999-12-29,Aston Villa,Tottenham,1,1,D,1,1,1,3,1,3,1,1,12,6,25,30,6,5,December,-2.4492935982947064e-16,1.0,1,42,2,1,2,2.0,1.6,18,20,-2,30,22,8,"December, 1999"
1999-2000,18,1999-12-29,Chelsea,Sheffield Weds,3,0,H,3,0,2,1,2,1,1,3,9,20,27,9,11,18,December,-2.4492935982947064e-16,1.0,14,37,2,3,0,1.6,0.8,23,18,5,16,42,-26,"December, 1999"
1999-2000,19,2000-01-03,Wimbledon,Sunderland,1,0,H,3,0,0,1,4,2,1,2,15,4,22,38,11,16,January,0.4999999999999999,0.8660254037844387,47,40,2,0,0,2.0,0.5,31,35,-4,35,24,11,"January, 2000"
1999-2000,19,2000-01-03,Tottenham,Liverpool,1,0,H,3,0,3,1,1,0,2,3,6,5,31,37,1,6,January,0.4999999999999999,0.8660254037844387,42,25,1,1,3,1.6,2.6,31,23,8,31,17,14,"January, 2000"
1999-2000,19,2000-01-03,Southampton,Bradford,1,0,H,3,0,1,1,3,3,1,1,17,18,17,17,1,0,January,0.4999999999999999,0.8660254037844387,38,8,0,0,0,0.0,0.0,23,32,-9,15,29,-14,"January, 2000"
1999-2000,19,2000-01-03,Sheffield Weds,Arsenal,1,1,D,1,1,1,1,3,3,1,1,20,3,9,39,17,30,January,0.4999999999999999,0.8660254037844387,37,0,2,1,2,0.6,0.8,16,45,-29,36,20,16,"January, 2000"
1999-2000,19,2000-01-03,Leeds,Aston Villa,1,2,A,0,3,2,3,0,1,3,1,1,12,44,26,11,18,January,0.4999999999999999,0.8660254037844387,23,1,1,3,1,0.6,0.6,34,22,12,19,21,-2,"January, 2000"
1999-2000,19,2000-01-03,Everton,Leicester,2,2,D,1,1,1,2,2,3,1,1,9,8,28,29,1,1,January,0.4999999999999999,0.8660254037844387,18,24,1,3,1,0.6,0.8,33,28,5,28,28,0,"January, 2000"
1999-2000,19,2000-01-03,Derby,Watford,2,0,H,3,0,1,3,1,1,1,3,18,19,16,14,1,2,January,0.4999999999999999,0.8660254037844387,17,43,0,0,0,0.0,0.0,17,32,-15,17,42,-25,"January, 2000"
1999-2000,19,2000-01-03,Newcastle,West Ham,2,2,D,1,1,2,3,0,1,1,3,14,11,23,27,3,4,January,0.4999999999999999,0.8660254037844387,30,45,1,1,3,0.2,1.2,32,35,-3,22,21,1,"January, 2000"
1999-2000,19,2000-01-04,Coventry,Chelsea,2,2,D,1,1,2,0,3,2,1,2,14,7,24,30,7,6,January,0.4999999999999999,0.8660254037844387,15,14,3,0,2,2.0,1.8,26,22,4,26,18,8,"January, 2000"
1999-2000,19,2000-01-08,Bradford,Chelsea,1,1,D,1,1,3,1,1,2,1,2,18,7,17,31,11,14,January,0.4999999999999999,0.8660254037844387,8,14,0,0,1,0.0,1.0,15,30,-15,28,20,8,"January, 2000"
1999-2000,19,2000-01-12,Chelsea,Tottenham,1,0,H,3,0,2,1,2,3,1,1,7,6,32,34,1,2,January,0.4999999999999999,0.8660254037844387,14,42,4,1,0,2.8,0.8,29,21,8,32,23,9,"January, 2000"
1999-2000,20,2000-01-15,West Ham,Aston Villa,1,1,D,1,1,1,1,3,1,3,1,12,10,28,29,2,1,January,0.4999999999999999,0.8660254037844387,45,1,1,3,1,0.8,1.0,24,23,1,21,22,-1,"January, 2000"
1999-2000,20,2000-01-15,Watford,Liverpool,2,3,A,0,3,1,1,3,0,2,3,19,5,14,37,14,23,January,0.4999999999999999,0.8660254037844387,43,25,1,0,0,1.0,0.0,17,44,-27,31,18,13,"January, 2000"
1999-2000,20,2000-01-15,Middlesbrough,Derby,1,4,A,0,3,2,3,0,1,3,1,13,17,27,19,4,8,January,0.4999999999999999,0.8660254037844387,29,17,2,1,2,2.4,1.4,23,26,-3,19,32,-13,"January, 2000"
1999-2000,20,2000-01-15,Sheffield Weds,Bradford,2,0,H,3,0,1,1,3,3,1,1,20,18,10,18,2,8,January,0.4999999999999999,0.8660254037844387,37,8,0,1,0,1.0,1.0,17,46,-29,16,31,-15,"January, 2000"
1999-2000,20,2000-01-15,Coventry,Wimbledon,2,0,H,3,0,2,0,3,0,1,4,13,14,25,25,1,0,January,0.4999999999999999,0.8660254037844387,15,47,2,2,1,1.2,1.0,28,24,4,32,35,-3,"January, 2000"
1999-2000,20,2000-01-15,Arsenal,Sunderland,4,1,H,3,0,3,1,1,2,1,2,3,4,40,38,1,2,January,0.4999999999999999,0.8660254037844387,0,40,1,1,1,0.6666666666666666,0.3333333333333333,37,21,16,35,25,10,"January, 2000"
1999-2000,20,2000-01-15,Everton,Tottenham,2,2,D,1,1,1,2,2,3,1,1,9,7,29,34,2,5,January,0.4999999999999999,0.8660254037844387,18,42,0,1,4,0.8,2.2,35,30,5,32,24,8,"January, 2000"
1999-2000,20,2000-01-15,Chelsea,Leicester,1,1,D,1,1,2,1,2,3,1,1,6,8,35,30,2,5,January,0.4999999999999999,0.8660254037844387,14,24,2,2,1,1.8,1.6,30,21,9,30,30,0,"January, 2000"
1999-2000,20,2000-01-16,Newcastle,Southampton,5,0,H,3,0,2,3,0,1,1,3,15,17,24,20,2,4,January,0.4999999999999999,0.8660254037844387,30,38,2,0,3,2.0,1.8,34,37,-3,24,32,-8,"January, 2000"
1999-2000,21,2000-01-22,Tottenham,Sheffield Weds,0,1,A,0,3,3,1,1,1,1,3,7,20,35,13,13,22,January,0.4999999999999999,0.8660254037844387,42,37,2,1,2,1.0,1.4,34,26,8,19,46,-27,"January, 2000"
1999-2000,21,2000-01-22,Wimbledon,Newcastle,2,0,H,3,0,0,1,4,2,3,0,15,14,25,27,1,2,January,0.4999999999999999,0.8660254037844387,47,30,1,3,1,1.6,1.6,32,37,-5,39,37,2,"January, 2000"
1999-2000,21,2000-01-22,Liverpool,Middlesbrough,0,0,D,1,1,0,2,3,2,3,0,4,14,40,27,10,13,January,0.4999999999999999,0.8660254037844387,25,29,3,1,1,2.8,1.4,34,20,14,24,30,-6,"January, 2000"
1999-2000,21,2000-01-22,Southampton,Everton,2,0,H,3,0,1,1,3,1,2,2,18,11,20,30,7,10,January,0.4999999999999999,0.8660254037844387,38,18,3,0,2,1.4,1.2,24,37,-13,37,32,5,"January, 2000"
1999-2000,21,2000-01-22,Derby,Coventry,0,0,D,1,1,1,3,1,2,0,3,16,12,22,28,4,6,January,0.4999999999999999,0.8660254037844387,17,15,1,2,2,0.8,1.0,23,33,-10,30,24,6,"January, 2000"
1999-2000,21,2000-01-22,Bradford,Watford,3,2,H,3,0,3,1,1,1,1,3,18,19,18,14,1,4,January,0.4999999999999999,0.8660254037844387,8,43,0,0,1,0.0,1.0,16,33,-17,19,47,-28,"January, 2000"
1999-2000,21,2000-01-22,Aston Villa,Chelsea,0,0,D,1,1,1,3,1,2,1,2,10,6,30,36,4,6,January,0.4999999999999999,0.8660254037844387,1,14,1,0,4,0.4,1.6,22,23,-1,31,22,9,"January, 2000"
1999-2000,21,2000-01-22,Leicester,West Ham,1,3,A,0,3,3,1,1,1,1,3,8,12,31,29,4,2,January,0.4999999999999999,0.8660254037844387,24,45,1,1,3,1.6,2.0,31,31,0,25,24,1,"January, 2000"
1999-2000,21,2000-01-23,Sunderland,Leeds,1,2,A,0,3,2,1,2,2,3,0,5,1,38,44,4,6,January,0.4999999999999999,0.8660254037844387,40,23,0,0,3,0.3333333333333333,2.0,36,29,7,35,24,11,"January, 2000"
1999-2000,21,2000-01-24,Man United,Arsenal,1,1,D,1,1,5,0,0,3,1,1,2,3,43,43,1,0,January,0.4999999999999999,0.8660254037844387,28,0,1,1,3,1.0,1.8,50,25,25,41,22,19,"January, 2000"
1999-2000,21,2000-01-29,Man United,Middlesbrough,1,0,H,3,0,5,0,0,2,3,0,2,14,44,28,12,16,January,0.4999999999999999,0.8660254037844387,28,29,2,2,1,2.2,1.6,51,26,25,24,30,-6,"January, 2000"
1999-2000,21,2000-02-02,Sheffield Weds,Man United,0,1,A,0,3,1,1,3,5,0,0,19,1,16,47,18,31,February,0.8660254037844386,0.5000000000000001,37,28,2,0,3,1.2,2.8,20,46,-26,52,26,26,"February, 2000"
1999-2000,22,2000-02-05,Man United,Coventry,3,2,H,3,0,5,0,0,2,0,3,1,12,50,29,11,21,February,0.8660254037844386,0.5000000000000001,28,15,4,0,1,2.0,0.8,53,26,27,30,24,6,"February, 2000"
1999-2000,22,2000-02-05,Sunderland,Newcastle,2,2,D,1,1,2,1,2,2,3,0,5,15,38,27,10,11,February,0.8660254037844386,0.5000000000000001,40,30,1,1,1,1.3333333333333333,1.3333333333333333,37,31,6,39,39,0,"February, 2000"
1999-2000,22,2000-02-05,Southampton,West Ham,2,1,H,3,0,1,1,3,1,1,3,18,10,23,32,8,9,February,0.8660254037844386,0.5000000000000001,38,45,4,0,1,2.0,0.6,26,37,-11,28,25,3,"February, 2000"
1999-2000,22,2000-02-05,Tottenham,Chelsea,0,1,A,0,3,3,1,1,2,1,2,7,6,35,37,1,2,February,0.8660254037844386,0.5000000000000001,42,14,0,1,4,0.6,2.6,34,27,7,31,22,9,"February, 2000"
1999-2000,22,2000-02-05,Liverpool,Leeds,3,1,H,3,0,0,2,3,2,3,0,4,2,41,47,2,6,February,0.8660254037844386,0.5000000000000001,25,23,3,1,1,1.6,1.0,34,20,14,37,25,12,"February, 2000"
1999-2000,22,2000-02-05,Derby,Sheffield Weds,3,3,D,1,1,1,3,1,1,1,3,17,19,23,16,2,7,February,0.8660254037844386,0.5000000000000001,17,37,5,0,0,2.4,0.4,23,33,-10,20,47,-27,"February, 2000"
1999-2000,22,2000-02-05,Bradford,Arsenal,2,1,H,3,0,3,1,1,3,1,1,18,3,21,44,15,23,February,0.8660254037844386,0.5000000000000001,8,0,0,0,1,0.0,2.0,19,35,-16,42,23,19,"February, 2000"
1999-2000,22,2000-02-05,Aston Villa,Watford,4,0,H,3,0,1,3,1,1,1,3,9,20,31,14,11,17,February,0.8660254037844386,0.5000000000000001,1,43,1,0,0,1.0,0.0,22,23,-1,21,50,-29,"February, 2000"
1999-2000,22,2000-02-05,Leicester,Middlesbrough,2,1,H,3,0,3,1,1,2,3,0,10,14,31,28,4,3,February,0.8660254037844386,0.5000000000000001,24,29,2,1,2,1.2,0.8,32,34,-2,24,31,-7,"February, 2000"
1999-2000,22,2000-02-06,Wimbledon,Everton,0,3,A,0,3,0,1,4,1,2,2,14,11,28,30,3,2,February,0.8660254037844386,0.5000000000000001,47,18,0,3,2,0.4,1.4,34,37,-3,37,34,3,"February, 2000"
1999-2000,23,2000-02-12,West Ham,Bradford,5,4,H,3,0,1,1,3,3,1,1,12,18,32,24,6,8,February,0.8660254037844386,0.5000000000000001,45,8,1,0,0,3.0,0.0,29,27,2,21,36,-15,"February, 2000"
1999-2000,23,2000-02-12,Watford,Leicester,1,1,D,1,1,1,1,3,3,1,1,20,10,14,34,10,20,February,0.8660254037844386,0.5000000000000001,43,24,0,0,1,0.0,1.0,21,54,-33,34,35,-1,"February, 2000"
1999-2000,23,2000-02-12,Newcastle,Man United,3,0,H,3,0,2,3,0,5,0,0,13,1,28,53,12,25,February,0.8660254037844386,0.5000000000000001,30,28,0,2,3,0.6,1.8,41,41,0,56,28,28,"February, 2000"
1999-2000,23,2000-02-12,Sheffield Weds,Southampton,0,1,A,0,3,1,1,3,1,1,3,19,16,17,26,3,9,February,0.8660254037844386,0.5000000000000001,37,38,2,1,2,0.8,1.0,23,50,-27,28,38,-10,"February, 2000"
1999-2000,23,2000-02-12,Everton,Derby,2,1,H,3,0,1,2,2,1,3,1,10,17,33,24,7,9,February,0.8660254037844386,0.5000000000000001,18,17,0,1,4,0.6,1.6,40,34,6,26,36,-10,"February, 2000"
1999-2000,23,2000-02-12,Coventry,Sunderland,3,2,H,3,0,2,0,3,2,1,2,12,6,29,39,6,10,February,0.8660254037844386,0.5000000000000001,15,40,0,2,1,1.0,1.3333333333333333,32,27,5,39,33,6,"February, 2000"
1999-2000,23,2000-02-12,Chelsea,Wimbledon,3,1,H,3,0,2,1,2,0,1,4,5,14,40,28,9,12,February,0.8660254037844386,0.5000000000000001,14,47,4,1,0,1.8,0.4,32,22,10,34,40,-6,"February, 2000"
1999-2000,23,2000-02-12,Leeds,Tottenham,1,0,H,3,0,2,3,0,3,1,1,2,8,47,35,6,12,February,0.8660254037844386,0.5000000000000001,23,42,4,1,0,1.8,0.8,38,28,10,34,28,6,"February, 2000"
1999-2000,23,2000-02-13,Arsenal,Liverpool,0,1,A,0,3,3,1,1,0,2,3,3,4,44,44,1,0,February,0.8660254037844386,0.5000000000000001,0,25,0,2,3,0.0,1.4,43,25,18,37,21,16,"February, 2000"
1999-2000,23,2000-02-14,Middlesbrough,Aston Villa,0,4,A,0,3,2,3,0,1,3,1,16,11,28,34,5,6,February,0.8660254037844386,0.5000000000000001,29,1,1,1,3,0.8,1.4,25,33,-8,26,23,3,"February, 2000"
1999-2000,23,2000-02-19,Middlesbrough,Coventry,2,0,H,3,0,2,3,0,2,0,3,16,12,28,32,4,4,February,0.8660254037844386,0.5000000000000001,29,15,3,1,1,1.6,0.8,25,37,-12,35,29,6,"February, 2000"
1999-2000,23,2000-02-20,Leeds,Man United,0,1,A,0,3,2,3,0,5,0,0,2,1,50,53,1,3,February,0.8660254037844386,0.5000000000000001,23,28,1,1,3,0.8,1.8,39,28,11,56,31,25,"February, 2000"
1999-2000,24,2000-02-26,Sheffield Weds,Newcastle,0,2,A,0,3,1,1,3,2,3,0,19,14,17,31,5,14,February,0.8660254037844386,0.5000000000000001,37,30,1,2,2,1.0,2.6,23,51,-28,44,41,3,"February, 2000"
1999-2000,24,2000-02-26,Wimbledon,Man United,2,2,D,1,1,0,1,4,5,0,0,16,1,28,56,15,28,February,0.8660254037844386,0.5000000000000001,47,28,0,2,3,1.0,2.8,35,43,-8,57,31,26,"February, 2000"
1999-2000,24,2000-02-26,West Ham,Everton,0,4,A,0,3,1,1,3,1,2,2,10,9,35,36,1,1,February,0.8660254037844386,0.5000000000000001,45,18,1,1,3,1.0,2.4,34,31,3,42,35,7,"February, 2000"
1999-2000,24,2000-02-26,Middlesbrough,Leeds,0,0,D,1,1,2,3,0,2,3,0,14,2,31,50,12,19,February,0.8660254037844386,0.5000000000000001,29,23,0,3,2,0.2,1.0,27,37,-10,39,29,10,"February, 2000"
1999-2000,24,2000-02-26,Sunderland,Derby,1,1,D,1,1,2,1,2,1,3,1,6,18,39,24,12,15,February,0.8660254037844386,0.5000000000000001,40,17,2,0,1,2.333333333333333,0.3333333333333333,41,36,5,27,38,-11,"February, 2000"
1999-2000,24,2000-02-26,Chelsea,Watford,2,1,H,3,0,2,1,2,1,1,3,5,20,43,15,15,28,February,0.8660254037844386,0.5000000000000001,14,43,0,0,1,0.0,1.0,35,23,12,22,55,-33,"February, 2000"
1999-2000,24,2000-02-26,Bradford,Aston Villa,1,1,D,1,1,3,1,1,1,3,1,18,7,24,37,11,13,February,0.8660254037844386,0.5000000000000001,8,1,0,0,1,0.0,1.0,25,41,-16,30,23,7,"February, 2000"
1999-2000,24,2000-02-26,Arsenal,Southampton,3,1,H,3,0,3,1,1,1,1,3,4,15,44,29,11,15,February,0.8660254037844386,0.5000000000000001,0,38,3,2,0,1.6,0.4,43,26,17,29,38,-9,"February, 2000"
1999-2000,24,2000-02-26,Coventry,Tottenham,0,1,A,0,3,2,0,3,3,1,1,12,9,32,35,3,3,February,0.8660254037844386,0.5000000000000001,15,42,1,3,1,1.6,1.0,35,31,4,34,29,5,"February, 2000"
1999-2000,25,2000-03-04,Watford,West Ham,1,2,A,0,3,1,1,3,1,1,3,20,11,15,35,9,20,March,1.0,6.123233995736766e-17,43,45,0,0,1,0.0,1.0,23,57,-34,34,35,-1,"March, 2000"
1999-2000,25,2000-03-04,Tottenham,Bradford,1,1,D,1,1,3,1,1,3,1,1,9,18,38,25,9,13,March,1.0,6.123233995736766e-17,42,8,0,1,0,1.0,1.0,35,29,6,26,42,-16,"March, 2000"
1999-2000,25,2000-03-04,Southampton,Middlesbrough,1,1,D,1,1,1,1,3,2,3,0,15,14,29,32,1,3,March,1.0,6.123233995736766e-17,38,29,2,1,2,2.0,1.8,30,41,-11,27,37,-10,"March, 2000"
1999-2000,25,2000-03-04,Derby,Wimbledon,4,0,H,3,0,1,3,1,0,1,4,17,15,25,29,2,4,March,1.0,6.123233995736766e-17,17,47,0,4,1,0.8,1.0,28,39,-11,37,45,-8,"March, 2000"
1999-2000,25,2000-03-04,Man United,Liverpool,1,1,D,1,1,5,0,0,0,2,3,1,4,57,47,3,10,March,1.0,6.123233995736766e-17,28,25,3,2,0,2.2,1.2,59,33,26,38,21,17,"March, 2000"
1999-2000,25,2000-03-04,Everton,Sheffield Weds,1,1,D,1,1,1,2,2,1,1,3,7,19,39,17,12,22,March,1.0,6.123233995736766e-17,18,37,1,1,3,1.0,1.6,46,35,11,23,53,-30,"March, 2000"
1999-2000,25,2000-03-04,Newcastle,Chelsea,0,1,A,0,3,2,3,0,2,1,2,12,5,34,46,7,12,March,1.0,6.123233995736766e-17,30,14,1,1,3,0.8,1.0,46,41,5,37,24,13,"March, 2000"
1999-2000,25,2000-03-05,Aston Villa,Arsenal,1,1,D,1,1,1,3,1,3,1,1,9,5,38,47,4,9,March,1.0,6.123233995736766e-17,1,0,2,1,2,1.0,1.2,31,24,7,46,27,19,"March, 2000"
1999-2000,25,2000-03-05,Leeds,Coventry,3,0,H,3,0,2,3,0,2,0,3,2,14,51,32,12,19,March,1.0,6.123233995736766e-17,23,15,2,3,0,2.2,1.6,39,29,10,35,32,3,"March, 2000"
1999-2000,25,2000-03-05,Leicester,Sunderland,5,2,H,3,0,3,1,1,2,1,2,11,7,35,40,4,5,March,1.0,6.123233995736766e-17,24,40,0,2,1,0.3333333333333333,1.0,35,36,-1,42,37,5,"March, 2000"
1999-2000,25,2000-03-08,West Ham,Southampton,2,0,H,3,0,1,1,3,1,1,3,11,15,38,30,4,8,March,1.0,6.123233995736766e-17,45,38,1,0,4,0.8,2.0,36,36,0,31,42,-11,"March, 2000"
1999-2000,26,2000-03-11,Wimbledon,Leicester,2,1,H,3,0,0,1,4,3,1,1,16,11,29,38,5,9,March,1.0,6.123233995736766e-17,47,24,2,1,2,1.0,1.0,37,49,-12,40,38,2,"March, 2000"
1999-2000,26,2000-03-11,Tottenham,Southampton,7,2,H,3,0,3,1,1,1,1,3,10,15,39,30,5,9,March,1.0,6.123233995736766e-17,42,38,2,2,1,1.6,1.0,36,30,6,31,44,-13,"March, 2000"
1999-2000,26,2000-03-11,Sheffield Weds,West Ham,3,1,H,3,0,1,1,3,1,1,3,19,9,18,41,10,23,March,1.0,6.123233995736766e-17,37,45,1,1,3,1.6,1.4,24,54,-30,38,36,2,"March, 2000"
1999-2000,26,2000-03-11,Newcastle,Watford,1,0,H,3,0,2,3,0,1,1,3,12,20,34,15,8,19,March,1.0,6.123233995736766e-17,30,43,0,1,0,1.0,1.0,46,42,4,24,59,-35,"March, 2000"
1999-2000,26,2000-03-11,Man United,Derby,3,1,H,3,0,5,0,0,1,3,1,1,17,58,28,16,30,March,1.0,6.123233995736766e-17,28,17,3,2,0,1.6,0.8,60,34,26,32,39,-7,"March, 2000"
1999-2000,26,2000-03-11,Liverpool,Sunderland,1,1,D,1,1,0,2,3,2,1,2,5,9,48,40,4,8,March,1.0,6.123233995736766e-17,25,40,2,1,0,1.3333333333333333,0.3333333333333333,39,22,17,44,42,2,"March, 2000"
1999-2000,26,2000-03-11,Chelsea,Everton,1,1,D,1,1,2,1,2,1,2,2,3,8,49,40,5,9,March,1.0,6.123233995736766e-17,14,18,2,2,1,1.4,1.0,38,24,14,47,36,11,"March, 2000"
1999-2000,26,2000-03-11,Aston Villa,Coventry,1,0,H,3,0,1,3,1,2,0,3,9,14,39,32,5,7,March,1.0,6.123233995736766e-17,1,15,3,0,2,1.8,1.6,32,25,7,35,35,0,"March, 2000"
1999-2000,26,2000-03-12,Bradford,Leeds,1,2,A,0,3,3,1,1,2,3,0,18,2,26,54,16,28,March,1.0,6.123233995736766e-17,8,23,0,0,1,1.0,2.0,27,43,-16,42,29,13,"March, 2000"
1999-2000,26,2000-03-12,Middlesbrough,Arsenal,2,1,H,3,0,2,3,0,3,1,1,13,5,33,48,8,15,March,1.0,6.123233995736766e-17,29,0,0,1,4,0.6,3.2,28,38,-10,47,28,19,"March, 2000"
1999-2000,26,2000-03-15,Coventry,Everton,1,0,H,3,0,2,0,3,1,2,2,14,8,32,41,6,9,March,1.0,6.123233995736766e-17,15,18,1,3,1,1.0,0.8,35,36,-1,48,37,11,"March, 2000"
1999-2000,26,2000-03-15,Liverpool,Aston Villa,0,0,D,1,1,0,2,3,1,3,1,4,7,49,42,3,7,March,1.0,6.123233995736766e-17,25,1,2,1,2,1.6,1.0,40,23,17,33,25,8,"March, 2000"
1999-2000,27,2000-03-18,West Ham,Chelsea,0,0,D,1,1,1,1,3,2,1,2,10,4,41,50,6,9,March,1.0,6.123233995736766e-17,45,14,2,2,1,1.0,0.8,39,39,0,39,25,14,"March, 2000"
1999-2000,27,2000-03-18,Watford,Sheffield Weds,1,0,H,3,0,1,1,3,1,1,3,20,19,15,21,1,6,March,1.0,6.123233995736766e-17,43,37,0,1,0,2.0,2.0,24,60,-36,27,55,-28,"March, 2000"
1999-2000,27,2000-03-18,Sunderland,Middlesbrough,1,1,D,1,1,2,1,2,2,3,0,9,14,41,36,5,5,March,1.0,6.123233995736766e-17,40,29,1,2,0,1.3333333333333333,1.0,45,43,2,30,39,-9,"March, 2000"
1999-2000,27,2000-03-18,Derby,Liverpool,0,2,A,0,3,1,3,1,0,2,3,17,3,28,50,14,22,March,1.0,6.123233995736766e-17,17,25,3,0,2,1.2,1.8,33,42,-9,40,23,17,"March, 2000"
1999-2000,27,2000-03-18,Leicester,Man United,0,2,A,0,3,3,1,1,5,0,0,12,1,38,61,11,23,March,1.0,6.123233995736766e-17,24,28,1,2,2,1.0,2.0,41,40,1,63,35,28,"March, 2000"
1999-2000,27,2000-03-18,Coventry,Bradford,4,0,H,3,0,2,0,3,3,1,1,14,18,35,26,4,9,March,1.0,6.123233995736766e-17,15,8,0,1,0,1.0,1.0,36,36,0,28,45,-17,"March, 2000"
1999-2000,27,2000-03-18,Southampton,Aston Villa,2,0,H,3,0,1,1,3,1,3,1,16,6,30,43,10,13,March,1.0,6.123233995736766e-17,38,1,1,1,3,0.8,2.0,33,51,-18,33,25,8,"March, 2000"
1999-2000,27,2000-03-19,Arsenal,Tottenham,2,1,H,3,0,3,1,1,3,1,1,5,7,48,42,2,6,March,1.0,6.123233995736766e-17,0,42,1,3,1,1.0,0.8,48,30,18,43,32,11,"March, 2000"
1999-2000,27,2000-03-19,Everton,Newcastle,0,2,A,0,3,1,2,2,2,3,0,10,13,41,37,3,4,March,1.0,6.123233995736766e-17,18,30,2,2,1,1.0,0.6,48,38,10,47,42,5,"March, 2000"
1999-2000,27,2000-03-19,Leeds,Wimbledon,4,1,H,3,0,2,3,0,0,1,4,2,16,57,32,14,25,March,1.0,6.123233995736766e-17,23,47,0,3,2,0.8,1.4,44,30,14,39,50,-11,"March, 2000"
1999-2000,28,2000-03-25,Watford,Tottenham,1,1,D,1,1,1,1,3,3,1,1,20,8,18,42,12,24,March,1.0,6.123233995736766e-17,43,42,0,0,1,0.0,4.0,25,60,-35,44,34,10,"March, 2000"
1999-2000,28,2000-03-25,Sunderland,Everton,2,1,H,3,0,2,1,2,1,2,2,8,10,42,41,2,1,March,1.0,6.123233995736766e-17,40,18,2,0,1,2.0,2.0,46,44,2,48,40,8,"March, 2000"
1999-2000,28,2000-03-25,Middlesbrough,Sheffield Weds,1,0,H,3,0,2,3,0,1,1,3,14,19,37,21,5,16,March,1.0,6.123233995736766e-17,29,37,2,0,3,2.0,1.8,31,40,-9,27,56,-29,"March, 2000"
1999-2000,28,2000-03-25,Liverpool,Newcastle,2,1,H,3,0,0,2,3,2,3,0,3,11,53,40,8,13,March,1.0,6.123233995736766e-17,25,30,4,1,0,2.6,1.2,42,23,19,49,42,7,"March, 2000"
1999-2000,28,2000-03-25,Bradford,Man United,0,4,A,0,3,3,1,1,5,0,0,18,1,26,64,17,38,March,1.0,6.123233995736766e-17,8,28,0,0,1,0.0,4.0,28,49,-21,65,35,30,"March, 2000"
1999-2000,28,2000-03-25,Aston Villa,Derby,2,0,H,3,0,1,3,1,1,3,1,6,17,43,28,11,15,March,1.0,6.123233995736766e-17,1,17,4,0,1,1.4,0.6,33,27,6,33,44,-11,"March, 2000"
1999-2000,28,2000-03-25,Chelsea,Southampton,1,1,D,1,1,2,1,2,1,1,3,5,15,51,33,10,18,March,1.0,6.123233995736766e-17,14,38,4,0,1,1.8,0.8,39,25,14,35,51,-16,"March, 2000"
1999-2000,28,2000-03-26,Arsenal,Coventry,3,0,H,3,0,3,1,1,2,0,3,5,13,51,38,8,13,March,1.0,6.123233995736766e-17,0,15,3,1,1,1.8,1.0,50,31,19,40,36,4,"March, 2000"
1999-2000,28,2000-03-26,Leicester,Leeds,2,1,H,3,0,3,1,1,2,3,0,14,2,38,60,12,22,March,1.0,6.123233995736766e-17,24,23,3,0,2,1.0,0.8,41,42,-1,48,31,17,"March, 2000"
1999-2000,28,2000-03-26,West Ham,Wimbledon,2,1,H,3,0,1,1,3,0,1,4,9,16,42,32,7,10,March,1.0,6.123233995736766e-17,45,47,2,2,1,2.0,1.6,39,39,0,40,54,-14,"March, 2000"
1999-2000,29,2000-04-01,Southampton,Sunderland,1,2,A,0,3,1,1,3,2,1,2,15,7,34,45,8,11,April,0.8660254037844388,-0.4999999999999998,38,40,2,0,1,1.3333333333333333,0.6666666666666666,36,52,-16,48,45,3,"April, 2000"
1999-2000,29,2000-04-01,Wimbledon,Arsenal,1,3,A,0,3,0,1,4,3,1,1,16,5,32,54,11,22,April,0.8660254037844388,-0.4999999999999998,47,0,1,1,3,0.6,2.4,41,56,-15,53,31,22,"April, 2000"
1999-2000,29,2000-04-01,Man United,West Ham,7,1,H,3,0,5,0,0,1,1,3,1,8,67,45,7,22,April,0.8660254037844388,-0.4999999999999998,28,45,3,2,0,2.2,1.0,69,35,34,41,40,1,"April, 2000"
1999-2000,29,2000-04-01,Newcastle,Bradford,2,0,H,3,0,2,3,0,3,1,1,12,18,40,26,6,14,April,0.8660254037844388,-0.4999999999999998,30,8,0,0,1,0.0,2.0,50,44,6,28,53,-25,"April, 2000"
1999-2000,29,2000-04-01,Leeds,Chelsea,0,1,A,0,3,2,3,0,2,1,2,2,5,60,52,3,8,April,0.8660254037844388,-0.4999999999999998,23,14,2,2,1,1.0,0.4,49,33,16,40,26,14,"April, 2000"
1999-2000,29,2000-04-01,Everton,Watford,4,2,H,3,0,1,2,2,1,1,3,10,20,41,19,10,22,April,0.8660254037844388,-0.4999999999999998,18,43,1,0,0,3.0,1.0,49,42,7,26,61,-35,"April, 2000"
1999-2000,29,2000-04-01,Coventry,Liverpool,0,3,A,0,3,2,0,3,0,2,3,14,3,38,56,11,18,April,0.8660254037844388,-0.4999999999999998,15,25,1,1,3,0.6,1.4,40,39,1,44,24,20,"April, 2000"
1999-2000,29,2000-04-02,Derby,Leicester,3,0,H,3,0,1,3,1,3,1,1,17,12,28,41,5,13,April,0.8660254037844388,-0.4999999999999998,17,24,4,0,1,1.4,1.2,33,46,-13,43,43,0,"April, 2000"
1999-2000,29,2000-04-03,Tottenham,Middlesbrough,2,3,A,0,3,3,1,1,2,3,0,10,13,43,40,3,3,April,0.8660254037844388,-0.4999999999999998,42,29,2,1,2,1.0,1.0,45,35,10,32,40,-8,"April, 2000"
1999-2000,29,2000-04-05,Sheffield Weds,Aston Villa,0,1,A,0,3,1,1,3,1,3,1,19,7,21,46,12,25,April,0.8660254037844388,-0.4999999999999998,37,1,0,1,4,1.0,2.0,27,57,-30,35,27,8,"April, 2000"
1999-2000,30,2000-04-08,Sunderland,Wimbledon,2,1,H,3,0,2,1,2,0,1,4,7,16,48,32,9,16,April,0.8660254037844388,-0.4999999999999998,40,47,0,0,3,0.3333333333333333,1.6666666666666667,50,46,4,42,59,-17,"April, 2000"
1999-2000,30,2000-04-08,Watford,Derby,0,0,D,1,1,1,1,3,1,3,1,20,17,19,31,3,12,April,0.8660254037844388,-0.4999999999999998,43,17,0,0,1,0.0,2.0,28,65,-37,36,46,-10,"April, 2000"
1999-2000,30,2000-04-08,Bradford,Southampton,1,2,A,0,3,3,1,1,1,1,3,18,15,26,34,3,8,April,0.8660254037844388,-0.4999999999999998,8,38,0,0,1,0.0,1.0,28,55,-27,37,54,-17,"April, 2000"
1999-2000,30,2000-04-08,Leicester,Everton,1,1,D,1,1,3,1,1,1,2,2,13,9,41,44,4,3,April,0.8660254037844388,-0.4999999999999998,24,18,1,3,1,1.0,0.8,43,46,-3,53,44,9,"April, 2000"
1999-2000,30,2000-04-09,Aston Villa,Leeds,1,0,H,3,0,1,3,1,2,3,0,7,2,49,60,5,11,April,0.8660254037844388,-0.4999999999999998,1,23,2,2,1,1.0,0.8,36,27,9,49,34,15,"April, 2000"
1999-2000,30,2000-04-09,Liverpool,Tottenham,2,0,H,3,0,0,2,3,3,1,1,3,10,59,43,7,16,April,0.8660254037844388,-0.4999999999999998,25,42,2,1,2,2.2,1.6,47,24,23,47,38,9,"April, 2000"
1999-2000,30,2000-04-10,Middlesbrough,Man United,3,4,A,0,3,2,3,0,5,0,0,12,1,43,70,11,27,April,0.8660254037844388,-0.4999999999999998,29,28,1,2,2,1.6,1.8,35,42,-7,76,36,40,"April, 2000"
1999-2000,31,2000-04-12,Chelsea,Coventry,2,1,H,3,0,2,1,2,2,0,3,5,14,55,38,9,17,April,0.8660254037844388,-0.4999999999999998,14,15,2,1,2,2.0,1.8,41,26,15,40,42,-2,"April, 2000"
1999-2000,31,2000-04-12,West Ham,Newcastle,2,1,H,3,0,1,1,3,2,3,0,9,10,45,43,1,2,April,0.8660254037844388,-0.4999999999999998,45,30,3,1,1,1.6,0.6,42,47,-5,52,44,8,"April, 2000"
1999-2000,31,2000-04-12,Wimbledon,Sheffield Weds,0,2,A,0,3,0,1,4,1,1,3,17,19,32,21,2,11,April,0.8660254037844388,-0.4999999999999998,47,37,2,2,1,1.4,1.8,43,61,-18,27,58,-31,"April, 2000"
1999-2000,32,2000-04-15,Southampton,Watford,2,0,H,3,0,1,1,3,1,1,3,15,20,37,20,5,17,April,0.8660254037844388,-0.4999999999999998,38,43,0,0,1,2.0,3.0,39,55,-16,28,65,-37,"April, 2000"
1999-2000,32,2000-04-15,Tottenham,Aston Villa,2,4,A,0,3,3,1,1,1,3,1,11,6,43,52,5,9,April,0.8660254037844388,-0.4999999999999998,42,1,2,1,2,1.6,2.0,47,40,7,37,27,10,"April, 2000"
1999-2000,32,2000-04-15,Sheffield Weds,Chelsea,1,0,H,3,0,1,1,3,2,1,2,19,4,24,58,15,34,April,0.8660254037844388,-0.4999999999999998,37,14,0,2,3,0.4,1.8,29,58,-29,43,27,16,"April, 2000"
1999-2000,32,2000-04-15,Newcastle,Leicester,0,2,A,0,3,2,3,0,3,1,1,10,13,43,42,3,1,April,0.8660254037844388,-0.4999999999999998,30,24,2,2,1,1.2,1.2,53,46,7,44,47,-3,"April, 2000"
1999-2000,32,2000-04-15,Everton,Bradford,4,0,H,3,0,1,2,2,3,1,1,9,18,45,26,9,19,April,0.8660254037844388,-0.4999999999999998,18,8,0,1,0,0.0,0.0,54,45,9,29,57,-28,"April, 2000"
1999-2000,32,2000-04-15,Derby,West Ham,1,2,A,0,3,1,3,1,1,1,3,16,8,32,48,8,16,April,0.8660254037844388,-0.4999999999999998,17,45,1,2,2,0.8,1.6,36,46,-10,44,48,-4,"April, 2000"
1999-2000,32,2000-04-15,Coventry,Middlesbrough,2,1,H,3,0,2,0,3,2,3,0,14,12,38,43,2,5,April,0.8660254037844388,-0.4999999999999998,15,29,1,0,4,0.8,2.0,41,44,-3,38,46,-8,"April, 2000"
1999-2000,32,2000-04-15,Man United,Sunderland,4,0,H,3,0,5,0,0,2,1,2,1,7,73,51,6,22,April,0.8660254037844388,-0.4999999999999998,28,40,1,1,1,2.6666666666666665,1.3333333333333333,80,39,41,52,47,5,"April, 2000"
1999-2000,32,2000-04-16,Leeds,Arsenal,0,4,A,0,3,2,3,0,3,1,1,3,5,60,57,2,3,April,0.8660254037844388,-0.4999999999999998,23,0,1,1,3,0.8,1.6,49,35,14,56,32,24,"April, 2000"
1999-2000,32,2000-04-16,Wimbledon,Liverpool,1,2,A,0,3,0,1,4,0,2,3,17,2,32,62,15,30,April,0.8660254037844388,-0.4999999999999998,47,25,1,1,3,0.6,1.8,43,63,-20,49,24,25,"April, 2000"
1999-2000,32,2000-04-19,Leicester,Tottenham,0,1,A,0,3,3,1,1,3,1,1,10,12,45,43,2,2,April,0.8660254037844388,-0.4999999999999998,24,42,4,1,0,2.2,0.8,46,47,-1,49,44,5,"April, 2000"
1999-2000,33,2000-04-21,Everton,Liverpool,0,0,D,1,1,1,2,2,0,2,3,9,2,48,65,7,17,April,0.8660254037844388,-0.4999999999999998,18,25,2,2,1,1.2,0.8,58,45,13,51,25,26,"April, 2000"
1999-2000,33,2000-04-21,Bradford,Derby,4,4,D,1,1,3,1,1,1,3,1,19,16,26,32,3,6,April,0.8660254037844388,-0.4999999999999998,8,17,1,0,0,1.0,0.0,29,61,-32,37,48,-11,"April, 2000"
1999-2000,33,2000-04-22,West Ham,Coventry,5,0,H,3,0,1,1,3,2,0,3,8,14,51,41,6,10,April,0.8660254037844388,-0.4999999999999998,45,15,2,2,1,0.8,0.4,46,49,-3,43,45,-2,"April, 2000"
1999-2000,33,2000-04-22,Tottenham,Wimbledon,2,0,H,3,0,3,1,1,0,1,4,10,17,46,32,7,14,April,0.8660254037844388,-0.4999999999999998,42,47,1,3,1,1.6,1.2,50,44,6,44,65,-21,"April, 2000"
1999-2000,33,2000-04-22,Southampton,Man United,1,3,A,0,3,1,1,3,5,0,0,15,1,40,76,14,36,April,0.8660254037844388,-0.4999999999999998,38,28,1,1,3,1.0,1.8,41,55,-14,84,39,45,"April, 2000"
1999-2000,33,2000-04-22,Chelsea,Middlesbrough,1,1,D,1,1,2,1,2,2,3,0,5,13,58,43,8,15,April,0.8660254037844388,-0.4999999999999998,14,29,3,1,1,0.8,0.2,43,28,15,39,48,-9,"April, 2000"
1999-2000,33,2000-04-22,Aston Villa,Leicester,2,2,D,1,1,1,3,1,3,1,1,6,11,55,45,5,10,April,0.8660254037844388,-0.4999999999999998,1,24,0,3,2,1.0,1.6,41,29,12,46,48,-2,"April, 2000"
1999-2000,33,2000-04-22,Sheffield Weds,Sunderland,0,2,A,0,3,1,1,3,2,1,2,18,7,27,51,11,24,April,0.8660254037844388,-0.4999999999999998,37,40,1,1,1,1.0,1.0,30,58,-28,52,51,1,"April, 2000"
1999-2000,33,2000-04-23,Watford,Arsenal,2,3,A,0,3,1,1,3,3,1,1,20,4,20,60,16,40,April,0.8660254037844388,-0.4999999999999998,43,0,0,0,1,0.0,1.0,28,67,-39,60,32,28,"April, 2000"
1999-2000,33,2000-04-23,Newcastle,Leeds,2,2,D,1,1,2,3,0,2,3,0,13,4,43,60,9,17,April,0.8660254037844388,-0.4999999999999998,30,23,1,1,3,1.0,2.2,53,48,5,49,39,10,"April, 2000"
1999-2000,33,2000-04-24,Man United,Chelsea,3,2,H,3,0,5,0,0,2,1,2,1,5,79,59,4,20,April,0.8660254037844388,-0.4999999999999998,28,14,1,3,1,0.8,1.6,87,40,47,44,29,15,"April, 2000"
1999-2000,33,2000-04-24,Sunderland,Bradford,0,1,A,0,3,2,1,2,3,1,1,7,19,54,27,12,27,April,0.8660254037844388,-0.4999999999999998,40,8,1,0,0,4.0,0.0,54,51,3,33,65,-32,"April, 2000"
1999-2000,33,2000-04-24,Derby,Southampton,2,0,H,3,0,1,3,1,1,1,3,16,15,33,40,1,7,April,0.8660254037844388,-0.4999999999999998,17,38,3,2,0,2.0,0.6,41,52,-11,42,58,-16,"April, 2000"
1999-2000,34,2000-04-29,Watford,Man United,2,3,A,0,3,1,1,3,5,0,0,20,1,20,82,19,62,April,0.8660254037844388,-0.4999999999999998,43,28,0,0,1,1.0,4.0,30,70,-40,90,42,48,"April, 2000"
1999-2000,34,2000-04-29,Tottenham,Derby,1,1,D,1,1,3,1,1,1,3,1,10,16,49,36,6,13,April,0.8660254037844388,-0.4999999999999998,42,17,3,1,1,1.0,0.6,52,44,8,43,52,-9,"April, 2000"
1999-2000,34,2000-04-29,West Ham,Middlesbrough,0,1,A,0,3,1,1,3,2,3,0,8,13,54,44,5,10,April,0.8660254037844388,-0.4999999999999998,45,29,1,1,3,1.0,1.4,51,49,2,40,49,-9,"April, 2000"
1999-2000,34,2000-04-29,Southampton,Leicester,1,2,A,0,3,1,1,3,3,1,1,15,12,40,46,3,6,April,0.8660254037844388,-0.4999999999999998,38,24,2,1,2,1.6,1.8,42,60,-18,48,50,-2,"April, 2000"
1999-2000,34,2000-04-29,Chelsea,Liverpool,2,0,H,3,0,2,1,2,0,2,3,5,2,59,66,3,7,April,0.8660254037844388,-0.4999999999999998,14,25,2,1,2,1.8,1.6,46,32,14,51,25,26,"April, 2000"
1999-2000,34,2000-04-29,Everton,Arsenal,0,1,A,0,3,1,2,2,3,1,1,9,3,49,63,6,14,April,0.8660254037844388,-0.4999999999999998,18,0,0,1,4,0.6,2.6,58,45,13,63,34,29,"April, 2000"
1999-2000,34,2000-04-29,Newcastle,Coventry,2,0,H,3,0,2,3,0,2,0,3,12,14,44,41,2,3,April,0.8660254037844388,-0.4999999999999998,30,15,2,2,1,2.4,1.6,55,50,5,43,50,-7,"April, 2000"
1999-2000,34,2000-04-29,Aston Villa,Sunderland,1,1,D,1,1,1,3,1,2,1,2,6,7,56,54,1,2,April,0.8660254037844388,-0.4999999999999998,1,40,1,0,2,0.6666666666666666,1.0,43,31,12,54,52,2,"April, 2000"
1999-2000,34,2000-04-30,Bradford,Wimbledon,3,0,H,3,0,3,1,1,0,1,4,18,17,30,32,1,2,April,0.8660254037844388,-0.4999999999999998,8,47,0,0,1,2.0,3.0,34,65,-31,44,67,-23,"April, 2000"
1999-2000,34,2000-04-30,Sheffield Weds,Leeds,0,3,A,0,3,1,1,3,2,3,0,19,5,27,61,14,34,April,0.8660254037844388,-0.4999999999999998,37,23,1,0,4,0.8,2.0,30,60,-30,51,41,10,"April, 2000"
1999-2000,35,2000-05-02,Arsenal,West Ham,2,1,H,3,0,3,1,1,1,1,3,2,8,66,54,6,12,May,0.4999999999999999,-0.8660254037844387,0,45,3,1,1,2.0,0.4,64,34,30,51,50,1,"May, 2000"
1999-2000,35,2000-05-02,Middlesbrough,Newcastle,2,2,D,1,1,2,3,0,2,3,0,13,12,47,47,1,0,May,0.4999999999999999,-0.8660254037844387,29,30,0,2,3,1.0,1.8,41,49,-8,57,50,7,"May, 2000"
1999-2000,35,2000-05-03,Leeds,Watford,3,1,H,3,0,2,3,0,1,1,3,4,20,64,20,16,44,May,0.4999999999999999,-0.8660254037844387,23,43,1,0,0,2.0,1.0,54,41,13,32,73,-41,"May, 2000"
1999-2000,35,2000-05-03,Liverpool,Leicester,0,2,A,0,3,0,2,3,3,1,1,4,11,66,49,7,17,May,0.4999999999999999,-0.8660254037844387,25,24,0,2,3,0.6,1.2,51,27,24,50,51,-1,"May, 2000"
1999-2000,36,2000-05-06,Wimbledon,Aston Villa,2,2,D,1,1,0,1,4,1,3,1,18,7,32,57,11,25,May,0.4999999999999999,-0.8660254037844387,47,1,2,2,1,1.0,1.0,44,70,-26,44,32,12,"May, 2000"
1999-2000,36,2000-05-06,Sunderland,West Ham,1,0,H,3,0,2,1,2,1,1,3,8,9,55,54,1,1,May,0.4999999999999999,-0.8660254037844387,40,45,0,2,1,0.3333333333333333,1.0,55,53,2,52,52,0,"May, 2000"
1999-2000,36,2000-05-06,Middlesbrough,Watford,1,1,D,1,1,2,3,0,1,1,3,13,20,48,20,7,28,May,0.4999999999999999,-0.8660254037844387,29,43,1,0,0,3.0,1.0,43,51,-8,33,76,-43,"May, 2000"
1999-2000,36,2000-05-06,Man United,Tottenham,3,1,H,3,0,5,0,0,3,1,1,1,10,85,50,9,35,May,0.4999999999999999,-0.8660254037844387,28,42,3,1,1,1.8,1.2,93,44,49,53,45,8,"May, 2000"
1999-2000,36,2000-05-06,Arsenal,Chelsea,2,1,H,3,0,3,1,1,2,1,2,2,5,69,62,3,7,May,0.4999999999999999,-0.8660254037844387,0,14,4,1,0,1.8,0.8,66,35,31,48,32,16,"May, 2000"
1999-2000,36,2000-05-06,Derby,Newcastle,0,0,D,1,1,1,3,1,2,3,0,16,12,37,48,4,11,May,0.4999999999999999,-0.8660254037844387,17,30,1,1,3,1.0,1.6,44,53,-9,59,52,7,"May, 2000"
1999-2000,36,2000-05-06,Coventry,Sheffield Weds,4,1,H,3,0,2,0,3,1,1,3,14,19,41,27,5,14,May,0.4999999999999999,-0.8660254037844387,15,37,3,2,0,0.8,0.2,43,52,-9,30,63,-33,"May, 2000"
1999-2000,36,2000-05-06,Leicester,Bradford,3,0,H,3,0,3,1,1,3,1,1,9,17,52,33,8,19,May,0.4999999999999999,-0.8660254037844387,24,8,0,0,1,1.0,3.0,52,51,1,37,65,-28,"May, 2000"
1999-2000,36,2000-05-07,Liverpool,Southampton,0,0,D,1,1,0,2,3,1,1,3,4,15,66,40,11,26,May,0.4999999999999999,-0.8660254037844387,25,38,2,2,1,2.6,1.4,51,29,22,43,62,-19,"May, 2000"
1999-2000,36,2000-05-08,Leeds,Everton,1,1,D,1,1,2,3,0,1,2,2,4,11,67,49,7,18,May,0.4999999999999999,-0.8660254037844387,23,18,1,3,1,1.0,1.2,57,42,15,58,46,12,"May, 2000"
1999-2000,36,2000-05-09,Arsenal,Sheffield Weds,3,3,D,1,1,3,1,1,1,1,3,2,19,72,27,17,45,May,0.4999999999999999,-0.8660254037844387,0,37,2,1,2,1.0,0.8,68,36,32,31,67,-36,"May, 2000"
1999-2000,37,2000-05-14,Aston Villa,Man United,0,1,A,0,3,1,3,1,5,0,0,6,1,58,88,5,30,May,0.4999999999999999,-0.8660254037844387,1,28,0,1,4,0.4,1.8,46,34,12,96,45,51,"May, 2000"
1999-2000,37,2000-05-14,Watford,Coventry,1,0,H,3,0,1,1,3,2,0,3,20,14,21,44,6,23,May,0.4999999999999999,-0.8660254037844387,43,15,0,0,1,0.0,4.0,34,77,-43,47,53,-6,"May, 2000"
1999-2000,37,2000-05-14,Tottenham,Sunderland,3,1,H,3,0,3,1,1,2,1,2,13,7,50,58,6,8,May,0.4999999999999999,-0.8660254037844387,42,40,2,0,1,2.333333333333333,0.6666666666666666,54,48,6,56,53,3,"May, 2000"
1999-2000,37,2000-05-14,Southampton,Wimbledon,2,0,H,3,0,1,1,3,0,1,4,15,18,41,33,3,8,May,0.4999999999999999,-0.8660254037844387,38,47,2,1,2,1.2,0.8,43,62,-19,46,72,-26,"May, 2000"
1999-2000,37,2000-05-14,Sheffield Weds,Leicester,4,0,H,3,0,1,1,3,3,1,1,19,8,28,55,11,27,May,0.4999999999999999,-0.8660254037844387,37,24,2,1,2,0.8,1.0,34,70,-36,55,51,4,"May, 2000"
1999-2000,37,2000-05-14,West Ham,Leeds,0,0,D,1,1,1,1,3,2,3,0,9,3,54,68,6,14,May,0.4999999999999999,-0.8660254037844387,45,23,1,0,4,1.0,2.6,52,53,-1,58,43,15,"May, 2000"
1999-2000,37,2000-05-14,Everton,Middlesbrough,0,2,A,0,3,1,2,2,2,3,0,10,13,50,49,3,1,May,0.4999999999999999,-0.8660254037844387,18,29,1,1,3,2.2,2.0,59,47,12,44,52,-8,"May, 2000"
1999-2000,37,2000-05-14,Chelsea,Derby,4,0,H,3,0,2,1,2,1,3,1,5,16,62,38,11,24,May,0.4999999999999999,-0.8660254037844387,14,17,3,1,1,2.0,1.2,49,34,15,44,53,-9,"May, 2000"
1999-2000,37,2000-05-14,Bradford,Liverpool,1,0,H,3,0,3,1,1,0,2,3,18,4,33,67,14,34,May,0.4999999999999999,-0.8660254037844387,8,25,0,0,1,1.0,3.0,37,68,-31,51,29,22,"May, 2000"
1999-2000,37,2000-05-14,Newcastle,Arsenal,4,2,H,3,0,2,3,0,3,1,1,13,2,49,73,11,24,May,0.4999999999999999,-0.8660254037844387,30,0,0,2,3,0.4,1.6,59,52,7,71,39,32,"May, 2000"
2000-2001,1,2000-08-19,Tottenham,Ipswich,3,1,H,3,0,1,1,3,3,1,1,14,11,0,0,3,0,August,-0.8660254037844384,-0.5000000000000004,42,22,0,0,0,0.0,0.0,0,0,0,0,0,0,"August, 2000"
2000-2001,1,2000-08-19,Charlton,Man City,4,0,H,3,0,2,1,2,2,1,2,4,13,0,0,9,0,August,-0.8660254037844384,-0.5000000000000004,13,27,0,0,0,0.0,0.0,0,0,0,0,0,0,"August, 2000"
2000-2001,1,2000-08-19,Chelsea,West Ham,4,2,H,3,0,2,1,2,1,0,4,5,19,0,0,14,0,August,-0.8660254037844384,-0.5000000000000004,14,45,0,3,2,0.4,0.8,0,0,0,0,0,0,"August, 2000"
2000-2001,1,2000-08-19,Coventry,Middlesbrough,1,3,A,0,3,1,1,3,2,1,2,6,14,0,0,8,0,August,-0.8660254037844384,-0.5000000000000004,15,29,2,0,3,1.2,1.4,0,0,0,0,0,0,"August, 2000"
2000-2001,1,2000-08-19,Derby,Southampton,2,2,D,1,1,2,1,2,2,1,2,7,15,0,0,8,0,August,-0.8660254037844384,-0.5000000000000004,17,38,3,2,0,1.6,0.6,0,0,0,0,0,0,"August, 2000"
2000-2001,1,2000-08-19,Leeds,Everton,2,0,H,3,0,4,0,1,1,1,3,11,9,0,0,2,0,August,-0.8660254037844384,-0.5000000000000004,23,18,1,3,1,1.2,1.4,0,0,0,0,0,0,"August, 2000"
2000-2001,1,2000-08-19,Leicester,Aston Villa,0,0,D,1,1,1,0,4,1,3,1,11,8,0,0,3,0,August,-0.8660254037844384,-0.5000000000000004,24,1,1,4,0,1.8,1.4,0,0,0,0,0,0,"August, 2000"
2000-2001,1,2000-08-19,Liverpool,Bradford,1,0,H,3,0,4,1,0,0,2,3,12,10,0,0,2,0,August,-0.8660254037844384,-0.5000000000000004,25,8,1,0,1,1.5,1.0,0,0,0,0,0,0,"August, 2000"
2000-2001,1,2000-08-19,Sunderland,Arsenal,1,0,H,3,0,2,2,1,3,1,1,14,10,0,0,4,0,August,-0.8660254037844384,-0.5000000000000004,40,0,1,1,2,0.5,1.5,0,0,0,0,0,0,"August, 2000"
2000-2001,1,2000-08-20,Man United,Newcastle,2,0,H,3,0,1,1,3,2,2,1,12,13,0,0,1,0,August,-0.8660254037844384,-0.5000000000000004,28,30,2,2,1,1.6,1.2,0,0,0,0,0,0,"August, 2000"
2000-2001,1,2000-08-21,Arsenal,Liverpool,2,0,H,3,0,3,1,1,4,1,0,13,7,0,3,6,3,August,-0.8660254037844384,-0.5000000000000004,0,25,0,2,3,0.0,1.4,0,1,-1,1,0,1,"August, 2000"
2000-2001,1,2000-08-22,Bradford,Chelsea,2,0,H,3,0,0,2,3,2,1,2,14,2,0,3,12,3,August,-0.8660254037844384,-0.5000000000000004,8,14,0,1,1,0.5,1.0,0,1,-1,4,2,2,"August, 2000"
2000-2001,1,2000-08-22,Ipswich,Man United,1,1,D,1,1,3,1,1,1,1,3,17,5,0,3,12,3,August,-0.8660254037844384,-0.5000000000000004,22,28,0,0,0,0.0,0.0,1,3,-2,2,0,2,"August, 2000"
2000-2001,1,2000-08-22,Middlesbrough,Tottenham,1,1,D,1,1,2,1,2,1,1,3,3,4,3,3,1,0,August,-0.8660254037844384,-0.5000000000000004,29,42,3,1,1,1.6,0.8,3,1,2,3,1,2,"August, 2000"
2000-2001,1,2000-08-23,Everton,Charlton,3,0,H,3,0,1,1,3,2,1,2,18,4,0,3,14,3,August,-0.8660254037844384,-0.5000000000000004,18,13,2,0,0,3.0,1.0,0,2,-2,4,0,4,"August, 2000"
2000-2001,1,2000-08-23,Man City,Sunderland,4,2,H,3,0,2,1,2,2,2,1,20,9,0,3,11,3,August,-0.8660254037844384,-0.5000000000000004,27,40,0,0,0,0.0,0.0,0,4,-4,1,0,1,"August, 2000"
2000-2001,1,2000-08-23,Newcastle,Derby,3,2,H,3,0,2,2,1,2,1,2,20,13,0,1,7,1,August,-0.8660254037844384,-0.5000000000000004,30,17,3,1,1,1.6,1.0,0,2,-2,2,2,0,"August, 2000"
2000-2001,1,2000-08-23,Southampton,Coventry,1,2,A,0,3,2,1,2,1,1,3,14,20,1,0,6,1,August,-0.8660254037844384,-0.5000000000000004,38,15,2,1,2,0.8,0.8,2,2,0,1,3,-2,"August, 2000"
2000-2001,1,2000-08-23,West Ham,Leicester,0,1,A,0,3,1,0,4,1,0,4,20,16,0,1,4,1,August,-0.8660254037844384,-0.5000000000000004,45,24,4,1,0,2.4,1.4,2,4,-2,0,0,0,"August, 2000"
2000-2001,2,2000-08-26,West Ham,Man United,2,2,D,1,1,1,0,4,1,1,3,20,6,0,4,14,4,August,-0.8660254037844384,-0.5000000000000004,45,28,0,2,3,1.0,3.2,2,5,-3,3,1,2,"August, 2000"
2000-2001,2,2000-08-26,Southampton,Liverpool,3,3,D,1,1,2,1,2,4,1,0,19,14,1,3,5,2,August,-0.8660254037844384,-0.5000000000000004,38,25,1,2,2,1.2,2.4,3,4,-1,1,2,-1,"August, 2000"
2000-2001,2,2000-08-26,Newcastle,Tottenham,2,0,H,3,0,2,2,1,1,1,3,13,5,3,4,8,1,August,-0.8660254037844384,-0.5000000000000004,30,42,1,1,3,0.8,1.8,3,4,-1,4,2,2,"August, 2000"
2000-2001,2,2000-08-26,Middlesbrough,Leeds,1,2,A,0,3,2,1,2,4,0,1,4,10,4,3,6,1,August,-0.8660254037844384,-0.5000000000000004,29,23,0,3,2,0.2,1.0,4,2,2,2,0,2,"August, 2000"
2000-2001,2,2000-08-26,Bradford,Leicester,0,0,D,1,1,0,2,3,1,0,4,8,5,3,4,3,1,August,-0.8660254037844384,-0.5000000000000004,8,24,1,0,1,1.5,2.0,2,1,1,1,0,1,"August, 2000"
2000-2001,2,2000-08-26,Ipswich,Sunderland,1,0,H,3,0,3,1,1,2,2,1,19,13,1,3,6,2,August,-0.8660254037844384,-0.5000000000000004,22,40,0,0,0,0.0,0.0,2,4,-2,3,4,-1,"August, 2000"
2000-2001,2,2000-08-26,Everton,Derby,2,2,D,1,1,1,1,3,2,1,2,8,17,3,1,9,2,August,-0.8660254037844384,-0.5000000000000004,18,17,1,1,3,0.8,1.2,3,2,1,4,5,-1,"August, 2000"
2000-2001,2,2000-08-26,Arsenal,Charlton,5,3,H,3,0,3,1,1,2,1,2,8,6,3,3,2,0,August,-0.8660254037844384,-0.5000000000000004,0,13,1,1,0,0.5,0.0,2,1,1,4,3,1,"August, 2000"
2000-2001,2,2000-08-26,Man City,Coventry,1,2,A,0,3,2,1,2,1,1,3,15,12,3,3,3,0,August,-0.8660254037844384,-0.5000000000000004,27,15,0,1,1,1.0,1.5,4,6,-2,3,4,-1,"August, 2000"
2000-2001,2,2000-08-27,Aston Villa,Chelsea,1,1,D,1,1,1,3,1,2,1,2,19,13,1,3,6,2,August,-0.8660254037844384,-0.5000000000000004,1,14,1,1,3,0.4,1.2,0,0,0,4,4,0,"August, 2000"
2000-2001,3,2000-09-05,Tottenham,Everton,3,2,H,3,0,1,1,3,1,1,3,11,8,4,4,3,0,September,-1.0,-1.8369701987210287e-16,42,18,3,2,0,2.2,1.2,4,4,0,5,4,1,"September, 2000"
2000-2001,3,2000-09-05,Sunderland,West Ham,1,1,D,1,1,2,2,1,1,0,4,16,20,3,1,4,2,September,-1.0,-1.8369701987210287e-16,40,45,1,2,1,0.5,0.75,3,5,-2,4,7,-3,"September, 2000"
2000-2001,3,2000-09-05,Leeds,Man City,1,2,A,0,3,4,0,1,2,1,2,2,16,6,3,14,3,September,-1.0,-1.8369701987210287e-16,23,27,0,1,1,0.0,0.5,4,1,3,5,8,-3,"September, 2000"
2000-2001,3,2000-09-05,Man United,Bradford,6,0,H,3,0,1,1,3,0,2,3,6,10,5,4,4,1,September,-1.0,-1.8369701987210287e-16,28,8,2,0,0,4.0,0.0,5,3,2,2,1,1,"September, 2000"
2000-2001,3,2000-09-06,Charlton,Southampton,1,1,D,1,1,2,1,2,2,1,2,16,19,3,2,3,1,September,-1.0,-1.8369701987210287e-16,13,38,1,0,1,3.0,1.5,7,8,-1,6,7,-1,"September, 2000"
2000-2001,3,2000-09-06,Chelsea,Arsenal,2,2,D,1,1,2,1,2,3,1,1,11,3,4,6,8,2,September,-1.0,-1.8369701987210287e-16,14,0,0,1,4,0.6,1.6,5,5,0,7,4,3,"September, 2000"
2000-2001,3,2000-09-06,Coventry,Newcastle,0,2,A,0,3,1,1,3,2,2,1,6,5,6,6,1,0,September,-1.0,-1.8369701987210287e-16,15,30,1,1,3,1.2,2.4,5,5,0,5,4,1,"September, 2000"
2000-2001,3,2000-09-06,Derby,Middlesbrough,3,3,D,1,1,2,1,2,2,1,2,19,10,2,4,9,2,September,-1.0,-1.8369701987210287e-16,17,29,2,1,2,1.8,2.4,6,7,-1,5,4,1,"September, 2000"
2000-2001,3,2000-09-06,Leicester,Ipswich,2,1,H,3,0,1,0,4,3,1,1,9,14,5,4,5,1,September,-1.0,-1.8369701987210287e-16,24,22,0,0,0,0.0,0.0,1,0,1,3,4,-1,"September, 2000"
2000-2001,3,2000-09-06,Liverpool,Aston Villa,3,1,H,3,0,4,1,0,1,3,1,13,19,4,2,6,2,September,-1.0,-1.8369701987210287e-16,25,1,1,2,2,1.0,1.0,4,5,-1,1,1,0,"September, 2000"
2000-2001,4,2000-09-09,Ipswich,Aston Villa,1,2,A,0,3,3,1,1,1,3,1,15,19,4,2,4,2,September,-1.0,-1.8369701987210287e-16,22,1,0,0,0,0.0,0.0,4,6,-2,2,4,-2,"September, 2000"
2000-2001,4,2000-09-09,Newcastle,Chelsea,0,0,D,1,1,2,2,1,2,1,2,4,12,9,5,8,4,September,-1.0,-1.8369701987210287e-16,30,14,1,1,3,0.8,1.0,7,4,3,7,7,0,"September, 2000"
2000-2001,4,2000-09-09,Middlesbrough,Everton,1,2,A,0,3,2,1,2,1,1,3,10,14,5,4,4,1,September,-1.0,-1.8369701987210287e-16,29,18,3,1,1,2.0,2.0,8,7,1,7,7,0,"September, 2000"
2000-2001,4,2000-09-09,Man United,Sunderland,3,0,H,3,0,1,1,3,2,2,1,4,16,8,4,12,4,September,-1.0,-1.8369701987210287e-16,28,40,2,1,1,3.0,1.0,11,3,8,4,6,-2,"September, 2000"
2000-2001,4,2000-09-09,Bradford,Arsenal,1,1,D,1,1,0,2,3,3,1,1,16,4,4,7,12,3,September,-1.0,-1.8369701987210287e-16,8,0,1,0,1,1.0,1.5,2,7,-5,9,6,3,"September, 2000"
2000-2001,4,2000-09-09,Leicester,Southampton,1,0,H,3,0,1,0,4,2,1,2,4,19,8,3,15,5,September,-1.0,-1.8369701987210287e-16,24,38,3,1,1,2.0,1.4,3,1,2,7,8,-1,"September, 2000"
2000-2001,4,2000-09-09,Coventry,Leeds,0,0,D,1,1,1,1,3,4,0,1,9,7,6,6,2,0,September,-1.0,-1.8369701987210287e-16,15,23,0,2,3,1.6,2.8,5,7,-2,5,3,2,"September, 2000"
2000-2001,4,2000-09-09,Liverpool,Man City,3,2,H,3,0,4,1,0,2,1,2,6,9,7,6,3,1,September,-1.0,-1.8369701987210287e-16,25,27,1,1,0,4.0,1.0,7,6,1,7,9,-2,"September, 2000"
2000-2001,4,2000-09-10,Derby,Charlton,2,2,D,1,1,2,1,2,2,1,2,18,15,3,4,3,1,September,-1.0,-1.8369701987210287e-16,17,13,1,0,1,1.0,1.5,9,10,-1,8,9,-1,"September, 2000"
2000-2001,4,2000-09-11,Tottenham,West Ham,1,0,H,3,0,1,1,3,1,0,4,8,20,7,2,12,5,September,-1.0,-1.8369701987210287e-16,42,45,1,1,3,0.6,1.0,7,6,1,5,8,-3,"September, 2000"
2000-2001,5,2000-09-16,Leeds,Ipswich,1,2,A,0,3,4,0,1,3,1,1,9,17,7,4,8,3,September,-1.0,-1.8369701987210287e-16,23,22,0,0,0,0.0,0.0,5,3,2,5,8,-3,"September, 2000"
2000-2001,5,2000-09-16,Sunderland,Derby,2,1,H,3,0,2,2,1,2,1,2,19,18,4,4,1,0,September,-1.0,-1.8369701987210287e-16,40,17,2,1,1,2.0,0.5,4,9,-5,11,12,-1,"September, 2000"
2000-2001,5,2000-09-16,Everton,Man United,1,3,A,0,3,1,1,3,1,1,3,10,1,7,11,9,4,September,-1.0,-1.8369701987210287e-16,18,28,0,1,4,0.8,3.0,9,8,1,14,3,11,"September, 2000"
2000-2001,5,2000-09-16,Southampton,Newcastle,2,0,H,3,0,2,1,2,2,2,1,19,4,3,10,15,7,September,-1.0,-1.8369701987210287e-16,38,30,3,0,2,1.6,2.6,7,9,-2,7,4,3,"September, 2000"
2000-2001,5,2000-09-16,Aston Villa,Bradford,2,0,H,3,0,1,3,1,0,2,3,14,15,5,5,1,0,September,-1.0,-1.8369701987210287e-16,1,8,1,1,0,1.0,0.5,4,5,-1,3,8,-5,"September, 2000"
2000-2001,5,2000-09-16,Arsenal,Coventry,2,1,H,3,0,3,1,1,1,1,3,6,9,8,7,3,1,September,-1.0,-1.8369701987210287e-16,0,15,3,1,1,2.0,1.0,10,7,3,5,7,-2,"September, 2000"
2000-2001,5,2000-09-16,Charlton,Tottenham,1,0,H,3,0,2,1,2,1,1,3,14,6,5,10,8,5,September,-1.0,-1.8369701987210287e-16,13,42,0,1,1,1.5,3.0,10,11,-1,8,6,2,"September, 2000"
2000-2001,5,2000-09-17,Chelsea,Leicester,0,2,A,0,3,2,1,2,1,0,4,15,3,6,11,12,5,September,-1.0,-1.8369701987210287e-16,14,24,1,3,1,1.8,1.8,7,7,0,4,1,3,"September, 2000"
2000-2001,5,2000-09-17,Man City,Middlesbrough,1,1,D,1,1,2,1,2,2,1,2,16,17,6,5,1,1,September,-1.0,-1.8369701987210287e-16,27,29,0,0,2,0.5,2.5,9,12,-3,9,9,0,"September, 2000"
2000-2001,5,2000-09-17,West Ham,Liverpool,1,1,D,1,1,1,0,4,4,1,0,20,4,2,10,16,8,September,-1.0,-1.8369701987210287e-16,45,25,2,1,2,1.0,1.8,5,9,-4,10,8,2,"September, 2000"
2000-2001,6,2000-09-23,Tottenham,Man City,0,0,D,1,1,1,1,3,2,1,2,6,16,10,7,10,3,September,-1.0,-1.8369701987210287e-16,42,27,1,1,0,1.0,0.5,8,7,1,10,13,-3,"September, 2000"
2000-2001,6,2000-09-23,Newcastle,Charlton,0,1,A,0,3,2,2,1,2,1,2,6,10,10,8,4,2,September,-1.0,-1.8369701987210287e-16,30,13,0,2,0,1.0,1.0,7,6,1,11,11,0,"September, 2000"
2000-2001,6,2000-09-23,Middlesbrough,Aston Villa,1,1,D,1,1,2,1,2,1,3,1,17,9,6,8,8,2,September,-1.0,-1.8369701987210287e-16,29,1,1,1,3,0.8,2.0,10,10,0,6,5,1,"September, 2000"
2000-2001,6,2000-09-23,Man United,Chelsea,3,3,D,1,1,1,1,3,2,1,2,1,18,14,6,17,8,September,-1.0,-1.8369701987210287e-16,28,14,2,2,1,1.0,1.6,17,4,13,7,9,-2,"September, 2000"
2000-2001,6,2000-09-23,Ipswich,Arsenal,1,1,D,1,1,3,1,1,3,1,1,12,3,7,11,9,4,September,-1.0,-1.8369701987210287e-16,22,0,0,0,0,0.0,0.0,7,9,-2,12,8,4,"September, 2000"
2000-2001,6,2000-09-23,Derby,Leeds,1,1,D,1,1,2,1,2,4,0,1,20,10,4,7,10,3,September,-1.0,-1.8369701987210287e-16,17,23,0,2,3,0.6,2.4,12,14,-2,6,5,1,"September, 2000"
2000-2001,6,2000-09-23,Coventry,West Ham,0,3,A,0,3,1,1,3,1,0,4,14,20,7,3,6,4,September,-1.0,-1.8369701987210287e-16,15,45,1,1,3,0.2,1.6,6,9,-3,6,10,-4,"September, 2000"
2000-2001,6,2000-09-23,Bradford,Southampton,0,1,A,0,3,0,2,3,2,1,2,18,16,5,6,2,1,September,-1.0,-1.8369701987210287e-16,8,38,0,0,2,0.5,1.5,3,10,-7,9,9,0,"September, 2000"
2000-2001,6,2000-09-23,Liverpool,Sunderland,1,1,D,1,1,4,1,0,2,2,1,4,14,11,7,10,4,September,-1.0,-1.8369701987210287e-16,25,40,2,2,0,1.25,0.5,11,9,2,6,10,-4,"September, 2000"
2000-2001,6,2000-09-24,Leicester,Everton,1,1,D,1,1,1,0,4,1,1,3,2,15,14,7,13,7,September,-1.0,-1.8369701987210287e-16,24,18,1,4,0,1.2,0.8,6,1,5,10,11,-1,"September, 2000"
2000-2001,7,2000-09-30,Man City,Newcastle,0,1,A,0,3,2,1,2,2,2,1,12,10,8,10,2,2,September,-1.0,-1.8369701987210287e-16,27,30,0,1,1,2.0,3.0,10,13,-3,7,7,0,"September, 2000"
2000-2001,7,2000-09-30,West Ham,Bradford,1,1,D,1,1,1,0,4,0,2,3,18,20,6,5,2,1,September,-1.0,-1.8369701987210287e-16,45,8,2,0,0,4.0,2.0,9,10,-1,3,11,-8,"September, 2000"
2000-2001,7,2000-09-30,Leeds,Tottenham,4,3,H,3,0,4,0,1,1,1,3,11,8,8,11,3,3,September,-1.0,-1.8369701987210287e-16,23,42,4,1,0,1.8,0.8,7,6,1,8,7,1,"September, 2000"
2000-2001,7,2000-09-30,Southampton,Middlesbrough,1,3,A,0,3,2,1,2,2,1,2,11,16,9,7,5,2,September,-1.0,-1.8369701987210287e-16,38,29,1,2,2,1.4,2.0,10,9,1,11,11,0,"September, 2000"
2000-2001,7,2000-09-30,Charlton,Coventry,2,2,D,1,1,2,1,2,1,1,3,6,17,11,7,11,4,September,-1.0,-1.8369701987210287e-16,13,15,0,1,1,1.0,1.5,12,11,1,6,12,-6,"September, 2000"
2000-2001,7,2000-09-30,Aston Villa,Derby,4,1,H,3,0,1,3,1,2,1,2,9,19,9,5,10,4,September,-1.0,-1.8369701987210287e-16,1,17,4,0,1,1.4,0.4,7,6,1,13,15,-2,"September, 2000"
2000-2001,7,2000-09-30,Everton,Ipswich,0,3,A,0,3,1,1,3,3,1,1,11,12,8,8,1,0,September,-1.0,-1.8369701987210287e-16,18,22,0,0,0,0.0,0.0,11,12,-1,8,10,-2,"September, 2000"
2000-2001,7,2000-10-01,Arsenal,Man United,1,0,H,3,0,3,1,1,1,1,3,4,1,12,15,3,3,October,-0.8660254037844386,0.5,0,28,2,2,1,1.4,0.8,13,9,4,20,7,13,"October, 2000"
2000-2001,7,2000-10-01,Chelsea,Liverpool,3,0,H,3,0,2,1,2,4,1,0,18,6,7,12,12,5,October,-0.8660254037844386,0.5,14,25,3,1,1,1.8,0.8,10,12,-2,12,10,2,"October, 2000"
2000-2001,8,2000-10-01,Sunderland,Leicester,0,0,D,1,1,2,2,1,1,0,4,16,3,8,15,13,7,October,-0.8660254037844386,0.5,40,24,1,2,1,1.25,1.5,7,11,-4,7,2,5,"October, 2000"
2000-2001,8,2000-10-14,Sunderland,Chelsea,1,0,H,3,0,2,2,1,2,1,2,17,14,9,10,3,1,October,-0.8660254037844386,0.5,40,14,2,0,2,2.25,2.75,7,11,-4,13,12,1,"October, 2000"
2000-2001,8,2000-10-14,Man City,Bradford,2,0,H,3,0,2,1,2,0,2,3,18,19,8,6,1,2,October,-0.8660254037844386,0.5,27,8,0,0,0,0.0,0.0,10,14,-4,4,12,-8,"October, 2000"
2000-2001,8,2000-10-14,Leeds,Charlton,3,1,H,3,0,4,0,1,2,1,2,9,6,11,12,3,1,October,-0.8660254037844386,0.5,23,13,1,1,0,2.5,1.0,11,9,2,14,13,1,"October, 2000"
2000-2001,8,2000-10-14,Leicester,Man United,0,3,A,0,3,1,0,4,1,1,3,2,3,16,15,1,1,October,-0.8660254037844386,0.5,24,28,1,1,3,1.0,2.4,7,2,5,20,8,12,"October, 2000"
2000-2001,8,2000-10-14,Everton,Southampton,1,1,D,1,1,1,1,3,2,1,2,16,14,8,9,2,1,October,-0.8660254037844386,0.5,18,38,2,0,3,1.2,1.4,11,15,-4,11,12,-1,"October, 2000"
2000-2001,8,2000-10-14,Coventry,Tottenham,2,1,H,3,0,1,1,3,1,1,3,17,10,8,11,7,3,October,-0.8660254037844386,0.5,15,42,0,3,2,0.8,1.2,8,14,-6,11,11,0,"October, 2000"
2000-2001,8,2000-10-14,Arsenal,Aston Villa,1,0,H,3,0,3,1,1,1,3,1,3,5,15,12,2,3,October,-0.8660254037844386,0.5,0,1,2,1,2,1.4,1.2,14,9,5,11,7,4,"October, 2000"
2000-2001,8,2000-10-14,Ipswich,West Ham,1,1,D,1,1,3,1,1,1,0,4,9,18,11,7,9,4,October,-0.8660254037844386,0.5,22,45,0,0,0,0.0,0.0,11,10,1,10,11,-1,"October, 2000"
2000-2001,8,2000-10-15,Derby,Liverpool,0,4,A,0,3,2,1,2,4,1,0,20,9,5,12,11,7,October,-0.8660254037844386,0.5,17,25,3,0,2,1.2,1.4,14,19,-5,12,13,-1,"October, 2000"
2000-2001,8,2000-10-16,Middlesbrough,Newcastle,1,3,A,0,3,2,1,2,2,2,1,14,6,10,13,8,3,October,-0.8660254037844386,0.5,29,30,0,3,2,1.2,1.6,14,12,2,8,7,1,"October, 2000"
2000-2001,9,2000-10-21,Tottenham,Derby,3,1,H,3,0,1,1,3,2,1,2,13,20,11,5,7,6,October,-0.8660254037844386,0.5,42,17,2,2,1,1.0,0.8,12,13,-1,14,23,-9,"October, 2000"
2000-2001,9,2000-10-21,Bradford,Ipswich,0,2,A,0,3,0,2,3,3,1,1,19,8,6,12,11,6,October,-0.8660254037844386,0.5,8,22,0,0,0,0.0,0.0,4,14,-10,12,11,1,"October, 2000"
2000-2001,9,2000-10-21,Charlton,Middlesbrough,1,0,H,3,0,2,1,2,2,1,2,9,14,12,10,5,2,October,-0.8660254037844386,0.5,13,29,0,1,1,0.5,1.5,15,16,-1,15,15,0,"October, 2000"
2000-2001,9,2000-10-21,Chelsea,Coventry,6,1,H,3,0,2,1,2,1,1,3,14,13,10,11,1,1,October,-0.8660254037844386,0.5,14,15,3,1,1,2.0,1.4,13,13,0,10,15,-5,"October, 2000"
2000-2001,9,2000-10-21,Liverpool,Leicester,1,0,H,3,0,4,1,0,1,0,4,5,4,15,16,1,1,October,-0.8660254037844386,0.5,25,24,0,2,3,0.4,1.2,16,13,3,7,5,2,"October, 2000"
2000-2001,9,2000-10-21,Man United,Leeds,3,0,H,3,0,1,1,3,4,0,1,1,8,18,14,7,4,October,-0.8660254037844386,0.5,28,23,4,1,0,2.0,0.6,23,8,15,14,10,4,"October, 2000"
2000-2001,9,2000-10-21,Newcastle,Everton,0,1,A,0,3,2,2,1,1,1,3,4,17,16,9,13,7,October,-0.8660254037844386,0.5,30,18,1,2,2,0.8,1.0,11,8,3,12,16,-4,"October, 2000"
2000-2001,9,2000-10-21,West Ham,Arsenal,1,2,A,0,3,1,0,4,3,1,1,18,2,8,18,16,10,October,-0.8660254037844386,0.5,45,0,1,1,3,0.6,1.6,11,12,-1,15,9,6,"October, 2000"
2000-2001,9,2000-10-22,Aston Villa,Sunderland,0,0,D,1,1,1,3,1,2,2,1,11,13,12,12,2,0,October,-0.8660254037844386,0.5,1,40,1,1,2,0.75,1.0,11,8,3,8,11,-3,"October, 2000"
2000-2001,9,2000-10-23,Southampton,Man City,0,2,A,0,3,2,1,2,2,1,2,17,14,10,11,3,1,October,-0.8660254037844386,0.5,38,27,0,1,1,1.0,1.5,12,13,-1,12,14,-2,"October, 2000"
2000-2001,10,2000-10-28,Arsenal,Man City,5,0,H,3,0,3,1,1,2,1,2,2,10,21,14,8,7,October,-0.8660254037844386,0.5,0,27,2,0,0,2.0,0.5,17,10,7,14,14,0,"October, 2000"
2000-2001,10,2000-10-28,Aston Villa,Charlton,2,1,H,3,0,1,3,1,2,1,2,12,7,13,15,5,2,October,-0.8660254037844386,0.5,1,13,1,0,1,2.0,2.0,11,8,3,16,16,0,"October, 2000"
2000-2001,10,2000-10-28,Chelsea,Tottenham,3,0,H,3,0,2,1,2,1,1,3,12,9,13,14,3,1,October,-0.8660254037844386,0.5,14,42,4,1,0,1.6,0.4,19,14,5,15,14,1,"October, 2000"
2000-2001,10,2000-10-28,Ipswich,Middlesbrough,2,1,H,3,0,3,1,1,2,1,2,8,16,15,10,8,5,October,-0.8660254037844386,0.5,22,29,0,0,0,0.0,0.0,14,11,3,15,16,-1,"October, 2000"
2000-2001,10,2000-10-28,Leicester,Derby,2,1,H,3,0,1,0,4,2,1,2,8,20,16,5,12,11,October,-0.8660254037844386,0.5,24,17,1,0,4,1.0,1.6,7,6,1,15,26,-11,"October, 2000"
2000-2001,10,2000-10-28,Man United,Southampton,5,0,H,3,0,1,1,3,2,1,2,2,17,21,10,15,11,October,-0.8660254037844386,0.5,28,38,3,1,1,2.2,1.2,26,8,18,12,15,-3,"October, 2000"
2000-2001,10,2000-10-28,Sunderland,Coventry,1,0,H,3,0,2,2,1,1,1,3,13,15,13,11,2,2,October,-0.8660254037844386,0.5,40,15,1,2,1,1.5,1.5,8,11,-3,11,21,-10,"October, 2000"
2000-2001,10,2000-10-28,West Ham,Newcastle,1,0,H,3,0,1,0,4,2,2,1,18,8,8,16,10,8,October,-0.8660254037844386,0.5,45,30,4,1,0,2.0,0.6,12,14,-2,11,9,2,"October, 2000"
2000-2001,10,2000-10-29,Bradford,Leeds,1,1,D,1,1,0,2,3,4,0,1,19,11,6,14,8,8,October,-0.8660254037844386,0.5,8,23,0,0,2,1.0,2.0,4,16,-12,14,13,1,"October, 2000"
2000-2001,10,2000-10-29,Liverpool,Everton,3,1,H,3,0,4,1,0,1,1,3,4,14,18,12,10,6,October,-0.8660254037844386,0.5,25,18,1,3,1,0.8,0.8,17,13,4,13,16,-3,"October, 2000"
2000-2001,11,2000-11-04,Tottenham,Sunderland,2,1,H,3,0,1,1,3,2,2,1,12,11,14,16,1,2,November,-0.5000000000000004,0.8660254037844384,42,40,3,0,1,2.5,0.75,15,17,-2,9,11,-2,"November, 2000"
2000-2001,11,2000-11-04,Southampton,Chelsea,3,2,H,3,0,2,1,2,2,1,2,18,9,10,16,9,6,November,-0.5000000000000004,0.8660254037844384,38,14,1,1,3,0.6,1.2,12,20,-8,22,14,8,"November, 2000"
2000-2001,11,2000-11-04,Newcastle,Ipswich,2,1,H,3,0,2,2,1,3,1,1,10,5,16,18,5,2,November,-0.5000000000000004,0.8660254037844384,30,22,0,0,0,0.0,0.0,11,10,1,16,12,4,"November, 2000"
2000-2001,11,2000-11-04,Middlesbrough,Arsenal,0,1,A,0,3,2,1,2,3,1,1,17,2,10,24,15,14,November,-0.5000000000000004,0.8660254037844384,29,0,1,1,3,1.0,3.0,16,18,-2,22,10,12,"November, 2000"
2000-2001,11,2000-11-04,Coventry,Man United,1,2,A,0,3,1,1,3,1,1,3,16,1,11,24,15,13,November,-0.5000000000000004,0.8660254037844384,15,28,1,0,4,1.2,2.0,11,22,-11,31,8,23,"November, 2000"
2000-2001,11,2000-11-04,Leeds,Liverpool,4,3,H,3,0,4,0,1,4,1,0,11,3,15,21,8,6,November,-0.5000000000000004,0.8660254037844384,23,25,1,1,3,1.2,1.8,15,14,1,20,14,6,"November, 2000"
2000-2001,11,2000-11-04,Charlton,Bradford,2,0,H,3,0,2,1,2,0,2,3,11,19,15,7,8,8,November,-0.5000000000000004,0.8660254037844384,13,8,0,0,0,0.0,0.0,17,18,-1,5,17,-12,"November, 2000"
2000-2001,11,2000-11-04,Man City,Leicester,0,1,A,0,3,2,1,2,1,0,4,13,4,14,19,9,5,November,-0.5000000000000004,0.8660254037844384,27,24,0,0,0,0.0,0.0,14,19,-5,9,7,2,"November, 2000"
2000-2001,11,2000-11-05,Everton,Aston Villa,0,1,A,0,3,1,1,3,1,3,1,15,11,12,16,4,4,November,-0.5000000000000004,0.8660254037844384,18,1,0,2,3,0.2,2.0,14,19,-5,13,9,4,"November, 2000"
2000-2001,11,2000-11-06,Derby,West Ham,0,0,D,1,1,2,1,2,1,0,4,20,16,5,11,4,6,November,-0.5000000000000004,0.8660254037844384,17,45,0,2,3,0.6,2.0,16,28,-12,13,14,-1,"November, 2000"
2000-2001,12,2000-11-11,Man United,Middlesbrough,2,1,H,3,0,1,1,3,2,1,2,2,18,27,10,16,17,November,-0.5000000000000004,0.8660254037844384,28,29,3,1,1,2.2,1.8,33,9,24,16,19,-3,"November, 2000"
2000-2001,12,2000-11-11,West Ham,Man City,4,1,H,3,0,1,0,4,2,1,2,16,14,12,14,2,2,November,-0.5000000000000004,0.8660254037844384,45,27,1,0,1,2.5,2.0,13,14,-1,14,20,-6,"November, 2000"
2000-2001,12,2000-11-11,Sunderland,Southampton,2,2,D,1,1,2,2,1,2,1,2,12,15,16,13,3,3,November,-0.5000000000000004,0.8660254037844384,40,38,2,0,2,1.0,1.25,10,13,-3,15,22,-7,"November, 2000"
2000-2001,12,2000-11-11,Leicester,Newcastle,1,1,D,1,1,1,0,4,2,2,1,4,7,22,19,3,3,November,-0.5000000000000004,0.8660254037844384,24,30,2,1,2,1.0,0.6,10,7,3,13,11,2,"November, 2000"
2000-2001,12,2000-11-11,Aston Villa,Tottenham,2,0,H,3,0,1,3,1,1,1,3,5,10,19,17,5,2,November,-0.5000000000000004,0.8660254037844384,1,42,3,1,1,2.4,1.4,14,9,5,17,18,-1,"November, 2000"
2000-2001,12,2000-11-11,Bradford,Everton,0,1,A,0,3,0,2,3,1,1,3,20,16,7,12,4,5,November,-0.5000000000000004,0.8660254037844384,8,18,0,1,1,0.0,2.0,5,19,-14,14,20,-6,"November, 2000"
2000-2001,12,2000-11-11,Arsenal,Derby,0,0,D,1,1,3,1,1,2,1,2,2,20,27,6,18,21,November,-0.5000000000000004,0.8660254037844384,0,17,4,1,0,1.2,0.4,23,10,13,16,28,-12,"November, 2000"
2000-2001,12,2000-11-11,Ipswich,Charlton,2,0,H,3,0,3,1,1,2,1,2,7,9,18,18,2,0,November,-0.5000000000000004,0.8660254037844384,22,13,0,0,0,0.0,0.0,17,14,3,19,18,1,"November, 2000"
2000-2001,12,2000-11-12,Chelsea,Leeds,1,1,D,1,1,2,1,2,4,0,1,12,8,16,18,4,2,November,-0.5000000000000004,0.8660254037844384,14,23,2,1,2,0.6,1.0,24,17,7,19,17,2,"November, 2000"
2000-2001,12,2000-11-12,Liverpool,Coventry,4,1,H,3,0,4,1,0,1,1,3,5,17,21,11,12,10,November,-0.5000000000000004,0.8660254037844384,25,15,3,1,1,1.8,0.6,23,18,5,12,24,-12,"November, 2000"
2000-2001,13,2000-11-18,Southampton,Aston Villa,2,0,H,3,0,2,1,2,1,3,1,15,5,14,22,10,8,November,-0.5000000000000004,0.8660254037844384,38,1,2,0,3,1.0,1.8,17,24,-7,16,9,7,"November, 2000"
2000-2001,13,2000-11-18,Newcastle,Sunderland,1,2,A,0,3,2,2,1,2,2,1,8,14,20,17,6,3,November,-0.5000000000000004,0.8660254037844384,30,40,1,2,1,1.5,1.5,14,12,2,12,15,-3,"November, 2000"
2000-2001,13,2000-11-18,Middlesbrough,Leicester,0,3,A,0,3,2,1,2,1,0,4,18,4,10,23,14,13,November,-0.5000000000000004,0.8660254037844384,29,24,2,1,2,1.0,1.2,17,21,-4,11,8,3,"November, 2000"
2000-2001,13,2000-11-18,Man City,Man United,0,1,A,0,3,2,1,2,1,1,3,16,1,14,30,15,16,November,-0.5000000000000004,0.8660254037844384,27,28,0,0,2,1.0,2.0,15,24,-9,35,10,25,"November, 2000"
2000-2001,13,2000-11-18,Everton,Arsenal,2,0,H,3,0,1,1,3,3,1,1,14,2,15,28,12,13,November,-0.5000000000000004,0.8660254037844384,18,0,0,0,5,0.2,2.4,15,20,-5,23,10,13,"November, 2000"
2000-2001,13,2000-11-18,Derby,Bradford,2,0,H,3,0,2,1,2,0,2,3,19,20,7,7,1,0,November,-0.5000000000000004,0.8660254037844384,17,8,0,1,1,2.0,2.5,16,28,-12,5,20,-15,"November, 2000"
2000-2001,13,2000-11-18,Charlton,Chelsea,2,0,H,3,0,2,1,2,2,1,2,9,10,18,17,1,1,November,-0.5000000000000004,0.8660254037844384,13,14,0,0,2,0.5,1.5,19,20,-1,25,18,7,"November, 2000"
2000-2001,13,2000-11-18,Leeds,West Ham,0,1,A,0,3,4,0,1,1,0,4,9,14,19,15,5,4,November,-0.5000000000000004,0.8660254037844384,23,45,3,1,1,2.0,0.8,20,18,2,17,15,2,"November, 2000"
2000-2001,13,2000-11-19,Tottenham,Liverpool,2,1,H,3,0,1,1,3,4,1,0,14,4,17,24,10,7,November,-0.5000000000000004,0.8660254037844384,42,25,2,1,2,1.6,1.8,17,20,-3,27,19,8,"November, 2000"
2000-2001,13,2000-11-20,Coventry,Ipswich,0,1,A,0,3,1,1,3,3,1,1,17,6,11,21,11,10,November,-0.5000000000000004,0.8660254037844384,15,22,0,0,0,0.0,0.0,13,28,-15,19,14,5,"November, 2000"
2000-2001,14,2000-11-25,Middlesbrough,Bradford,2,2,D,1,1,2,1,2,0,2,3,18,20,10,7,2,3,November,-0.5000000000000004,0.8660254037844384,29,8,0,1,1,0.5,1.0,17,24,-7,5,22,-17,"November, 2000"
2000-2001,14,2000-11-25,Southampton,West Ham,2,3,A,0,3,2,1,2,1,0,4,15,13,17,18,2,1,November,-0.5000000000000004,0.8660254037844384,38,45,3,0,2,1.4,1.2,19,24,-5,18,15,3,"November, 2000"
2000-2001,14,2000-11-25,Tottenham,Leicester,3,0,H,3,0,1,1,3,1,0,4,12,4,20,26,8,6,November,-0.5000000000000004,0.8660254037844384,42,24,1,1,3,1.0,1.6,19,21,-2,14,8,6,"November, 2000"
2000-2001,14,2000-11-25,Man City,Ipswich,2,3,A,0,3,2,1,2,3,1,1,16,5,14,24,11,10,November,-0.5000000000000004,0.8660254037844384,27,22,0,0,0,0.0,0.0,15,25,-10,20,14,6,"November, 2000"
2000-2001,14,2000-11-25,Coventry,Aston Villa,1,1,D,1,1,1,1,3,1,3,1,17,7,11,22,10,11,November,-0.5000000000000004,0.8660254037844384,15,1,2,0,3,1.6,1.4,13,29,-16,16,11,5,"November, 2000"
2000-2001,14,2000-11-25,Derby,Man United,0,3,A,0,3,2,1,2,1,1,3,19,1,10,33,18,23,November,-0.5000000000000004,0.8660254037844384,17,28,0,1,4,0.6,1.8,18,28,-10,36,10,26,"November, 2000"
2000-2001,14,2000-11-25,Everton,Chelsea,2,1,H,3,0,1,1,3,2,1,2,13,14,18,17,1,1,November,-0.5000000000000004,0.8660254037844384,18,14,1,3,1,1.2,1.2,17,20,-3,25,20,5,"November, 2000"
2000-2001,14,2000-11-25,Charlton,Sunderland,0,1,A,0,3,2,1,2,2,2,1,7,10,21,20,3,1,November,-0.5000000000000004,0.8660254037844384,13,40,0,0,0,0.0,0.0,21,20,1,14,16,-2,"November, 2000"
2000-2001,14,2000-11-26,Leeds,Arsenal,1,0,H,3,0,4,0,1,3,1,1,13,2,19,28,11,9,November,-0.5000000000000004,0.8660254037844384,23,0,1,0,4,0.6,2.2,20,19,1,23,12,11,"November, 2000"
2000-2001,14,2000-11-26,Newcastle,Liverpool,2,1,H,3,0,2,2,1,4,1,0,13,5,20,24,8,4,November,-0.5000000000000004,0.8660254037844384,30,25,0,1,4,1.2,2.6,15,14,1,28,21,7,"November, 2000"
2000-2001,15,2000-12-02,Arsenal,Southampton,1,0,H,3,0,3,1,1,2,1,2,2,15,28,17,13,11,December,-2.4492935982947064e-16,1.0,0,38,3,2,0,1.6,0.4,23,13,10,21,27,-6,"December, 2000"
2000-2001,15,2000-12-02,Aston Villa,Newcastle,1,1,D,1,1,1,3,1,2,2,1,6,7,23,23,1,0,December,-2.4492935982947064e-16,1.0,1,30,2,0,3,0.6,0.8,17,12,5,17,15,2,"December, 2000"
2000-2001,15,2000-12-02,Bradford,Coventry,2,1,H,3,0,0,2,3,1,1,3,20,17,8,12,3,4,December,-2.4492935982947064e-16,1.0,8,15,0,1,1,0.5,2.5,7,24,-17,14,30,-16,"December, 2000"
2000-2001,15,2000-12-02,Leicester,Leeds,3,1,H,3,0,1,0,4,4,0,1,4,10,26,22,6,4,December,-2.4492935982947064e-16,1.0,24,23,3,0,2,1.2,1.0,14,11,3,21,19,2,"December, 2000"
2000-2001,15,2000-12-02,Liverpool,Charlton,3,0,H,3,0,4,1,0,2,1,2,5,12,24,21,7,3,December,-2.4492935982947064e-16,1.0,25,13,0,1,1,1.5,2.0,29,23,6,21,21,0,"December, 2000"
2000-2001,15,2000-12-02,Man United,Tottenham,2,0,H,3,0,1,1,3,1,1,3,1,8,36,23,7,13,December,-2.4492935982947064e-16,1.0,28,42,3,1,1,2.0,1.4,39,10,29,22,21,1,"December, 2000"
2000-2001,15,2000-12-02,West Ham,Middlesbrough,1,0,H,3,0,1,0,4,2,1,2,11,19,21,11,8,10,December,-2.4492935982947064e-16,1.0,45,29,1,1,3,0.8,0.8,21,17,4,19,26,-7,"December, 2000"
2000-2001,15,2000-12-02,Ipswich,Derby,0,1,A,0,3,3,1,1,2,1,2,3,20,27,10,17,17,December,-2.4492935982947064e-16,1.0,22,17,0,0,0,0.0,0.0,23,16,7,18,31,-13,"December, 2000"
2000-2001,15,2000-12-03,Chelsea,Man City,2,1,H,3,0,2,1,2,2,1,2,14,16,17,14,2,3,December,-2.4492935982947064e-16,1.0,14,27,1,1,0,1.0,0.5,26,22,4,17,28,-11,"December, 2000"
2000-2001,15,2000-12-04,Sunderland,Everton,2,0,H,3,0,2,2,1,1,1,3,10,12,23,21,2,2,December,-2.4492935982947064e-16,1.0,40,18,3,0,1,2.0,1.75,15,16,-1,19,21,-2,"December, 2000"
2000-2001,16,2000-12-09,West Ham,Aston Villa,1,1,D,1,1,1,0,4,1,3,1,7,8,24,24,1,0,December,-2.4492935982947064e-16,1.0,45,1,0,4,1,0.6,1.0,22,17,5,18,13,5,"December, 2000"
2000-2001,16,2000-12-09,Southampton,Leeds,1,0,H,3,0,2,1,2,4,0,1,16,12,17,22,4,5,December,-2.4492935982947064e-16,1.0,38,23,2,0,3,0.8,1.4,21,28,-7,22,22,0,"December, 2000"
2000-2001,16,2000-12-09,Sunderland,Middlesbrough,1,0,H,3,0,2,2,1,2,1,2,6,20,26,11,14,15,December,-2.4492935982947064e-16,1.0,40,29,1,3,0,1.25,1.0,17,16,1,19,27,-8,"December, 2000"
2000-2001,16,2000-12-09,Man City,Everton,5,0,H,3,0,2,1,2,1,1,3,16,14,14,21,2,7,December,-2.4492935982947064e-16,1.0,27,18,0,0,2,0.0,2.0,18,30,-12,19,23,-4,"December, 2000"
2000-2001,16,2000-12-09,Charlton,Man United,3,3,D,1,1,2,1,2,1,1,3,12,1,21,39,11,18,December,-2.4492935982947064e-16,1.0,13,28,0,0,2,0.5,2.5,21,24,-3,41,10,31,"December, 2000"
2000-2001,16,2000-12-09,Bradford,Tottenham,3,3,D,1,1,0,2,3,1,1,3,20,10,11,23,10,12,December,-2.4492935982947064e-16,1.0,8,42,0,2,0,1.0,1.0,9,25,-16,22,23,-1,"December, 2000"
2000-2001,16,2000-12-09,Arsenal,Newcastle,5,0,H,3,0,3,1,1,2,2,1,2,9,31,24,7,7,December,-2.4492935982947064e-16,1.0,0,30,2,2,1,1.8,1.2,24,13,11,18,16,2,"December, 2000"
2000-2001,16,2000-12-09,Chelsea,Derby,4,1,H,3,0,2,1,2,2,1,2,14,17,20,13,3,7,December,-2.4492935982947064e-16,1.0,14,17,3,1,1,2.0,1.2,28,23,5,19,31,-12,"December, 2000"
2000-2001,16,2000-12-10,Coventry,Leicester,1,0,H,3,0,1,1,3,1,0,4,19,3,12,29,16,17,December,-2.4492935982947064e-16,1.0,15,24,0,2,3,0.4,1.0,15,32,-17,17,12,5,"December, 2000"
2000-2001,16,2000-12-10,Liverpool,Ipswich,0,1,A,0,3,4,1,0,3,1,1,5,6,27,27,1,0,December,-2.4492935982947064e-16,1.0,25,22,0,0,0,0.0,0.0,32,23,9,23,17,6,"December, 2000"
2000-2001,17,2000-12-16,Newcastle,Bradford,2,1,H,3,0,2,2,1,0,2,3,11,20,24,12,9,12,December,-2.4492935982947064e-16,1.0,30,8,1,0,1,1.0,1.0,18,21,-3,12,28,-16,"December, 2000"
2000-2001,17,2000-12-16,Middlesbrough,Chelsea,1,0,H,3,0,2,1,2,2,1,2,20,12,11,23,8,12,December,-2.4492935982947064e-16,1.0,29,14,1,2,2,0.4,0.8,19,28,-9,32,24,8,"December, 2000"
2000-2001,17,2000-12-16,Leicester,Charlton,3,1,H,3,0,1,0,4,2,1,2,4,13,29,22,9,7,December,-2.4492935982947064e-16,1.0,24,13,0,2,0,0.5,0.5,17,13,4,24,27,-3,"December, 2000"
2000-2001,17,2000-12-16,Leeds,Sunderland,2,0,H,3,0,4,0,1,2,2,1,12,5,22,29,7,7,December,-2.4492935982947064e-16,1.0,23,40,4,0,0,2.0,0.5,22,23,-1,18,16,2,"December, 2000"
2000-2001,17,2000-12-16,Everton,West Ham,1,1,D,1,1,1,1,3,1,0,4,14,8,21,25,6,4,December,-2.4492935982947064e-16,1.0,18,45,3,1,1,2.8,0.8,19,28,-9,23,18,5,"December, 2000"
2000-2001,17,2000-12-16,Derby,Coventry,1,0,H,3,0,2,1,2,1,1,3,18,17,13,15,1,2,December,-2.4492935982947064e-16,1.0,17,15,0,3,2,0.2,0.8,20,35,-15,16,32,-16,"December, 2000"
2000-2001,17,2000-12-16,Aston Villa,Man City,2,2,D,1,1,1,3,1,2,1,2,8,16,25,17,8,8,December,-2.4492935982947064e-16,1.0,1,27,0,0,2,0.0,1.0,19,14,5,23,30,-7,"December, 2000"
2000-2001,17,2000-12-16,Ipswich,Southampton,3,1,H,3,0,3,1,1,2,1,2,3,15,30,20,12,10,December,-2.4492935982947064e-16,1.0,22,38,0,0,0,0.0,0.0,24,17,7,22,28,-6,"December, 2000"
2000-2001,17,2000-12-17,Man United,Liverpool,0,1,A,0,3,1,1,3,4,1,0,1,6,40,27,5,13,December,-2.4492935982947064e-16,1.0,28,25,2,3,0,1.8,1.2,44,13,31,32,24,8,"December, 2000"
2000-2001,17,2000-12-18,Tottenham,Arsenal,1,1,D,1,1,1,1,3,3,1,1,11,2,24,34,9,10,December,-2.4492935982947064e-16,1.0,42,0,1,2,2,1.0,1.4,25,26,-1,29,13,16,"December, 2000"
2000-2001,18,2000-12-22,Coventry,Southampton,1,1,D,1,1,1,1,3,2,1,2,18,15,15,20,3,5,December,-2.4492935982947064e-16,1.0,15,38,2,1,2,0.8,0.8,16,33,-17,23,31,-8,"December, 2000"
2000-2001,18,2000-12-23,Tottenham,Middlesbrough,0,0,D,1,1,1,1,3,2,1,2,12,19,25,14,7,11,December,-2.4492935982947064e-16,1.0,42,29,0,2,3,0.8,1.8,26,27,-1,20,28,-8,"December, 2000"
2000-2001,18,2000-12-23,Sunderland,Man City,1,0,H,3,0,2,2,1,2,1,2,7,17,29,18,10,11,December,-2.4492935982947064e-16,1.0,40,27,0,0,1,2.0,4.0,18,18,0,25,32,-7,"December, 2000"
2000-2001,18,2000-12-23,Man United,Ipswich,2,0,H,3,0,1,1,3,3,1,1,1,5,40,33,4,7,December,-2.4492935982947064e-16,1.0,28,22,0,1,0,1.0,1.0,44,14,30,27,18,9,"December, 2000"
2000-2001,18,2000-12-23,Leicester,West Ham,2,1,H,3,0,1,0,4,1,0,4,4,10,32,26,6,6,December,-2.4492935982947064e-16,1.0,24,45,1,1,3,1.0,1.6,20,14,6,24,19,5,"December, 2000"
2000-2001,18,2000-12-23,Liverpool,Arsenal,4,0,H,3,0,4,1,0,3,1,1,5,2,30,35,3,5,December,-2.4492935982947064e-16,1.0,25,0,2,2,1,0.6,0.4,33,24,9,30,14,16,"December, 2000"
2000-2001,18,2000-12-23,Derby,Newcastle,2,0,H,3,0,2,1,2,2,2,1,17,7,16,27,10,11,December,-2.4492935982947064e-16,1.0,17,30,0,1,4,1.2,2.2,21,35,-14,20,22,-2,"December, 2000"
2000-2001,18,2000-12-23,Chelsea,Bradford,3,0,H,3,0,2,1,2,0,2,3,13,20,23,12,7,11,December,-2.4492935982947064e-16,1.0,14,8,1,1,1,0.6666666666666666,1.0,32,25,7,13,30,-17,"December, 2000"
2000-2001,18,2000-12-23,Charlton,Everton,1,0,H,3,0,2,1,2,1,1,3,13,14,22,22,1,0,December,-2.4492935982947064e-16,1.0,13,18,0,0,3,0.6666666666666666,3.0,25,30,-5,20,29,-9,"December, 2000"
2000-2001,18,2000-12-23,Leeds,Aston Villa,1,2,A,0,3,4,0,1,1,3,1,11,10,25,26,1,1,December,-2.4492935982947064e-16,1.0,23,1,1,2,2,0.8,1.0,24,23,1,21,16,5,"December, 2000"
2000-2001,19,2000-12-26,West Ham,Charlton,5,0,H,3,0,1,0,4,2,1,2,10,13,26,25,3,1,December,-2.4492935982947064e-16,1.0,45,13,0,0,2,1.0,2.5,25,21,4,26,30,-4,"December, 2000"
2000-2001,19,2000-12-26,Middlesbrough,Liverpool,1,0,H,3,0,2,1,2,4,1,0,19,6,15,33,13,18,December,-2.4492935982947064e-16,1.0,29,25,1,1,3,0.8,2.2,20,28,-8,37,24,13,"December, 2000"
2000-2001,19,2000-12-26,Man City,Derby,0,0,D,1,1,2,1,2,2,1,2,18,16,18,19,2,1,December,-2.4492935982947064e-16,1.0,27,17,0,0,0,0.0,0.0,25,33,-8,23,35,-12,"December, 2000"
2000-2001,19,2000-12-26,Ipswich,Chelsea,2,2,D,1,1,3,1,1,2,1,2,6,9,33,26,3,7,December,-2.4492935982947064e-16,1.0,22,14,0,0,0,0.0,0.0,27,20,7,35,25,10,"December, 2000"
2000-2001,19,2000-12-26,Newcastle,Leeds,2,1,H,3,0,2,2,1,4,0,1,9,12,27,25,3,2,December,-2.4492935982947064e-16,1.0,30,23,1,2,2,1.2,1.8,20,24,-4,25,25,0,"December, 2000"
2000-2001,19,2000-12-26,Bradford,Sunderland,1,4,A,0,3,0,2,3,2,2,1,20,6,12,32,14,20,December,-2.4492935982947064e-16,1.0,8,40,1,0,1,0.5,2.0,13,33,-20,19,18,1,"December, 2000"
2000-2001,19,2000-12-26,Aston Villa,Man United,0,1,A,0,3,1,3,1,1,1,3,7,1,29,43,6,14,December,-2.4492935982947064e-16,1.0,1,28,0,1,4,0.4,1.8,23,17,6,46,14,32,"December, 2000"
2000-2001,19,2000-12-26,Arsenal,Leicester,6,1,H,3,0,3,1,1,1,0,4,2,3,35,35,1,0,December,-2.4492935982947064e-16,1.0,0,24,4,1,0,2.6,0.6,30,18,12,22,15,7,"December, 2000"
2000-2001,19,2000-12-26,Everton,Coventry,1,2,A,0,3,1,1,3,1,1,3,14,18,22,16,4,6,December,-2.4492935982947064e-16,1.0,18,15,1,2,2,0.8,1.2,20,30,-10,17,34,-17,"December, 2000"
2000-2001,19,2000-12-27,Southampton,Tottenham,2,0,H,3,0,2,1,2,1,1,3,15,11,21,26,4,5,December,-2.4492935982947064e-16,1.0,38,42,0,2,3,0.8,2.6,24,32,-8,26,27,-1,"December, 2000"
2000-2001,20,2000-12-30,Arsenal,Sunderland,2,2,D,1,1,3,1,1,2,2,1,2,3,38,35,1,3,December,-2.4492935982947064e-16,1.0,0,40,2,1,2,1.2,0.6,36,19,17,23,19,4,"December, 2000"
2000-2001,20,2000-12-30,Ipswich,Tottenham,3,0,H,3,0,3,1,1,1,1,3,5,11,34,26,6,8,December,-2.4492935982947064e-16,1.0,22,42,0,0,1,1.0,3.0,29,22,7,26,29,-3,"December, 2000"
2000-2001,20,2000-12-30,Man City,Charlton,1,4,A,0,3,2,1,2,2,1,2,17,13,19,25,4,6,December,-2.4492935982947064e-16,1.0,27,13,0,0,1,0.0,4.0,25,33,-8,26,35,-9,"December, 2000"
2000-2001,20,2000-12-30,Middlesbrough,Coventry,1,1,D,1,1,2,1,2,1,1,3,19,18,18,19,1,1,December,-2.4492935982947064e-16,1.0,29,15,4,0,1,2.0,0.8,21,28,-7,19,35,-16,"December, 2000"
2000-2001,20,2000-12-30,Newcastle,Man United,1,1,D,1,1,2,2,1,1,1,3,7,1,30,46,6,16,December,-2.4492935982947064e-16,1.0,30,28,1,1,3,1.0,1.8,22,25,-3,47,14,33,"December, 2000"
2000-2001,20,2000-12-30,Southampton,Derby,1,0,H,3,0,2,1,2,2,1,2,14,16,24,20,2,4,December,-2.4492935982947064e-16,1.0,38,17,0,3,2,1.0,1.6,26,32,-6,23,35,-12,"December, 2000"
2000-2001,21,2001-01-01,Liverpool,Southampton,2,1,H,3,0,4,1,0,2,1,2,6,12,33,27,6,6,January,0.4999999999999999,0.8660254037844387,25,38,2,3,0,2.6,1.2,37,25,12,27,32,-5,"January, 2001"
2000-2001,21,2001-01-01,Man United,West Ham,3,1,H,3,0,1,1,3,1,0,4,1,10,47,29,9,18,January,0.4999999999999999,0.8660254037844387,28,45,3,2,0,3.4,1.2,48,15,33,30,21,9,"January, 2001"
2000-2001,21,2001-01-01,Sunderland,Ipswich,4,1,H,3,0,2,2,1,3,1,1,5,3,36,37,2,1,January,0.4999999999999999,0.8660254037844387,40,22,0,0,1,0.0,1.0,25,21,4,32,22,10,"January, 2001"
2000-2001,21,2001-01-01,Leicester,Bradford,1,2,A,0,3,1,0,4,0,2,3,5,20,35,12,15,23,January,0.4999999999999999,0.8660254037844387,24,8,1,1,1,1.3333333333333333,1.0,23,21,2,14,37,-23,"January, 2001"
2000-2001,21,2001-01-01,Chelsea,Aston Villa,1,0,H,3,0,2,1,2,1,3,1,11,10,27,29,1,2,January,0.4999999999999999,0.8660254037844387,14,1,3,2,0,1.4,0.4,37,27,10,23,18,5,"January, 2001"
2000-2001,21,2001-01-01,Derby,Everton,1,0,H,3,0,2,1,2,1,1,3,18,15,20,22,3,2,January,0.4999999999999999,0.8660254037844387,17,18,2,2,1,1.2,1.0,23,36,-13,21,32,-11,"January, 2001"
2000-2001,21,2001-01-01,Coventry,Man City,1,1,D,1,1,1,1,3,2,1,2,17,19,20,19,2,1,January,0.4999999999999999,0.8660254037844387,15,27,2,1,0,1.6666666666666667,1.0,20,36,-16,26,37,-11,"January, 2001"
2000-2001,21,2001-01-01,Charlton,Arsenal,1,0,H,3,0,2,1,2,3,1,1,10,2,28,39,8,11,January,0.4999999999999999,0.8660254037844387,13,0,0,1,2,1.0,2.0,30,36,-6,38,21,17,"January, 2001"
2000-2001,21,2001-01-01,Leeds,Middlesbrough,1,1,D,1,1,4,0,1,2,1,2,14,19,25,19,5,6,January,0.4999999999999999,0.8660254037844387,23,29,3,2,0,1.2,0.2,26,27,-1,22,29,-7,"January, 2001"
2000-2001,21,2001-01-02,Tottenham,Newcastle,4,2,H,3,0,1,1,3,2,2,1,14,7,26,31,7,5,January,0.4999999999999999,0.8660254037844387,42,30,2,1,2,1.4,1.2,26,32,-6,23,26,-3,"January, 2001"
2000-2001,22,2001-01-13,West Ham,Sunderland,0,2,A,0,3,1,0,4,2,2,1,11,4,29,39,7,10,January,0.4999999999999999,0.8660254037844387,45,40,1,3,1,0.8,0.6,31,24,7,29,22,7,"January, 2001"
2000-2001,22,2001-01-13,Southampton,Charlton,0,0,D,1,1,2,1,2,2,1,2,14,9,27,31,5,4,January,0.4999999999999999,0.8660254037844387,38,13,1,1,1,1.3333333333333333,2.333333333333333,28,34,-6,31,36,-5,"January, 2001"
2000-2001,22,2001-01-13,Newcastle,Coventry,3,1,H,3,0,2,2,1,1,1,3,9,18,31,21,9,10,January,0.4999999999999999,0.8660254037844387,30,15,4,0,1,2.8,1.2,25,30,-5,21,37,-16,"January, 2001"
2000-2001,22,2001-01-13,Middlesbrough,Derby,4,0,H,3,0,2,1,2,2,1,2,18,15,20,23,3,3,January,0.4999999999999999,0.8660254037844387,29,17,1,2,2,1.8,2.2,23,30,-7,24,36,-12,"January, 2001"
2000-2001,22,2001-01-13,Everton,Tottenham,0,0,D,1,1,1,1,3,1,1,3,16,12,22,29,4,7,January,0.4999999999999999,0.8660254037844387,18,42,0,1,4,1.4,2.6,21,33,-12,30,34,-4,"January, 2001"
2000-2001,22,2001-01-13,Bradford,Man United,0,3,A,0,3,0,2,3,1,1,3,20,1,15,50,19,35,January,0.4999999999999999,0.8660254037844387,8,28,0,0,3,0.0,4.666666666666667,16,38,-22,51,16,35,"January, 2001"
2000-2001,22,2001-01-13,Aston Villa,Liverpool,0,3,A,0,3,1,3,1,4,1,0,11,5,29,36,6,7,January,0.4999999999999999,0.8660254037844387,1,25,1,2,2,0.8,1.4,23,19,4,39,26,13,"January, 2001"
2000-2001,22,2001-01-13,Arsenal,Chelsea,1,1,D,1,1,3,1,1,2,1,2,2,9,39,30,7,9,January,0.4999999999999999,0.8660254037844387,0,14,3,2,0,1.6,1.0,38,22,16,38,27,11,"January, 2001"
2000-2001,22,2001-01-13,Man City,Leeds,0,4,A,0,3,2,1,2,4,0,1,19,14,20,26,5,6,January,0.4999999999999999,0.8660254037844387,27,23,2,1,0,1.0,0.3333333333333333,27,38,-11,27,28,-1,"January, 2001"
2000-2001,22,2001-01-14,Ipswich,Leicester,2,0,H,3,0,3,1,1,1,0,4,5,6,37,35,1,2,January,0.4999999999999999,0.8660254037844387,22,24,0,0,1,1.0,2.0,33,26,7,24,23,1,"January, 2001"
2000-2001,23,2001-01-20,Liverpool,Middlesbrough,0,0,D,1,1,4,1,0,2,1,2,5,17,39,23,12,16,January,0.4999999999999999,0.8660254037844387,25,29,2,1,2,1.2,0.8,42,26,16,27,30,-3,"January, 2001"
2000-2001,23,2001-01-20,Man United,Aston Villa,2,0,H,3,0,1,1,3,1,3,1,1,13,53,29,12,24,January,0.4999999999999999,0.8660254037844387,28,1,4,1,0,1.6,0.4,54,16,38,23,22,1,"January, 2001"
2000-2001,23,2001-01-20,Leicester,Arsenal,0,0,D,1,1,1,0,4,3,1,1,7,3,35,40,4,5,January,0.4999999999999999,0.8660254037844387,24,0,0,1,4,0.6,3.4,24,25,-1,39,23,16,"January, 2001"
2000-2001,23,2001-01-20,Tottenham,Southampton,0,0,D,1,1,1,1,3,2,1,2,10,14,30,28,4,2,January,0.4999999999999999,0.8660254037844387,42,38,3,1,1,2.4,1.0,30,34,-4,28,34,-6,"January, 2001"
2000-2001,23,2001-01-20,Derby,Man City,1,1,D,1,1,2,1,2,2,1,2,17,19,23,20,2,3,January,0.4999999999999999,0.8660254037844387,17,27,0,1,0,0.0,0.0,24,40,-16,27,42,-15,"January, 2001"
2000-2001,23,2001-01-20,Coventry,Everton,1,3,A,0,3,1,1,3,1,1,3,18,16,21,23,2,2,January,0.4999999999999999,0.8660254037844387,15,18,3,1,1,1.4,0.8,22,40,-18,21,33,-12,"January, 2001"
2000-2001,23,2001-01-20,Chelsea,Ipswich,4,1,H,3,0,2,1,2,3,1,1,9,4,31,40,5,9,January,0.4999999999999999,0.8660254037844387,14,22,0,1,0,2.0,2.0,39,28,11,35,26,9,"January, 2001"
2000-2001,23,2001-01-20,Leeds,Newcastle,1,3,A,0,3,4,0,1,2,2,1,12,8,29,34,4,5,January,0.4999999999999999,0.8660254037844387,23,30,2,1,2,1.8,1.4,31,28,3,28,31,-3,"January, 2001"
2000-2001,23,2001-01-21,Sunderland,Bradford,0,0,D,1,1,2,2,1,0,2,3,2,20,42,15,18,27,January,0.4999999999999999,0.8660254037844387,40,8,2,0,1,2.6666666666666665,0.6666666666666666,31,22,9,16,41,-25,"January, 2001"
2000-2001,23,2001-01-22,Charlton,West Ham,1,1,D,1,1,2,1,2,1,0,4,9,11,32,29,2,3,January,0.4999999999999999,0.8660254037844387,13,45,2,0,1,1.6666666666666667,2.333333333333333,31,36,-5,31,26,5,"January, 2001"
2000-2001,23,2001-01-24,Aston Villa,Leeds,1,2,A,0,3,1,3,1,4,0,1,13,12,29,29,1,0,January,0.4999999999999999,0.8660254037844387,1,23,3,1,1,1.2,0.8,23,24,-1,32,31,1,"January, 2001"
2000-2001,24,2001-01-30,Arsenal,Bradford,2,0,H,3,0,3,1,1,0,2,3,3,20,41,16,17,25,January,0.4999999999999999,0.8660254037844387,0,8,1,1,1,1.3333333333333333,1.0,39,23,16,16,41,-25,"January, 2001"
2000-2001,24,2001-01-30,Charlton,Derby,2,1,H,3,0,2,1,2,2,1,2,9,17,33,24,8,9,January,0.4999999999999999,0.8660254037844387,13,17,1,1,1,1.6666666666666667,1.3333333333333333,32,37,-5,25,41,-16,"January, 2001"
2000-2001,24,2001-01-31,Chelsea,Newcastle,3,1,H,3,0,2,1,2,2,2,1,9,6,34,37,3,3,January,0.4999999999999999,0.8660254037844387,14,30,3,2,0,0.8,0.2,43,29,14,31,32,-1,"January, 2001"
2000-2001,24,2001-01-31,Everton,Middlesbrough,2,2,D,1,1,1,1,3,2,1,2,15,16,26,24,1,2,January,0.4999999999999999,0.8660254037844387,18,29,2,1,2,2.0,1.4,24,34,-10,27,30,-3,"January, 2001"
2000-2001,24,2001-01-31,Leeds,Coventry,1,0,H,3,0,4,0,1,1,1,3,10,19,32,21,9,11,January,0.4999999999999999,0.8660254037844387,23,15,3,2,0,2.2,1.0,34,32,2,23,43,-20,"January, 2001"
2000-2001,24,2001-01-31,Man City,Liverpool,1,1,D,1,1,2,1,2,4,1,0,18,4,21,40,14,19,January,0.4999999999999999,0.8660254037844387,27,25,0,1,2,1.3333333333333333,3.6666666666666665,28,43,-15,42,26,16,"January, 2001"
2000-2001,24,2001-01-31,Southampton,Leicester,1,0,H,3,0,2,1,2,1,0,4,14,8,29,36,6,7,January,0.4999999999999999,0.8660254037844387,38,24,1,0,4,0.8,1.6,28,34,-6,24,25,-1,"January, 2001"
2000-2001,24,2001-01-31,Sunderland,Man United,0,1,A,0,3,2,2,1,1,1,3,3,1,43,56,2,13,January,0.4999999999999999,0.8660254037844387,40,28,1,1,3,0.8,3.0,31,22,9,56,16,40,"January, 2001"
2000-2001,24,2001-01-31,West Ham,Tottenham,0,0,D,1,1,1,0,4,1,1,3,13,12,30,31,1,1,January,0.4999999999999999,0.8660254037844387,45,42,3,1,1,1.0,0.6,32,27,5,30,34,-4,"January, 2001"
2000-2001,25,2001-02-03,Tottenham,Charlton,0,0,D,1,1,1,1,3,2,1,2,12,10,32,36,2,4,February,0.8660254037844386,0.5000000000000001,42,13,1,1,1,2.0,1.3333333333333333,30,34,-4,34,38,-4,"February, 2001"
2000-2001,25,2001-02-03,Middlesbrough,Man City,1,1,D,1,1,2,1,2,2,1,2,17,18,25,22,1,3,February,0.8660254037844386,0.5000000000000001,29,27,2,1,0,2.0,0.6666666666666666,29,32,-3,29,44,-15,"February, 2001"
2000-2001,25,2001-02-03,Man United,Everton,1,0,H,3,0,1,1,3,1,1,3,1,15,59,27,14,32,February,0.8660254037844386,0.5000000000000001,28,18,4,1,0,3.2,1.0,57,16,41,26,36,-10,"February, 2001"
2000-2001,25,2001-02-03,Liverpool,West Ham,3,0,H,3,0,4,1,0,1,0,4,4,14,41,31,10,10,February,0.8660254037844386,0.5000000000000001,25,45,1,2,2,1.0,1.2,43,27,16,32,27,5,"February, 2001"
2000-2001,25,2001-02-03,Coventry,Arsenal,0,1,A,0,3,1,1,3,3,1,1,19,2,21,44,17,23,February,0.8660254037844386,0.5000000000000001,15,0,1,0,4,0.8,2.0,23,44,-21,41,23,18,"February, 2001"
2000-2001,25,2001-02-03,Ipswich,Leeds,1,2,A,0,3,3,1,1,4,0,1,5,10,40,35,5,5,February,0.8660254037844386,0.5000000000000001,22,23,1,0,0,2.0,1.0,36,30,6,35,32,3,"February, 2001"
2000-2001,25,2001-02-03,Derby,Sunderland,1,0,H,3,0,2,1,2,2,2,1,17,3,24,43,14,19,February,0.8660254037844386,0.5000000000000001,17,40,1,1,3,0.6,2.0,26,43,-17,31,23,8,"February, 2001"
2000-2001,25,2001-02-03,Bradford,Aston Villa,0,3,A,0,3,0,2,3,1,3,1,20,14,16,29,6,13,February,0.8660254037844386,0.5000000000000001,8,1,0,1,2,0.3333333333333333,1.3333333333333333,16,43,-27,24,26,-2,"February, 2001"
2000-2001,25,2001-02-03,Leicester,Chelsea,2,1,H,3,0,1,0,4,2,1,2,9,7,36,37,2,1,February,0.8660254037844386,0.5000000000000001,24,14,1,3,1,1.8,1.8,24,26,-2,46,30,16,"February, 2001"
2000-2001,25,2001-02-07,Everton,Leeds,2,2,D,1,1,1,1,3,4,0,1,15,7,27,38,8,11,February,0.8660254037844386,0.5000000000000001,18,23,0,3,2,1.0,1.6,26,37,-11,37,33,4,"February, 2001"
2000-2001,26,2001-02-10,Man City,Tottenham,0,1,A,0,3,2,1,2,1,1,3,18,12,23,33,6,10,February,0.8660254037844386,0.5000000000000001,27,42,0,2,1,0.3333333333333333,0.6666666666666666,30,45,-15,30,34,-4,"February, 2001"
2000-2001,26,2001-02-10,Sunderland,Liverpool,1,1,D,1,1,2,2,1,4,1,0,4,3,43,44,1,1,February,0.8660254037844386,0.5000000000000001,40,25,0,3,2,0.6,1.2,31,24,7,46,27,19,"February, 2001"
2000-2001,26,2001-02-10,Southampton,Bradford,2,0,H,3,0,2,1,2,0,2,3,13,20,32,16,7,16,February,0.8660254037844386,0.5000000000000001,38,8,3,0,0,1.3333333333333333,0.3333333333333333,29,34,-5,16,46,-30,"February, 2001"
2000-2001,26,2001-02-10,Leeds,Derby,0,0,D,1,1,4,0,1,2,1,2,6,17,39,27,11,12,February,0.8660254037844386,0.5000000000000001,23,17,2,3,0,1.6,0.8,39,35,4,27,43,-16,"February, 2001"
2000-2001,26,2001-02-10,Arsenal,Ipswich,1,0,H,3,0,3,1,1,3,1,1,2,5,47,40,3,7,February,0.8660254037844386,0.5000000000000001,0,22,0,1,0,1.0,1.0,42,23,19,37,32,5,"February, 2001"
2000-2001,26,2001-02-10,Chelsea,Man United,1,1,D,1,1,2,1,2,1,1,3,8,1,37,62,7,25,February,0.8660254037844386,0.5000000000000001,14,28,1,3,1,2.2,1.4,47,32,15,58,16,42,"February, 2001"
2000-2001,26,2001-02-10,Aston Villa,Middlesbrough,1,1,D,1,1,1,3,1,2,1,2,12,17,32,26,5,6,February,0.8660254037844386,0.5000000000000001,1,29,3,2,0,1.8,0.4,27,26,1,30,33,-3,"February, 2001"
2000-2001,26,2001-02-10,Everton,Leicester,2,1,H,3,0,1,1,3,1,0,4,15,7,28,39,8,11,February,0.8660254037844386,0.5000000000000001,18,24,0,4,1,0.8,1.2,28,39,-11,26,27,-1,"February, 2001"
2000-2001,26,2001-02-11,Charlton,Newcastle,2,0,H,3,0,2,1,2,2,2,1,10,9,37,37,1,0,February,0.8660254037844386,0.5000000000000001,13,30,1,2,0,1.0,0.6666666666666666,34,38,-4,32,35,-3,"February, 2001"
2000-2001,26,2001-02-12,West Ham,Coventry,1,1,D,1,1,1,0,4,1,1,3,14,19,31,21,5,10,February,0.8660254037844386,0.5000000000000001,45,15,3,1,1,2.0,0.2,32,30,2,23,45,-22,"February, 2001"
2000-2001,27,2001-02-24,Tottenham,Leeds,1,2,A,0,3,1,1,3,4,0,1,12,8,36,40,4,4,February,0.8660254037844386,0.5000000000000001,42,23,0,1,4,1.4,2.4,31,34,-3,39,35,4,"February, 2001"
2000-2001,27,2001-02-24,Newcastle,Man City,0,1,A,0,3,2,2,1,2,1,2,11,18,37,23,7,14,February,0.8660254037844386,0.5000000000000001,30,27,2,1,0,2.333333333333333,1.3333333333333333,32,37,-5,30,46,-16,"February, 2001"
2000-2001,27,2001-02-24,Middlesbrough,Southampton,0,1,A,0,3,2,1,2,2,1,2,17,13,27,35,4,8,February,0.8660254037844386,0.5000000000000001,29,38,3,2,0,2.6,1.4,31,34,-3,31,34,-3,"February, 2001"
2000-2001,27,2001-02-24,Leicester,Sunderland,2,0,H,3,0,1,0,4,2,2,1,8,4,39,44,4,5,February,0.8660254037844386,0.5000000000000001,24,40,1,3,1,1.2,1.0,27,29,-2,32,25,7,"February, 2001"
2000-2001,27,2001-02-24,Ipswich,Everton,2,0,H,3,0,3,1,1,1,1,3,7,15,40,31,8,9,February,0.8660254037844386,0.5000000000000001,22,18,1,0,0,3.0,0.0,37,33,4,30,40,-10,"February, 2001"
2000-2001,27,2001-02-24,Coventry,Charlton,2,2,D,1,1,1,1,3,2,1,2,19,7,22,40,12,18,February,0.8660254037844386,0.5000000000000001,15,13,1,2,0,1.6666666666666667,1.3333333333333333,24,46,-22,36,38,-2,"February, 2001"
2000-2001,27,2001-02-24,Bradford,West Ham,1,2,A,0,3,0,2,3,1,0,4,20,14,16,32,6,16,February,0.8660254037844386,0.5000000000000001,8,45,0,1,2,1.6666666666666667,3.0,16,48,-32,33,31,2,"February, 2001"
2000-2001,27,2001-02-24,Derby,Aston Villa,1,0,H,3,0,2,1,2,1,3,1,16,14,28,33,2,5,February,0.8660254037844386,0.5000000000000001,17,1,1,0,4,0.6,2.0,27,43,-16,28,27,1,"February, 2001"
2000-2001,27,2001-02-25,Man United,Arsenal,6,1,H,3,0,1,1,3,3,1,1,1,2,63,50,1,13,February,0.8660254037844386,0.5000000000000001,28,0,1,2,2,0.8,1.4,59,17,42,43,23,20,"February, 2001"
2000-2001,28,2001-03-03,Man City,Southampton,0,1,A,0,3,2,1,2,2,1,2,18,10,26,38,8,12,March,1.0,6.123233995736766e-17,27,38,2,1,0,1.6666666666666667,0.6666666666666666,31,46,-15,32,34,-2,"March, 2001"
2000-2001,28,2001-03-03,Middlesbrough,Charlton,0,0,D,1,1,2,1,2,2,1,2,17,9,27,41,8,14,March,1.0,6.123233995736766e-17,29,13,1,1,1,1.0,0.6666666666666666,31,35,-4,38,40,-2,"March, 2001"
2000-2001,28,2001-03-03,Leicester,Liverpool,2,0,H,3,0,1,0,4,4,1,0,7,3,42,45,4,3,March,1.0,6.123233995736766e-17,24,25,3,1,1,1.2,0.6,29,29,0,47,28,19,"March, 2001"
2000-2001,28,2001-03-03,Leeds,Man United,1,1,D,1,1,4,0,1,1,1,3,6,1,43,66,5,23,March,1.0,6.123233995736766e-17,23,28,0,1,4,0.6,2.0,41,36,5,65,18,47,"March, 2001"
2000-2001,28,2001-03-03,Everton,Newcastle,1,1,D,1,1,1,1,3,2,2,1,16,11,31,37,5,6,March,1.0,6.123233995736766e-17,18,30,3,1,1,1.2,0.8,30,42,-12,32,38,-6,"March, 2001"
2000-2001,28,2001-03-03,Derby,Tottenham,2,1,H,3,0,2,1,2,1,1,3,16,12,31,36,4,5,March,1.0,6.123233995736766e-17,17,42,0,2,3,0.6,1.4,28,43,-15,32,36,-4,"March, 2001"
2000-2001,28,2001-03-03,Coventry,Chelsea,0,0,D,1,1,1,1,3,2,1,2,19,9,23,38,10,15,March,1.0,6.123233995736766e-17,15,14,1,1,3,1.4,2.6,26,48,-22,48,33,15,"March, 2001"
2000-2001,28,2001-03-03,Arsenal,West Ham,3,0,H,3,0,3,1,1,1,0,4,2,13,50,35,11,15,March,1.0,6.123233995736766e-17,0,45,4,0,1,2.0,0.8,44,29,15,35,32,3,"March, 2001"
2000-2001,28,2001-03-04,Ipswich,Bradford,3,1,H,3,0,3,1,1,0,2,3,7,20,43,16,13,27,March,1.0,6.123233995736766e-17,22,8,1,0,0,2.0,0.0,39,33,6,17,50,-33,"March, 2001"
2000-2001,28,2001-03-05,Sunderland,Aston Villa,1,1,D,1,1,2,2,1,1,3,1,7,15,44,33,8,11,March,1.0,6.123233995736766e-17,40,1,2,2,1,0.8,0.6,32,27,5,28,28,0,"March, 2001"
2000-2001,28,2001-03-07,West Ham,Chelsea,0,2,A,0,3,1,0,4,2,1,2,13,10,35,39,3,4,March,1.0,6.123233995736766e-17,45,14,1,3,1,0.8,1.0,35,35,0,48,33,15,"March, 2001"
2000-2001,28,2001-03-10,Aston Villa,Ipswich,2,1,H,3,0,1,3,1,3,1,1,14,3,34,46,11,12,March,1.0,6.123233995736766e-17,1,22,1,0,0,2.0,1.0,29,29,0,42,34,8,"March, 2001"
2000-2001,29,2001-03-17,West Ham,Ipswich,0,1,A,0,3,1,0,4,3,1,1,14,5,35,46,9,11,March,1.0,6.123233995736766e-17,45,22,0,1,0,1.0,1.0,35,37,-2,43,36,7,"March, 2001"
2000-2001,29,2001-03-17,Tottenham,Coventry,3,0,H,3,0,1,1,3,1,1,3,13,19,36,24,6,12,March,1.0,6.123233995736766e-17,42,15,2,2,1,1.2,1.0,33,38,-5,26,48,-22,"March, 2001"
2000-2001,29,2001-03-17,Southampton,Everton,1,0,H,3,0,2,1,2,1,1,3,10,16,41,32,6,9,March,1.0,6.123233995736766e-17,38,18,2,1,2,1.2,1.2,33,34,-1,31,43,-12,"March, 2001"
2000-2001,29,2001-03-17,Newcastle,Middlesbrough,1,2,A,0,3,2,2,1,2,1,2,11,17,38,28,6,10,March,1.0,6.123233995736766e-17,30,29,2,3,0,2.0,1.4,33,39,-6,31,35,-4,"March, 2001"
2000-2001,29,2001-03-17,Chelsea,Sunderland,2,4,A,0,3,2,1,2,2,2,1,8,6,42,45,2,3,March,1.0,6.123233995736766e-17,14,40,2,0,3,2.2,2.0,50,33,17,33,28,5,"March, 2001"
2000-2001,29,2001-03-17,Charlton,Leeds,1,2,A,0,3,2,1,2,4,0,1,9,7,42,44,2,2,March,1.0,6.123233995736766e-17,13,23,0,1,2,1.0,2.6666666666666665,38,40,-2,42,37,5,"March, 2001"
2000-2001,29,2001-03-17,Bradford,Man City,2,2,D,1,1,0,2,3,2,1,2,20,18,16,26,2,10,March,1.0,6.123233995736766e-17,8,27,0,0,1,0.0,2.0,18,53,-35,31,47,-16,"March, 2001"
2000-2001,29,2001-03-17,Man United,Leicester,2,0,H,3,0,1,1,3,1,0,4,1,7,67,45,6,22,March,1.0,6.123233995736766e-17,28,24,4,1,0,3.0,0.8,66,19,47,31,29,2,"March, 2001"
2000-2001,29,2001-03-18,Aston Villa,Arsenal,0,0,D,1,1,1,3,1,3,1,1,13,2,37,53,11,16,March,1.0,6.123233995736766e-17,1,0,1,1,3,1.0,1.6,31,30,1,47,29,18,"March, 2001"
2000-2001,29,2001-03-18,Liverpool,Derby,1,1,D,1,1,4,1,0,2,1,2,6,15,45,34,9,11,March,1.0,6.123233995736766e-17,25,17,3,0,2,2.2,1.0,47,30,17,30,44,-14,"March, 2001"
2000-2001,30,2001-03-31,Man City,Aston Villa,1,3,A,0,3,2,1,2,1,3,1,18,13,27,38,5,11,March,1.0,6.123233995736766e-17,27,1,2,1,0,1.3333333333333333,0.6666666666666666,33,49,-16,31,30,1,"March, 2001"
2000-2001,30,2001-03-31,West Ham,Everton,0,2,A,0,3,1,0,4,1,1,3,14,16,35,32,2,3,March,1.0,6.123233995736766e-17,45,18,1,1,3,0.6,2.6,35,38,-3,31,44,-13,"March, 2001"
2000-2001,30,2001-03-31,Sunderland,Leeds,0,2,A,0,3,2,2,1,4,0,1,5,6,48,47,1,1,March,1.0,6.123233995736766e-17,40,23,0,0,5,0.4,2.0,37,30,7,44,38,6,"March, 2001"
2000-2001,30,2001-03-31,Liverpool,Man United,2,0,H,3,0,4,1,0,1,1,3,6,1,46,70,5,24,March,1.0,6.123233995736766e-17,25,28,1,2,2,1.2,1.6,48,31,17,68,19,49,"March, 2001"
2000-2001,30,2001-03-31,Chelsea,Middlesbrough,2,1,H,3,0,2,1,2,2,1,2,9,17,42,31,8,11,March,1.0,6.123233995736766e-17,14,29,2,2,1,0.8,0.4,52,37,15,33,36,-3,"March, 2001"
2000-2001,30,2001-03-31,Bradford,Newcastle,2,2,D,1,1,0,2,3,2,2,1,20,13,17,38,7,21,March,1.0,6.123233995736766e-17,8,30,1,0,2,1.0,1.3333333333333333,20,55,-35,34,41,-7,"March, 2001"
2000-2001,30,2001-03-31,Arsenal,Tottenham,2,0,H,3,0,3,1,1,1,1,3,2,11,54,39,9,15,March,1.0,6.123233995736766e-17,0,42,2,2,1,1.4,1.0,47,29,18,36,38,-2,"March, 2001"
2000-2001,30,2001-03-31,Coventry,Derby,2,0,H,3,0,1,1,3,2,1,2,19,15,24,35,4,11,March,1.0,6.123233995736766e-17,15,17,1,3,1,0.6,0.4,26,51,-25,31,45,-14,"March, 2001"
2000-2001,30,2001-04-01,Charlton,Leicester,2,0,H,3,0,2,1,2,1,0,4,10,8,42,45,2,3,April,0.8660254037844388,-0.4999999999999998,13,24,0,2,1,0.6666666666666666,1.3333333333333333,39,42,-3,31,31,0,"April, 2001"
2000-2001,30,2001-04-02,Southampton,Ipswich,0,3,A,0,3,2,1,2,3,1,1,10,5,44,49,5,5,April,0.8660254037844388,-0.4999999999999998,38,22,0,0,1,1.0,3.0,34,34,0,44,36,8,"April, 2001"
2000-2001,30,2001-04-04,Aston Villa,Leicester,2,1,H,3,0,1,3,1,1,0,4,11,9,41,45,2,4,April,0.8660254037844388,-0.4999999999999998,1,24,0,4,1,1.2,1.6,34,31,3,31,33,-2,"April, 2001"
2000-2001,31,2001-04-07,Leicester,Coventry,1,3,A,0,3,1,0,4,1,1,3,10,19,45,27,9,18,April,0.8660254037844388,-0.4999999999999998,24,15,3,1,1,0.8,0.4,32,35,-3,28,51,-23,"April, 2001"
2000-2001,31,2001-04-07,Aston Villa,West Ham,2,2,D,1,1,1,3,1,1,0,4,10,14,44,35,4,9,April,0.8660254037844388,-0.4999999999999998,1,45,0,5,0,0.8,0.8,36,32,4,35,40,-5,"April, 2001"
2000-2001,31,2001-04-07,Derby,Chelsea,0,4,A,0,3,2,1,2,2,1,2,16,7,35,45,9,10,April,0.8660254037844388,-0.4999999999999998,17,14,1,1,3,1.4,2.6,31,47,-16,54,38,16,"April, 2001"
2000-2001,31,2001-04-07,Leeds,Southampton,2,0,H,3,0,4,0,1,2,1,2,4,11,50,44,7,6,April,0.8660254037844388,-0.4999999999999998,23,38,3,0,2,1.4,0.8,46,38,8,34,37,-3,"April, 2001"
2000-2001,31,2001-04-08,Everton,Man City,3,1,H,3,0,1,1,3,2,1,2,15,19,35,27,4,8,April,0.8660254037844388,-0.4999999999999998,18,27,2,0,1,1.3333333333333333,1.6666666666666667,33,44,-11,34,52,-18,"April, 2001"
2000-2001,31,2001-04-09,Middlesbrough,Sunderland,0,0,D,1,1,2,1,2,2,2,1,17,7,31,48,10,17,April,0.8660254037844388,-0.4999999999999998,29,40,0,3,2,0.8,1.2,34,38,-4,37,32,5,"April, 2001"
2000-2001,31,2001-04-10,Ipswich,Liverpool,1,1,D,1,1,3,1,1,4,1,0,4,5,52,49,1,3,April,0.8660254037844388,-0.4999999999999998,22,25,1,0,0,1.0,0.0,47,36,11,50,31,19,"April, 2001"
2000-2001,31,2001-04-10,Man United,Charlton,2,1,H,3,0,1,1,3,2,1,2,1,9,70,45,8,25,April,0.8660254037844388,-0.4999999999999998,28,13,2,1,0,2.6666666666666665,1.3333333333333333,68,21,47,41,42,-1,"April, 2001"
2000-2001,31,2001-04-10,Tottenham,Bradford,2,1,H,3,0,1,1,3,0,2,3,12,20,39,18,8,21,April,0.8660254037844388,-0.4999999999999998,42,8,0,3,0,1.6666666666666667,1.6666666666666667,36,40,-4,22,57,-35,"April, 2001"
2000-2001,31,2001-04-11,Man City,Arsenal,0,4,A,0,3,2,1,2,3,1,1,19,2,27,57,17,30,April,0.8660254037844388,-0.4999999999999998,27,0,0,0,3,0.3333333333333333,3.0,35,55,-20,49,29,20,"April, 2001"
2000-2001,32,2001-04-13,Liverpool,Leeds,1,2,A,0,3,4,1,0,4,0,1,5,4,50,53,1,3,April,0.8660254037844388,-0.4999999999999998,25,23,2,1,2,1.8,1.8,51,32,19,48,38,10,"April, 2001"
2000-2001,32,2001-04-13,Bradford,Charlton,2,0,H,3,0,0,2,3,2,1,2,20,9,18,45,11,27,April,0.8660254037844388,-0.4999999999999998,8,13,0,0,1,0.0,2.0,23,59,-36,42,44,-2,"April, 2001"
2000-2001,32,2001-04-14,Sunderland,Tottenham,2,3,A,0,3,2,2,1,1,1,3,7,12,49,42,5,7,April,0.8660254037844388,-0.4999999999999998,40,42,1,0,4,0.8,2.4,37,32,5,38,41,-3,"April, 2001"
2000-2001,32,2001-04-14,Man United,Coventry,4,2,H,3,0,1,1,3,1,1,3,1,18,73,30,17,43,April,0.8660254037844388,-0.4999999999999998,28,15,5,0,0,2.0,0.8,70,22,48,31,52,-21,"April, 2001"
2000-2001,32,2001-04-14,West Ham,Derby,3,1,H,3,0,1,0,4,2,1,2,15,17,36,35,2,1,April,0.8660254037844388,-0.4999999999999998,45,17,3,2,0,2.0,0.6,37,42,-5,31,51,-20,"April, 2001"
2000-2001,32,2001-04-14,Leicester,Man City,1,2,A,0,3,1,0,4,2,1,2,10,19,45,27,9,18,April,0.8660254037844388,-0.4999999999999998,24,27,1,0,0,1.0,0.0,33,38,-5,35,59,-24,"April, 2001"
2000-2001,32,2001-04-14,Chelsea,Southampton,1,0,H,3,0,2,1,2,2,1,2,7,11,48,44,4,4,April,0.8660254037844388,-0.4999999999999998,14,38,3,1,1,1.6,1.0,58,38,20,34,39,-5,"April, 2001"
2000-2001,32,2001-04-14,Aston Villa,Everton,2,1,H,3,0,1,3,1,1,1,3,8,14,45,38,6,7,April,0.8660254037844388,-0.4999999999999998,1,18,3,2,0,1.4,0.0,38,34,4,36,45,-9,"April, 2001"
2000-2001,32,2001-04-14,Arsenal,Middlesbrough,0,3,A,0,3,3,1,1,2,1,2,2,17,60,32,15,28,April,0.8660254037844388,-0.4999999999999998,0,29,3,1,1,2.8,1.0,53,29,24,34,38,-4,"April, 2001"
2000-2001,32,2001-04-14,Ipswich,Newcastle,1,0,H,3,0,3,1,1,2,2,1,4,13,53,39,9,14,April,0.8660254037844388,-0.4999999999999998,22,30,0,0,1,1.0,2.0,48,37,11,36,43,-7,"April, 2001"
2000-2001,33,2001-04-16,Coventry,Sunderland,1,0,H,3,0,1,1,3,2,2,1,19,7,30,49,12,19,April,0.8660254037844388,-0.4999999999999998,15,40,1,2,2,1.2,1.4,33,56,-23,39,35,4,"April, 2001"
2000-2001,33,2001-04-16,Derby,Leicester,2,0,H,3,0,2,1,2,1,0,4,17,11,35,45,6,10,April,0.8660254037844388,-0.4999999999999998,17,24,4,0,1,1.8,0.6,32,54,-22,34,40,-6,"April, 2001"
2000-2001,33,2001-04-16,Everton,Liverpool,2,3,A,0,3,1,1,3,4,1,0,15,6,38,50,9,12,April,0.8660254037844388,-0.4999999999999998,18,25,1,2,2,0.8,1.2,37,47,-10,52,34,18,"April, 2001"
2000-2001,33,2001-04-16,Middlesbrough,Ipswich,1,2,A,0,3,2,1,2,3,1,1,17,3,35,56,14,21,April,0.8660254037844388,-0.4999999999999998,29,22,0,0,1,1.0,2.0,37,38,-1,49,37,12,"April, 2001"
2000-2001,33,2001-04-16,Newcastle,West Ham,2,1,H,3,0,2,2,1,1,0,4,14,13,39,39,1,0,April,0.8660254037844388,-0.4999999999999998,30,45,0,1,4,0.6,2.0,36,44,-8,40,43,-3,"April, 2001"
2000-2001,33,2001-04-17,Charlton,Aston Villa,3,3,D,1,1,2,1,2,1,3,1,10,8,45,48,2,3,April,0.8660254037844388,-0.4999999999999998,13,1,1,0,2,1.6666666666666667,2.0,42,46,-4,40,35,5,"April, 2001"
2000-2001,33,2001-04-17,Tottenham,Chelsea,0,3,A,0,3,1,1,3,2,1,2,10,6,45,51,4,6,April,0.8660254037844388,-0.4999999999999998,42,14,0,1,4,0.4,1.8,41,43,-2,59,38,21,"April, 2001"
2000-2001,34,2001-04-21,Sunderland,Newcastle,1,1,D,1,1,2,2,1,2,2,1,8,13,49,42,5,7,April,0.8660254037844388,-0.4999999999999998,40,30,2,2,1,1.6,1.4,39,36,3,38,45,-7,"April, 2001"
2000-2001,34,2001-04-21,West Ham,Leeds,0,2,A,0,3,1,0,4,4,0,1,14,4,39,56,10,17,April,0.8660254037844388,-0.4999999999999998,45,23,1,1,3,0.4,2.0,41,45,-4,50,39,11,"April, 2001"
2000-2001,34,2001-04-21,Man United,Man City,1,1,D,1,1,1,1,3,2,1,2,1,19,76,30,18,46,April,0.8660254037844388,-0.4999999999999998,28,27,3,0,0,1.6666666666666667,0.6666666666666666,74,24,50,37,60,-23,"April, 2001"
2000-2001,34,2001-04-21,Leicester,Middlesbrough,0,3,A,0,3,1,0,4,2,1,2,12,17,45,35,5,10,April,0.8660254037844388,-0.4999999999999998,24,29,3,1,1,1.6,0.4,34,42,-8,38,40,-2,"April, 2001"
2000-2001,34,2001-04-21,Aston Villa,Southampton,0,0,D,1,1,1,3,1,2,1,2,7,12,49,44,5,5,April,0.8660254037844388,-0.4999999999999998,1,38,2,0,3,1.4,1.2,43,38,5,34,40,-6,"April, 2001"
2000-2001,34,2001-04-21,Chelsea,Charlton,0,1,A,0,3,2,1,2,2,1,2,5,9,54,46,4,8,April,0.8660254037844388,-0.4999999999999998,14,13,2,0,1,1.0,1.0,62,38,24,45,49,-4,"April, 2001"
2000-2001,34,2001-04-21,Bradford,Derby,2,0,H,3,0,0,2,3,2,1,2,20,16,21,38,4,17,April,0.8660254037844388,-0.4999999999999998,8,17,1,1,1,1.6666666666666667,2.0,25,59,-34,34,54,-20,"April, 2001"
2000-2001,34,2001-04-21,Arsenal,Everton,4,1,H,3,0,3,1,1,1,1,3,2,15,60,38,13,22,April,0.8660254037844388,-0.4999999999999998,0,18,4,0,1,1.6,0.6,53,32,21,39,50,-11,"April, 2001"
2000-2001,34,2001-04-21,Ipswich,Coventry,2,0,H,3,0,3,1,1,1,1,3,3,18,59,33,15,26,April,0.8660254037844388,-0.4999999999999998,22,15,1,0,0,1.0,0.0,51,38,13,34,56,-22,"April, 2001"
2000-2001,34,2001-04-22,Liverpool,Tottenham,3,1,H,3,0,4,1,0,1,1,3,6,10,53,45,4,8,April,0.8660254037844388,-0.4999999999999998,25,42,2,0,3,1.4,1.4,55,36,19,41,46,-5,"April, 2001"
2000-2001,35,2001-04-28,Tottenham,Aston Villa,0,0,D,1,1,1,1,3,1,3,1,11,8,45,50,3,5,April,0.8660254037844388,-0.4999999999999998,42,1,1,1,3,1.2,2.0,42,49,-7,43,38,5,"April, 2001"
2000-2001,35,2001-04-28,Newcastle,Leicester,1,0,H,3,0,2,2,1,1,0,4,13,12,43,45,1,2,April,0.8660254037844388,-0.4999999999999998,30,24,2,1,2,0.8,1.2,39,46,-7,34,45,-11,"April, 2001"
2000-2001,35,2001-04-28,Southampton,Sunderland,0,1,A,0,3,2,1,2,2,2,1,11,8,45,50,3,5,April,0.8660254037844388,-0.4999999999999998,38,40,2,1,2,1.4,1.2,34,40,-6,40,37,3,"April, 2001"
2000-2001,35,2001-04-28,Middlesbrough,Man United,0,2,A,0,3,2,1,2,1,1,3,16,1,38,77,15,39,April,0.8660254037844388,-0.4999999999999998,29,28,1,0,4,1.4,2.0,41,40,1,75,25,50,"April, 2001"
2000-2001,35,2001-04-28,Coventry,Liverpool,0,2,A,0,3,1,1,3,4,1,0,18,5,33,56,13,23,April,0.8660254037844388,-0.4999999999999998,15,25,1,0,4,0.6,2.4,34,58,-24,58,37,21,"April, 2001"
2000-2001,35,2001-04-28,Leeds,Chelsea,2,0,H,3,0,4,0,1,2,1,2,5,6,59,54,1,5,April,0.8660254037844388,-0.4999999999999998,23,14,1,2,2,0.6,0.6,52,39,13,62,39,23,"April, 2001"
2000-2001,35,2001-04-28,Everton,Bradford,2,1,H,3,0,1,1,3,0,2,3,16,20,38,24,4,14,April,0.8660254037844388,-0.4999999999999998,18,8,2,1,0,1.6666666666666667,0.0,40,54,-14,27,59,-32,"April, 2001"
2000-2001,35,2001-04-28,Derby,Arsenal,1,2,A,0,3,2,1,2,3,1,1,17,2,38,63,15,25,April,0.8660254037844388,-0.4999999999999998,17,0,0,2,3,0.4,1.0,34,56,-22,57,33,24,"April, 2001"
2000-2001,35,2001-04-28,Man City,West Ham,1,0,H,3,0,2,1,2,1,0,4,19,15,31,39,4,8,April,0.8660254037844388,-0.4999999999999998,27,45,1,0,2,1.6666666666666667,3.0,38,61,-23,41,47,-6,"April, 2001"
2000-2001,36,2001-04-30,Charlton,Ipswich,2,1,H,3,0,2,1,2,3,1,1,9,4,49,62,5,13,April,0.8660254037844388,-0.4999999999999998,13,22,0,0,1,0.0,2.0,46,49,-3,53,38,15,"April, 2001"
2000-2001,36,2001-05-01,Bradford,Liverpool,0,2,A,0,3,0,2,3,4,1,0,20,5,24,59,15,35,May,0.4999999999999999,-0.8660254037844387,8,25,1,0,2,0.6666666666666666,1.3333333333333333,28,61,-33,60,37,23,"May, 2001"
2000-2001,36,2001-05-01,Newcastle,Southampton,1,1,D,1,1,2,2,1,2,1,2,10,12,46,45,2,1,May,0.4999999999999999,-0.8660254037844387,30,38,2,0,3,2.4,1.6,40,46,-6,34,41,-7,"May, 2001"
2000-2001,37,2001-05-05,Liverpool,Newcastle,3,0,H,3,0,4,1,0,2,2,1,3,11,62,47,8,15,May,0.4999999999999999,-0.8660254037844387,25,30,3,1,1,2.6,1.6,62,37,25,41,47,-6,"May, 2001"
2000-2001,37,2001-05-05,Sunderland,Charlton,3,2,H,3,0,2,2,1,2,1,2,8,9,53,52,1,1,May,0.4999999999999999,-0.8660254037844387,40,13,1,0,0,1.0,0.0,41,37,4,48,50,-2,"May, 2001"
2000-2001,37,2001-05-05,Man United,Derby,0,1,A,0,3,1,1,3,2,1,2,1,17,80,38,16,42,May,0.4999999999999999,-0.8660254037844387,28,17,4,1,0,2.0,0.6,77,25,52,35,58,-23,"May, 2001"
2000-2001,37,2001-05-05,Leicester,Tottenham,4,2,H,3,0,1,0,4,1,1,3,13,11,45,46,2,1,May,0.4999999999999999,-0.8660254037844387,24,42,3,0,2,1.4,1.4,34,46,-12,42,49,-7,"May, 2001"
2000-2001,37,2001-05-05,West Ham,Southampton,3,0,H,3,0,1,0,4,2,1,2,17,12,39,46,5,7,May,0.4999999999999999,-0.8660254037844387,45,38,3,0,2,1.4,1.0,41,48,-7,35,42,-7,"May, 2001"
2000-2001,37,2001-05-05,Bradford,Middlesbrough,1,1,D,1,1,0,2,3,2,1,2,20,16,24,38,4,14,May,0.4999999999999999,-0.8660254037844387,8,29,1,2,0,1.3333333333333333,1.0,28,63,-35,41,42,-1,"May, 2001"
2000-2001,37,2001-05-05,Aston Villa,Coventry,3,2,H,3,0,1,3,1,1,1,3,9,19,51,33,10,18,May,0.4999999999999999,-0.8660254037844387,1,15,2,1,2,1.2,1.6,43,38,5,34,60,-26,"May, 2001"
2000-2001,37,2001-05-05,Arsenal,Leeds,2,1,H,3,0,3,1,1,4,0,1,2,4,66,62,2,4,May,0.4999999999999999,-0.8660254037844387,0,23,3,0,2,1.8,0.6,59,34,25,54,39,15,"May, 2001"
2000-2001,37,2001-05-05,Chelsea,Everton,2,1,H,3,0,2,1,2,1,1,3,6,14,54,41,8,13,May,0.4999999999999999,-0.8660254037844387,14,18,1,3,1,1.2,1.0,62,41,21,42,55,-13,"May, 2001"
2000-2001,37,2001-05-07,Ipswich,Man City,2,1,H,3,0,3,1,1,2,1,2,5,18,62,34,13,28,May,0.4999999999999999,-0.8660254037844387,22,27,1,0,0,3.0,2.0,54,40,14,39,61,-22,"May, 2001"
2000-2001,37,2001-05-08,Liverpool,Chelsea,2,2,D,1,1,4,1,0,2,1,2,3,6,65,57,3,8,May,0.4999999999999999,-0.8660254037844387,25,14,1,1,3,0.6,1.6,65,37,28,64,42,22,"May, 2001"
2000-2001,37,2001-05-13,Leeds,Bradford,6,1,H,3,0,4,0,1,0,2,3,5,20,62,25,15,37,May,0.4999999999999999,-0.8660254037844387,23,8,2,1,0,1.6666666666666667,1.0,55,41,14,29,64,-35,"May, 2001"
2000-2001,37,2001-05-13,Southampton,Man United,2,1,H,3,0,2,1,2,1,1,3,13,1,46,80,12,34,May,0.4999999999999999,-0.8660254037844387,38,28,0,1,4,1.0,3.2,35,45,-10,77,26,51,"May, 2001"
2000-2001,37,2001-05-15,Newcastle,Arsenal,0,0,D,1,1,2,2,1,3,1,1,12,2,47,69,10,22,May,0.4999999999999999,-0.8660254037844387,30,0,1,2,2,1.0,2.2,41,50,-9,61,35,26,"May, 2001"
2000-2001,38,2001-05-19,Charlton,Liverpool,0,4,A,0,3,2,1,2,4,1,0,9,3,52,66,6,14,May,0.4999999999999999,-0.8660254037844387,13,25,1,1,1,1.3333333333333333,2.0,50,53,-3,67,39,28,"May, 2001"
2000-2001,38,2001-05-19,Coventry,Bradford,0,0,D,1,1,1,1,3,0,2,3,19,20,33,25,1,8,May,0.4999999999999999,-0.8660254037844387,15,8,1,1,1,2.0,1.0,36,63,-27,30,70,-40,"May, 2001"
2000-2001,38,2001-05-19,Derby,Ipswich,1,1,D,1,1,2,1,2,3,1,1,16,5,41,65,11,24,May,0.4999999999999999,-0.8660254037844387,17,22,1,0,0,1.0,0.0,36,58,-22,56,41,15,"May, 2001"
2000-2001,38,2001-05-19,Everton,Sunderland,2,2,D,1,1,1,1,3,2,2,1,16,7,41,56,9,15,May,0.4999999999999999,-0.8660254037844387,18,40,1,0,4,1.4,2.0,43,57,-14,44,39,5,"May, 2001"
2000-2001,38,2001-05-19,Leeds,Leicester,3,1,H,3,0,4,0,1,1,0,4,5,12,65,48,7,17,May,0.4999999999999999,-0.8660254037844387,23,24,2,0,3,1.2,1.6,61,42,19,38,48,-10,"May, 2001"
2000-2001,38,2001-05-19,Man City,Chelsea,1,2,A,0,3,2,1,2,2,1,2,18,6,34,58,12,24,May,0.4999999999999999,-0.8660254037844387,27,14,0,1,2,0.6666666666666666,1.3333333333333333,40,63,-23,66,44,22,"May, 2001"
2000-2001,38,2001-05-19,Middlesbrough,West Ham,2,1,H,3,0,2,1,2,1,0,4,17,14,39,42,3,3,May,0.4999999999999999,-0.8660254037844387,29,45,3,0,2,0.8,1.0,42,43,-1,44,48,-4,"May, 2001"
2000-2001,38,2001-05-19,Newcastle,Aston Villa,3,0,H,3,0,2,2,1,1,3,1,11,8,48,54,3,6,May,0.4999999999999999,-0.8660254037844387,30,1,2,1,2,0.8,0.8,41,50,-9,46,40,6,"May, 2001"
2000-2001,38,2001-05-19,Southampton,Arsenal,3,2,H,3,0,2,1,2,3,1,1,11,2,49,70,9,21,May,0.4999999999999999,-0.8660254037844387,38,0,0,2,3,0.4,1.2,37,46,-9,61,35,26,"May, 2001"
2000-2001,38,2001-05-19,Tottenham,Man United,3,1,H,3,0,1,1,3,1,1,3,13,1,46,80,12,34,May,0.4999999999999999,-0.8660254037844387,42,28,1,1,3,1.4,2.0,44,53,-9,78,28,50,"May, 2001"
2001-2002,1,2001-08-18,Tottenham,Aston Villa,0,0,D,1,1,1,2,2,2,1,2,13,8,0,0,5,0,August,-0.8660254037844384,-0.5000000000000004,42,1,1,2,2,0.8,1.4,0,0,0,0,0,0,"August, 2001"
2001-2002,1,2001-08-18,Middlesbrough,Arsenal,0,4,A,0,3,1,0,4,5,0,0,12,6,0,0,6,0,August,-0.8660254037844384,-0.5000000000000004,29,0,2,0,3,1.4,2.6,0,0,0,0,0,0,"August, 2001"
2001-2002,1,2001-08-18,Liverpool,West Ham,2,1,H,3,0,4,0,1,2,1,2,10,16,0,0,6,0,August,-0.8660254037844384,-0.5000000000000004,25,45,2,2,1,1.4,0.8,0,0,0,0,0,0,"August, 2001"
2001-2002,1,2001-08-18,Sunderland,Ipswich,1,0,H,3,0,0,2,3,1,0,4,13,10,0,0,3,0,August,-0.8660254037844384,-0.5000000000000004,40,22,1,0,1,2.0,1.0,0,0,0,0,0,0,"August, 2001"
2001-2002,1,2001-08-18,Leeds,Southampton,2,0,H,3,0,4,0,1,2,1,2,9,15,0,0,6,0,August,-0.8660254037844384,-0.5000000000000004,23,38,3,0,2,1.2,0.8,0,0,0,0,0,0,"August, 2001"
2001-2002,1,2001-08-18,Derby,Blackburn,2,1,H,3,0,0,1,4,3,1,1,7,4,0,0,3,0,August,-0.8660254037844384,-0.5000000000000004,17,4,2,2,1,0.8,0.4,0,0,0,0,0,0,"August, 2001"
2001-2002,1,2001-08-18,Charlton,Everton,1,2,A,0,3,0,3,2,1,1,3,5,8,0,0,3,0,August,-0.8660254037844384,-0.5000000000000004,13,18,1,0,3,0.75,2.25,0,0,0,0,0,0,"August, 2001"
2001-2002,1,2001-08-18,Leicester,Bolton,0,5,A,0,3,1,3,1,1,1,3,10,6,0,0,4,0,August,-0.8660254037844384,-0.5000000000000004,24,6,0,1,1,0.0,1.0,0,0,0,0,0,0,"August, 2001"
2001-2002,1,2001-08-19,Chelsea,Newcastle,1,1,D,1,1,2,1,2,3,1,1,10,13,0,0,3,0,August,-0.8660254037844384,-0.5000000000000004,14,30,4,1,0,1.2,0.2,0,0,0,0,0,0,"August, 2001"
2001-2002,1,2001-08-19,Man United,Fulham,3,2,H,3,0,3,1,1,2,2,1,13,12,0,0,1,0,August,-0.8660254037844384,-0.5000000000000004,28,19,0,0,0,0.0,0.0,0,0,0,0,0,0,"August, 2001"
2001-2002,1,2001-08-20,Everton,Tottenham,1,1,D,1,1,1,1,3,1,2,2,6,12,3,1,6,2,August,-0.8660254037844384,-0.5000000000000004,18,42,0,2,3,1.4,2.4,2,1,1,0,0,0,"August, 2001"
2001-2002,1,2001-08-21,Arsenal,Leeds,1,2,A,0,3,5,0,0,4,0,1,3,4,3,3,1,0,August,-0.8660254037844384,-0.5000000000000004,0,23,3,0,2,1.6,0.6,4,0,4,2,0,2,"August, 2001"
2001-2002,1,2001-08-21,Bolton,Middlesbrough,1,0,H,3,0,1,1,3,1,0,4,3,19,3,0,16,3,August,-0.8660254037844384,-0.5000000000000004,6,29,1,1,0,2.5,1.0,5,0,5,0,4,-4,"August, 2001"
2001-2002,1,2001-08-21,Ipswich,Derby,3,1,H,3,0,1,0,4,0,1,4,17,6,0,3,11,3,August,-0.8660254037844384,-0.5000000000000004,22,17,0,1,1,0.5,1.0,0,1,-1,2,1,1,"August, 2001"
2001-2002,1,2001-08-22,Fulham,Sunderland,2,0,H,3,0,2,2,1,0,2,3,15,8,0,3,7,3,August,-0.8660254037844384,-0.5000000000000004,19,40,0,0,0,0.0,0.0,2,3,-1,1,0,1,"August, 2001"
2001-2002,1,2001-08-22,Blackburn,Man United,2,2,D,1,1,3,1,1,3,1,1,15,6,0,3,9,3,August,-0.8660254037844384,-0.5000000000000004,4,28,0,1,4,1.0,2.6,1,2,-1,3,2,1,"August, 2001"
2001-2002,2,2001-08-25,Arsenal,Leicester,4,0,H,3,0,5,0,0,1,3,1,5,19,3,0,14,3,August,-0.8660254037844384,-0.5000000000000004,0,24,4,1,0,3.2,0.4,5,2,3,0,5,-5,"August, 2001"
2001-2002,2,2001-08-25,Blackburn,Tottenham,2,1,H,3,0,3,1,1,1,2,2,15,11,1,2,4,1,August,-0.8660254037844384,-0.5000000000000004,4,42,0,2,3,0.6,1.6,3,4,-1,1,1,0,"August, 2001"
2001-2002,2,2001-08-25,Everton,Middlesbrough,2,0,H,3,0,1,1,3,1,0,4,5,19,4,0,14,4,August,-0.8660254037844384,-0.5000000000000004,18,29,2,1,2,2.0,1.4,3,2,1,0,5,-5,"August, 2001"
2001-2002,2,2001-08-25,Fulham,Derby,0,0,D,1,1,2,2,1,0,1,4,7,10,3,3,3,0,August,-0.8660254037844384,-0.5000000000000004,19,17,0,0,0,0.0,0.0,4,3,1,3,4,-1,"August, 2001"
2001-2002,2,2001-08-25,Ipswich,Charlton,0,1,A,0,3,1,0,4,0,3,2,9,16,3,0,7,3,August,-0.8660254037844384,-0.5000000000000004,22,13,1,0,1,1.5,1.0,3,2,1,1,2,-1,"August, 2001"
2001-2002,2,2001-08-25,Southampton,Chelsea,0,2,A,0,3,2,1,2,2,1,2,18,14,0,1,4,1,August,-0.8660254037844384,-0.5000000000000004,38,14,1,1,3,1.0,1.4,0,2,-2,1,1,0,"August, 2001"
2001-2002,2,2001-08-25,West Ham,Leeds,0,0,D,1,1,2,1,2,4,0,1,17,4,0,6,13,6,August,-0.8660254037844384,-0.5000000000000004,45,23,1,1,3,0.4,1.6,1,2,-1,4,1,3,"August, 2001"
2001-2002,2,2001-08-26,Aston Villa,Man United,1,1,D,1,1,2,1,2,3,1,1,16,6,1,4,10,3,August,-0.8660254037844384,-0.5000000000000004,1,28,0,0,5,0.2,1.8,0,0,0,5,4,1,"August, 2001"
2001-2002,2,2001-08-26,Newcastle,Sunderland,1,1,D,1,1,3,1,1,0,2,3,16,13,1,3,3,2,August,-0.8660254037844384,-0.5000000000000004,30,40,0,3,2,1.2,1.6,1,1,0,1,2,-1,"August, 2001"
2001-2002,2,2001-08-27,Bolton,Liverpool,2,1,H,3,0,1,1,3,4,0,1,4,11,6,3,7,3,August,-0.8660254037844384,-0.5000000000000004,6,25,0,1,3,1.0,2.25,6,0,6,2,1,1,"August, 2001"
2001-2002,3,2001-09-08,Man United,Everton,4,1,H,3,0,3,1,1,1,1,3,7,4,5,7,3,2,September,-1.0,-1.8369701987210287e-16,28,18,4,1,0,2.6,0.8,6,5,1,5,2,3,"September, 2001"
2001-2002,3,2001-09-08,Middlesbrough,Newcastle,1,4,A,0,3,1,0,4,3,1,1,20,15,0,2,5,2,September,-1.0,-1.8369701987210287e-16,29,30,1,2,2,1.4,1.8,0,7,-7,2,2,0,"September, 2001"
2001-2002,3,2001-09-08,Liverpool,Aston Villa,1,3,A,0,3,4,0,1,2,1,2,12,15,3,2,3,1,September,-1.0,-1.8369701987210287e-16,25,1,2,2,1,1.2,0.4,3,3,0,1,1,0,"September, 2001"
2001-2002,3,2001-09-08,Sunderland,Blackburn,1,0,H,3,0,0,2,3,3,1,1,13,11,4,4,2,0,September,-1.0,-1.8369701987210287e-16,40,4,0,1,1,0.0,0.5,2,3,-1,5,5,0,"September, 2001"
2001-2002,3,2001-09-08,Leeds,Bolton,0,0,D,1,1,4,0,1,1,1,3,4,1,7,9,3,2,September,-1.0,-1.8369701987210287e-16,23,6,3,0,1,1.75,0.75,4,1,3,8,1,7,"September, 2001"
2001-2002,3,2001-09-08,Chelsea,Arsenal,1,1,D,1,1,2,1,2,5,0,0,6,4,4,6,2,2,September,-1.0,-1.8369701987210287e-16,14,0,0,2,3,1.2,1.8,3,1,2,9,2,7,"September, 2001"
2001-2002,3,2001-09-08,Leicester,Ipswich,1,1,D,1,1,1,3,1,1,0,4,20,11,0,3,9,3,September,-1.0,-1.8369701987210287e-16,24,22,1,0,1,1.0,1.5,0,9,-9,3,3,0,"September, 2001"
2001-2002,3,2001-09-08,Derby,West Ham,0,0,D,1,1,0,1,4,2,1,2,9,17,4,1,8,3,September,-1.0,-1.8369701987210287e-16,17,45,0,2,3,0.8,2.2,3,4,-1,1,2,-1,"September, 2001"
2001-2002,3,2001-09-09,Charlton,Fulham,1,1,D,1,1,0,3,2,2,2,1,14,11,3,4,3,1,September,-1.0,-1.8369701987210287e-16,13,19,0,0,0,0.0,0.0,2,2,0,4,3,1,"September, 2001"
2001-2002,3,2001-09-09,Tottenham,Southampton,2,0,H,3,0,1,2,2,2,1,2,16,19,2,0,3,2,September,-1.0,-1.8369701987210287e-16,42,38,3,1,1,2.2,0.8,2,3,-1,0,4,-4,"September, 2001"
2001-2002,4,2001-09-15,Bolton,Southampton,0,1,A,0,3,1,1,3,2,1,2,1,19,10,0,18,10,September,-1.0,-1.8369701987210287e-16,6,38,1,1,2,0.25,0.5,8,1,7,0,6,-6,"September, 2001"
2001-2002,4,2001-09-15,Derby,Leicester,2,3,A,0,3,0,1,4,1,3,1,12,19,5,1,7,4,September,-1.0,-1.8369701987210287e-16,17,24,4,0,1,1.8,0.6,3,4,-1,1,10,-9,"September, 2001"
2001-2002,4,2001-09-15,Everton,Liverpool,1,3,A,0,3,1,1,3,4,0,1,5,17,7,3,12,4,September,-1.0,-1.8369701987210287e-16,18,25,1,1,3,1.2,1.8,6,6,0,4,6,-2,"September, 2001"
2001-2002,4,2001-09-15,Fulham,Arsenal,1,3,A,0,3,2,2,1,5,0,0,11,4,5,7,7,2,September,-1.0,-1.8369701987210287e-16,19,0,0,0,0,0.0,0.0,5,4,1,10,3,7,"September, 2001"
2001-2002,4,2001-09-15,Middlesbrough,West Ham,2,0,H,3,0,1,0,4,2,1,2,20,19,0,2,1,2,September,-1.0,-1.8369701987210287e-16,29,45,3,0,2,1.0,1.2,1,11,-10,1,2,-1,"September, 2001"
2001-2002,4,2001-09-15,Newcastle,Man United,4,3,H,3,0,3,1,1,3,1,1,8,3,5,8,5,3,September,-1.0,-1.8369701987210287e-16,30,28,1,1,3,1.2,2.0,6,3,3,10,6,4,"September, 2001"
2001-2002,4,2001-09-16,Tottenham,Chelsea,2,3,A,0,3,1,2,2,2,1,2,11,10,5,5,1,0,September,-1.0,-1.8369701987210287e-16,42,14,0,1,4,0.4,2.0,4,3,1,4,2,2,"September, 2001"
2001-2002,4,2001-09-16,Ipswich,Blackburn,1,1,D,1,1,1,0,4,3,1,1,14,15,4,4,1,0,September,-1.0,-1.8369701987210287e-16,22,4,0,0,0,0.0,0.0,4,4,0,5,6,-1,"September, 2001"
2001-2002,4,2001-09-16,Aston Villa,Sunderland,0,0,D,1,1,2,1,2,0,2,3,9,6,5,7,3,2,September,-1.0,-1.8369701987210287e-16,1,40,1,3,1,0.8,0.8,4,2,2,3,3,0,"September, 2001"
2001-2002,4,2001-09-16,Charlton,Leeds,0,2,A,0,3,0,3,2,4,0,1,15,5,4,8,10,4,September,-1.0,-1.8369701987210287e-16,13,23,0,1,3,1.0,2.5,3,3,0,4,1,3,"September, 2001"
2001-2002,4,2001-09-17,Leicester,Middlesbrough,1,2,A,0,3,1,3,1,1,0,4,17,19,4,3,2,1,September,-1.0,-1.8369701987210287e-16,24,29,3,1,1,1.6,0.8,4,12,-8,3,11,-8,"September, 2001"
2001-2002,4,2001-09-19,Blackburn,Bolton,1,1,D,1,1,3,1,1,1,1,3,14,3,5,10,11,5,September,-1.0,-1.8369701987210287e-16,4,6,2,0,2,2.0,1.5,6,7,-1,8,2,6,"September, 2001"
2001-2002,4,2001-09-19,Sunderland,Tottenham,1,2,A,0,3,0,2,3,1,2,2,7,13,8,5,6,3,September,-1.0,-1.8369701987210287e-16,40,42,1,0,4,1.2,2.6,3,3,0,6,6,0,"September, 2001"
2001-2002,5,2001-09-22,Man United,Ipswich,4,0,H,3,0,3,1,1,1,0,4,7,15,8,5,8,3,September,-1.0,-1.8369701987210287e-16,28,22,1,1,0,1.5,0.5,13,10,3,5,5,0,"September, 2001"
2001-2002,5,2001-09-22,Sunderland,Charlton,2,2,D,1,1,0,2,3,0,3,2,10,18,8,4,8,4,September,-1.0,-1.8369701987210287e-16,40,13,2,0,0,2.0,1.0,4,5,-1,3,5,-2,"September, 2001"
2001-2002,5,2001-09-22,Liverpool,Tottenham,1,0,H,3,0,4,0,1,1,2,2,12,8,6,8,4,2,September,-1.0,-1.8369701987210287e-16,25,42,3,0,2,1.8,1.2,7,7,0,8,7,1,"September, 2001"
2001-2002,5,2001-09-22,Leicester,Fulham,0,0,D,1,1,1,3,1,2,2,1,18,15,4,5,3,1,September,-1.0,-1.8369701987210287e-16,24,19,0,0,0,0.0,0.0,5,14,-9,6,7,-1,"September, 2001"
2001-2002,5,2001-09-22,Blackburn,Everton,1,0,H,3,0,3,1,1,1,1,3,12,9,6,7,3,1,September,-1.0,-1.8369701987210287e-16,4,18,2,1,2,1.2,1.0,7,8,-1,7,9,-2,"September, 2001"
2001-2002,5,2001-09-22,Arsenal,Bolton,1,1,D,1,1,5,0,0,1,1,3,3,1,10,11,2,1,September,-1.0,-1.8369701987210287e-16,0,6,3,0,1,1.75,0.75,13,4,9,9,3,6,"September, 2001"
2001-2002,5,2001-09-23,Chelsea,Middlesbrough,2,2,D,1,1,2,1,2,1,0,4,9,14,8,6,5,2,September,-1.0,-1.8369701987210287e-16,14,29,2,2,1,0.8,0.6,7,4,3,5,12,-7,"September, 2001"
2001-2002,5,2001-09-23,Leeds,Derby,3,0,H,3,0,4,0,1,0,1,4,4,16,11,5,12,6,September,-1.0,-1.8369701987210287e-16,23,17,2,3,0,1.2,0.4,6,1,5,5,7,-2,"September, 2001"
2001-2002,5,2001-09-23,West Ham,Newcastle,3,0,H,3,0,2,1,2,3,1,1,20,9,2,8,11,6,September,-1.0,-1.8369701987210287e-16,45,30,3,1,1,1.6,1.0,1,4,-3,10,6,4,"September, 2001"
2001-2002,5,2001-09-24,Southampton,Aston Villa,1,3,A,0,3,2,1,2,2,1,2,20,13,3,6,7,3,September,-1.0,-1.8369701987210287e-16,38,1,3,1,1,1.0,0.6,1,6,-5,4,2,2,"September, 2001"
2001-2002,5,2001-09-26,Newcastle,Leicester,1,0,H,3,0,3,1,1,1,3,1,10,19,8,5,9,3,September,-1.0,-1.8369701987210287e-16,30,24,2,1,2,0.8,1.2,10,9,1,5,14,-9,"September, 2001"
2001-2002,6,2001-09-29,Tottenham,Man United,3,5,A,0,3,1,2,2,3,1,1,12,5,8,11,7,3,September,-1.0,-1.8369701987210287e-16,42,28,2,0,3,1.6,1.8,8,8,0,17,10,7,"September, 2001"
2001-2002,6,2001-09-29,Middlesbrough,Southampton,1,3,A,0,3,1,0,4,2,1,2,14,20,7,3,6,4,September,-1.0,-1.8369701987210287e-16,29,38,3,1,1,2.0,1.0,7,14,-7,2,9,-7,"September, 2001"
2001-2002,6,2001-09-29,Everton,West Ham,5,0,H,3,0,1,1,3,2,1,2,13,16,7,5,3,2,September,-1.0,-1.8369701987210287e-16,18,45,4,1,0,2.8,0.2,7,10,-3,4,4,0,"September, 2001"
2001-2002,6,2001-09-29,Charlton,Leicester,2,0,H,3,0,0,3,2,1,3,1,16,19,5,5,3,0,September,-1.0,-1.8369701987210287e-16,13,24,1,2,1,1.0,1.0,5,7,-2,5,15,-10,"September, 2001"
2001-2002,6,2001-09-29,Bolton,Sunderland,0,2,A,0,3,1,1,3,0,2,3,2,10,12,9,8,3,September,-1.0,-1.8369701987210287e-16,6,40,0,0,0,0.0,0.0,10,4,6,6,7,-1,"September, 2001"
2001-2002,6,2001-09-29,Derby,Arsenal,0,2,A,0,3,0,1,4,5,0,0,18,4,5,11,14,6,September,-1.0,-1.8369701987210287e-16,17,0,0,1,4,0.6,1.4,5,10,-5,14,5,9,"September, 2001"
2001-2002,6,2001-09-30,Ipswich,Leeds,1,2,A,0,3,1,0,4,4,0,1,17,3,5,14,14,9,September,-1.0,-1.8369701987210287e-16,22,23,1,0,1,1.5,1.5,5,9,-4,9,1,8,"September, 2001"
2001-2002,6,2001-09-30,Aston Villa,Blackburn,2,0,H,3,0,2,1,2,3,1,1,8,11,9,9,3,0,September,-1.0,-1.8369701987210287e-16,1,4,1,0,4,0.8,2.8,7,3,4,8,8,0,"September, 2001"
2001-2002,6,2001-09-30,Fulham,Chelsea,1,1,D,1,1,2,2,1,2,1,2,15,9,6,9,6,3,September,-1.0,-1.8369701987210287e-16,19,14,0,0,0,0.0,0.0,6,7,-1,9,6,3,"September, 2001"
2001-2002,6,2001-09-30,Newcastle,Liverpool,0,2,A,0,3,3,1,1,4,0,1,7,10,11,9,3,2,September,-1.0,-1.8369701987210287e-16,30,25,1,1,3,1.4,2.4,11,9,2,8,7,1,"September, 2001"
2001-2002,7,2001-10-13,Sunderland,Man United,1,3,A,0,3,0,2,3,3,1,1,8,3,12,14,5,2,October,-0.8660254037844386,0.5,40,28,1,1,3,0.8,2.2,8,7,1,22,13,9,"October, 2001"
2001-2002,7,2001-10-13,Southampton,Arsenal,0,2,A,0,3,2,1,2,5,0,0,17,2,6,14,15,8,October,-0.8660254037844386,0.5,38,0,1,1,3,0.8,1.4,5,10,-5,16,5,11,"October, 2001"
2001-2002,7,2001-10-13,Ipswich,Everton,0,0,D,1,1,1,0,4,1,1,3,17,10,5,10,7,5,October,-0.8660254037844386,0.5,22,18,2,0,0,2.5,0.0,6,11,-5,12,10,2,"October, 2001"
2001-2002,7,2001-10-13,Liverpool,Leeds,1,1,D,1,1,4,0,1,4,0,1,7,1,12,17,6,5,October,-0.8660254037844386,0.5,25,23,2,1,2,1.8,1.6,10,7,3,11,2,9,"October, 2001"
2001-2002,7,2001-10-13,Chelsea,Leicester,2,0,H,3,0,2,1,2,1,3,1,9,20,10,5,11,5,October,-0.8660254037844386,0.5,14,24,0,3,2,1.2,1.8,10,7,3,5,17,-12,"October, 2001"
2001-2002,7,2001-10-13,Charlton,Middlesbrough,0,0,D,1,1,0,3,2,1,0,4,12,15,8,7,3,1,October,-0.8660254037844386,0.5,13,29,1,2,1,0.5,0.75,7,7,0,8,17,-9,"October, 2001"
2001-2002,7,2001-10-13,Bolton,Newcastle,0,4,A,0,3,1,1,3,3,1,1,5,8,12,11,3,1,October,-0.8660254037844386,0.5,6,30,1,0,3,1.0,1.75,10,6,4,11,11,0,"October, 2001"
2001-2002,7,2001-10-14,Aston Villa,Fulham,2,0,H,3,0,2,1,2,2,2,1,7,15,12,7,8,5,October,-0.8660254037844386,0.5,1,19,0,0,0,0.0,0.0,9,3,6,7,8,-1,"October, 2001"
2001-2002,7,2001-10-14,Blackburn,West Ham,7,1,H,3,0,3,1,1,2,1,2,12,18,9,5,6,4,October,-0.8660254037844386,0.5,4,45,3,0,2,1.8,1.0,8,10,-2,4,9,-5,"October, 2001"
2001-2002,7,2001-10-15,Tottenham,Derby,3,1,H,3,0,1,2,2,0,1,4,13,18,8,5,5,3,October,-0.8660254037844386,0.5,42,17,2,2,1,1.4,1.0,11,13,-2,5,12,-7,"October, 2001"
2001-2002,8,2001-10-20,Man United,Bolton,1,2,A,0,3,3,1,1,1,1,3,3,10,17,12,7,5,October,-0.8660254037844386,0.5,28,6,2,2,0,2.5,0.25,25,14,11,10,10,0,"October, 2001"
2001-2002,8,2001-10-20,Leicester,Liverpool,1,4,A,0,3,1,3,1,4,0,1,20,9,5,13,11,8,October,-0.8660254037844386,0.5,24,25,3,1,1,1.4,0.6,5,19,-14,11,8,3,"October, 2001"
2001-2002,8,2001-10-20,West Ham,Southampton,2,0,H,3,0,2,1,2,2,1,2,19,17,5,6,2,1,October,-0.8660254037844386,0.5,45,38,3,0,2,1.8,1.0,5,16,-11,5,12,-7,"October, 2001"
2001-2002,8,2001-10-20,Derby,Charlton,1,1,D,1,1,0,1,4,0,3,2,18,13,5,9,5,4,October,-0.8660254037844386,0.5,17,13,1,1,2,1.25,1.75,6,15,-9,7,7,0,"October, 2001"
2001-2002,8,2001-10-20,Arsenal,Blackburn,3,3,D,1,1,5,0,0,3,1,1,2,8,17,12,6,5,October,-0.8660254037844386,0.5,0,4,3,1,1,1.8,1.2,18,5,13,15,11,4,"October, 2001"
2001-2002,8,2001-10-20,Everton,Aston Villa,3,2,H,3,0,1,1,3,2,1,2,11,4,11,15,7,4,October,-0.8660254037844386,0.5,18,1,0,1,4,0.2,1.8,12,10,2,11,3,8,"October, 2001"
2001-2002,8,2001-10-21,Fulham,Ipswich,1,1,D,1,1,2,2,1,1,0,4,16,17,7,6,1,1,October,-0.8660254037844386,0.5,19,22,0,0,0,0.0,0.0,7,10,-3,6,11,-5,"October, 2001"
2001-2002,8,2001-10-21,Leeds,Chelsea,0,0,D,1,1,4,0,1,2,1,2,2,9,18,13,7,5,October,-0.8660254037844386,0.5,23,14,2,1,2,1.0,0.6,12,3,9,12,7,5,"October, 2001"
2001-2002,8,2001-10-21,Newcastle,Tottenham,0,2,A,0,3,3,1,1,1,2,2,8,12,14,11,4,3,October,-0.8660254037844386,0.5,30,42,2,1,2,1.6,1.8,15,11,4,14,14,0,"October, 2001"
2001-2002,8,2001-10-22,Middlesbrough,Sunderland,2,0,H,3,0,1,0,4,0,2,3,15,12,8,12,3,4,October,-0.8660254037844386,0.5,29,40,0,3,2,0.4,0.8,8,17,-9,9,10,-1,"October, 2001"
2001-2002,9,2001-10-24,Aston Villa,Charlton,1,0,H,3,0,2,1,2,0,3,2,5,14,15,10,9,5,October,-0.8660254037844386,0.5,1,13,2,1,1,2.25,2.0,13,6,7,8,8,0,"October, 2001"
2001-2002,9,2001-10-24,Southampton,Ipswich,3,3,D,1,1,2,1,2,1,0,4,19,17,6,7,2,1,October,-0.8660254037844386,0.5,38,22,0,0,2,0.5,3.0,5,14,-9,7,12,-5,"October, 2001"
2001-2002,9,2001-10-24,West Ham,Chelsea,2,1,H,3,0,2,1,2,2,1,2,17,7,8,14,10,6,October,-0.8660254037844386,0.5,45,14,1,2,2,0.6,1.2,7,16,-9,12,7,5,"October, 2001"
2001-2002,10,2001-10-27,Man United,Leeds,1,1,D,1,1,3,1,1,4,0,1,5,2,17,19,3,2,October,-0.8660254037844386,0.5,28,23,3,2,0,1.6,0.4,26,16,10,12,3,9,"October, 2001"
2001-2002,10,2001-10-27,Tottenham,Middlesbrough,2,1,H,3,0,1,2,2,1,0,4,9,14,14,11,5,3,October,-0.8660254037844386,0.5,42,29,0,3,2,0.8,1.2,16,14,2,10,17,-7,"October, 2001"
2001-2002,10,2001-10-27,Sunderland,Arsenal,1,1,D,1,1,0,2,3,5,0,0,12,4,12,18,8,6,October,-0.8660254037844386,0.5,40,0,2,2,1,1.0,1.2,9,12,-3,21,8,13,"October, 2001"
2001-2002,10,2001-10-27,Fulham,Southampton,2,1,H,3,0,2,2,1,2,1,2,16,18,8,7,2,1,October,-0.8660254037844386,0.5,19,38,0,0,0,0.0,0.0,8,11,-3,8,17,-9,"October, 2001"
2001-2002,10,2001-10-27,Charlton,Liverpool,0,2,A,0,3,0,3,2,4,0,1,15,5,10,16,10,6,October,-0.8660254037844386,0.5,13,25,1,1,2,1.0,2.5,8,9,-1,15,9,6,"October, 2001"
2001-2002,10,2001-10-27,Aston Villa,Bolton,3,2,H,3,0,2,1,2,1,1,3,3,6,18,15,3,3,October,-0.8660254037844386,0.5,1,6,3,0,1,1.25,0.75,14,6,8,12,11,1,"October, 2001"
2001-2002,10,2001-10-27,Everton,Newcastle,1,3,A,0,3,1,1,3,3,1,1,8,10,14,14,2,0,October,-0.8660254037844386,0.5,18,30,2,2,1,1.2,1.0,15,12,3,15,13,2,"October, 2001"
2001-2002,10,2001-10-28,Derby,Chelsea,1,1,D,1,1,0,1,4,2,1,2,19,9,6,14,10,8,October,-0.8660254037844386,0.5,17,14,1,0,4,1.0,3.0,7,16,-9,13,9,4,"October, 2001"
2001-2002,10,2001-10-28,Ipswich,West Ham,2,3,A,0,3,1,0,4,2,1,2,17,15,8,11,2,3,October,-0.8660254037844386,0.5,22,45,1,1,0,1.0,0.5,10,15,-5,9,17,-8,"October, 2001"
2001-2002,10,2001-10-29,Blackburn,Leicester,0,0,D,1,1,3,1,1,1,3,1,12,20,13,5,8,8,October,-0.8660254037844386,0.5,4,24,2,2,1,2.0,1.8,18,14,4,6,23,-17,"October, 2001"
2001-2002,11,2001-11-03,Newcastle,Aston Villa,3,0,H,3,0,3,1,1,2,1,2,6,1,17,21,5,4,November,-0.5000000000000004,0.8660254037844384,30,1,3,1,1,1.4,0.6,18,14,4,17,8,9,"November, 2001"
2001-2002,11,2001-11-03,Bolton,Everton,2,2,D,1,1,1,1,3,1,1,3,9,11,15,14,2,1,November,-0.5000000000000004,0.8660254037844384,6,18,0,2,2,0.75,1.75,14,14,0,16,15,1,"November, 2001"
2001-2002,11,2001-11-03,Leicester,Sunderland,1,0,H,3,0,1,3,1,0,2,3,20,13,6,13,7,7,November,-0.5000000000000004,0.8660254037844384,24,40,2,2,1,1.6,1.0,6,23,-17,10,13,-3,"November, 2001"
2001-2002,11,2001-11-03,Middlesbrough,Derby,5,1,H,3,0,1,0,4,0,1,4,15,19,11,7,4,4,November,-0.5000000000000004,0.8660254037844384,29,17,2,1,2,2.4,2.0,11,19,-8,8,17,-9,"November, 2001"
2001-2002,11,2001-11-03,Southampton,Blackburn,1,2,A,0,3,2,1,2,3,1,1,19,11,7,14,8,7,November,-0.5000000000000004,0.8660254037844384,38,4,3,1,1,2.0,0.8,9,19,-10,18,14,4,"November, 2001"
2001-2002,11,2001-11-03,West Ham,Fulham,0,2,A,0,3,2,1,2,2,2,1,13,15,14,11,2,3,November,-0.5000000000000004,0.8660254037844384,45,19,0,0,0,0.0,0.0,12,19,-7,10,12,-2,"November, 2001"
2001-2002,11,2001-11-04,Arsenal,Charlton,2,4,A,0,3,5,0,0,0,3,2,4,16,19,10,12,9,November,-0.5000000000000004,0.8660254037844384,0,13,2,1,1,1.5,1.0,22,9,13,8,11,-3,"November, 2001"
2001-2002,11,2001-11-04,Chelsea,Ipswich,2,1,H,3,0,2,1,2,1,0,4,10,18,15,8,8,7,November,-0.5000000000000004,0.8660254037844384,14,22,1,1,0,3.0,1.5,14,10,4,12,18,-6,"November, 2001"
2001-2002,11,2001-11-04,Leeds,Tottenham,2,1,H,3,0,4,0,1,1,2,2,2,9,20,17,7,3,November,-0.5000000000000004,0.8660254037844384,23,42,5,0,0,2.2,1.0,13,4,9,18,15,3,"November, 2001"
2001-2002,11,2001-11-04,Liverpool,Man United,3,1,H,3,0,4,0,1,3,1,1,5,6,19,18,1,1,November,-0.5000000000000004,0.8660254037844384,25,28,2,2,1,1.6,1.2,17,9,8,27,17,10,"November, 2001"
2001-2002,12,2001-11-17,Man United,Leicester,2,0,H,3,0,3,1,1,1,3,1,6,18,18,9,12,9,November,-0.5000000000000004,0.8660254037844384,28,24,5,0,0,3.0,0.4,28,20,8,7,23,-16,"November, 2001"
2001-2002,12,2001-11-17,Fulham,Newcastle,3,1,H,3,0,2,2,1,3,1,1,13,4,14,20,9,6,November,-0.5000000000000004,0.8660254037844384,19,30,0,0,0,0.0,0.0,12,12,0,21,14,7,"November, 2001"
2001-2002,12,2001-11-17,Tottenham,Arsenal,1,1,D,1,1,1,2,2,5,0,0,9,6,17,19,3,2,November,-0.5000000000000004,0.8660254037844384,42,0,1,1,3,1.0,1.8,19,17,2,24,13,11,"November, 2001"
2001-2002,12,2001-11-17,Blackburn,Liverpool,1,1,D,1,1,3,1,1,4,0,1,8,2,17,22,6,5,November,-0.5000000000000004,0.8660254037844384,4,25,0,3,2,0.4,1.2,20,15,5,20,10,10,"November, 2001"
2001-2002,12,2001-11-17,Aston Villa,Middlesbrough,0,0,D,1,1,2,1,2,1,0,4,3,13,21,14,10,7,November,-0.5000000000000004,0.8660254037844384,1,29,2,3,0,1.4,0.4,17,11,6,16,20,-4,"November, 2001"
2001-2002,12,2001-11-17,Derby,Southampton,1,0,H,3,0,0,1,4,2,1,2,20,19,7,7,1,0,November,-0.5000000000000004,0.8660254037844384,17,38,1,3,1,1.4,1.2,9,22,-13,10,21,-11,"November, 2001"
2001-2002,12,2001-11-18,Sunderland,Leeds,2,0,H,3,0,0,2,3,4,0,1,16,2,13,23,14,10,November,-0.5000000000000004,0.8660254037844384,40,23,0,0,5,0.4,1.8,10,14,-4,15,5,10,"November, 2001"
2001-2002,12,2001-11-18,Ipswich,Bolton,1,2,A,0,3,1,0,4,1,1,3,19,12,8,16,7,8,November,-0.5000000000000004,0.8660254037844384,22,6,0,0,0,0.0,0.0,13,20,-7,16,16,0,"November, 2001"
2001-2002,12,2001-11-18,Everton,Chelsea,0,0,D,1,1,1,1,3,2,1,2,12,8,15,18,4,3,November,-0.5000000000000004,0.8660254037844384,18,14,1,2,2,1.2,1.6,18,17,1,16,11,5,"November, 2001"
2001-2002,12,2001-11-19,Charlton,West Ham,4,4,D,1,1,0,3,2,2,1,2,16,15,13,14,1,1,November,-0.5000000000000004,0.8660254037844384,13,45,2,1,1,1.5,2.0,12,13,-1,12,21,-9,"November, 2001"
2001-2002,13,2001-11-24,Bolton,Fulham,0,0,D,1,1,1,1,3,2,2,1,8,11,19,17,3,2,November,-0.5000000000000004,0.8660254037844384,6,19,0,0,0,0.0,0.0,18,17,1,15,13,2,"November, 2001"
2001-2002,13,2001-11-24,Chelsea,Blackburn,0,0,D,1,1,2,1,2,3,1,1,8,9,19,18,1,1,November,-0.5000000000000004,0.8660254037844384,14,4,1,2,2,1.2,1.4,16,11,5,21,16,5,"November, 2001"
2001-2002,13,2001-11-24,Leicester,Everton,0,0,D,1,1,1,3,1,1,1,3,18,12,9,16,6,7,November,-0.5000000000000004,0.8660254037844384,24,18,0,4,1,1.0,1.2,7,25,-18,18,17,1,"November, 2001"
2001-2002,13,2001-11-24,Newcastle,Derby,1,0,H,3,0,3,1,1,0,1,4,6,17,20,10,11,10,November,-0.5000000000000004,0.8660254037844384,30,17,3,1,1,1.8,1.4,22,17,5,10,22,-12,"November, 2001"
2001-2002,13,2001-11-24,Southampton,Charlton,1,0,H,3,0,2,1,2,0,3,2,20,16,7,14,4,7,November,-0.5000000000000004,0.8660254037844384,38,13,1,2,1,1.0,1.75,10,22,-12,16,17,-1,"November, 2001"
2001-2002,13,2001-11-24,West Ham,Tottenham,0,1,A,0,3,2,1,2,1,2,2,15,10,15,18,5,3,November,-0.5000000000000004,0.8660254037844384,45,42,2,2,1,0.6,0.4,16,25,-9,20,18,2,"November, 2001"
2001-2002,13,2001-11-25,Liverpool,Sunderland,1,0,H,3,0,4,0,1,0,2,3,3,13,23,16,10,7,November,-0.5000000000000004,0.8660254037844384,25,40,2,3,0,1.4,0.8,21,11,10,12,14,-2,"November, 2001"
2001-2002,13,2001-11-25,Middlesbrough,Ipswich,0,0,D,1,1,1,0,4,1,0,4,14,20,15,8,6,7,November,-0.5000000000000004,0.8660254037844384,29,22,0,0,2,1.0,2.0,16,20,-4,14,22,-8,"November, 2001"
2001-2002,13,2001-11-25,Arsenal,Man United,3,1,H,3,0,5,0,0,3,1,1,7,5,20,21,2,1,November,-0.5000000000000004,0.8660254037844384,0,28,1,2,2,1.0,2.0,25,14,11,30,20,10,"November, 2001"
2001-2002,13,2001-11-25,Leeds,Aston Villa,1,1,D,1,1,4,0,1,2,1,2,3,5,23,22,2,1,November,-0.5000000000000004,0.8660254037844384,23,1,2,0,3,1.2,1.4,15,7,8,17,11,6,"November, 2001"
2001-2002,14,2001-12-01,Aston Villa,Leicester,0,2,A,0,3,2,1,2,1,3,1,5,19,23,10,14,13,December,-2.4492935982947064e-16,1.0,1,24,1,3,1,1.4,1.6,18,12,6,7,25,-18,"December, 2001"
2001-2002,14,2001-12-01,Blackburn,Middlesbrough,0,1,A,0,3,3,1,1,1,0,4,10,14,19,16,4,3,December,-2.4492935982947064e-16,1.0,4,29,1,2,2,0.6,0.8,21,16,5,16,20,-4,"December, 2001"
2001-2002,14,2001-12-01,Charlton,Newcastle,1,1,D,1,1,0,3,2,3,1,1,16,4,14,23,12,9,December,-2.4492935982947064e-16,1.0,13,30,2,2,0,1.25,0.5,16,18,-2,23,17,6,"December, 2001"
2001-2002,14,2001-12-01,Derby,Liverpool,0,1,A,0,3,0,1,4,4,0,1,19,1,10,26,18,16,December,-2.4492935982947064e-16,1.0,17,25,1,1,3,0.8,2.2,10,23,-13,22,11,11,"December, 2001"
2001-2002,14,2001-12-01,Ipswich,Arsenal,0,2,A,0,3,1,0,4,5,0,0,20,4,9,23,16,14,December,-2.4492935982947064e-16,1.0,22,0,0,1,1,0.5,1.0,14,22,-8,28,15,13,"December, 2001"
2001-2002,14,2001-12-01,Man United,Chelsea,0,3,A,0,3,3,1,1,2,1,2,6,8,21,20,2,1,December,-2.4492935982947064e-16,1.0,28,14,1,3,1,1.4,2.2,31,23,8,16,11,5,"December, 2001"
2001-2002,14,2001-12-01,Sunderland,West Ham,1,0,H,3,0,0,2,3,2,1,2,14,16,16,15,2,1,December,-2.4492935982947064e-16,1.0,40,45,2,2,1,1.0,0.8,12,15,-3,16,26,-10,"December, 2001"
2001-2002,14,2001-12-02,Everton,Southampton,2,0,H,3,0,1,1,3,2,1,2,14,18,17,10,4,7,December,-2.4492935982947064e-16,1.0,18,38,1,1,3,1.0,1.4,18,17,1,11,22,-11,"December, 2001"
2001-2002,14,2001-12-02,Fulham,Leeds,0,0,D,1,1,2,2,1,4,0,1,14,3,18,24,11,6,December,-2.4492935982947064e-16,1.0,19,23,0,0,0,0.0,0.0,15,13,2,16,8,8,"December, 2001"
2001-2002,14,2001-12-03,Tottenham,Bolton,3,2,H,3,0,1,2,2,1,1,3,8,10,21,20,2,1,December,-2.4492935982947064e-16,1.0,42,6,2,2,0,1.75,1.25,21,18,3,18,17,1,"December, 2001"
2001-2002,14,2001-12-05,West Ham,Aston Villa,1,1,D,1,1,2,1,2,2,1,2,16,7,15,23,9,8,December,-2.4492935982947064e-16,1.0,45,1,0,5,0,1.2,1.2,16,27,-11,18,14,4,"December, 2001"
2001-2002,14,2001-12-05,Chelsea,Charlton,0,1,A,0,3,2,1,2,0,3,2,6,15,23,15,9,8,December,-2.4492935982947064e-16,1.0,14,13,2,0,2,0.75,1.0,19,11,8,17,19,-2,"December, 2001"
2001-2002,15,2001-12-08,Charlton,Tottenham,3,1,H,3,0,0,3,2,1,2,2,15,5,18,24,10,6,December,-2.4492935982947064e-16,1.0,13,42,1,2,1,1.0,1.5,18,19,-1,24,20,4,"December, 2001"
2001-2002,15,2001-12-08,Derby,Bolton,1,0,H,3,0,0,1,4,1,1,3,19,11,10,20,8,10,December,-2.4492935982947064e-16,1.0,17,6,1,1,0,3.5,1.5,10,24,-14,20,20,0,"December, 2001"
2001-2002,15,2001-12-08,Fulham,Everton,2,0,H,3,0,2,2,1,1,1,3,13,10,19,20,3,1,December,-2.4492935982947064e-16,1.0,19,18,0,0,0,0.0,0.0,15,13,2,20,17,3,"December, 2001"
2001-2002,15,2001-12-08,Leicester,Southampton,0,4,A,0,3,1,3,1,2,1,2,18,19,13,10,1,3,December,-2.4492935982947064e-16,1.0,24,38,3,0,2,1.2,1.0,9,25,-16,11,24,-13,"December, 2001"
2001-2002,15,2001-12-08,Liverpool,Middlesbrough,2,0,H,3,0,4,0,1,1,0,4,1,15,29,19,14,10,December,-2.4492935982947064e-16,1.0,25,29,1,2,2,0.6,0.6,23,11,12,17,20,-3,"December, 2001"
2001-2002,15,2001-12-08,Man United,West Ham,0,1,A,0,3,3,1,1,2,1,2,9,16,21,16,7,5,December,-2.4492935982947064e-16,1.0,28,45,4,1,0,4.0,1.4,31,26,5,17,28,-11,"December, 2001"
2001-2002,15,2001-12-09,Ipswich,Newcastle,0,1,A,0,3,1,0,4,3,1,1,20,4,9,24,16,15,December,-2.4492935982947064e-16,1.0,22,30,1,0,1,1.0,1.0,14,24,-10,24,18,6,"December, 2001"
2001-2002,15,2001-12-09,Sunderland,Chelsea,0,0,D,1,1,0,2,3,2,1,2,14,7,19,23,7,4,December,-2.4492935982947064e-16,1.0,40,14,3,0,2,2.2,2.6,13,15,-2,19,12,7,"December, 2001"
2001-2002,15,2001-12-09,Arsenal,Aston Villa,3,2,H,3,0,5,0,0,2,1,2,2,5,26,24,3,2,December,-2.4492935982947064e-16,1.0,0,1,3,2,0,1.2,0.4,30,15,15,19,15,4,"December, 2001"
2001-2002,15,2001-12-09,Blackburn,Leeds,1,2,A,0,3,3,1,1,4,0,1,13,3,19,25,10,6,December,-2.4492935982947064e-16,1.0,4,23,1,1,3,0.8,1.8,21,17,4,16,8,8,"December, 2001"
2001-2002,15,2001-12-12,Liverpool,Fulham,0,0,D,1,1,4,0,1,2,2,1,1,8,32,22,7,10,December,-2.4492935982947064e-16,1.0,25,19,0,0,0,0.0,0.0,25,11,14,17,13,4,"December, 2001"
2001-2002,15,2001-12-12,Man United,Derby,5,0,H,3,0,3,1,1,0,1,4,9,18,21,13,9,8,December,-2.4492935982947064e-16,1.0,28,17,4,0,1,1.8,0.6,31,27,4,11,24,-13,"December, 2001"
2001-2002,16,2001-12-15,Tottenham,Fulham,4,0,H,3,0,1,2,2,2,2,1,8,9,24,23,1,1,December,-2.4492935982947064e-16,1.0,42,19,0,0,0,0.0,0.0,25,23,2,17,13,4,"December, 2001"
2001-2002,16,2001-12-15,Bolton,Charlton,0,0,D,1,1,1,1,3,0,3,2,12,10,20,21,2,1,December,-2.4492935982947064e-16,1.0,6,13,0,0,0,0.0,0.0,20,21,-1,21,20,1,"December, 2001"
2001-2002,16,2001-12-15,Everton,Derby,1,0,H,3,0,1,1,3,0,1,4,12,18,20,13,6,7,December,-2.4492935982947064e-16,1.0,18,17,1,1,3,1.0,1.4,20,19,1,11,29,-18,"December, 2001"
2001-2002,16,2001-12-15,Middlesbrough,Man United,0,1,A,0,3,1,0,4,3,1,1,15,5,19,24,10,5,December,-2.4492935982947064e-16,1.0,29,28,0,0,5,0.8,2.0,17,22,-5,36,27,9,"December, 2001"
2001-2002,16,2001-12-15,Newcastle,Blackburn,2,1,H,3,0,3,1,1,3,1,1,5,14,27,19,9,8,December,-2.4492935982947064e-16,1.0,30,4,0,3,2,0.4,0.8,25,18,7,22,19,3,"December, 2001"
2001-2002,16,2001-12-15,Southampton,Sunderland,2,0,H,3,0,2,1,2,0,2,3,17,13,13,20,4,7,December,-2.4492935982947064e-16,1.0,38,40,1,1,3,0.8,1.4,15,24,-9,13,15,-2,"December, 2001"
2001-2002,16,2001-12-15,West Ham,Arsenal,1,1,D,1,1,2,1,2,5,0,0,16,3,19,29,13,10,December,-2.4492935982947064e-16,1.0,45,0,1,0,4,0.8,2.4,18,28,-10,33,17,16,"December, 2001"
2001-2002,16,2001-12-16,Chelsea,Liverpool,4,0,H,3,0,2,1,2,4,0,1,7,1,24,33,6,9,December,-2.4492935982947064e-16,1.0,14,25,3,1,1,1.8,0.8,19,12,7,25,11,14,"December, 2001"
2001-2002,16,2001-12-16,Leeds,Leicester,2,2,D,1,1,4,0,1,1,3,1,4,19,28,13,15,15,December,-2.4492935982947064e-16,1.0,23,24,3,0,2,1.8,1.6,18,9,9,9,29,-20,"December, 2001"
2001-2002,16,2001-12-17,Aston Villa,Ipswich,2,1,H,3,0,2,1,2,1,0,4,8,20,24,9,12,15,December,-2.4492935982947064e-16,1.0,1,22,2,0,0,2.0,1.0,21,18,3,14,25,-11,"December, 2001"
2001-2002,16,2001-12-18,Arsenal,Newcastle,1,3,A,0,3,5,0,0,3,1,1,2,3,30,30,1,0,December,-2.4492935982947064e-16,1.0,0,30,1,3,1,1.6,1.0,34,18,16,27,19,8,"December, 2001"
2001-2002,16,2001-12-19,Leeds,Everton,3,2,H,3,0,4,0,1,1,1,3,4,9,29,23,5,6,December,-2.4492935982947064e-16,1.0,23,18,2,3,0,2.0,1.4,20,11,9,21,19,2,"December, 2001"
2001-2002,17,2001-12-22,Charlton,Blackburn,0,2,A,0,3,0,3,2,3,1,1,11,15,22,19,4,3,December,-2.4492935982947064e-16,1.0,13,4,0,1,1,0.0,0.5,21,20,1,23,21,2,"December, 2001"
2001-2002,17,2001-12-22,Derby,Aston Villa,3,1,H,3,0,0,1,4,2,1,2,19,8,13,27,11,14,December,-2.4492935982947064e-16,1.0,17,1,2,0,3,0.8,1.8,11,30,-19,23,19,4,"December, 2001"
2001-2002,17,2001-12-22,Leeds,Newcastle,3,4,A,0,3,4,0,1,3,1,1,3,1,32,33,2,1,December,-2.4492935982947064e-16,1.0,23,30,1,1,3,1.4,2.0,23,13,10,30,20,10,"December, 2001"
2001-2002,17,2001-12-22,Leicester,West Ham,1,1,D,1,1,1,3,1,2,1,2,19,15,14,20,4,6,December,-2.4492935982947064e-16,1.0,24,45,2,1,2,1.0,1.2,11,31,-20,19,29,-10,"December, 2001"
2001-2002,17,2001-12-22,Man United,Southampton,6,1,H,3,0,3,1,1,2,1,2,6,17,27,16,11,11,December,-2.4492935982947064e-16,1.0,28,38,3,1,1,2.8,1.4,37,27,10,17,24,-7,"December, 2001"
2001-2002,17,2001-12-22,Sunderland,Everton,1,0,H,3,0,0,2,3,1,1,3,15,9,20,23,6,3,December,-2.4492935982947064e-16,1.0,40,18,3,1,1,1.8,1.6,13,17,-4,23,22,1,"December, 2001"
2001-2002,17,2001-12-22,Tottenham,Ipswich,1,2,A,0,3,1,2,2,1,0,4,7,20,27,9,13,18,December,-2.4492935982947064e-16,1.0,42,22,1,0,1,1.5,2.0,29,23,6,15,27,-12,"December, 2001"
2001-2002,17,2001-12-23,Chelsea,Bolton,5,1,H,3,0,2,1,2,1,1,3,6,14,27,21,8,6,December,-2.4492935982947064e-16,1.0,14,6,2,0,2,1.5,1.25,23,12,11,20,21,-1,"December, 2001"
2001-2002,17,2001-12-23,Liverpool,Arsenal,1,2,A,0,3,4,0,1,5,0,0,2,6,33,30,4,3,December,-2.4492935982947064e-16,1.0,25,0,3,1,1,1.4,0.4,25,15,10,35,21,14,"December, 2001"
2001-2002,18,2001-12-26,Southampton,Tottenham,1,0,H,3,0,2,1,2,1,2,2,17,7,16,27,10,11,December,-2.4492935982947064e-16,1.0,38,42,1,1,3,0.8,2.0,18,30,-12,30,25,5,"December, 2001"
2001-2002,18,2001-12-26,Newcastle,Middlesbrough,3,0,H,3,0,3,1,1,1,0,4,2,16,36,19,14,17,December,-2.4492935982947064e-16,1.0,30,29,3,1,1,2.4,1.4,34,23,11,17,23,-6,"December, 2001"
2001-2002,18,2001-12-26,Ipswich,Leicester,2,0,H,3,0,1,0,4,1,3,1,20,19,12,15,1,3,December,-2.4492935982947064e-16,1.0,22,24,1,1,1,1.3333333333333333,1.0,17,28,-11,12,32,-20,"December, 2001"
2001-2002,18,2001-12-26,Fulham,Charlton,0,0,D,1,1,2,2,1,0,3,2,10,13,23,22,3,1,December,-2.4492935982947064e-16,1.0,19,13,0,1,0,1.0,1.0,17,17,0,21,22,-1,"December, 2001"
2001-2002,18,2001-12-26,West Ham,Derby,4,0,H,3,0,2,1,2,0,1,4,15,18,21,16,3,5,December,-2.4492935982947064e-16,1.0,45,17,2,3,0,1.2,0.6,20,30,-10,14,31,-17,"December, 2001"
2001-2002,18,2001-12-26,Bolton,Leeds,0,3,A,0,3,1,1,3,4,0,1,14,4,21,32,10,11,December,-2.4492935982947064e-16,1.0,6,23,1,1,3,0.6,1.4,21,26,-5,26,17,9,"December, 2001"
2001-2002,18,2001-12-26,Blackburn,Sunderland,0,3,A,0,3,3,1,1,0,2,3,12,11,22,23,1,1,December,-2.4492935982947064e-16,1.0,4,40,1,1,1,0.3333333333333333,0.3333333333333333,25,21,4,14,17,-3,"December, 2001"
2001-2002,18,2001-12-26,Aston Villa,Liverpool,1,2,A,0,3,2,1,2,4,0,1,8,3,27,33,5,6,December,-2.4492935982947064e-16,1.0,1,25,1,2,2,0.8,1.4,24,22,2,26,17,9,"December, 2001"
2001-2002,18,2001-12-26,Arsenal,Chelsea,2,1,H,3,0,5,0,0,2,1,2,2,6,33,30,4,3,December,-2.4492935982947064e-16,1.0,0,14,2,3,0,1.8,1.4,37,22,15,28,13,15,"December, 2001"
2001-2002,18,2001-12-26,Everton,Man United,0,2,A,0,3,1,1,3,3,1,1,10,5,23,30,5,7,December,-2.4492935982947064e-16,1.0,18,28,0,1,4,0.8,2.8,23,23,0,43,28,15,"December, 2001"
2001-2002,19,2001-12-29,West Ham,Liverpool,1,1,D,1,1,2,1,2,4,0,1,12,4,24,36,8,12,December,-2.4492935982947064e-16,1.0,45,25,1,1,3,0.6,1.4,24,30,-6,28,18,10,"December, 2001"
2001-2002,19,2001-12-29,Newcastle,Chelsea,1,2,A,0,3,3,1,1,2,1,2,2,6,39,30,4,9,December,-2.4492935982947064e-16,1.0,30,14,0,2,3,0.4,1.2,37,23,14,29,15,14,"December, 2001"
2001-2002,19,2001-12-29,Ipswich,Sunderland,5,0,H,3,0,1,0,4,0,2,3,20,10,15,26,10,11,December,-2.4492935982947064e-16,1.0,22,40,1,0,2,0.6666666666666666,1.6666666666666667,19,28,-9,17,17,0,"December, 2001"
2001-2002,19,2001-12-29,Everton,Charlton,0,3,A,0,3,1,1,3,0,3,2,13,12,23,23,1,0,December,-2.4492935982947064e-16,1.0,18,13,4,0,1,2.2,0.8,23,25,-2,21,22,-1,"December, 2001"
2001-2002,19,2001-12-29,Southampton,Leeds,0,1,A,0,3,2,1,2,4,0,1,17,4,19,35,13,16,December,-2.4492935982947064e-16,1.0,38,23,1,0,4,0.2,1.6,19,30,-11,29,17,12,"December, 2001"
2001-2002,19,2001-12-29,Blackburn,Derby,0,1,A,0,3,3,1,1,0,1,4,14,18,22,16,4,6,December,-2.4492935982947064e-16,1.0,4,17,1,1,3,0.6,1.2,25,24,1,14,35,-21,"December, 2001"
2001-2002,19,2001-12-29,Aston Villa,Tottenham,1,1,D,1,1,2,1,2,1,2,2,8,7,27,27,1,0,December,-2.4492935982947064e-16,1.0,1,42,2,3,0,1.4,0.6,25,24,1,30,26,4,"December, 2001"
2001-2002,19,2001-12-29,Arsenal,Middlesbrough,2,1,H,3,0,5,0,0,1,0,4,2,16,36,19,14,17,December,-2.4492935982947064e-16,1.0,0,29,3,0,2,2.2,1.2,39,23,16,17,26,-9,"December, 2001"
2001-2002,19,2001-12-29,Bolton,Leicester,2,2,D,1,1,1,1,3,1,3,1,15,20,21,15,5,6,December,-2.4492935982947064e-16,1.0,6,24,2,1,0,2.333333333333333,0.0,21,29,-8,12,34,-22,"December, 2001"
2001-2002,19,2001-12-30,Fulham,Man United,2,3,A,0,3,2,2,1,3,1,1,12,5,24,33,7,9,December,-2.4492935982947064e-16,1.0,19,28,0,0,1,2.0,3.0,17,17,0,45,28,17,"December, 2001"
2001-2002,20,2002-01-01,Charlton,Ipswich,3,2,H,3,0,0,3,2,1,0,4,9,19,26,18,10,8,January,0.4999999999999999,0.8660254037844387,13,22,2,0,1,1.0,1.0,24,22,2,24,28,-4,"January, 2002"
2001-2002,20,2002-01-01,Chelsea,Southampton,2,4,A,0,3,2,1,2,2,1,2,6,17,33,19,11,14,January,0.4999999999999999,0.8660254037844387,14,38,3,1,1,1.6,1.0,31,16,15,19,31,-12,"January, 2002"
2001-2002,20,2002-01-01,Leeds,West Ham,3,0,H,3,0,4,0,1,2,1,2,3,11,38,25,8,13,January,0.4999999999999999,0.8660254037844387,23,45,2,2,1,0.6,0.2,30,17,13,25,31,-6,"January, 2002"
2001-2002,20,2002-01-01,Liverpool,Bolton,1,1,D,1,1,4,0,1,1,1,3,4,15,37,22,11,15,January,0.4999999999999999,0.8660254037844387,25,6,3,1,1,2.0,1.2,29,19,10,23,31,-8,"January, 2002"
2001-2002,20,2002-01-01,Middlesbrough,Everton,1,0,H,3,0,1,0,4,1,1,3,17,13,19,23,4,4,January,0.4999999999999999,0.8660254037844387,29,18,2,1,2,1.4,1.4,18,28,-10,23,28,-5,"January, 2002"
2001-2002,20,2002-01-01,Sunderland,Aston Villa,1,1,D,1,1,0,2,3,2,1,2,10,9,26,28,1,2,January,0.4999999999999999,0.8660254037844387,40,1,1,4,0,0.8,0.6,17,22,-5,26,25,1,"January, 2002"
2001-2002,20,2002-01-01,Tottenham,Blackburn,1,0,H,3,0,1,2,2,3,1,1,9,15,28,22,6,6,January,0.4999999999999999,0.8660254037844387,42,4,2,2,1,1.4,0.8,31,27,4,25,25,0,"January, 2002"
2001-2002,20,2002-01-02,Derby,Fulham,0,1,A,0,3,0,1,4,2,2,1,18,12,19,24,6,5,January,0.4999999999999999,0.8660254037844387,17,19,0,1,0,0.0,0.0,15,35,-20,19,20,-1,"January, 2002"
2001-2002,20,2002-01-02,Man United,Newcastle,3,1,H,3,0,3,1,1,3,1,1,5,3,36,39,2,3,January,0.4999999999999999,0.8660254037844387,28,30,2,1,2,2.2,1.8,48,30,18,38,25,13,"January, 2002"
2001-2002,20,2002-01-09,Southampton,Liverpool,2,0,H,3,0,2,1,2,4,0,1,17,5,22,38,12,16,January,0.4999999999999999,0.8660254037844387,38,25,0,3,2,1.2,2.6,23,33,-10,30,20,10,"January, 2002"
2001-2002,21,2002-01-12,Newcastle,Leeds,3,1,H,3,0,3,1,1,4,0,1,4,1,39,41,3,2,January,0.4999999999999999,0.8660254037844387,30,23,3,1,1,2.6,2.0,39,28,11,33,17,16,"January, 2002"
2001-2002,21,2002-01-12,Ipswich,Tottenham,2,1,H,3,0,1,0,4,1,2,2,19,8,18,31,11,13,January,0.4999999999999999,0.8660254037844387,22,42,2,0,1,2.0,1.3333333333333333,26,31,-5,32,27,5,"January, 2002"
2001-2002,21,2002-01-12,West Ham,Leicester,1,0,H,3,0,2,1,2,1,3,1,15,20,25,16,5,9,January,0.4999999999999999,0.8660254037844387,45,24,2,1,2,1.4,1.2,25,34,-9,14,36,-22,"January, 2002"
2001-2002,21,2002-01-12,Fulham,Middlesbrough,2,1,H,3,0,2,2,1,1,0,4,10,17,27,22,7,5,January,0.4999999999999999,0.8660254037844387,19,29,0,0,0,0.0,0.0,20,20,0,19,28,-9,"January, 2002"
2001-2002,21,2002-01-12,Aston Villa,Derby,2,1,H,3,0,2,1,2,0,1,4,9,18,29,19,9,10,January,0.4999999999999999,0.8660254037844387,1,17,3,0,2,1.8,1.0,27,26,1,15,36,-21,"January, 2002"
2001-2002,21,2002-01-12,Bolton,Chelsea,2,2,D,1,1,1,1,3,2,1,2,16,6,23,33,10,10,January,0.4999999999999999,0.8660254037844387,6,14,2,0,3,1.2,2.2,24,32,-8,33,20,13,"January, 2002"
2001-2002,21,2002-01-12,Everton,Sunderland,1,0,H,3,0,1,1,3,0,2,3,16,11,23,27,5,4,January,0.4999999999999999,0.8660254037844387,18,40,1,1,3,1.6,1.4,23,29,-6,18,23,-5,"January, 2002"
2001-2002,21,2002-01-12,Blackburn,Charlton,4,1,H,3,0,3,1,1,0,3,2,16,9,22,29,7,7,January,0.4999999999999999,0.8660254037844387,4,13,2,1,0,1.0,0.0,25,26,-1,27,24,3,"January, 2002"
2001-2002,21,2002-01-13,Arsenal,Liverpool,1,1,D,1,1,5,0,0,4,0,1,4,5,39,38,1,1,January,0.4999999999999999,0.8660254037844387,0,25,2,0,3,0.8,1.6,41,24,17,30,22,8,"January, 2002"
2001-2002,21,2002-01-13,Southampton,Man United,1,3,A,0,3,2,1,2,3,1,1,15,4,25,39,11,14,January,0.4999999999999999,0.8660254037844387,38,28,1,1,3,1.4,3.6,25,33,-8,51,31,20,"January, 2002"
2001-2002,22,2002-01-19,Derby,Ipswich,1,3,A,0,3,0,1,4,1,0,4,19,18,19,21,1,2,January,0.4999999999999999,0.8660254037844387,17,22,1,1,1,1.0,1.3333333333333333,16,38,-22,28,32,-4,"January, 2002"
2001-2002,22,2002-01-19,Leicester,Newcastle,0,0,D,1,1,1,3,1,3,1,1,20,2,16,42,18,26,January,0.4999999999999999,0.8660254037844387,24,30,1,1,3,0.8,1.0,14,37,-23,42,29,13,"January, 2002"
2001-2002,22,2002-01-19,Liverpool,Southampton,1,1,D,1,1,4,0,1,2,1,2,5,15,39,25,10,14,January,0.4999999999999999,0.8660254037844387,25,38,1,3,1,1.2,1.4,31,23,8,26,36,-10,"January, 2002"
2001-2002,22,2002-01-19,Man United,Blackburn,2,1,H,3,0,3,1,1,3,1,1,2,15,42,25,13,17,January,0.4999999999999999,0.8660254037844387,28,4,3,2,0,2.4,1.0,54,32,22,29,27,2,"January, 2002"
2001-2002,22,2002-01-19,Middlesbrough,Bolton,1,1,D,1,1,1,0,4,1,1,3,18,17,22,24,1,2,January,0.4999999999999999,0.8660254037844387,29,6,0,1,2,0.6666666666666666,2.0,20,30,-10,26,34,-8,"January, 2002"
2001-2002,22,2002-01-19,Sunderland,Fulham,1,1,D,1,1,0,2,3,2,2,1,12,9,27,30,3,3,January,0.4999999999999999,0.8660254037844387,40,19,0,0,1,0.0,2.0,18,24,-6,22,21,1,"January, 2002"
2001-2002,22,2002-01-19,Tottenham,Everton,1,1,D,1,1,1,2,2,1,1,3,8,13,31,26,5,5,January,0.4999999999999999,0.8660254037844387,42,18,2,3,0,1.8,1.4,33,29,4,24,29,-5,"January, 2002"
2001-2002,22,2002-01-20,Leeds,Arsenal,1,1,D,1,1,4,0,1,5,0,0,3,4,41,40,1,1,January,0.4999999999999999,0.8660254037844387,23,0,2,0,3,0.8,1.8,34,20,14,42,25,17,"January, 2002"
2001-2002,22,2002-01-20,Chelsea,West Ham,5,1,H,3,0,2,1,2,2,1,2,6,12,34,28,6,6,January,0.4999999999999999,0.8660254037844387,14,45,2,2,1,1.4,0.8,35,22,13,26,34,-8,"January, 2002"
2001-2002,22,2002-01-21,Charlton,Aston Villa,1,2,A,0,3,0,3,2,2,1,2,10,8,29,32,2,3,January,0.4999999999999999,0.8660254037844387,13,1,1,1,3,1.6,2.0,28,28,0,29,27,2,"January, 2002"
2001-2002,22,2002-01-22,Man United,Liverpool,0,1,A,0,3,3,1,1,4,0,1,1,5,45,40,4,5,January,0.4999999999999999,0.8660254037844387,28,25,1,1,3,1.0,1.8,56,33,23,32,24,8,"January, 2002"
2001-2002,22,2002-01-23,Leicester,Arsenal,1,3,A,0,3,1,3,1,5,0,0,20,5,17,41,15,24,January,0.4999999999999999,0.8660254037844387,24,0,0,1,4,0.4,3.0,14,37,-23,43,26,17,"January, 2002"
2001-2002,23,2002-01-29,Bolton,Man United,0,4,A,0,3,1,1,3,3,1,1,16,1,25,45,15,20,January,0.4999999999999999,0.8660254037844387,6,28,1,2,2,0.6,2.2,27,35,-8,56,34,22,"January, 2002"
2001-2002,23,2002-01-29,Charlton,Derby,1,0,H,3,0,0,3,2,0,1,4,10,19,29,19,9,10,January,0.4999999999999999,0.8660254037844387,13,17,2,2,1,1.6,1.2,29,30,-1,17,41,-24,"January, 2002"
2001-2002,23,2002-01-29,Sunderland,Middlesbrough,0,1,A,0,3,0,2,3,1,0,4,11,18,28,23,7,5,January,0.4999999999999999,0.8660254037844387,40,29,1,3,1,0.6,0.8,19,25,-6,21,31,-10,"January, 2002"
2001-2002,23,2002-01-30,Tottenham,Newcastle,1,3,A,0,3,1,2,2,3,1,1,8,4,32,43,4,11,January,0.4999999999999999,0.8660254037844387,42,30,3,0,2,2.0,1.4,34,30,4,42,29,13,"January, 2002"
2001-2002,23,2002-01-30,Southampton,West Ham,2,0,H,3,0,2,1,2,2,1,2,16,13,26,28,3,2,January,0.4999999999999999,0.8660254037844387,38,45,1,0,4,0.8,2.2,27,37,-10,27,39,-12,"January, 2002"
2001-2002,23,2002-01-30,Liverpool,Leicester,1,0,H,3,0,4,0,1,1,3,1,4,20,43,17,16,26,January,0.4999999999999999,0.8660254037844387,25,24,2,1,2,1.4,1.4,33,24,9,15,40,-25,"January, 2002"
2001-2002,23,2002-01-30,Ipswich,Fulham,1,0,H,3,0,1,0,4,2,2,1,18,10,24,31,8,7,January,0.4999999999999999,0.8660254037844387,22,19,0,1,0,1.0,1.0,31,33,-2,23,22,1,"January, 2002"
2001-2002,23,2002-01-30,Chelsea,Leeds,2,0,H,3,0,2,1,2,4,0,1,6,5,37,42,1,5,January,0.4999999999999999,0.8660254037844387,14,23,1,2,2,0.4,1.0,40,23,17,35,21,14,"January, 2002"
2001-2002,23,2002-01-30,Blackburn,Arsenal,2,3,A,0,3,3,1,1,5,0,0,16,2,25,44,14,19,January,0.4999999999999999,0.8660254037844387,4,0,1,1,3,1.6,2.2,30,29,1,46,27,19,"January, 2002"
2001-2002,23,2002-01-30,Aston Villa,Everton,0,0,D,1,1,2,1,2,1,1,3,7,13,35,27,6,8,January,0.4999999999999999,0.8660254037844387,1,18,3,1,1,1.6,0.8,31,28,3,25,30,-5,"January, 2002"
2001-2002,24,2002-02-02,Newcastle,Bolton,3,2,H,3,0,3,1,1,1,1,3,3,18,46,25,15,21,February,0.8660254037844386,0.5000000000000001,30,6,4,0,1,2.2,0.8,45,30,15,27,39,-12,"February, 2002"
2001-2002,24,2002-02-02,Man United,Sunderland,4,1,H,3,0,3,1,1,0,2,3,1,14,48,28,13,20,February,0.8660254037844386,0.5000000000000001,28,40,4,1,0,2.6,0.6,60,34,26,19,26,-7,"February, 2002"
2001-2002,24,2002-02-02,Leicester,Chelsea,2,3,A,0,3,1,3,1,2,1,2,20,6,17,40,14,23,February,0.8660254037844386,0.5000000000000001,24,14,2,2,1,1.4,1.2,15,41,-26,42,23,19,"February, 2002"
2001-2002,24,2002-02-02,West Ham,Blackburn,2,0,H,3,0,2,1,2,3,1,1,15,17,28,25,2,3,February,0.8660254037844386,0.5000000000000001,45,4,2,0,3,1.0,2.8,27,41,-14,32,32,0,"February, 2002"
2001-2002,24,2002-02-02,Everton,Ipswich,1,2,A,0,3,1,1,3,1,0,4,12,15,28,27,3,1,February,0.8660254037844386,0.5000000000000001,18,22,0,1,2,0.0,1.6666666666666667,25,30,-5,32,33,-1,"February, 2002"
2001-2002,24,2002-02-02,Derby,Tottenham,1,0,H,3,0,0,1,4,1,2,2,19,8,19,32,11,13,February,0.8660254037844386,0.5000000000000001,17,42,1,1,3,1.0,1.8,17,42,-25,35,33,2,"February, 2002"
2001-2002,24,2002-02-02,Arsenal,Southampton,1,1,D,1,1,5,0,0,2,1,2,2,11,47,29,9,18,February,0.8660254037844386,0.5000000000000001,0,38,4,0,1,1.8,0.8,49,29,20,29,37,-8,"February, 2002"
2001-2002,24,2002-02-02,Fulham,Aston Villa,0,0,D,1,1,2,2,1,2,1,2,10,7,31,36,3,5,February,0.8660254037844386,0.5000000000000001,19,1,0,0,1,0.0,2.0,23,23,0,31,28,3,"February, 2002"
2001-2002,24,2002-02-03,Leeds,Liverpool,0,4,A,0,3,4,0,1,4,0,1,6,4,42,46,2,4,February,0.8660254037844386,0.5000000000000001,23,25,2,1,2,1.8,2.0,35,23,12,34,24,10,"February, 2002"
2001-2002,24,2002-02-03,Middlesbrough,Charlton,0,0,D,1,1,1,0,4,0,3,2,16,9,26,32,7,6,February,0.8660254037844386,0.5000000000000001,29,13,1,3,1,0.6,0.4,22,31,-9,30,30,0,"February, 2002"
2001-2002,25,2002-02-09,Newcastle,Southampton,3,1,H,3,0,3,1,1,2,1,2,3,14,49,30,11,19,February,0.8660254037844386,0.5000000000000001,30,38,1,1,3,1.8,1.8,48,32,16,30,38,-8,"February, 2002"
2001-2002,25,2002-02-09,Aston Villa,Chelsea,1,1,D,1,1,2,1,2,2,1,2,7,5,37,43,2,6,February,0.8660254037844386,0.5000000000000001,1,14,0,2,3,0.2,1.2,31,28,3,45,25,20,"February, 2002"
2001-2002,25,2002-02-09,Bolton,West Ham,1,0,H,3,0,1,1,3,2,1,2,18,11,25,31,7,6,February,0.8660254037844386,0.5000000000000001,6,45,0,1,3,0.25,2.0,29,42,-13,29,41,-12,"February, 2002"
2001-2002,25,2002-02-09,Derby,Sunderland,0,1,A,0,3,0,1,4,0,2,3,19,15,22,28,4,6,February,0.8660254037844386,0.5000000000000001,17,40,1,1,3,0.6,2.0,18,42,-24,20,30,-10,"February, 2002"
2001-2002,25,2002-02-09,Fulham,Blackburn,2,0,H,3,0,2,2,1,3,1,1,10,18,32,25,8,7,February,0.8660254037844386,0.5000000000000001,19,4,0,0,0,0.0,0.0,23,23,0,32,34,-2,"February, 2002"
2001-2002,25,2002-02-09,Ipswich,Liverpool,0,6,A,0,3,1,0,4,4,0,1,13,3,30,49,10,19,February,0.8660254037844386,0.5000000000000001,22,25,1,1,0,1.0,0.5,34,34,0,38,24,14,"February, 2002"
2001-2002,25,2002-02-09,Middlesbrough,Leeds,2,2,D,1,1,1,0,4,4,0,1,17,6,27,42,11,15,February,0.8660254037844386,0.5000000000000001,29,23,0,2,3,0.4,1.4,22,31,-9,35,27,8,"February, 2002"
2001-2002,25,2002-02-09,Tottenham,Leicester,2,1,H,3,0,1,2,2,1,3,1,10,20,32,17,10,15,February,0.8660254037844386,0.5000000000000001,42,24,2,0,3,1.6,1.8,35,34,1,17,44,-27,"February, 2002"
2001-2002,25,2002-02-10,Everton,Arsenal,0,1,A,0,3,1,1,3,5,0,0,15,4,28,48,11,20,February,0.8660254037844386,0.5000000000000001,18,0,1,0,4,0.8,2.2,26,32,-6,50,30,20,"February, 2002"
2001-2002,25,2002-02-10,Charlton,Man United,0,2,A,0,3,0,3,2,3,1,1,10,3,33,51,7,18,February,0.8660254037844386,0.5000000000000001,13,28,0,1,3,1.25,2.5,30,30,0,64,35,29,"February, 2002"
2001-2002,25,2002-02-19,Middlesbrough,Fulham,2,1,H,3,0,1,0,4,2,2,1,16,9,28,35,7,7,February,0.8660254037844386,0.5000000000000001,29,19,0,0,1,1.0,2.0,24,33,-9,25,23,2,"February, 2002"
2001-2002,26,2002-02-23,Arsenal,Fulham,4,1,H,3,0,5,0,0,2,2,1,4,9,51,35,5,16,February,0.8660254037844386,0.5000000000000001,0,19,1,0,0,3.0,1.0,51,30,21,26,25,1,"February, 2002"
2001-2002,26,2002-02-23,Leicester,Derby,0,3,A,0,3,1,3,1,0,1,4,20,19,17,22,1,5,February,0.8660254037844386,0.5000000000000001,24,17,2,0,3,1.0,1.8,18,46,-28,18,43,-25,"February, 2002"
2001-2002,26,2002-02-23,Liverpool,Everton,1,1,D,1,1,4,0,1,1,1,3,3,16,52,28,13,24,February,0.8660254037844386,0.5000000000000001,25,18,3,1,1,1.8,1.0,44,24,20,26,33,-7,"February, 2002"
2001-2002,26,2002-02-23,Man United,Aston Villa,1,0,H,3,0,3,1,1,2,1,2,1,7,54,38,6,16,February,0.8660254037844386,0.5000000000000001,28,1,4,1,0,1.6,0.2,66,35,31,32,29,3,"February, 2002"
2001-2002,26,2002-02-23,Southampton,Bolton,0,0,D,1,1,2,1,2,1,1,3,15,17,30,28,2,2,February,0.8660254037844386,0.5000000000000001,38,6,3,1,1,0.6,0.2,31,41,-10,30,42,-12,"February, 2002"
2001-2002,26,2002-02-23,West Ham,Middlesbrough,1,0,H,3,0,2,1,2,1,0,4,14,11,31,31,3,0,February,0.8660254037844386,0.5000000000000001,45,29,1,0,4,0.4,1.4,29,42,-13,26,34,-8,"February, 2002"
2001-2002,26,2002-02-24,Leeds,Charlton,0,0,D,1,1,4,0,1,0,3,2,6,11,43,33,5,10,February,0.8660254037844386,0.5000000000000001,23,13,4,1,0,2.4,0.8,37,29,8,30,32,-2,"February, 2002"
2001-2002,26,2002-02-24,Sunderland,Newcastle,0,1,A,0,3,0,2,3,3,1,1,13,4,31,52,9,21,February,0.8660254037844386,0.5000000000000001,40,30,2,3,0,1.6,1.2,21,30,-9,51,33,18,"February, 2002"
2001-2002,27,2002-03-02,Tottenham,Sunderland,2,1,H,3,0,1,2,2,0,2,3,9,14,35,31,5,4,March,1.0,6.123233995736766e-17,42,40,4,0,1,2.2,1.4,37,35,2,21,31,-10,"March, 2002"
2001-2002,27,2002-03-02,Newcastle,Arsenal,0,2,A,0,3,3,1,1,5,0,0,3,4,55,54,1,1,March,1.0,6.123233995736766e-17,30,0,2,2,1,1.4,1.6,52,33,19,55,31,24,"March, 2002"
2001-2002,27,2002-03-02,Middlesbrough,Leicester,1,0,H,3,0,1,0,4,1,3,1,13,20,31,17,7,14,March,1.0,6.123233995736766e-17,29,24,2,0,3,1.2,1.8,26,35,-9,18,49,-31,"March, 2002"
2001-2002,27,2002-03-02,Ipswich,Southampton,1,3,A,0,3,1,0,4,2,1,2,15,13,30,31,2,1,March,1.0,6.123233995736766e-17,22,38,2,1,0,3.0,1.3333333333333333,34,40,-6,31,41,-10,"March, 2002"
2001-2002,27,2002-03-02,Aston Villa,West Ham,2,1,H,3,0,2,1,2,2,1,2,7,11,38,34,4,4,March,1.0,6.123233995736766e-17,1,45,0,5,0,1.4,1.4,32,30,2,30,42,-12,"March, 2002"
2001-2002,27,2002-03-02,Charlton,Chelsea,2,1,H,3,0,0,3,2,2,1,2,10,5,34,44,5,10,March,1.0,6.123233995736766e-17,13,14,3,0,2,1.0,0.6,30,32,-2,46,26,20,"March, 2002"
2001-2002,27,2002-03-02,Bolton,Blackburn,1,1,D,1,1,1,1,3,3,1,1,17,18,29,25,1,4,March,1.0,6.123233995736766e-17,6,4,2,1,2,1.4,1.8,30,42,-12,32,36,-4,"March, 2002"
2001-2002,27,2002-03-02,Fulham,Liverpool,0,2,A,0,3,2,2,1,4,0,1,10,4,35,53,6,18,March,1.0,6.123233995736766e-17,19,25,0,1,0,0.0,0.0,27,29,-2,45,25,20,"March, 2002"
2001-2002,27,2002-03-03,Derby,Man United,2,2,D,1,1,0,1,4,3,1,1,19,1,25,57,18,32,March,1.0,6.123233995736766e-17,17,28,1,0,4,0.6,2.6,21,43,-22,67,35,32,"March, 2002"
2001-2002,27,2002-03-03,Everton,Leeds,0,0,D,1,1,1,1,3,4,0,1,17,6,29,44,11,15,March,1.0,6.123233995736766e-17,18,23,0,3,2,1.8,2.4,27,34,-7,37,29,8,"March, 2002"
2001-2002,28,2002-03-05,Sunderland,Bolton,1,0,H,3,0,0,2,3,1,1,3,14,17,31,30,3,1,March,1.0,6.123233995736766e-17,40,6,1,0,0,2.0,0.0,22,33,-11,31,43,-12,"March, 2002"
2001-2002,28,2002-03-05,Arsenal,Derby,1,0,H,3,0,5,0,0,0,1,4,2,19,57,26,17,31,March,1.0,6.123233995736766e-17,0,17,4,1,0,1.6,0.6,57,31,26,23,45,-22,"March, 2002"
2001-2002,28,2002-03-05,Blackburn,Aston Villa,3,0,H,3,0,3,1,1,2,1,2,18,7,26,41,11,15,March,1.0,6.123233995736766e-17,4,1,4,0,1,2.8,0.8,33,37,-4,34,31,3,"March, 2002"
2001-2002,28,2002-03-06,Chelsea,Fulham,3,2,H,3,0,2,1,2,2,2,1,6,10,44,35,4,9,March,1.0,6.123233995736766e-17,14,19,0,1,0,1.0,1.0,47,28,19,27,31,-4,"March, 2002"
2001-2002,28,2002-03-06,Leeds,Ipswich,2,0,H,3,0,4,0,1,1,0,4,6,16,45,30,10,15,March,1.0,6.123233995736766e-17,23,22,2,0,1,1.6666666666666667,1.3333333333333333,37,29,8,35,43,-8,"March, 2002"
2001-2002,28,2002-03-06,Liverpool,Newcastle,3,0,H,3,0,4,0,1,3,1,1,3,4,56,55,1,1,March,1.0,6.123233995736766e-17,25,30,3,1,1,2.0,1.0,47,25,22,52,35,17,"March, 2002"
2001-2002,28,2002-03-06,Man United,Tottenham,4,0,H,3,0,3,1,1,1,2,2,3,8,58,38,5,20,March,1.0,6.123233995736766e-17,28,42,3,0,2,2.4,2.0,69,37,32,39,36,3,"March, 2002"
2001-2002,28,2002-03-06,Southampton,Middlesbrough,1,1,D,1,1,2,1,2,1,0,4,11,12,34,34,1,0,March,1.0,6.123233995736766e-17,38,29,2,1,2,1.6,1.6,34,42,-8,27,35,-8,"March, 2002"
2001-2002,28,2002-03-06,West Ham,Everton,1,0,H,3,0,2,1,2,1,1,3,14,15,34,30,1,4,March,1.0,6.123233995736766e-17,45,18,0,1,4,0.2,2.6,31,44,-13,27,34,-7,"March, 2002"
2001-2002,28,2002-03-09,Leicester,Charlton,1,1,D,1,1,1,3,1,0,3,2,20,9,17,37,11,20,March,1.0,6.123233995736766e-17,24,13,1,2,2,0.8,1.2,18,50,-32,32,33,-1,"March, 2002"
2001-2002,28,2002-03-13,Blackburn,Ipswich,2,1,H,3,0,3,1,1,1,0,4,18,16,29,30,2,1,March,1.0,6.123233995736766e-17,4,22,0,1,0,1.0,1.0,36,37,-1,35,45,-10,"March, 2002"
2001-2002,28,2002-03-13,Chelsea,Tottenham,4,0,H,3,0,2,1,2,1,2,2,6,8,47,38,2,9,March,1.0,6.123233995736766e-17,14,42,5,0,0,2.2,0.4,50,30,20,39,40,-1,"March, 2002"
2001-2002,29,2002-03-16,Newcastle,Ipswich,2,2,D,1,1,3,1,1,1,0,4,4,17,55,30,13,25,March,1.0,6.123233995736766e-17,30,22,2,0,1,1.0,0.6666666666666666,52,38,14,36,47,-11,"March, 2002"
2001-2002,29,2002-03-16,Middlesbrough,Liverpool,1,2,A,0,3,1,0,4,4,0,1,13,3,35,59,10,24,March,1.0,6.123233995736766e-17,29,25,2,2,1,0.4,0.4,28,36,-8,50,25,25,"March, 2002"
2001-2002,29,2002-03-16,Southampton,Leicester,2,2,D,1,1,2,1,2,1,3,1,12,20,35,18,8,17,March,1.0,6.123233995736766e-17,38,24,2,0,3,1.4,1.0,35,43,-8,19,51,-32,"March, 2002"
2001-2002,29,2002-03-16,Chelsea,Sunderland,4,0,H,3,0,2,1,2,0,2,3,5,14,50,34,9,16,March,1.0,6.123233995736766e-17,14,40,1,1,3,1.4,1.8,54,30,24,23,33,-10,"March, 2002"
2001-2002,29,2002-03-16,Bolton,Derby,1,3,A,0,3,1,1,3,0,1,4,18,19,30,26,1,4,March,1.0,6.123233995736766e-17,6,17,0,1,2,1.0,2.6666666666666665,31,44,-13,23,46,-23,"March, 2002"
2001-2002,29,2002-03-16,Everton,Fulham,2,1,H,3,0,1,1,3,2,2,1,16,11,30,35,5,5,March,1.0,6.123233995736766e-17,18,19,0,0,1,0.0,2.0,27,35,-8,29,34,-5,"March, 2002"
2001-2002,29,2002-03-16,West Ham,Man United,3,5,A,0,3,2,1,2,3,1,1,10,2,37,61,8,24,March,1.0,6.123233995736766e-17,45,28,1,1,3,1.4,3.2,32,44,-12,73,37,36,"March, 2002"
2001-2002,29,2002-03-17,Aston Villa,Arsenal,1,2,A,0,3,2,1,2,5,0,0,7,3,41,60,4,19,March,1.0,6.123233995736766e-17,1,0,0,2,3,0.8,1.6,34,34,0,58,31,27,"March, 2002"
2001-2002,29,2002-03-17,Leeds,Blackburn,3,1,H,3,0,4,0,1,3,1,1,6,16,48,32,10,16,March,1.0,6.123233995736766e-17,23,4,4,0,1,2.2,1.0,39,29,10,38,38,0,"March, 2002"
2001-2002,29,2002-03-18,Tottenham,Charlton,0,1,A,0,3,1,2,2,0,3,2,9,8,38,38,1,0,March,1.0,6.123233995736766e-17,42,13,1,2,2,1.4,1.4,39,44,-5,33,34,-1,"March, 2002"
2001-2002,30,2002-03-23,Man United,Middlesbrough,0,1,A,0,3,3,1,1,1,0,4,1,14,64,35,13,29,March,1.0,6.123233995736766e-17,28,29,5,0,0,2.0,0.8,78,40,38,29,38,-9,"March, 2002"
2001-2002,30,2002-03-23,Sunderland,Southampton,1,1,D,1,1,0,2,3,2,1,2,15,13,34,36,2,2,March,1.0,6.123233995736766e-17,40,38,3,1,1,1.4,1.0,23,37,-14,37,45,-8,"March, 2002"
2001-2002,30,2002-03-23,Leicester,Leeds,0,2,A,0,3,1,3,1,4,0,1,20,6,19,51,14,32,March,1.0,6.123233995736766e-17,24,23,2,1,2,1.8,1.8,21,53,-32,42,30,12,"March, 2002"
2001-2002,30,2002-03-23,Charlton,Bolton,1,2,A,0,3,0,3,2,1,1,3,7,18,41,30,11,11,March,1.0,6.123233995736766e-17,13,6,0,1,0,0.0,0.0,34,34,0,32,47,-15,"March, 2002"
2001-2002,30,2002-03-23,Derby,Everton,3,4,A,0,3,0,1,4,1,1,3,19,15,29,33,4,4,March,1.0,6.123233995736766e-17,17,18,2,1,2,1.0,1.0,26,47,-21,29,36,-7,"March, 2002"
2001-2002,30,2002-03-23,Ipswich,Aston Villa,0,0,D,1,1,1,0,4,2,1,2,18,7,31,41,11,10,March,1.0,6.123233995736766e-17,22,1,0,0,3,1.0,2.0,38,49,-11,35,36,-1,"March, 2002"
2001-2002,30,2002-03-24,Fulham,Tottenham,0,2,A,0,3,2,2,1,1,2,2,14,9,35,38,5,3,March,1.0,6.123233995736766e-17,19,42,0,0,1,0.0,4.0,30,36,-6,39,45,-6,"March, 2002"
2001-2002,30,2002-03-24,Liverpool,Chelsea,1,0,H,3,0,4,0,1,2,1,2,3,6,62,53,3,9,March,1.0,6.123233995736766e-17,25,14,1,1,3,0.6,2.2,52,26,26,58,30,28,"March, 2002"
2001-2002,31,2002-03-29,Newcastle,Everton,6,2,H,3,0,3,1,1,1,1,3,4,13,56,36,9,20,March,1.0,6.123233995736766e-17,30,18,2,2,1,1.4,0.8,54,40,14,33,39,-6,"March, 2002"
2001-2002,31,2002-03-30,West Ham,Ipswich,3,1,H,3,0,2,1,2,1,0,4,12,18,37,32,6,5,March,1.0,6.123233995736766e-17,45,22,1,1,1,1.3333333333333333,1.3333333333333333,35,49,-14,38,49,-11,"March, 2002"
2001-2002,31,2002-03-30,Southampton,Fulham,1,1,D,1,1,2,1,2,2,2,1,11,15,37,35,4,2,March,1.0,6.123233995736766e-17,38,19,0,0,1,1.0,2.0,38,46,-8,30,38,-8,"March, 2002"
2001-2002,31,2002-03-30,Middlesbrough,Tottenham,1,1,D,1,1,1,0,4,1,2,2,10,9,38,41,1,3,March,1.0,6.123233995736766e-17,29,42,2,2,1,1.4,1.2,30,38,-8,41,45,-4,"March, 2002"
2001-2002,31,2002-03-30,Liverpool,Charlton,2,0,H,3,0,4,0,1,0,3,2,3,8,65,41,5,24,March,1.0,6.123233995736766e-17,25,13,3,1,1,2.4,0.8,53,26,27,35,36,-1,"March, 2002"
2001-2002,31,2002-03-30,Leeds,Man United,3,4,A,0,3,4,0,1,3,1,1,6,3,54,64,3,10,March,1.0,6.123233995736766e-17,23,28,0,2,3,0.4,1.6,44,30,14,78,41,37,"March, 2002"
2001-2002,31,2002-03-30,Chelsea,Derby,2,1,H,3,0,2,1,2,0,1,4,6,19,53,29,13,24,March,1.0,6.123233995736766e-17,14,17,3,1,1,2.8,1.0,58,31,27,29,51,-22,"March, 2002"
2001-2002,31,2002-03-30,Bolton,Aston Villa,3,2,H,3,0,1,1,3,2,1,2,16,7,33,42,9,9,March,1.0,6.123233995736766e-17,6,1,1,0,4,1.0,1.6,34,48,-14,35,36,-1,"March, 2002"
2001-2002,31,2002-03-30,Arsenal,Sunderland,3,0,H,3,0,5,0,0,0,2,3,3,15,63,35,12,28,March,1.0,6.123233995736766e-17,0,40,1,3,1,1.4,1.0,60,32,28,24,38,-14,"March, 2002"
2001-2002,31,2002-03-30,Leicester,Blackburn,2,1,H,3,0,1,3,1,3,1,1,20,17,19,32,3,13,March,1.0,6.123233995736766e-17,24,4,0,3,2,1.0,1.6,21,55,-34,39,41,-2,"March, 2002"
2001-2002,32,2002-04-01,Ipswich,Chelsea,0,0,D,1,1,1,0,4,2,1,2,18,5,32,56,13,24,April,0.8660254037844388,-0.4999999999999998,22,14,0,1,2,1.3333333333333333,2.6666666666666665,39,52,-13,60,32,28,"April, 2002"
2001-2002,32,2002-04-01,Sunderland,Leicester,2,1,H,3,0,0,2,3,1,3,1,17,20,35,22,3,13,April,0.8660254037844388,-0.4999999999999998,40,24,1,1,3,0.8,1.6,24,41,-17,23,56,-33,"April, 2002"
2001-2002,32,2002-04-01,Fulham,West Ham,0,1,A,0,3,2,2,1,2,1,2,14,11,36,40,3,4,April,0.8660254037844388,-0.4999999999999998,19,45,1,0,0,2.0,0.0,31,39,-8,38,50,-12,"April, 2002"
2001-2002,32,2002-04-01,Tottenham,Leeds,2,1,H,3,0,1,2,2,4,0,1,9,6,42,54,3,12,April,0.8660254037844388,-0.4999999999999998,42,23,0,0,5,1.2,2.2,42,46,-4,47,34,13,"April, 2002"
2001-2002,32,2002-04-01,Derby,Middlesbrough,0,1,A,0,3,0,1,4,1,0,4,19,11,29,39,8,10,April,0.8660254037844388,-0.4999999999999998,17,29,1,1,3,1.8,3.2,30,53,-23,31,39,-8,"April, 2002"
2001-2002,32,2002-04-01,Charlton,Arsenal,0,3,A,0,3,0,3,2,5,0,0,9,3,41,66,6,25,April,0.8660254037844388,-0.4999999999999998,13,0,2,1,2,1.6,1.6,35,38,-3,63,32,31,"April, 2002"
2001-2002,32,2002-04-01,Blackburn,Southampton,2,0,H,3,0,3,1,1,2,1,2,17,12,32,38,5,6,April,0.8660254037844388,-0.4999999999999998,4,38,2,1,2,1.2,1.8,40,43,-3,39,47,-8,"April, 2002"
2001-2002,32,2002-04-01,Everton,Bolton,3,1,H,3,0,1,1,3,1,1,3,14,15,36,36,1,0,April,0.8660254037844388,-0.4999999999999998,18,6,2,3,0,1.8,1.0,35,45,-10,37,50,-13,"April, 2002"
2001-2002,32,2002-04-02,Aston Villa,Newcastle,1,1,D,1,1,2,1,2,3,1,1,9,4,42,59,5,17,April,0.8660254037844388,-0.4999999999999998,1,30,1,1,3,0.4,1.6,37,39,-2,60,42,18,"April, 2002"
2001-2002,33,2002-04-06,Arsenal,Tottenham,2,1,H,3,0,5,0,0,1,2,2,1,7,69,45,6,24,April,0.8660254037844388,-0.4999999999999998,0,42,2,2,1,1.4,1.0,66,32,34,44,47,-3,"April, 2002"
2001-2002,33,2002-04-06,Bolton,Ipswich,4,1,H,3,0,1,1,3,1,0,4,16,18,36,33,2,3,April,0.8660254037844388,-0.4999999999999998,6,22,1,0,0,2.0,1.0,38,53,-15,39,52,-13,"April, 2002"
2001-2002,33,2002-04-06,Chelsea,Everton,3,0,H,3,0,2,1,2,1,1,3,5,12,57,39,7,18,April,0.8660254037844388,-0.4999999999999998,14,18,1,3,1,1.0,1.0,60,32,28,38,46,-8,"April, 2002"
2001-2002,33,2002-04-06,Leicester,Man United,0,1,A,0,3,1,3,1,3,1,1,20,3,22,67,17,45,April,0.8660254037844388,-0.4999999999999998,24,28,0,0,5,0.0,2.2,24,58,-34,82,44,38,"April, 2002"
2001-2002,33,2002-04-06,Middlesbrough,Aston Villa,2,1,H,3,0,1,0,4,2,1,2,10,8,42,43,2,1,April,0.8660254037844388,-0.4999999999999998,29,1,0,3,2,0.4,1.4,32,39,-7,38,40,-2,"April, 2002"
2001-2002,33,2002-04-06,Southampton,Derby,2,0,H,3,0,2,1,2,0,1,4,14,19,38,29,5,9,April,0.8660254037844388,-0.4999999999999998,38,17,1,2,2,1.2,1.6,39,49,-10,30,54,-24,"April, 2002"
2001-2002,33,2002-04-06,West Ham,Charlton,2,0,H,3,0,2,1,2,0,3,2,10,11,43,41,1,2,April,0.8660254037844388,-0.4999999999999998,45,13,1,2,2,2.4,2.0,39,50,-11,35,41,-6,"April, 2002"
2001-2002,33,2002-04-07,Leeds,Sunderland,2,0,H,3,0,4,0,1,0,2,3,6,15,54,38,9,16,April,0.8660254037844388,-0.4999999999999998,23,40,4,0,1,1.6,0.8,48,36,12,26,42,-16,"April, 2002"
2001-2002,33,2002-04-08,Newcastle,Fulham,1,1,D,1,1,3,1,1,2,2,1,5,16,60,36,11,24,April,0.8660254037844388,-0.4999999999999998,30,19,0,0,1,1.0,3.0,61,43,18,31,40,-9,"April, 2002"
2001-2002,33,2002-04-10,Blackburn,Chelsea,0,0,D,1,1,3,1,1,2,1,2,17,5,35,60,12,25,April,0.8660254037844388,-0.4999999999999998,4,14,2,2,1,1.2,1.0,42,43,-1,63,32,31,"April, 2002"
2001-2002,34,2002-04-13,Aston Villa,Leeds,0,1,A,0,3,2,1,2,4,0,1,10,6,43,57,4,14,April,0.8660254037844388,-0.4999999999999998,1,23,3,1,1,1.4,1.0,39,42,-3,50,36,14,"April, 2002"
2001-2002,34,2002-04-13,Charlton,Southampton,1,1,D,1,1,0,3,2,2,1,2,12,11,41,41,1,0,April,0.8660254037844388,-0.4999999999999998,13,38,1,2,2,1.4,1.0,35,43,-8,41,49,-8,"April, 2002"
2001-2002,34,2002-04-13,Derby,Newcastle,2,3,A,0,3,0,1,4,3,1,1,19,5,29,61,14,32,April,0.8660254037844388,-0.4999999999999998,17,30,1,1,3,0.8,1.2,30,56,-26,62,44,18,"April, 2002"
2001-2002,34,2002-04-13,Everton,Leicester,2,2,D,1,1,1,1,3,1,3,1,13,20,39,22,7,17,April,0.8660254037844388,-0.4999999999999998,18,24,1,4,0,1.2,1.0,38,49,-11,24,59,-35,"April, 2002"
2001-2002,34,2002-04-13,Sunderland,Liverpool,0,1,A,0,3,0,2,3,4,0,1,15,3,38,68,12,30,April,0.8660254037844388,-0.4999999999999998,40,25,0,3,2,0.6,1.2,26,44,-18,55,26,29,"April, 2002"
2001-2002,34,2002-04-13,Tottenham,West Ham,1,1,D,1,1,1,2,2,2,1,2,8,7,45,46,1,1,April,0.8660254037844388,-0.4999999999999998,42,45,2,2,1,0.4,0.2,45,49,-4,41,50,-9,"April, 2002"
2001-2002,35,2002-04-20,Southampton,Everton,0,1,A,0,3,2,1,2,1,1,3,11,14,42,40,3,2,April,0.8660254037844388,-0.4999999999999998,38,18,2,1,2,1.0,1.4,42,50,-8,40,51,-11,"April, 2002"
2001-2002,35,2002-04-20,Newcastle,Charlton,3,0,H,3,0,3,1,1,0,3,2,4,12,64,42,8,22,April,0.8660254037844388,-0.4999999999999998,30,13,0,3,2,0.6,1.2,65,46,19,36,44,-8,"April, 2002"
2001-2002,35,2002-04-20,West Ham,Sunderland,3,0,H,3,0,2,1,2,0,2,3,8,17,47,38,9,9,April,0.8660254037844388,-0.4999999999999998,45,40,0,2,3,0.4,1.2,42,51,-9,26,45,-19,"April, 2002"
2001-2002,35,2002-04-20,Middlesbrough,Blackburn,1,3,A,0,3,1,0,4,3,1,1,9,17,45,36,8,9,April,0.8660254037844388,-0.4999999999999998,29,4,3,2,0,1.0,0.4,34,40,-6,42,43,-1,"April, 2002"
2001-2002,35,2002-04-20,Leeds,Fulham,0,1,A,0,3,4,0,1,2,2,1,6,16,60,37,10,23,April,0.8660254037844388,-0.4999999999999998,23,19,0,1,0,0.0,0.0,51,36,15,32,41,-9,"April, 2002"
2001-2002,35,2002-04-20,Leicester,Aston Villa,2,2,D,1,1,1,3,1,2,1,2,20,10,23,43,10,20,April,0.8660254037844388,-0.4999999999999998,24,1,2,2,1,1.6,1.0,26,61,-35,39,43,-4,"April, 2002"
2001-2002,35,2002-04-20,Bolton,Tottenham,1,1,D,1,1,1,1,3,1,2,2,14,8,39,46,6,7,April,0.8660254037844388,-0.4999999999999998,6,42,0,2,3,1.4,2.0,42,54,-12,46,50,-4,"April, 2002"
2001-2002,35,2002-04-20,Liverpool,Derby,2,0,H,3,0,4,0,1,0,1,4,3,19,71,29,16,42,April,0.8660254037844388,-0.4999999999999998,25,17,4,1,0,2.0,0.2,56,26,30,32,59,-27,"April, 2002"
2001-2002,35,2002-04-20,Chelsea,Man United,0,3,A,0,3,2,1,2,3,1,1,5,3,61,70,2,9,April,0.8660254037844388,-0.4999999999999998,14,28,2,2,1,2.8,1.4,63,32,31,83,44,39,"April, 2002"
2001-2002,35,2002-04-21,Arsenal,Ipswich,2,0,H,3,0,5,0,0,1,0,4,3,18,72,33,15,39,April,0.8660254037844388,-0.4999999999999998,0,22,2,1,0,1.3333333333333333,0.3333333333333333,68,33,35,40,56,-16,"April, 2002"
2001-2002,36,2002-04-23,Blackburn,Newcastle,2,2,D,1,1,3,1,1,3,1,1,16,4,39,67,12,28,April,0.8660254037844388,-0.4999999999999998,4,30,1,3,1,0.8,0.8,45,44,1,68,46,22,"April, 2002"
2001-2002,36,2002-04-23,Fulham,Bolton,3,0,H,3,0,2,2,1,1,1,3,15,16,40,40,1,0,April,0.8660254037844388,-0.4999999999999998,19,6,0,1,0,0.0,0.0,33,41,-8,43,55,-12,"April, 2002"
2001-2002,36,2002-04-24,Arsenal,West Ham,2,0,H,3,0,5,0,0,2,1,2,1,7,75,50,6,25,April,0.8660254037844388,-0.4999999999999998,0,45,3,1,1,1.8,1.0,70,33,37,45,51,-6,"April, 2002"
2001-2002,36,2002-04-24,Ipswich,Middlesbrough,1,0,H,3,0,1,0,4,1,0,4,18,9,33,45,9,12,April,0.8660254037844388,-0.4999999999999998,22,29,2,1,0,1.3333333333333333,0.6666666666666666,40,58,-18,35,43,-8,"April, 2002"
2001-2002,37,2002-04-27,Derby,Leeds,0,1,A,0,3,0,1,4,4,0,1,19,6,29,60,13,31,April,0.8660254037844388,-0.4999999999999998,17,23,0,3,2,0.2,1.0,32,61,-29,51,37,14,"April, 2002"
2001-2002,37,2002-04-27,Tottenham,Liverpool,1,0,H,3,0,1,2,2,4,0,1,9,3,47,74,6,27,April,0.8660254037844388,-0.4999999999999998,42,25,2,0,3,0.8,1.4,47,51,-4,58,26,32,"April, 2002"
2001-2002,37,2002-04-27,Newcastle,West Ham,3,1,H,3,0,3,1,1,2,1,2,4,7,68,50,3,18,April,0.8660254037844388,-0.4999999999999998,30,45,1,1,3,1.0,1.8,70,48,22,45,53,-8,"April, 2002"
2001-2002,37,2002-04-27,Middlesbrough,Chelsea,0,2,A,0,3,1,0,4,2,1,2,10,6,45,61,4,16,April,0.8660254037844388,-0.4999999999999998,29,14,1,2,2,1.0,1.2,35,44,-9,63,35,28,"April, 2002"
2001-2002,37,2002-04-27,Aston Villa,Southampton,2,1,H,3,0,2,1,2,2,1,2,10,13,44,42,3,2,April,0.8660254037844388,-0.4999999999999998,1,38,1,1,3,0.6,1.2,41,45,-4,42,51,-9,"April, 2002"
2001-2002,37,2002-04-27,Fulham,Leicester,0,0,D,1,1,2,2,1,1,3,1,11,20,43,24,9,19,April,0.8660254037844388,-0.4999999999999998,19,24,0,1,0,0.0,0.0,36,41,-5,28,63,-35,"April, 2002"
2001-2002,37,2002-04-27,Charlton,Sunderland,2,2,D,1,1,0,3,2,0,2,3,14,17,42,38,3,4,April,0.8660254037844388,-0.4999999999999998,13,40,0,1,2,1.3333333333333333,2.0,36,47,-11,26,48,-22,"April, 2002"
2001-2002,37,2002-04-27,Ipswich,Man United,0,1,A,0,3,1,0,4,3,1,1,18,3,36,73,15,37,April,0.8660254037844388,-0.4999999999999998,22,28,0,1,2,0.3333333333333333,2.333333333333333,41,58,-17,86,44,42,"April, 2002"
2001-2002,37,2002-04-28,Everton,Blackburn,1,2,A,0,3,1,1,3,3,1,1,12,15,43,40,3,3,April,0.8660254037844388,-0.4999999999999998,18,4,2,1,2,1.0,1.0,41,51,-10,47,46,1,"April, 2002"
2001-2002,37,2002-04-29,Bolton,Arsenal,0,2,A,0,3,1,1,3,5,0,0,16,1,40,78,15,38,April,0.8660254037844388,-0.4999999999999998,6,0,1,1,3,0.8,1.6,43,58,-15,72,33,39,"April, 2002"
2001-2002,37,2002-05-08,Man United,Arsenal,0,1,A,0,3,3,1,1,5,0,0,3,1,76,81,2,5,May,0.4999999999999999,-0.8660254037844387,28,0,2,1,2,2.0,1.4,87,44,43,74,33,41,"May, 2002"
2001-2002,37,2002-05-08,Liverpool,Blackburn,4,3,H,3,0,4,0,1,3,1,1,3,12,74,43,9,31,May,0.4999999999999999,-0.8660254037844387,25,4,2,3,0,1.4,0.6,58,27,31,49,47,2,"May, 2002"
2001-2002,38,2002-05-11,Arsenal,Everton,4,3,H,3,0,5,0,0,1,1,3,1,13,84,43,12,41,May,0.4999999999999999,-0.8660254037844387,0,18,4,0,1,2.0,0.8,75,33,42,42,53,-11,"May, 2002"
2001-2002,38,2002-05-11,West Ham,Bolton,2,1,H,3,0,2,1,2,1,1,3,9,16,50,40,7,10,May,0.4999999999999999,-0.8660254037844387,45,6,3,1,1,1.6,0.4,46,56,-10,43,60,-17,"May, 2002"
2001-2002,38,2002-05-11,Southampton,Newcastle,3,1,H,3,0,2,1,2,3,1,1,15,4,42,71,11,29,May,0.4999999999999999,-0.8660254037844387,38,30,2,1,2,1.6,2.2,43,53,-10,73,49,24,"May, 2002"
2001-2002,38,2002-05-11,Man United,Charlton,0,0,D,1,1,3,1,1,0,3,2,3,13,76,43,10,33,May,0.4999999999999999,-0.8660254037844387,28,13,4,1,0,2.4,1.0,87,45,42,38,49,-11,"May, 2002"
2001-2002,38,2002-05-11,Liverpool,Ipswich,5,0,H,3,0,4,0,1,1,0,4,2,18,77,36,16,41,May,0.4999999999999999,-0.8660254037844387,25,22,1,1,1,2.333333333333333,0.6666666666666666,62,30,32,41,59,-18,"May, 2002"
2001-2002,38,2002-05-11,Sunderland,Derby,1,1,D,1,1,0,2,3,0,1,4,17,19,39,29,2,10,May,0.4999999999999999,-0.8660254037844387,40,17,3,1,1,1.8,0.6,28,50,-22,32,62,-30,"May, 2002"
2001-2002,38,2002-05-11,Leeds,Middlesbrough,1,0,H,3,0,4,0,1,1,0,4,6,11,63,45,5,18,May,0.4999999999999999,-0.8660254037844387,23,29,2,3,0,1.4,0.8,52,37,15,35,46,-11,"May, 2002"
2001-2002,38,2002-05-11,Chelsea,Aston Villa,1,3,A,0,3,2,1,2,2,1,2,5,9,64,47,4,17,May,0.4999999999999999,-0.8660254037844387,14,1,2,3,0,0.8,0.4,65,35,30,43,46,-3,"May, 2002"
2001-2002,38,2002-05-11,Blackburn,Fulham,3,0,H,3,0,3,1,1,2,2,1,12,11,43,44,1,1,May,0.4999999999999999,-0.8660254037844387,4,19,0,0,1,0.0,2.0,52,51,1,36,41,-5,"May, 2002"
2001-2002,38,2002-05-11,Leicester,Tottenham,2,1,H,3,0,1,3,1,1,2,2,20,8,25,50,12,25,May,0.4999999999999999,-0.8660254037844387,24,42,2,0,3,1.6,2.0,28,63,-35,48,51,-3,"May, 2002"
2002-2003,1,2002-08-17,Southampton,Middlesbrough,0,0,D,1,1,1,1,3,1,0,4,15,13,0,0,2,0,August,-0.8660254037844384,-0.5000000000000004,38,29,2,2,1,1.4,1.2,0,0,0,0,0,0,"August, 2002"
2002-2003,1,2002-08-17,Blackburn,Sunderland,0,0,D,1,1,2,2,1,0,0,5,4,17,0,0,13,0,August,-0.8660254037844384,-0.5000000000000004,4,40,1,1,2,0.25,1.0,0,0,0,0,0,0,"August, 2002"
2002-2003,1,2002-08-17,Charlton,Chelsea,2,3,A,0,3,1,0,4,2,1,2,7,8,0,0,1,0,August,-0.8660254037844384,-0.5000000000000004,13,14,4,0,1,1.2,0.4,0,0,0,0,0,0,"August, 2002"
2002-2003,1,2002-08-17,Everton,Tottenham,2,2,D,1,1,1,0,4,1,0,4,8,17,0,0,9,0,August,-0.8660254037844384,-0.5000000000000004,18,42,0,4,1,1.2,1.4,0,0,0,0,0,0,"August, 2002"
2002-2003,1,2002-08-17,Fulham,Bolton,4,1,H,3,0,3,1,1,2,3,0,10,9,0,0,1,0,August,-0.8660254037844384,-0.5000000000000004,19,6,1,1,0,1.5,0.0,0,0,0,0,0,0,"August, 2002"
2002-2003,1,2002-08-17,Leeds,Man City,3,0,H,3,0,3,0,2,3,0,2,10,12,0,0,2,0,August,-0.8660254037844384,-0.5000000000000004,23,27,1,1,2,1.25,0.75,0,0,0,0,0,0,"August, 2002"
2002-2003,1,2002-08-17,Man United,West Brom,1,0,H,3,0,4,1,0,1,2,2,12,16,0,0,4,0,August,-0.8660254037844384,-0.5000000000000004,28,44,0,0,0,0.0,0.0,0,0,0,0,0,0,"August, 2002"
2002-2003,1,2002-08-18,Aston Villa,Liverpool,0,1,A,0,3,2,1,2,3,0,2,12,13,0,0,1,0,August,-0.8660254037844384,-0.5000000000000004,1,25,1,1,3,1.0,1.8,0,0,0,0,0,0,"August, 2002"
2002-2003,1,2002-08-18,Arsenal,Birmingham,2,0,H,3,0,3,1,1,3,1,1,11,13,0,0,2,0,August,-0.8660254037844384,-0.5000000000000004,0,3,0,0,0,0.0,0.0,0,0,0,0,0,0,"August, 2002"
2002-2003,1,2002-08-19,Newcastle,West Ham,4,0,H,3,0,2,2,1,3,1,1,13,14,0,0,1,0,August,-0.8660254037844384,-0.5000000000000004,30,45,2,0,3,1.2,1.6,0,0,0,0,0,0,"August, 2002"
2002-2003,2,2002-08-23,Chelsea,Man United,2,2,D,1,1,2,1,2,4,1,0,5,7,3,3,2,0,August,-0.8660254037844384,-0.5000000000000004,14,28,1,2,2,1.8,2.0,3,2,1,1,0,1,"August, 2002"
2002-2003,2,2002-08-24,West Brom,Leeds,1,3,A,0,3,1,2,2,3,0,2,16,9,0,3,7,3,August,-0.8660254037844384,-0.5000000000000004,44,23,0,0,0,0.0,0.0,0,1,-1,3,0,3,"August, 2002"
2002-2003,2,2002-08-24,Tottenham,Aston Villa,1,0,H,3,0,1,0,4,2,1,2,13,16,1,0,3,1,August,-0.8660254037844384,-0.5000000000000004,42,1,0,3,2,0.6,1.4,2,2,0,0,1,-1,"August, 2002"
2002-2003,2,2002-08-24,Sunderland,Everton,0,1,A,0,3,0,0,5,1,0,4,14,12,1,1,2,0,August,-0.8660254037844384,-0.5000000000000004,40,18,3,1,1,1.4,0.8,0,0,0,2,2,0,"August, 2002"
2002-2003,2,2002-08-24,Middlesbrough,Fulham,2,2,D,1,1,1,0,4,3,1,1,13,5,1,3,8,2,August,-0.8660254037844384,-0.5000000000000004,29,19,1,0,1,1.5,1.5,0,0,0,4,1,3,"August, 2002"
2002-2003,2,2002-08-24,West Ham,Arsenal,2,2,D,1,1,3,1,1,3,1,1,20,10,0,3,10,3,August,-0.8660254037844384,-0.5000000000000004,45,0,0,1,4,0.6,2.0,0,4,-4,2,0,2,"August, 2002"
2002-2003,2,2002-08-24,Liverpool,Southampton,3,0,H,3,0,3,0,2,1,1,3,8,13,3,1,5,2,August,-0.8660254037844384,-0.5000000000000004,25,38,1,3,1,1.2,1.4,1,0,1,0,0,0,"August, 2002"
2002-2003,2,2002-08-24,Bolton,Charlton,1,2,A,0,3,2,3,0,1,0,4,17,14,0,0,3,0,August,-0.8660254037844384,-0.5000000000000004,6,13,1,1,0,1.0,0.5,1,4,-3,2,3,-1,"August, 2002"
2002-2003,2,2002-08-24,Birmingham,Blackburn,0,1,A,0,3,3,1,1,2,2,1,17,10,0,1,7,1,August,-0.8660254037844384,-0.5000000000000004,3,4,0,0,0,0.0,0.0,0,2,-2,0,0,0,"August, 2002"
2002-2003,2,2002-08-24,Man City,Newcastle,1,0,H,3,0,3,0,2,2,2,1,18,5,0,3,13,3,August,-0.8660254037844384,-0.5000000000000004,27,30,1,1,2,1.25,1.75,0,3,-3,4,0,4,"August, 2002"
2002-2003,3,2002-08-27,Arsenal,West Brom,5,2,H,3,0,3,1,1,1,2,2,4,18,4,0,14,4,August,-0.8660254037844384,-0.5000000000000004,0,44,0,0,0,0.0,0.0,4,2,2,1,4,-3,"August, 2002"
2002-2003,3,2002-08-27,Charlton,Tottenham,0,1,A,0,3,1,0,4,1,0,4,11,8,3,4,3,1,August,-0.8660254037844384,-0.5000000000000004,13,42,3,1,1,1.2,1.0,4,4,0,3,2,1,"August, 2002"
2002-2003,3,2002-08-28,Aston Villa,Man City,1,0,H,3,0,2,1,2,3,0,2,17,12,0,3,5,3,August,-0.8660254037844384,-0.5000000000000004,1,27,1,1,2,1.25,1.25,0,2,-2,1,3,-2,"August, 2002"
2002-2003,3,2002-08-28,Blackburn,Liverpool,2,2,D,1,1,2,2,1,3,0,2,9,4,4,6,5,2,August,-0.8660254037844384,-0.5000000000000004,4,25,0,2,3,1.0,2.0,1,0,1,4,0,4,"August, 2002"
2002-2003,3,2002-08-28,Everton,Birmingham,1,1,D,1,1,1,0,4,3,1,1,8,18,4,0,10,4,August,-0.8660254037844384,-0.5000000000000004,18,3,0,0,0,0.0,0.0,3,2,1,0,3,-3,"August, 2002"
2002-2003,3,2002-08-28,Leeds,Sunderland,0,1,A,0,3,3,0,2,0,0,5,4,15,6,1,11,5,August,-0.8660254037844384,-0.5000000000000004,23,40,4,0,1,1.6,0.6,6,1,5,0,1,-1,"August, 2002"
2002-2003,3,2002-08-28,Southampton,Chelsea,1,1,D,1,1,1,1,3,2,1,2,17,8,1,4,9,3,August,-0.8660254037844384,-0.5000000000000004,38,14,2,1,2,1.6,1.6,0,3,-3,5,4,1,"August, 2002"
2002-2003,4,2002-08-31,West Brom,Fulham,1,0,H,3,0,1,2,2,3,1,1,20,12,0,4,8,4,August,-0.8660254037844384,-0.5000000000000004,44,19,0,0,0,0.0,0.0,3,9,-6,6,3,3,"August, 2002"
2002-2003,4,2002-08-31,West Ham,Charlton,0,2,A,0,3,3,1,1,1,0,4,19,15,1,3,4,2,August,-0.8660254037844384,-0.5000000000000004,45,13,2,2,1,2.4,1.2,2,6,-4,4,5,-1,"August, 2002"
2002-2003,4,2002-08-31,Tottenham,Southampton,2,1,H,3,0,1,0,4,1,1,3,3,17,7,2,14,5,August,-0.8660254037844384,-0.5000000000000004,42,38,2,1,2,1.8,1.0,4,2,2,1,4,-3,"August, 2002"
2002-2003,4,2002-08-31,Middlesbrough,Blackburn,1,0,H,3,0,1,0,4,2,2,1,16,7,2,5,9,3,August,-0.8660254037844384,-0.5000000000000004,29,4,2,2,1,0.8,0.8,2,2,0,3,2,1,"August, 2002"
2002-2003,4,2002-08-31,Man City,Everton,3,1,H,3,0,3,0,2,1,0,4,15,6,3,5,9,2,August,-0.8660254037844384,-0.5000000000000004,27,18,1,0,3,1.5,1.75,1,4,-3,4,3,1,"August, 2002"
2002-2003,4,2002-08-31,Birmingham,Leeds,2,1,H,3,0,3,1,1,3,0,2,17,4,1,6,13,5,August,-0.8660254037844384,-0.5000000000000004,3,23,0,0,0,0.0,0.0,1,4,-3,6,2,4,"August, 2002"
2002-2003,4,2002-08-31,Sunderland,Man United,1,1,D,1,1,0,0,5,4,1,0,12,11,4,4,1,0,August,-0.8660254037844384,-0.5000000000000004,40,28,0,0,5,0.4,3.0,1,1,0,3,2,1,"August, 2002"
2002-2003,4,2002-09-01,Bolton,Aston Villa,1,0,H,3,0,2,3,0,2,1,2,20,16,0,3,4,3,September,-1.0,-1.8369701987210287e-16,6,1,2,0,3,1.6,1.8,2,6,-4,1,2,-1,"September, 2002"
2002-2003,4,2002-09-01,Chelsea,Arsenal,1,1,D,1,1,2,1,2,3,1,1,7,2,5,7,5,2,September,-1.0,-1.8369701987210287e-16,14,0,0,3,2,1.2,1.6,6,5,1,9,4,5,"September, 2002"
2002-2003,4,2002-09-02,Liverpool,Newcastle,2,2,D,1,1,3,0,2,2,2,1,3,15,7,3,12,4,September,-1.0,-1.8369701987210287e-16,25,30,4,0,1,2.2,0.6,6,2,4,4,1,3,"September, 2002"
2002-2003,4,2002-09-03,Man United,Middlesbrough,1,0,H,3,0,4,1,0,1,0,4,8,9,5,5,1,0,September,-1.0,-1.8369701987210287e-16,28,29,4,0,1,1.8,1.0,4,3,1,3,2,1,"September, 2002"
2002-2003,5,2002-09-10,Middlesbrough,Sunderland,3,0,H,3,0,1,0,4,0,0,5,10,11,5,5,1,0,September,-1.0,-1.8369701987210287e-16,29,40,2,2,1,0.8,0.4,3,3,0,2,2,0,"September, 2002"
2002-2003,5,2002-09-10,Arsenal,Man City,2,1,H,3,0,3,1,1,3,0,2,2,8,8,6,6,2,September,-1.0,-1.8369701987210287e-16,0,27,4,0,0,3.25,0.25,10,5,5,4,5,-1,"September, 2002"
2002-2003,5,2002-09-11,Newcastle,Leeds,0,2,A,0,3,2,2,1,3,0,2,17,8,4,6,9,2,September,-1.0,-1.8369701987210287e-16,30,23,4,1,0,2.8,1.6,6,3,3,7,4,3,"September, 2002"
2002-2003,5,2002-09-11,Man United,Bolton,0,1,A,0,3,4,1,0,2,3,0,6,17,8,3,11,5,September,-1.0,-1.8369701987210287e-16,28,6,2,2,1,2.4,0.6,5,3,2,3,6,-3,"September, 2002"
2002-2003,5,2002-09-11,Liverpool,Birmingham,2,2,D,1,1,3,0,2,3,1,1,4,16,8,4,12,4,September,-1.0,-1.8369701987210287e-16,25,3,0,0,0,0.0,0.0,8,4,4,3,5,-2,"September, 2002"
2002-2003,5,2002-09-11,Aston Villa,Charlton,2,0,H,3,0,2,1,2,1,0,4,16,8,3,6,8,3,September,-1.0,-1.8369701987210287e-16,1,13,3,1,1,2.2,1.8,1,3,-2,6,5,1,"September, 2002"
2002-2003,5,2002-09-11,Blackburn,Chelsea,2,3,A,0,3,2,2,1,2,1,2,11,7,5,6,4,1,September,-1.0,-1.8369701987210287e-16,4,14,1,3,1,1.0,1.0,3,3,0,7,6,1,"September, 2002"
2002-2003,5,2002-09-11,Southampton,Everton,1,0,H,3,0,1,1,3,1,0,4,19,14,2,5,5,3,September,-1.0,-1.8369701987210287e-16,38,18,2,1,2,0.8,0.8,2,6,-4,5,6,-1,"September, 2002"
2002-2003,5,2002-09-11,Fulham,Tottenham,3,2,H,3,0,3,1,1,1,0,4,15,2,4,10,13,6,September,-1.0,-1.8369701987210287e-16,19,42,0,0,2,0.0,3.0,6,4,2,6,3,3,"September, 2002"
2002-2003,5,2002-09-11,West Ham,West Brom,0,1,A,0,3,3,1,1,1,2,2,20,19,1,3,1,2,September,-1.0,-1.8369701987210287e-16,45,44,0,0,0,0.0,0.0,2,8,-6,4,9,-5,"September, 2002"
2002-2003,6,2002-09-14,Sunderland,Fulham,0,3,A,0,3,0,0,5,3,1,1,18,9,5,7,9,2,September,-1.0,-1.8369701987210287e-16,40,19,0,1,1,0.5,1.5,2,5,-3,9,6,3,"September, 2002"
2002-2003,6,2002-09-14,West Brom,Southampton,1,0,H,3,0,1,2,2,1,1,3,14,17,6,5,3,1,September,-1.0,-1.8369701987210287e-16,44,38,0,0,0,0.0,0.0,5,9,-4,3,6,-3,"September, 2002"
2002-2003,6,2002-09-14,Everton,Middlesbrough,2,1,H,3,0,1,0,4,1,0,4,16,6,5,8,10,3,September,-1.0,-1.8369701987210287e-16,18,29,2,1,2,1.2,1.2,5,7,-2,6,3,3,"September, 2002"
2002-2003,6,2002-09-14,Leeds,Man United,1,0,H,3,0,3,0,2,4,1,0,5,7,9,8,2,1,September,-1.0,-1.8369701987210287e-16,23,28,0,2,3,1.0,2.0,9,4,5,5,4,1,"September, 2002"
2002-2003,6,2002-09-14,Chelsea,Newcastle,3,0,H,3,0,2,1,2,2,2,1,5,19,9,4,14,5,September,-1.0,-1.8369701987210287e-16,14,30,3,2,0,1.4,0.6,10,8,2,6,5,1,"September, 2002"
2002-2003,6,2002-09-14,Charlton,Arsenal,0,3,A,0,3,1,0,4,3,1,1,10,2,6,11,8,5,September,-1.0,-1.8369701987210287e-16,13,0,2,0,3,1.6,2.2,6,7,-1,12,6,6,"September, 2002"
2002-2003,6,2002-09-14,Bolton,Liverpool,2,3,A,0,3,2,3,0,3,0,2,12,4,6,9,8,3,September,-1.0,-1.8369701987210287e-16,6,25,1,2,2,1.0,1.2,4,6,-2,10,6,4,"September, 2002"
2002-2003,6,2002-09-15,Man City,Blackburn,2,2,D,1,1,3,0,2,2,2,1,12,15,6,5,3,1,September,-1.0,-1.8369701987210287e-16,27,4,0,1,1,0.5,1.5,5,7,-2,5,6,-1,"September, 2002"
2002-2003,6,2002-09-15,Tottenham,West Ham,3,2,H,3,0,1,0,4,3,1,1,6,20,10,1,14,9,September,-1.0,-1.8369701987210287e-16,42,45,2,3,0,0.6,0.2,8,6,2,2,9,-7,"September, 2002"
2002-2003,6,2002-09-16,Birmingham,Aston Villa,3,0,H,3,0,3,1,1,2,1,2,16,12,5,6,4,1,September,-1.0,-1.8369701987210287e-16,3,1,0,0,0,0.0,0.0,5,7,-2,3,3,0,"September, 2002"
2002-2003,7,2002-09-21,West Ham,Man City,0,0,D,1,1,3,1,1,3,0,2,20,13,1,7,7,6,September,-1.0,-1.8369701987210287e-16,45,27,2,0,2,2.25,1.5,4,12,-8,7,9,-2,"September, 2002"
2002-2003,7,2002-09-21,Southampton,Charlton,0,0,D,1,1,1,1,3,1,0,4,18,17,5,6,1,1,September,-1.0,-1.8369701987210287e-16,38,13,2,3,0,1.2,0.6,3,7,-4,6,10,-4,"September, 2002"
2002-2003,7,2002-09-21,Newcastle,Sunderland,2,0,H,3,0,2,2,1,0,0,5,19,18,4,5,1,1,September,-1.0,-1.8369701987210287e-16,30,40,1,3,1,1.2,1.2,6,8,-2,2,8,-6,"September, 2002"
2002-2003,7,2002-09-21,Middlesbrough,Birmingham,1,0,H,3,0,1,0,4,3,1,1,9,10,8,8,1,0,September,-1.0,-1.8369701987210287e-16,29,3,0,0,0,0.0,0.0,7,5,2,8,7,1,"September, 2002"
2002-2003,7,2002-09-21,Man United,Tottenham,1,0,H,3,0,4,1,0,1,0,4,10,3,8,13,7,5,September,-1.0,-1.8369701987210287e-16,28,42,4,0,1,3.0,1.4,5,5,0,11,8,3,"September, 2002"
2002-2003,7,2002-09-21,Liverpool,West Brom,2,0,H,3,0,3,0,2,1,2,2,5,7,12,9,2,3,September,-1.0,-1.8369701987210287e-16,25,44,0,0,0,0.0,0.0,13,8,5,6,9,-3,"September, 2002"
2002-2003,7,2002-09-21,Arsenal,Bolton,2,1,H,3,0,3,1,1,2,3,0,1,14,14,6,13,8,September,-1.0,-1.8369701987210287e-16,0,6,4,1,0,2.0,0.6,15,6,9,6,9,-3,"September, 2002"
2002-2003,7,2002-09-22,Aston Villa,Everton,3,2,H,3,0,2,1,2,1,0,4,16,11,6,8,5,2,September,-1.0,-1.8369701987210287e-16,1,18,2,2,1,1.0,0.8,3,6,-3,7,8,-1,"September, 2002"
2002-2003,7,2002-09-22,Blackburn,Leeds,1,0,H,3,0,2,2,1,3,0,2,16,4,6,12,12,6,September,-1.0,-1.8369701987210287e-16,4,23,1,0,4,0.6,2.0,7,8,-1,10,4,6,"September, 2002"
2002-2003,7,2002-09-23,Fulham,Chelsea,0,0,D,1,1,3,1,1,2,1,2,8,4,10,12,4,2,September,-1.0,-1.8369701987210287e-16,19,14,0,1,1,1.5,2.0,12,6,6,13,8,5,"September, 2002"
2002-2003,8,2002-09-28,Tottenham,Middlesbrough,0,3,A,0,3,1,0,4,1,0,4,5,8,13,11,3,2,September,-1.0,-1.8369701987210287e-16,42,29,1,3,1,1.2,1.2,11,9,2,8,5,3,"September, 2002"
2002-2003,8,2002-09-28,Sunderland,Aston Villa,1,0,H,3,0,0,0,5,2,1,2,20,12,5,9,8,4,September,-1.0,-1.8369701987210287e-16,40,1,0,5,0,0.6,0.6,2,10,-8,6,8,-2,"September, 2002"
2002-2003,8,2002-09-28,Man City,Liverpool,0,3,A,0,3,3,0,2,3,0,2,15,2,8,15,13,7,September,-1.0,-1.8369701987210287e-16,27,25,0,2,2,1.25,3.0,7,9,-2,15,8,7,"September, 2002"
2002-2003,8,2002-09-28,Leeds,Arsenal,1,4,A,0,3,3,0,2,3,1,1,6,1,12,17,5,5,September,-1.0,-1.8369701987210287e-16,23,0,2,1,2,1.0,1.6,10,5,5,17,7,10,"September, 2002"
2002-2003,8,2002-09-28,Chelsea,West Ham,2,3,A,0,3,2,1,2,3,1,1,4,20,13,2,16,11,September,-1.0,-1.8369701987210287e-16,14,45,3,1,1,2.4,1.0,13,8,5,4,12,-8,"September, 2002"
2002-2003,8,2002-09-28,Charlton,Man United,1,3,A,0,3,1,0,4,4,1,0,17,8,7,11,9,4,September,-1.0,-1.8369701987210287e-16,13,28,0,2,3,0.8,1.6,6,10,-4,6,5,1,"September, 2002"
2002-2003,8,2002-09-28,Bolton,Southampton,1,1,D,1,1,2,3,0,1,1,3,17,18,6,6,1,0,September,-1.0,-1.8369701987210287e-16,6,38,1,2,2,0.2,0.4,7,11,-4,3,7,-4,"September, 2002"
2002-2003,8,2002-09-28,Birmingham,Newcastle,0,2,A,0,3,3,1,1,2,2,1,12,15,8,7,3,1,September,-1.0,-1.8369701987210287e-16,3,30,0,0,0,0.0,0.0,8,8,0,8,8,0,"September, 2002"
2002-2003,8,2002-09-28,Everton,Fulham,2,0,H,3,0,1,0,4,3,1,1,13,7,8,11,6,3,September,-1.0,-1.8369701987210287e-16,18,19,1,0,1,1.0,1.5,9,11,-2,12,6,6,"September, 2002"
2002-2003,8,2002-09-30,West Brom,Blackburn,0,2,A,0,3,1,2,2,2,2,1,13,11,9,9,2,0,September,-1.0,-1.8369701987210287e-16,44,4,0,0,0,0.0,0.0,6,11,-5,8,8,0,"September, 2002"
2002-2003,9,2002-10-05,West Ham,Birmingham,1,2,A,0,3,3,1,1,3,1,1,20,15,5,8,5,3,October,-0.8660254037844386,0.5,45,3,0,0,0,0.0,0.0,7,14,-7,8,10,-2,"October, 2002"
2002-2003,9,2002-10-05,Middlesbrough,Bolton,2,0,H,3,0,1,0,4,2,3,0,3,17,14,7,14,7,October,-0.8660254037844386,0.5,29,6,0,2,2,0.75,1.75,11,5,6,8,12,-4,"October, 2002"
2002-2003,9,2002-10-05,Newcastle,West Brom,2,1,H,3,0,2,2,1,1,2,2,11,13,10,9,2,1,October,-0.8660254037844386,0.5,30,44,0,0,0,0.0,0.0,10,8,2,6,13,-7,"October, 2002"
2002-2003,9,2002-10-05,Southampton,Man City,2,0,H,3,0,1,1,3,3,0,2,17,15,7,8,2,1,October,-0.8660254037844386,0.5,38,27,1,1,2,0.75,1.25,4,8,-4,7,12,-5,"October, 2002"
2002-2003,9,2002-10-06,Arsenal,Sunderland,3,1,H,3,0,3,1,1,0,0,5,1,17,20,8,16,12,October,-0.8660254037844386,0.5,0,40,2,2,1,2.0,1.0,21,8,13,3,10,-7,"October, 2002"
2002-2003,9,2002-10-06,Aston Villa,Leeds,0,0,D,1,1,2,1,2,3,0,2,14,8,9,12,6,3,October,-0.8660254037844386,0.5,1,23,2,1,2,1.0,1.0,6,9,-3,11,9,2,"October, 2002"
2002-2003,9,2002-10-06,Blackburn,Tottenham,1,2,A,0,3,2,2,1,1,0,4,9,8,12,13,1,1,October,-0.8660254037844386,0.5,4,42,1,1,3,0.8,1.6,10,8,2,11,12,-1,"October, 2002"
2002-2003,9,2002-10-06,Fulham,Charlton,1,0,H,3,0,3,1,1,1,0,4,10,19,11,7,9,4,October,-0.8660254037844386,0.5,19,13,0,2,0,0.5,0.5,12,8,4,7,13,-6,"October, 2002"
2002-2003,9,2002-10-06,Liverpool,Chelsea,1,0,H,3,0,3,0,2,2,1,2,2,7,18,13,5,5,October,-0.8660254037844386,0.5,25,14,1,1,3,0.6,2.2,18,8,10,15,11,4,"October, 2002"
2002-2003,9,2002-10-07,Man United,Everton,3,0,H,3,0,4,1,0,1,0,4,6,11,14,11,5,3,October,-0.8660254037844386,0.5,28,18,5,0,0,3.0,0.6,9,6,3,11,11,0,"October, 2002"
2002-2003,10,2002-10-19,Man City,Chelsea,0,3,A,0,3,3,0,2,2,1,2,16,9,8,13,7,5,October,-0.8660254037844386,0.5,27,14,0,1,3,0.75,1.5,7,14,-7,15,12,3,"October, 2002"
2002-2003,10,2002-10-19,Sunderland,West Ham,0,1,A,0,3,0,0,5,3,1,1,16,20,8,5,4,3,October,-0.8660254037844386,0.5,40,45,3,1,1,1.0,0.8,4,13,-9,8,16,-8,"October, 2002"
2002-2003,10,2002-10-19,Leeds,Liverpool,0,1,A,0,3,3,0,2,3,0,2,10,2,13,21,8,8,October,-0.8660254037844386,0.5,23,25,2,1,2,1.6,2.4,11,9,2,19,8,11,"October, 2002"
2002-2003,10,2002-10-19,West Brom,Birmingham,1,1,D,1,1,1,2,2,3,1,1,15,12,9,11,3,2,October,-0.8660254037844386,0.5,44,3,0,0,0,0.0,0.0,7,15,-8,10,11,-1,"October, 2002"
2002-2003,10,2002-10-19,Everton,Arsenal,2,1,H,3,0,1,0,4,3,1,1,12,1,11,23,11,12,October,-0.8660254037844386,0.5,18,0,1,0,4,1.2,2.0,11,14,-3,24,9,15,"October, 2002"
2002-2003,10,2002-10-19,Blackburn,Newcastle,5,2,H,3,0,2,2,1,2,2,1,10,8,12,13,2,1,October,-0.8660254037844386,0.5,4,30,1,3,1,1.0,1.0,11,10,1,12,9,3,"October, 2002"
2002-2003,10,2002-10-19,Fulham,Man United,1,1,D,1,1,3,1,1,4,1,0,7,4,14,17,3,3,October,-0.8660254037844386,0.5,19,28,0,0,2,2.0,3.0,13,8,5,12,6,6,"October, 2002"
2002-2003,10,2002-10-20,Tottenham,Bolton,3,1,H,3,0,1,0,4,2,3,0,6,20,16,7,14,9,October,-0.8660254037844386,0.5,42,6,3,2,0,1.8,1.2,13,13,0,8,14,-6,"October, 2002"
2002-2003,10,2002-10-20,Charlton,Middlesbrough,1,0,H,3,0,1,0,4,1,0,4,20,4,7,17,16,10,October,-0.8660254037844386,0.5,13,29,1,3,1,0.2,0.4,7,14,-7,13,5,8,"October, 2002"
2002-2003,10,2002-10-21,Aston Villa,Southampton,0,1,A,0,3,2,1,2,1,1,3,14,13,10,10,1,0,October,-0.8660254037844386,0.5,1,38,2,1,2,1.0,1.2,6,9,-3,6,8,-2,"October, 2002"
2002-2003,10,2002-10-23,Fulham,West Ham,0,1,A,0,3,3,1,1,3,1,1,7,17,15,8,10,7,October,-0.8660254037844386,0.5,19,45,1,0,1,1.0,0.5,14,9,5,9,16,-7,"October, 2002"
2002-2003,11,2002-10-26,Arsenal,Blackburn,1,2,A,0,3,3,1,1,2,2,1,2,7,23,15,5,8,October,-0.8660254037844386,0.5,0,4,4,1,0,2.6,1.4,25,11,14,16,12,4,"October, 2002"
2002-2003,11,2002-10-26,Birmingham,Man City,0,2,A,0,3,3,1,1,3,0,2,13,18,12,8,5,4,October,-0.8660254037844386,0.5,3,27,0,0,0,0.0,0.0,11,12,-1,7,17,-10,"October, 2002"
2002-2003,11,2002-10-26,Chelsea,West Brom,2,0,H,3,0,2,1,2,1,2,2,7,18,16,10,11,6,October,-0.8660254037844386,0.5,14,44,0,0,0,0.0,0.0,18,12,6,8,16,-8,"October, 2002"
2002-2003,11,2002-10-26,Liverpool,Tottenham,2,1,H,3,0,3,0,2,1,0,4,1,4,24,19,3,5,October,-0.8660254037844386,0.5,25,42,3,0,2,1.4,0.8,20,8,12,16,14,2,"October, 2002"
2002-2003,11,2002-10-26,Man United,Aston Villa,1,1,D,1,1,4,1,0,2,1,2,5,16,18,10,11,8,October,-0.8660254037844386,0.5,28,1,4,1,0,1.2,0.2,13,7,6,6,10,-4,"October, 2002"
2002-2003,11,2002-10-26,Middlesbrough,Leeds,2,2,D,1,1,1,0,4,3,0,2,7,10,17,13,3,4,October,-0.8660254037844386,0.5,29,23,0,3,2,0.8,1.2,13,6,7,11,10,1,"October, 2002"
2002-2003,11,2002-10-26,Newcastle,Charlton,2,1,H,3,0,2,2,1,1,0,4,11,17,13,10,6,3,October,-0.8660254037844386,0.5,30,13,1,2,2,1.2,1.2,14,14,0,8,14,-6,"October, 2002"
2002-2003,11,2002-10-27,Southampton,Fulham,4,2,H,3,0,1,1,3,3,1,1,12,9,13,15,3,2,October,-0.8660254037844386,0.5,38,19,0,1,1,1.0,1.5,7,8,-1,14,10,4,"October, 2002"
2002-2003,11,2002-10-27,West Ham,Everton,0,1,A,0,3,3,1,1,1,0,4,15,12,11,14,3,3,October,-0.8660254037844386,0.5,45,18,1,1,3,0.4,2.4,10,16,-6,13,15,-2,"October, 2002"
2002-2003,11,2002-10-28,Bolton,Sunderland,1,1,D,1,1,2,3,0,0,0,5,20,19,7,8,1,1,October,-0.8660254037844386,0.5,6,40,0,0,2,0.0,1.5,9,17,-8,4,14,-10,"October, 2002"
2002-2003,12,2002-11-02,West Brom,Man City,1,2,A,0,3,1,2,2,3,0,2,18,15,10,11,3,1,November,-0.5000000000000004,0.8660254037844384,44,27,0,0,0,0.0,0.0,8,18,-10,9,17,-8,"November, 2002"
2002-2003,12,2002-11-02,Man United,Southampton,2,1,H,3,0,4,1,0,1,1,3,4,10,19,16,6,3,November,-0.5000000000000004,0.8660254037844384,28,38,4,0,1,3.6,1.0,14,8,6,11,10,1,"November, 2002"
2002-2003,12,2002-11-02,Birmingham,Bolton,3,1,H,3,0,3,1,1,2,3,0,13,20,12,8,7,4,November,-0.5000000000000004,0.8660254037844384,3,6,0,0,0,0.0,0.0,11,14,-3,10,18,-8,"November, 2002"
2002-2003,12,2002-11-02,Liverpool,West Ham,2,0,H,3,0,3,0,2,3,1,1,1,15,27,11,14,16,November,-0.5000000000000004,0.8660254037844384,25,45,2,2,1,1.4,0.8,22,9,13,10,17,-7,"November, 2002"
2002-2003,12,2002-11-03,Blackburn,Aston Villa,0,0,D,1,1,2,2,1,2,1,2,7,15,18,11,8,7,November,-0.5000000000000004,0.8660254037844384,4,1,4,0,1,2.6,0.8,18,13,5,7,11,-4,"November, 2002"
2002-2003,12,2002-11-03,Charlton,Sunderland,1,1,D,1,1,1,0,4,0,0,5,17,19,10,9,2,1,November,-0.5000000000000004,0.8660254037844384,13,40,0,2,2,1.5,2.0,9,16,-7,5,15,-10,"November, 2002"
2002-2003,12,2002-11-03,Fulham,Arsenal,0,1,A,0,3,3,1,1,3,1,1,11,2,15,23,9,8,November,-0.5000000000000004,0.8660254037844384,19,0,0,0,2,1.0,3.5,16,14,2,26,13,13,"November, 2002"
2002-2003,12,2002-11-03,Leeds,Everton,0,1,A,0,3,3,0,2,1,0,4,13,8,14,17,5,3,November,-0.5000000000000004,0.8660254037844384,23,18,2,3,0,1.6,1.0,13,12,1,14,15,-1,"November, 2002"
2002-2003,12,2002-11-03,Tottenham,Chelsea,0,0,D,1,1,1,0,4,2,1,2,7,5,19,19,2,0,November,-0.5000000000000004,0.8660254037844384,42,14,0,0,5,0.4,2.8,17,16,1,20,12,8,"November, 2002"
2002-2003,12,2002-11-04,Newcastle,Middlesbrough,2,0,H,3,0,2,2,1,1,0,4,9,8,16,18,1,2,November,-0.5000000000000004,0.8660254037844384,30,29,3,1,1,2.6,1.2,16,15,1,15,8,7,"November, 2002"
2002-2003,13,2002-11-09,Man City,Man United,3,1,H,3,0,3,0,2,4,1,0,15,5,14,22,10,8,November,-0.5000000000000004,0.8660254037844384,27,28,0,1,3,0.75,1.5,11,18,-7,16,9,7,"November, 2002"
2002-2003,13,2002-11-09,Southampton,Blackburn,1,1,D,1,1,1,1,3,2,2,1,11,8,16,19,3,3,November,-0.5000000000000004,0.8660254037844384,38,4,2,1,2,1.8,1.4,12,12,0,18,13,5,"November, 2002"
2002-2003,13,2002-11-09,Middlesbrough,Liverpool,1,0,H,3,0,1,0,4,3,0,2,9,1,18,30,8,12,November,-0.5000000000000004,0.8660254037844384,29,25,1,2,2,0.4,0.8,15,10,5,24,9,15,"November, 2002"
2002-2003,13,2002-11-09,Everton,Charlton,1,0,H,3,0,1,0,4,1,0,4,6,16,20,11,10,9,November,-0.5000000000000004,0.8660254037844384,18,13,3,0,2,1.8,1.2,15,15,0,10,17,-7,"November, 2002"
2002-2003,13,2002-11-09,Arsenal,Newcastle,1,0,H,3,0,3,1,1,2,2,1,2,8,26,19,6,7,November,-0.5000000000000004,0.8660254037844384,0,30,2,1,2,2.0,1.4,27,13,14,18,15,3,"November, 2002"
2002-2003,13,2002-11-09,Bolton,West Brom,1,1,D,1,1,2,3,0,1,2,2,20,19,8,10,1,2,November,-0.5000000000000004,0.8660254037844384,6,44,0,0,0,0.0,0.0,11,21,-10,9,20,-11,"November, 2002"
2002-2003,13,2002-11-09,Aston Villa,Fulham,3,1,H,3,0,2,1,2,3,1,1,15,11,12,15,4,3,November,-0.5000000000000004,0.8660254037844384,1,19,1,1,0,1.0,0.0,7,11,-4,16,15,1,"November, 2002"
2002-2003,13,2002-11-09,Chelsea,Birmingham,3,0,H,3,0,2,1,2,3,1,1,4,12,20,15,8,5,November,-0.5000000000000004,0.8660254037844384,14,3,0,0,0,0.0,0.0,20,12,8,14,15,-1,"November, 2002"
2002-2003,13,2002-11-10,Sunderland,Tottenham,2,0,H,3,0,0,0,5,1,0,4,19,8,10,20,11,10,November,-0.5000000000000004,0.8660254037844384,40,42,0,0,5,1.2,2.4,6,16,-10,17,16,1,"November, 2002"
2002-2003,13,2002-11-10,West Ham,Leeds,3,4,A,0,3,3,1,1,3,0,2,18,15,11,14,3,3,November,-0.5000000000000004,0.8660254037844384,45,23,1,2,2,0.2,1.0,10,19,-9,13,13,0,"November, 2002"
2002-2003,14,2002-11-16,Newcastle,Southampton,2,1,H,3,0,2,2,1,1,1,3,9,11,19,17,2,2,November,-0.5000000000000004,0.8660254037844384,30,38,2,1,2,2.0,1.4,18,16,2,13,13,0,"November, 2002"
2002-2003,14,2002-11-16,Man City,Charlton,0,1,A,0,3,3,0,2,1,0,4,12,17,17,11,5,6,November,-0.5000000000000004,0.8660254037844384,27,13,0,0,2,0.5,4.0,14,19,-5,10,18,-8,"November, 2002"
2002-2003,14,2002-11-16,West Brom,Aston Villa,0,0,D,1,1,1,2,2,2,1,2,19,14,11,15,5,4,November,-0.5000000000000004,0.8660254037844384,44,1,0,0,0,0.0,0.0,10,21,-11,10,12,-2,"November, 2002"
2002-2003,14,2002-11-16,Arsenal,Tottenham,3,0,H,3,0,3,1,1,1,0,4,2,8,29,20,6,9,November,-0.5000000000000004,0.8660254037844384,0,42,3,2,0,1.6,0.8,28,13,15,17,18,-1,"November, 2002"
2002-2003,14,2002-11-16,Chelsea,Middlesbrough,1,0,H,3,0,2,1,2,1,0,4,3,6,23,21,3,2,November,-0.5000000000000004,0.8660254037844384,14,29,2,2,1,1.4,1.0,23,12,11,16,10,6,"November, 2002"
2002-2003,14,2002-11-17,Birmingham,Fulham,0,0,D,1,1,3,1,1,3,1,1,15,14,15,15,1,0,November,-0.5000000000000004,0.8660254037844384,3,19,0,0,0,0.0,0.0,14,18,-4,17,18,-1,"November, 2002"
2002-2003,14,2002-11-17,Blackburn,Everton,0,1,A,0,3,2,2,1,1,0,4,8,4,20,23,4,3,November,-0.5000000000000004,0.8660254037844384,4,18,2,1,2,0.8,0.8,19,14,5,16,15,1,"November, 2002"
2002-2003,14,2002-11-17,Leeds,Bolton,2,4,A,0,3,3,0,2,2,3,0,10,20,17,9,10,8,November,-0.5000000000000004,0.8660254037844384,23,6,3,1,1,1.6,0.6,17,16,1,12,22,-10,"November, 2002"
2002-2003,14,2002-11-17,Liverpool,Sunderland,0,0,D,1,1,3,0,2,0,0,5,2,17,30,13,15,17,November,-0.5000000000000004,0.8660254037844384,25,40,2,3,0,1.0,0.6,24,10,14,8,16,-8,"November, 2002"
2002-2003,14,2002-11-17,West Ham,Man United,1,1,D,1,1,3,1,1,4,1,0,20,5,11,22,15,11,November,-0.5000000000000004,0.8660254037844384,45,28,1,1,3,1.6,3.4,13,23,-10,17,12,5,"November, 2002"
2002-2003,15,2002-11-23,Middlesbrough,Man City,3,1,H,3,0,1,0,4,3,0,2,7,14,21,17,7,4,November,-0.5000000000000004,0.8660254037844384,29,27,2,2,0,1.75,0.75,16,11,5,14,20,-6,"November, 2002"
2002-2003,15,2002-11-23,Sunderland,Birmingham,0,1,A,0,3,0,0,5,3,1,1,17,15,14,16,2,2,November,-0.5000000000000004,0.8660254037844384,40,3,0,0,0,0.0,0.0,8,16,-8,14,18,-4,"November, 2002"
2002-2003,15,2002-11-23,Southampton,Arsenal,3,2,H,3,0,1,1,3,3,1,1,13,1,17,32,12,15,November,-0.5000000000000004,0.8660254037844384,38,0,1,1,3,1.0,1.8,14,15,-1,31,13,18,"November, 2002"
2002-2003,15,2002-11-23,Man United,Newcastle,5,3,H,3,0,4,1,0,2,2,1,5,6,23,22,1,1,November,-0.5000000000000004,0.8660254037844384,28,30,2,1,2,1.8,1.8,18,13,5,20,17,3,"November, 2002"
2002-2003,15,2002-11-23,Aston Villa,West Ham,4,1,H,3,0,2,1,2,3,1,1,14,19,16,12,5,4,November,-0.5000000000000004,0.8660254037844384,1,45,1,4,0,1.4,1.2,10,12,-2,14,24,-10,"November, 2002"
2002-2003,15,2002-11-23,Everton,West Brom,1,0,H,3,0,1,0,4,1,2,2,4,19,26,12,15,14,November,-0.5000000000000004,0.8660254037844384,18,44,0,0,0,0.0,0.0,17,15,2,10,21,-11,"November, 2002"
2002-2003,15,2002-11-23,Fulham,Liverpool,3,2,H,3,0,3,1,1,3,0,2,14,2,16,31,12,15,November,-0.5000000000000004,0.8660254037844384,19,25,0,1,1,0.0,1.0,17,18,-1,24,10,14,"November, 2002"
2002-2003,15,2002-11-23,Bolton,Chelsea,1,1,D,1,1,2,3,0,2,1,2,18,3,12,26,15,14,November,-0.5000000000000004,0.8660254037844384,6,14,2,1,2,1.2,2.0,16,24,-8,24,12,12,"November, 2002"
2002-2003,15,2002-11-24,Charlton,Blackburn,3,1,H,3,0,1,0,4,2,2,1,16,8,14,20,8,6,November,-0.5000000000000004,0.8660254037844384,13,4,0,1,3,0.25,1.75,11,18,-7,19,15,4,"November, 2002"
2002-2003,15,2002-11-24,Tottenham,Leeds,2,0,H,3,0,1,0,4,3,0,2,10,14,20,17,4,3,November,-0.5000000000000004,0.8660254037844384,42,23,1,0,4,1.4,2.0,17,21,-4,19,20,-1,"November, 2002"
2002-2003,16,2002-11-30,West Brom,Middlesbrough,1,0,H,3,0,1,2,2,1,0,4,19,6,12,24,13,12,November,-0.5000000000000004,0.8660254037844384,44,29,0,0,0,0.0,0.0,10,22,-12,19,12,7,"November, 2002"
2002-2003,16,2002-11-30,Chelsea,Sunderland,3,0,H,3,0,2,1,2,0,0,5,4,17,27,14,13,13,November,-0.5000000000000004,0.8660254037844384,14,40,1,1,3,1.4,1.8,25,13,12,8,17,-9,"November, 2002"
2002-2003,16,2002-11-30,Man City,Bolton,2,0,H,3,0,3,0,2,2,3,0,16,18,17,13,2,4,November,-0.5000000000000004,0.8660254037844384,27,6,1,1,0,1.0,0.5,15,23,-8,17,25,-8,"November, 2002"
2002-2003,16,2002-11-30,Birmingham,Tottenham,1,1,D,1,1,3,1,1,1,0,4,13,7,19,23,6,4,November,-0.5000000000000004,0.8660254037844384,3,42,0,0,0,0.0,0.0,15,18,-3,19,21,-2,"November, 2002"
2002-2003,16,2002-11-30,Arsenal,Aston Villa,3,1,H,3,0,3,1,1,2,1,2,1,11,32,19,10,13,November,-0.5000000000000004,0.8660254037844384,0,1,3,2,0,1.4,0.8,33,16,17,14,13,1,"November, 2002"
2002-2003,16,2002-11-30,Blackburn,Fulham,2,1,H,3,0,2,2,1,3,1,1,9,12,20,19,3,1,November,-0.5000000000000004,0.8660254037844384,4,19,1,0,1,1.5,1.0,20,18,2,20,20,0,"November, 2002"
2002-2003,16,2002-12-01,Leeds,Charlton,1,2,A,0,3,3,0,2,1,0,4,15,16,17,17,1,0,December,-2.4492935982947064e-16,1.0,23,13,3,2,0,1.6,0.6,19,22,-3,14,19,-5,"December, 2002"
2002-2003,16,2002-12-01,Liverpool,Man United,1,2,A,0,3,3,0,2,4,1,0,2,5,31,26,3,5,December,-2.4492935982947064e-16,1.0,25,28,4,1,0,1.6,0.4,26,13,13,23,16,7,"December, 2002"
2002-2003,16,2002-12-01,Newcastle,Everton,2,1,H,3,0,2,2,1,1,0,4,9,5,22,29,4,7,December,-2.4492935982947064e-16,1.0,30,18,3,1,1,2.4,1.0,23,22,1,18,15,3,"December, 2002"
2002-2003,16,2002-12-02,West Ham,Southampton,0,1,A,0,3,3,1,1,1,1,3,20,10,12,20,10,8,December,-2.4492935982947064e-16,1.0,45,38,4,0,1,2.0,0.8,15,28,-13,17,17,0,"December, 2002"
2002-2003,17,2002-12-07,Fulham,Leeds,1,0,H,3,0,3,1,1,3,0,2,14,16,19,17,2,2,December,-2.4492935982947064e-16,1.0,19,23,1,1,0,0.5,0.0,21,22,-1,20,24,-4,"December, 2002"
2002-2003,17,2002-12-07,Middlesbrough,West Ham,2,2,D,1,1,1,0,4,3,1,1,7,20,24,12,13,12,December,-2.4492935982947064e-16,1.0,29,45,3,0,2,1.0,0.6,19,13,6,15,29,-14,"December, 2002"
2002-2003,17,2002-12-07,Man United,Arsenal,2,0,H,3,0,4,1,0,3,1,1,4,1,29,35,3,6,December,-2.4492935982947064e-16,1.0,28,0,1,1,3,1.6,1.4,25,17,8,36,17,19,"December, 2002"
2002-2003,17,2002-12-07,Southampton,Birmingham,2,0,H,3,0,1,1,3,3,1,1,10,13,23,20,3,3,December,-2.4492935982947064e-16,1.0,38,3,0,0,0,0.0,0.0,18,17,1,16,19,-3,"December, 2002"
2002-2003,17,2002-12-07,Everton,Chelsea,1,3,A,0,3,1,0,4,2,1,2,5,3,29,30,2,1,December,-2.4492935982947064e-16,1.0,18,14,1,2,2,0.8,1.4,19,17,2,28,13,15,"December, 2002"
2002-2003,17,2002-12-07,Bolton,Blackburn,1,1,D,1,1,2,3,0,2,2,1,19,9,13,23,10,10,December,-2.4492935982947064e-16,1.0,6,4,1,2,2,1.2,1.8,17,27,-10,22,19,3,"December, 2002"
2002-2003,17,2002-12-07,Aston Villa,Newcastle,0,1,A,0,3,2,1,2,2,2,1,15,6,19,25,9,6,December,-2.4492935982947064e-16,1.0,1,30,0,2,3,0.4,1.8,15,16,-1,25,23,2,"December, 2002"
2002-2003,17,2002-12-07,Charlton,Liverpool,2,0,H,3,0,1,0,4,3,0,2,12,2,20,31,10,11,December,-2.4492935982947064e-16,1.0,13,25,1,0,4,0.2,2.2,16,20,-4,27,15,12,"December, 2002"
2002-2003,17,2002-12-08,Tottenham,West Brom,3,1,H,3,0,1,0,4,1,2,2,10,17,24,15,7,9,December,-2.4492935982947064e-16,1.0,42,44,0,0,0,0.0,0.0,20,22,-2,11,22,-11,"December, 2002"
2002-2003,17,2002-12-09,Sunderland,Man City,0,3,A,0,3,0,0,5,3,0,2,19,14,14,20,5,6,December,-2.4492935982947064e-16,1.0,40,27,1,0,1,1.5,2.0,8,20,-12,17,23,-6,"December, 2002"
2002-2003,18,2002-12-14,Southampton,Newcastle,1,1,D,1,1,1,1,3,2,2,1,9,6,26,28,3,2,December,-2.4492935982947064e-16,1.0,38,30,2,1,2,1.6,1.4,20,17,3,26,23,3,"December, 2002"
2002-2003,18,2002-12-14,Middlesbrough,Chelsea,1,1,D,1,1,1,0,4,2,1,2,9,3,25,33,6,8,December,-2.4492935982947064e-16,1.0,29,14,1,1,3,0.8,1.4,21,15,6,31,14,17,"December, 2002"
2002-2003,18,2002-12-14,Man United,West Ham,3,0,H,3,0,4,1,0,3,1,1,3,20,32,13,17,19,December,-2.4492935982947064e-16,1.0,28,45,2,2,1,2.2,1.6,27,17,10,17,31,-14,"December, 2002"
2002-2003,18,2002-12-14,Charlton,Man City,2,2,D,1,1,1,0,4,3,0,2,11,12,23,23,1,0,December,-2.4492935982947064e-16,1.0,13,27,3,0,0,3.0,0.3333333333333333,18,20,-2,20,23,-3,"December, 2002"
2002-2003,18,2002-12-14,Aston Villa,West Brom,2,1,H,3,0,2,1,2,1,2,2,15,17,19,15,2,4,December,-2.4492935982947064e-16,1.0,1,44,0,1,0,0.0,0.0,15,17,-2,12,25,-13,"December, 2002"
2002-2003,18,2002-12-14,Everton,Blackburn,2,1,H,3,0,1,0,4,2,2,1,5,10,29,24,5,5,December,-2.4492935982947064e-16,1.0,18,4,2,1,2,0.8,0.8,20,20,0,23,20,3,"December, 2002"
2002-2003,18,2002-12-15,Fulham,Birmingham,0,1,A,0,3,3,1,1,3,1,1,13,15,22,20,2,2,December,-2.4492935982947064e-16,1.0,19,3,0,1,0,0.0,0.0,22,22,0,16,21,-5,"December, 2002"
2002-2003,18,2002-12-15,Sunderland,Liverpool,2,1,H,3,0,0,0,5,3,0,2,19,5,14,31,14,17,December,-2.4492935982947064e-16,1.0,40,25,0,3,2,0.4,0.8,8,23,-15,27,17,10,"December, 2002"
2002-2003,18,2002-12-15,Tottenham,Arsenal,1,1,D,1,1,1,0,4,3,1,1,8,1,27,35,7,8,December,-2.4492935982947064e-16,1.0,42,0,0,2,3,0.6,1.8,23,23,0,36,19,17,"December, 2002"
2002-2003,18,2002-12-16,Bolton,Leeds,0,3,A,0,3,2,3,0,3,0,2,19,16,14,17,3,3,December,-2.4492935982947064e-16,1.0,6,23,1,1,3,1.2,2.0,18,28,-10,20,25,-5,"December, 2002"
2002-2003,19,2002-12-21,Newcastle,Fulham,2,0,H,3,0,2,2,1,3,1,1,6,14,29,22,8,7,December,-2.4492935982947064e-16,1.0,30,19,0,1,1,1.0,2.0,27,24,3,22,23,-1,"December, 2002"
2002-2003,19,2002-12-21,West Brom,Sunderland,2,2,D,1,1,1,2,2,0,0,5,18,17,15,17,1,2,December,-2.4492935982947064e-16,1.0,44,40,0,0,0,0.0,0.0,13,27,-14,10,24,-14,"December, 2002"
2002-2003,19,2002-12-21,Leeds,Southampton,1,1,D,1,1,3,0,2,1,1,3,16,8,20,27,8,7,December,-2.4492935982947064e-16,1.0,23,38,4,0,1,1.2,0.2,23,25,-2,21,18,3,"December, 2002"
2002-2003,19,2002-12-21,West Ham,Bolton,1,1,D,1,1,3,1,1,2,3,0,20,19,13,14,1,1,December,-2.4492935982947064e-16,1.0,45,6,3,1,1,1.4,0.6,17,34,-17,18,31,-13,"December, 2002"
2002-2003,19,2002-12-21,Birmingham,Charlton,1,1,D,1,1,3,1,1,1,0,4,13,11,23,24,2,1,December,-2.4492935982947064e-16,1.0,3,13,0,0,0,0.0,0.0,17,21,-4,20,22,-2,"December, 2002"
2002-2003,19,2002-12-21,Arsenal,Middlesbrough,2,0,H,3,0,3,1,1,1,0,4,1,9,36,26,8,10,December,-2.4492935982947064e-16,1.0,0,29,3,0,2,1.6,1.2,37,20,17,22,16,6,"December, 2002"
2002-2003,19,2002-12-21,Chelsea,Aston Villa,2,0,H,3,0,2,1,2,2,1,2,3,15,34,22,12,12,December,-2.4492935982947064e-16,1.0,14,1,1,3,1,0.8,1.0,32,15,17,17,18,-1,"December, 2002"
2002-2003,19,2002-12-22,Liverpool,Everton,0,0,D,1,1,3,0,2,1,0,4,6,5,31,32,1,1,December,-2.4492935982947064e-16,1.0,25,18,3,2,0,2.0,1.0,28,19,9,22,21,1,"December, 2002"
2002-2003,19,2002-12-22,Blackburn,Man United,1,0,H,3,0,2,2,1,4,1,0,11,3,24,35,8,11,December,-2.4492935982947064e-16,1.0,4,28,0,2,3,1.2,2.0,24,22,2,30,17,13,"December, 2002"
2002-2003,19,2002-12-23,Man City,Tottenham,2,3,A,0,3,3,0,2,1,0,4,12,8,24,28,4,4,December,-2.4492935982947064e-16,1.0,27,42,0,2,2,0.25,0.75,22,25,-3,24,24,0,"December, 2002"
2002-2003,20,2002-12-26,Birmingham,Everton,1,1,D,1,1,3,1,1,1,0,4,13,4,24,33,9,9,December,-2.4492935982947064e-16,1.0,3,18,0,1,0,1.0,1.0,18,22,-4,22,21,1,"December, 2002"
2002-2003,20,2002-12-26,Bolton,Newcastle,4,3,H,3,0,2,3,0,2,2,1,19,6,15,32,13,17,December,-2.4492935982947064e-16,1.0,6,30,1,0,4,1.0,2.2,19,32,-13,29,24,5,"December, 2002"
2002-2003,20,2002-12-26,Chelsea,Southampton,0,0,D,1,1,2,1,2,1,1,3,2,8,37,28,6,9,December,-2.4492935982947064e-16,1.0,14,38,2,1,2,1.6,1.6,34,15,19,22,19,3,"December, 2002"
2002-2003,20,2002-12-26,Liverpool,Blackburn,1,1,D,1,1,3,0,2,2,2,1,5,9,32,27,4,5,December,-2.4492935982947064e-16,1.0,25,4,3,2,0,2.4,1.4,28,19,9,25,22,3,"December, 2002"
2002-2003,20,2002-12-26,Man City,Aston Villa,3,1,H,3,0,3,0,2,2,1,2,13,15,24,22,2,2,December,-2.4492935982947064e-16,1.0,27,1,2,1,2,1.0,1.2,24,28,-4,17,20,-3,"December, 2002"
2002-2003,20,2002-12-26,Middlesbrough,Man United,3,1,H,3,0,1,0,4,4,1,0,11,3,26,35,8,9,December,-2.4492935982947064e-16,1.0,29,28,1,0,4,0.4,1.2,22,18,4,30,18,12,"December, 2002"
2002-2003,20,2002-12-26,Sunderland,Leeds,1,2,A,0,3,0,0,5,3,0,2,18,16,18,21,2,3,December,-2.4492935982947064e-16,1.0,40,23,2,0,3,0.6,1.2,12,26,-14,24,26,-2,"December, 2002"
2002-2003,20,2002-12-26,Tottenham,Charlton,2,2,D,1,1,1,0,4,1,0,4,7,12,31,25,5,6,December,-2.4492935982947064e-16,1.0,42,13,1,1,3,0.4,1.0,27,26,1,21,23,-2,"December, 2002"
2002-2003,20,2002-12-26,West Brom,Arsenal,1,2,A,0,3,1,2,2,3,1,1,19,1,16,39,18,23,December,-2.4492935982947064e-16,1.0,44,0,0,0,1,2.0,5.0,15,29,-14,39,20,19,"December, 2002"
2002-2003,20,2002-12-26,West Ham,Fulham,1,1,D,1,1,3,1,1,3,1,1,20,15,14,22,5,8,December,-2.4492935982947064e-16,1.0,45,19,2,0,1,0.6666666666666666,0.6666666666666666,18,35,-17,22,25,-3,"December, 2002"
2002-2003,21,2002-12-28,Southampton,Sunderland,2,1,H,3,0,1,1,3,0,0,5,11,18,29,18,7,11,December,-2.4492935982947064e-16,1.0,38,40,1,2,2,1.2,1.2,22,19,3,13,28,-15,"December, 2002"
2002-2003,21,2002-12-28,Man United,Birmingham,2,0,H,3,0,4,1,0,3,1,1,3,15,35,25,12,10,December,-2.4492935982947064e-16,1.0,28,3,0,0,0,0.0,0.0,31,21,10,19,23,-4,"December, 2002"
2002-2003,21,2002-12-28,Leeds,Chelsea,2,0,H,3,0,3,0,2,2,1,2,15,2,24,38,13,14,December,-2.4492935982947064e-16,1.0,23,14,1,2,2,0.6,0.8,26,27,-1,34,15,19,"December, 2002"
2002-2003,21,2002-12-28,Fulham,Man City,0,1,A,0,3,3,1,1,3,0,2,16,12,23,27,4,4,December,-2.4492935982947064e-16,1.0,19,27,0,0,0,0.0,0.0,23,26,-3,27,29,-2,"December, 2002"
2002-2003,21,2002-12-28,Blackburn,West Ham,2,2,D,1,1,2,2,1,3,1,1,10,20,28,15,10,13,December,-2.4492935982947064e-16,1.0,4,45,2,0,3,2.2,1.4,26,23,3,19,36,-17,"December, 2002"
2002-2003,21,2002-12-28,Charlton,West Brom,1,0,H,3,0,1,0,4,1,2,2,12,19,26,16,7,10,December,-2.4492935982947064e-16,1.0,13,44,0,0,0,0.0,0.0,23,25,-2,16,31,-15,"December, 2002"
2002-2003,21,2002-12-28,Aston Villa,Middlesbrough,1,0,H,3,0,2,1,2,1,0,4,16,8,22,29,8,7,December,-2.4492935982947064e-16,1.0,1,29,1,3,1,1.4,0.8,18,23,-5,25,19,6,"December, 2002"
2002-2003,21,2002-12-28,Everton,Bolton,0,0,D,1,1,1,0,4,2,3,0,4,17,34,18,13,16,December,-2.4492935982947064e-16,1.0,18,6,3,2,0,2.2,1.0,23,22,1,23,35,-12,"December, 2002"
2002-2003,21,2002-12-29,Arsenal,Liverpool,1,1,D,1,1,3,1,1,3,0,2,1,5,42,33,4,9,December,-2.4492935982947064e-16,1.0,0,25,2,1,2,1.0,1.4,41,21,20,29,20,9,"December, 2002"
2002-2003,21,2002-12-29,Newcastle,Tottenham,2,1,H,3,0,2,2,1,1,0,4,6,8,32,32,2,0,December,-2.4492935982947064e-16,1.0,30,42,3,0,2,1.8,1.6,32,28,4,29,28,1,"December, 2002"
2002-2003,22,2003-01-01,Man United,Sunderland,2,1,H,3,0,4,1,0,0,0,5,3,18,38,18,15,20,January,0.4999999999999999,0.8660254037844387,28,40,4,1,0,2.4,0.6,33,21,12,14,30,-16,"January, 2003"
2002-2003,22,2003-01-01,Southampton,Tottenham,1,0,H,3,0,1,1,3,1,0,4,8,9,32,32,1,0,January,0.4999999999999999,0.8660254037844387,38,42,2,1,2,0.8,0.8,24,20,4,30,30,0,"January, 2003"
2002-2003,22,2003-01-01,Newcastle,Liverpool,1,0,H,3,0,2,2,1,3,0,2,5,6,35,34,1,1,January,0.4999999999999999,0.8660254037844387,30,25,1,1,3,0.8,2.2,34,29,5,30,21,9,"January, 2003"
2002-2003,22,2003-01-01,Leeds,Birmingham,2,0,H,3,0,3,0,2,3,1,1,14,15,27,25,1,2,January,0.4999999999999999,0.8660254037844387,23,3,0,0,1,1.0,2.0,28,27,1,19,25,-6,"January, 2003"
2002-2003,22,2003-01-01,Arsenal,Chelsea,3,2,H,3,0,3,1,1,2,1,2,1,2,43,38,1,5,January,0.4999999999999999,0.8660254037844387,0,14,1,4,0,1.4,1.2,42,22,20,34,17,17,"January, 2003"
2002-2003,22,2003-01-01,Blackburn,Middlesbrough,1,0,H,3,0,2,2,1,1,0,4,11,10,29,29,1,0,January,0.4999999999999999,0.8660254037844387,4,29,1,1,3,0.8,1.0,28,25,3,25,20,5,"January, 2003"
2002-2003,22,2003-01-01,Aston Villa,Bolton,2,0,H,3,0,2,1,2,2,3,0,14,17,25,19,3,6,January,0.4999999999999999,0.8660254037844387,1,6,2,0,3,1.4,1.8,19,23,-4,23,35,-12,"January, 2003"
2002-2003,22,2003-01-01,Everton,Man City,2,2,D,1,1,1,0,4,3,0,2,5,10,35,30,5,5,January,0.4999999999999999,0.8660254037844387,18,27,3,0,2,1.6,1.8,23,22,1,28,29,-1,"January, 2003"
2002-2003,23,2003-01-11,West Ham,Newcastle,2,2,D,1,1,3,1,1,2,2,1,19,4,16,38,15,22,January,0.4999999999999999,0.8660254037844387,45,30,2,0,3,1.2,1.8,21,38,-17,35,29,6,"January, 2003"
2002-2003,23,2003-01-11,West Brom,Man United,1,3,A,0,3,1,2,2,4,1,0,19,3,16,41,16,25,January,0.4999999999999999,0.8660254037844387,44,28,0,0,1,0.0,1.0,16,32,-16,35,22,13,"January, 2003"
2002-2003,23,2003-01-11,Middlesbrough,Southampton,2,2,D,1,1,1,0,4,1,1,3,12,7,29,35,5,6,January,0.4999999999999999,0.8660254037844387,29,38,1,2,2,1.0,1.2,25,21,4,25,20,5,"January, 2003"
2002-2003,23,2003-01-11,Sunderland,Blackburn,0,0,D,1,1,0,0,5,2,2,1,18,9,18,32,9,14,January,0.4999999999999999,0.8660254037844387,40,4,2,2,1,0.8,0.2,15,32,-17,29,25,4,"January, 2003"
2002-2003,23,2003-01-11,Liverpool,Aston Villa,1,1,D,1,1,3,0,2,2,1,2,7,14,34,28,7,6,January,0.4999999999999999,0.8660254037844387,25,1,4,0,1,2.0,1.0,30,22,8,21,23,-2,"January, 2003"
2002-2003,23,2003-01-11,Chelsea,Charlton,4,1,H,3,0,2,1,2,1,0,4,3,13,38,29,10,9,January,0.4999999999999999,0.8660254037844387,14,13,1,0,4,0.8,1.6,36,20,16,24,25,-1,"January, 2003"
2002-2003,23,2003-01-11,Bolton,Fulham,0,0,D,1,1,2,3,0,3,1,1,17,16,19,23,1,4,January,0.4999999999999999,0.8660254037844387,6,19,0,1,2,0.3333333333333333,2.333333333333333,23,37,-14,23,27,-4,"January, 2003"
2002-2003,23,2003-01-11,Man City,Leeds,2,1,H,3,0,3,0,2,3,0,2,10,11,31,30,1,1,January,0.4999999999999999,0.8660254037844387,27,23,2,1,2,0.6,1.6,30,31,-1,30,27,3,"January, 2003"
2002-2003,23,2003-01-12,Birmingham,Arsenal,0,4,A,0,3,3,1,1,3,1,1,15,1,25,46,14,21,January,0.4999999999999999,0.8660254037844387,3,0,0,0,1,0.0,2.0,19,27,-8,45,24,21,"January, 2003"
2002-2003,23,2003-01-12,Tottenham,Everton,4,3,H,3,0,1,0,4,1,0,4,10,6,32,36,4,4,January,0.4999999999999999,0.8660254037844387,42,18,1,4,0,1.4,1.2,30,31,-1,25,24,1,"January, 2003"
2002-2003,24,2003-01-18,Man United,Chelsea,2,1,H,3,0,4,1,0,2,1,2,2,3,44,41,1,3,January,0.4999999999999999,0.8660254037844387,28,14,1,3,1,1.8,1.8,38,23,15,40,21,19,"January, 2003"
2002-2003,24,2003-01-18,Southampton,Liverpool,0,1,A,0,3,1,1,3,3,0,2,7,8,36,35,1,1,January,0.4999999999999999,0.8660254037844387,38,25,1,2,2,1.4,1.8,27,22,5,31,23,8,"January, 2003"
2002-2003,24,2003-01-18,Newcastle,Man City,2,0,H,3,0,2,2,1,3,0,2,4,10,39,34,6,5,January,0.4999999999999999,0.8660254037844387,30,27,2,1,2,1.4,1.2,37,31,6,32,32,0,"January, 2003"
2002-2003,24,2003-01-18,Leeds,West Brom,0,0,D,1,1,3,0,2,1,2,2,12,20,30,16,8,14,January,0.4999999999999999,0.8660254037844387,23,44,1,0,0,3.0,1.0,31,29,2,17,35,-18,"January, 2003"
2002-2003,24,2003-01-18,Charlton,Bolton,1,1,D,1,1,1,0,4,2,3,0,14,17,29,20,3,9,January,0.4999999999999999,0.8660254037844387,13,6,1,1,1,1.0,1.0,25,29,-4,23,37,-14,"January, 2003"
2002-2003,24,2003-01-18,Everton,Sunderland,2,1,H,3,0,1,0,4,0,0,5,7,18,36,19,11,17,January,0.4999999999999999,0.8660254037844387,18,40,2,1,2,0.8,1.0,28,28,0,15,32,-17,"January, 2003"
2002-2003,24,2003-01-18,Blackburn,Birmingham,1,1,D,1,1,2,2,1,3,1,1,10,15,33,25,5,8,January,0.4999999999999999,0.8660254037844387,4,3,1,0,0,1.0,0.0,29,25,4,19,31,-12,"January, 2003"
2002-2003,24,2003-01-18,Aston Villa,Tottenham,0,1,A,0,3,2,1,2,1,0,4,13,8,29,35,5,6,January,0.4999999999999999,0.8660254037844387,1,42,1,3,1,0.6,0.4,22,24,-2,34,34,0,"January, 2003"
2002-2003,24,2003-01-19,Arsenal,West Ham,3,1,H,3,0,3,1,1,3,1,1,1,19,49,17,18,32,January,0.4999999999999999,0.8660254037844387,0,45,3,2,0,2.0,0.8,49,24,25,23,40,-17,"January, 2003"
2002-2003,24,2003-01-19,Fulham,Middlesbrough,1,0,H,3,0,3,1,1,1,0,4,16,12,24,30,4,6,January,0.4999999999999999,0.8660254037844387,19,29,1,1,1,1.6666666666666667,1.6666666666666667,23,27,-4,27,23,4,"January, 2003"
2002-2003,24,2003-01-22,Charlton,West Ham,4,2,H,3,0,1,0,4,3,1,1,13,20,30,17,7,13,January,0.4999999999999999,0.8660254037844387,13,45,1,2,2,1.4,2.4,26,30,-4,24,43,-19,"January, 2003"
2002-2003,24,2003-01-22,Newcastle,Bolton,1,0,H,3,0,2,2,1,2,3,0,3,17,42,21,14,21,January,0.4999999999999999,0.8660254037844387,30,6,3,0,2,2.4,1.6,39,31,8,24,38,-14,"January, 2003"
2002-2003,25,2003-01-28,Sunderland,Southampton,0,1,A,0,3,0,0,5,1,1,3,18,8,19,36,10,17,January,0.4999999999999999,0.8660254037844387,40,38,1,2,2,1.0,1.4,16,34,-18,27,23,4,"January, 2003"
2002-2003,25,2003-01-28,Middlesbrough,Aston Villa,2,5,A,0,3,1,0,4,2,1,2,13,14,30,29,1,1,January,0.4999999999999999,0.8660254037844387,29,1,1,3,1,0.8,0.8,27,24,3,22,25,-3,"January, 2003"
2002-2003,25,2003-01-28,Bolton,Everton,1,2,A,0,3,2,3,0,1,0,4,17,5,21,39,12,18,January,0.4999999999999999,0.8660254037844387,6,18,0,3,2,1.0,1.6,24,39,-15,30,29,1,"January, 2003"
2002-2003,25,2003-01-28,Chelsea,Leeds,3,2,H,3,0,2,1,2,3,0,2,5,12,41,31,7,10,January,0.4999999999999999,0.8660254037844387,14,23,1,2,2,0.6,1.0,41,23,18,31,29,2,"January, 2003"
2002-2003,25,2003-01-29,Liverpool,Arsenal,2,2,D,1,1,3,0,2,3,1,1,7,1,38,52,6,14,January,0.4999999999999999,0.8660254037844387,25,0,1,2,2,1.4,1.2,32,23,9,52,25,27,"January, 2003"
2002-2003,25,2003-01-29,Man City,Fulham,4,1,H,3,0,3,0,2,3,1,1,10,15,34,27,5,7,January,0.4999999999999999,0.8660254037844387,27,19,1,0,0,1.0,0.0,32,34,-2,24,27,-3,"January, 2003"
2002-2003,25,2003-01-29,Tottenham,Newcastle,0,1,A,0,3,1,0,4,2,2,1,8,3,38,45,5,7,January,0.4999999999999999,0.8660254037844387,42,30,2,0,3,1.6,1.8,35,34,1,40,31,9,"January, 2003"
2002-2003,25,2003-01-29,West Brom,Charlton,0,1,A,0,3,1,2,2,1,0,4,19,11,17,33,8,16,January,0.4999999999999999,0.8660254037844387,44,13,0,0,1,0.0,1.0,17,35,-18,30,32,-2,"January, 2003"
2002-2003,25,2003-01-29,West Ham,Blackburn,2,1,H,3,0,3,1,1,2,2,1,20,11,17,34,9,17,January,0.4999999999999999,0.8660254037844387,45,4,2,1,2,1.4,2.4,26,47,-21,30,26,4,"January, 2003"
2002-2003,26,2003-02-01,Man City,West Brom,1,2,A,0,3,3,0,2,1,2,2,9,20,37,17,11,20,February,0.8660254037844386,0.5000000000000001,27,44,1,0,0,2.0,1.0,36,35,1,17,36,-19,"February, 2003"
2002-2003,26,2003-02-01,Sunderland,Charlton,1,3,A,0,3,0,0,5,1,0,4,20,10,19,36,10,17,February,0.8660254037844386,0.5000000000000001,40,13,2,3,0,1.8,1.4,16,35,-19,31,32,-1,"February, 2003"
2002-2003,26,2003-02-01,Southampton,Man United,0,2,A,0,3,1,1,3,4,1,0,7,3,39,47,4,8,February,0.8660254037844386,0.5000000000000001,38,28,1,0,4,1.0,3.4,28,23,5,40,24,16,"February, 2003"
2002-2003,26,2003-02-01,Everton,Leeds,2,0,H,3,0,1,0,4,3,0,2,5,13,42,31,8,11,February,0.8660254037844386,0.5000000000000001,18,23,1,2,2,1.0,1.4,32,30,2,33,32,1,"February, 2003"
2002-2003,26,2003-02-01,Chelsea,Tottenham,1,1,D,1,1,2,1,2,1,0,4,4,8,44,38,4,6,February,0.8660254037844386,0.5000000000000001,14,42,4,1,0,2.6,0.4,44,25,19,35,35,0,"February, 2003"
2002-2003,26,2003-02-01,Bolton,Birmingham,4,2,H,3,0,2,3,0,3,1,1,17,16,21,26,1,5,February,0.8660254037844386,0.5000000000000001,6,3,0,0,1,1.0,3.0,25,41,-16,20,32,-12,"February, 2003"
2002-2003,26,2003-02-01,Arsenal,Fulham,2,1,H,3,0,3,1,1,3,1,1,1,15,53,27,14,26,February,0.8660254037844386,0.5000000000000001,0,19,3,0,0,2.6666666666666665,0.6666666666666666,54,27,27,25,31,-6,"February, 2003"
2002-2003,26,2003-02-02,Aston Villa,Blackburn,3,0,H,3,0,2,1,2,2,2,1,12,11,32,34,1,2,February,0.8660254037844386,0.5000000000000001,1,4,1,1,3,0.8,1.6,27,27,0,31,28,3,"February, 2003"
2002-2003,26,2003-02-02,West Ham,Liverpool,0,3,A,0,3,3,1,1,3,0,2,19,6,20,39,13,19,February,0.8660254037844386,0.5000000000000001,45,25,0,2,3,0.6,1.8,28,48,-20,34,25,9,"February, 2003"
2002-2003,26,2003-02-04,Birmingham,Man United,0,1,A,0,3,3,1,1,4,1,0,16,2,26,50,14,24,February,0.8660254037844386,0.5000000000000001,3,28,0,0,1,0.0,2.0,22,36,-14,42,24,18,"February, 2003"
2002-2003,27,2003-02-08,Birmingham,Chelsea,1,3,A,0,3,3,1,1,2,1,2,16,4,26,45,12,19,February,0.8660254037844386,0.5000000000000001,3,14,0,0,1,0.0,3.0,22,37,-15,45,26,19,"February, 2003"
2002-2003,27,2003-02-08,Blackburn,Southampton,1,0,H,3,0,2,2,1,1,1,3,12,7,34,39,5,5,February,0.8660254037844386,0.5000000000000001,4,38,2,2,1,1.6,1.4,31,31,0,28,25,3,"February, 2003"
2002-2003,27,2003-02-08,Charlton,Everton,2,1,H,3,0,1,0,4,1,0,4,8,5,39,45,3,6,February,0.8660254037844386,0.5000000000000001,13,18,2,0,3,1.0,1.2,34,33,1,34,30,4,"February, 2003"
2002-2003,27,2003-02-08,Fulham,Aston Villa,2,1,H,3,0,3,1,1,2,1,2,15,12,27,35,3,8,February,0.8660254037844386,0.5000000000000001,19,1,0,1,2,0.3333333333333333,1.6666666666666667,26,33,-7,30,27,3,"February, 2003"
2002-2003,27,2003-02-08,Leeds,West Ham,1,0,H,3,0,3,0,2,3,1,1,13,19,31,20,6,11,February,0.8660254037844386,0.5000000000000001,23,45,3,1,1,1.8,0.8,33,34,-1,28,51,-23,"February, 2003"
2002-2003,27,2003-02-08,Liverpool,Middlesbrough,1,1,D,1,1,3,0,2,1,0,4,6,14,42,30,8,12,February,0.8660254037844386,0.5000000000000001,25,29,2,1,2,0.8,0.6,37,25,12,29,29,0,"February, 2003"
2002-2003,27,2003-02-08,Tottenham,Sunderland,4,1,H,3,0,1,0,4,0,0,5,9,20,39,19,11,20,February,0.8660254037844386,0.5000000000000001,42,40,4,0,1,1.8,1.4,36,36,0,17,38,-21,"February, 2003"
2002-2003,27,2003-02-08,West Brom,Bolton,1,1,D,1,1,1,2,2,2,3,0,18,17,20,24,1,4,February,0.8660254037844386,0.5000000000000001,44,6,0,1,0,1.0,1.0,19,37,-18,29,43,-14,"February, 2003"
2002-2003,27,2003-02-09,Man United,Man City,1,1,D,1,1,4,1,0,3,0,2,2,11,53,37,9,16,February,0.8660254037844386,0.5000000000000001,28,27,3,1,1,1.4,1.2,43,24,19,37,37,0,"February, 2003"
2002-2003,27,2003-02-09,Newcastle,Arsenal,1,1,D,1,1,2,2,1,3,1,1,4,1,48,56,3,8,February,0.8660254037844386,0.5000000000000001,30,0,1,1,3,0.6,1.8,41,31,10,56,28,28,"February, 2003"
2002-2003,27,2003-02-19,Fulham,West Brom,3,0,H,3,0,3,1,1,1,2,2,15,18,30,21,3,9,February,0.8660254037844386,0.5000000000000001,19,44,0,0,1,0.0,1.0,28,34,-6,20,38,-18,"February, 2003"
2002-2003,28,2003-02-22,Leeds,Newcastle,0,3,A,0,3,3,0,2,2,2,1,13,3,34,49,10,15,February,0.8660254037844386,0.5000000000000001,23,30,1,0,4,1.6,2.4,34,34,0,42,32,10,"February, 2003"
2002-2003,28,2003-02-22,Man City,Arsenal,1,5,A,0,3,3,0,2,3,1,1,11,1,38,57,10,19,February,0.8660254037844386,0.5000000000000001,27,0,0,0,5,0.4,3.0,38,38,0,57,29,28,"February, 2003"
2002-2003,28,2003-02-22,Everton,Southampton,2,1,H,3,0,1,0,4,1,1,3,6,10,45,39,4,6,February,0.8660254037844386,0.5000000000000001,18,38,2,1,2,0.8,0.6,35,32,3,28,26,2,"February, 2003"
2002-2003,28,2003-02-22,Sunderland,Middlesbrough,1,3,A,0,3,0,0,5,1,0,4,20,15,19,31,5,12,February,0.8660254037844386,0.5000000000000001,40,29,1,1,3,0.2,1.2,18,42,-24,30,30,0,"February, 2003"
2002-2003,28,2003-02-22,Charlton,Aston Villa,3,0,H,3,0,1,0,4,2,1,2,8,12,42,35,4,7,February,0.8660254037844386,0.5000000000000001,13,1,0,1,4,1.0,2.0,36,34,2,31,29,2,"February, 2003"
2002-2003,28,2003-02-22,Bolton,Man United,1,1,D,1,1,2,3,0,4,1,0,17,2,25,54,15,29,February,0.8660254037844386,0.5000000000000001,6,28,2,2,1,0.8,1.2,30,44,-14,44,25,19,"February, 2003"
2002-2003,28,2003-02-22,Chelsea,Blackburn,1,2,A,0,3,2,1,2,2,2,1,4,11,48,37,7,11,February,0.8660254037844386,0.5000000000000001,14,4,2,3,0,1.6,1.2,48,27,21,32,31,1,"February, 2003"
2002-2003,28,2003-02-23,Birmingham,Liverpool,2,1,H,3,0,3,1,1,3,0,2,17,7,26,43,10,17,February,0.8660254037844386,0.5000000000000001,3,25,0,1,0,2.0,2.0,23,40,-17,38,26,12,"February, 2003"
2002-2003,28,2003-02-23,West Brom,West Ham,1,2,A,0,3,1,2,2,3,1,1,18,19,21,20,1,1,February,0.8660254037844386,0.5000000000000001,44,45,1,0,0,1.0,0.0,20,41,-21,28,52,-24,"February, 2003"
2002-2003,28,2003-02-24,Tottenham,Fulham,1,1,D,1,1,1,0,4,3,1,1,8,15,42,33,7,9,February,0.8660254037844386,0.5000000000000001,42,19,2,0,1,2.6666666666666665,1.0,40,37,3,31,34,-3,"February, 2003"
2002-2003,29,2003-03-01,West Ham,Tottenham,2,0,H,3,0,3,1,1,1,0,4,18,8,23,43,10,20,March,1.0,6.123233995736766e-17,45,42,0,2,3,0.6,1.2,30,53,-23,41,38,3,"March, 2003"
2002-2003,29,2003-03-01,Southampton,West Brom,1,0,H,3,0,1,1,3,1,2,2,10,19,39,21,9,18,March,1.0,6.123233995736766e-17,38,44,0,0,1,0.0,1.0,29,28,1,21,43,-22,"March, 2003"
2002-2003,29,2003-03-01,Newcastle,Chelsea,2,1,H,3,0,2,2,1,2,1,2,3,5,52,48,2,4,March,1.0,6.123233995736766e-17,30,14,0,2,3,0.6,1.8,45,32,13,49,29,20,"March, 2003"
2002-2003,29,2003-03-01,Fulham,Sunderland,1,0,H,3,0,3,1,1,0,0,5,15,20,34,19,5,15,March,1.0,6.123233995736766e-17,19,40,2,1,0,2.0,0.3333333333333333,32,35,-3,19,45,-26,"March, 2003"
2002-2003,29,2003-03-01,Blackburn,Man City,1,0,H,3,0,2,2,1,3,0,2,9,11,40,38,2,2,March,1.0,6.123233995736766e-17,4,27,1,2,0,1.6666666666666667,1.0,34,32,2,39,43,-4,"March, 2003"
2002-2003,29,2003-03-01,Middlesbrough,Everton,1,1,D,1,1,1,0,4,1,0,4,14,5,34,48,9,14,March,1.0,6.123233995736766e-17,29,18,1,1,3,1.0,1.6,33,31,2,37,33,4,"March, 2003"
2002-2003,29,2003-03-02,Arsenal,Charlton,2,0,H,3,0,3,1,1,1,0,4,1,6,60,45,5,15,March,1.0,6.123233995736766e-17,0,13,3,0,2,2.6,1.6,62,30,32,39,34,5,"March, 2003"
2002-2003,29,2003-03-03,Aston Villa,Birmingham,0,2,A,0,3,2,1,2,3,1,1,14,16,35,29,2,6,March,1.0,6.123233995736766e-17,1,3,0,0,1,0.0,3.0,31,32,-1,25,41,-16,"March, 2003"
2002-2003,29,2003-03-05,Man United,Leeds,2,1,H,3,0,4,1,0,3,0,2,2,15,55,34,13,21,March,1.0,6.123233995736766e-17,28,23,2,2,1,1.8,1.2,45,26,19,34,37,-3,"March, 2003"
2002-2003,29,2003-03-05,Middlesbrough,Newcastle,1,0,H,3,0,1,0,4,2,2,1,13,3,35,55,10,20,March,1.0,6.123233995736766e-17,29,30,1,0,4,0.8,2.6,34,32,2,47,33,14,"March, 2003"
2002-2003,29,2003-03-08,Liverpool,Bolton,2,0,H,3,0,3,0,2,2,3,0,7,17,43,26,10,17,March,1.0,6.123233995736766e-17,25,6,2,2,1,1.6,1.4,39,28,11,31,45,-14,"March, 2003"
2002-2003,30,2003-03-15,Leeds,Middlesbrough,2,3,A,0,3,3,0,2,1,0,4,15,11,34,38,4,4,March,1.0,6.123233995736766e-17,23,29,2,3,0,1.6,1.2,35,39,-4,35,32,3,"March, 2003"
2002-2003,30,2003-03-15,Sunderland,Bolton,0,2,A,0,3,0,0,5,2,3,0,20,18,19,26,2,7,March,1.0,6.123233995736766e-17,40,6,2,1,0,1.3333333333333333,0.3333333333333333,19,46,-27,31,47,-16,"March, 2003"
2002-2003,30,2003-03-15,Fulham,Southampton,2,2,D,1,1,3,1,1,1,1,3,13,10,37,42,3,5,March,1.0,6.123233995736766e-17,19,38,1,1,1,1.6666666666666667,2.0,33,35,-2,30,28,2,"March, 2003"
2002-2003,30,2003-03-15,Charlton,Newcastle,0,2,A,0,3,1,0,4,2,2,1,8,3,45,55,5,10,March,1.0,6.123233995736766e-17,13,30,2,1,2,1.0,1.2,39,36,3,47,34,13,"March, 2003"
2002-2003,30,2003-03-15,Blackburn,Arsenal,2,0,H,3,0,2,2,1,3,1,1,8,1,43,63,7,20,March,1.0,6.123233995736766e-17,4,0,1,1,3,1.6,2.0,35,32,3,64,30,34,"March, 2003"
2002-2003,30,2003-03-15,Aston Villa,Man United,0,1,A,0,3,2,1,2,4,1,0,14,2,35,58,12,23,March,1.0,6.123233995736766e-17,1,28,0,2,3,0.4,1.2,31,34,-3,47,27,20,"March, 2003"
2002-2003,30,2003-03-15,Everton,West Ham,0,0,D,1,1,1,0,4,3,1,1,4,18,49,26,14,23,March,1.0,6.123233995736766e-17,18,45,3,1,1,1.8,0.4,38,34,4,32,53,-21,"March, 2003"
2002-2003,30,2003-03-16,Man City,Birmingham,1,0,H,3,0,3,0,2,3,1,1,13,16,38,32,3,6,March,1.0,6.123233995736766e-17,27,3,1,0,0,2.0,0.0,39,44,-5,27,41,-14,"March, 2003"
2002-2003,30,2003-03-16,Tottenham,Liverpool,2,3,A,0,3,1,0,4,3,0,2,10,6,43,46,4,3,March,1.0,6.123233995736766e-17,42,25,2,0,3,1.0,1.4,41,40,1,41,28,13,"March, 2003"
2002-2003,30,2003-03-16,West Brom,Chelsea,0,2,A,0,3,1,2,2,2,1,2,19,6,21,48,13,27,March,1.0,6.123233995736766e-17,44,14,0,0,1,0.0,2.0,21,44,-23,50,31,19,"March, 2003"
2002-2003,31,2003-03-22,Middlesbrough,Charlton,1,1,D,1,1,1,0,4,1,0,4,11,8,41,45,3,4,March,1.0,6.123233995736766e-17,29,13,0,3,2,0.0,0.4,38,34,4,39,38,1,"March, 2003"
2002-2003,31,2003-03-22,Birmingham,West Brom,1,0,H,3,0,3,1,1,1,2,2,16,19,32,21,3,11,March,1.0,6.123233995736766e-17,3,44,0,1,0,1.0,1.0,27,42,-15,21,46,-25,"March, 2003"
2002-2003,31,2003-03-22,Chelsea,Man City,5,0,H,3,0,2,1,2,3,0,2,4,12,51,41,8,10,March,1.0,6.123233995736766e-17,14,27,4,1,0,1.8,0.6,52,31,21,40,44,-4,"March, 2003"
2002-2003,31,2003-03-22,Man United,Fulham,3,0,H,3,0,4,1,0,3,1,1,2,13,61,38,11,23,March,1.0,6.123233995736766e-17,28,19,2,1,0,2.333333333333333,1.6666666666666667,48,27,21,35,37,-2,"March, 2003"
2002-2003,31,2003-03-22,Newcastle,Blackburn,5,1,H,3,0,2,2,1,2,2,1,3,7,58,46,4,12,March,1.0,6.123233995736766e-17,30,4,1,3,1,1.4,1.8,49,34,15,37,32,5,"March, 2003"
2002-2003,31,2003-03-22,Southampton,Aston Villa,2,2,D,1,1,1,1,3,2,1,2,9,14,43,35,5,8,March,1.0,6.123233995736766e-17,38,1,2,1,2,1.0,1.0,32,30,2,31,35,-4,"March, 2003"
2002-2003,31,2003-03-22,West Ham,Sunderland,2,0,H,3,0,3,1,1,0,0,5,18,20,27,19,2,8,March,1.0,6.123233995736766e-17,45,40,2,1,2,1.0,0.8,32,53,-21,19,48,-29,"March, 2003"
2002-2003,31,2003-03-23,Arsenal,Everton,2,1,H,3,0,3,1,1,1,0,4,2,5,63,50,3,13,March,1.0,6.123233995736766e-17,0,18,3,0,2,2.0,1.6,64,32,32,38,34,4,"March, 2003"
2002-2003,31,2003-03-23,Liverpool,Leeds,3,1,H,3,0,3,0,2,3,0,2,6,16,49,34,10,15,March,1.0,6.123233995736766e-17,25,23,2,1,2,2.0,1.4,44,30,14,37,42,-5,"March, 2003"
2002-2003,31,2003-03-24,Bolton,Tottenham,1,0,H,3,0,2,3,0,1,0,4,18,10,29,43,8,14,March,1.0,6.123233995736766e-17,6,42,0,2,3,1.0,1.8,33,47,-14,43,43,0,"March, 2003"
2002-2003,32,2003-04-05,Southampton,West Ham,1,1,D,1,1,1,1,3,3,1,1,10,18,44,30,8,14,April,0.8660254037844388,-0.4999999999999998,38,45,2,0,3,1.0,1.6,34,32,2,34,53,-19,"April, 2003"
2002-2003,32,2003-04-05,Sunderland,Chelsea,1,2,A,0,3,0,0,5,2,1,2,20,4,19,54,16,35,April,0.8660254037844388,-0.4999999999999998,40,14,2,1,2,1.0,1.8,19,50,-31,57,31,26,"April, 2003"
2002-2003,32,2003-04-05,Middlesbrough,West Brom,3,0,H,3,0,1,0,4,1,2,2,11,19,42,21,8,21,April,0.8660254037844388,-0.4999999999999998,29,44,0,0,1,0.0,1.0,39,35,4,21,47,-26,"April, 2003"
2002-2003,32,2003-04-05,Tottenham,Birmingham,2,1,H,3,0,1,0,4,3,1,1,11,17,43,35,6,8,April,0.8660254037844388,-0.4999999999999998,42,3,0,1,0,1.0,1.0,43,44,-1,28,42,-14,"April, 2003"
2002-2003,32,2003-04-05,Charlton,Leeds,1,6,A,0,3,1,0,4,3,0,2,7,17,46,34,10,12,April,0.8660254037844388,-0.4999999999999998,13,23,1,1,3,0.8,1.6,40,39,1,38,45,-7,"April, 2003"
2002-2003,32,2003-04-05,Bolton,Man City,2,0,H,3,0,2,3,0,3,0,2,17,12,32,41,5,9,April,0.8660254037844388,-0.4999999999999998,6,27,0,1,2,0.3333333333333333,1.3333333333333333,34,47,-13,40,49,-9,"April, 2003"
2002-2003,32,2003-04-05,Aston Villa,Arsenal,1,1,D,1,1,2,1,2,3,1,1,14,1,36,66,13,30,April,0.8660254037844388,-0.4999999999999998,1,0,0,1,4,0.8,1.8,33,37,-4,66,33,33,"April, 2003"
2002-2003,32,2003-04-05,Man United,Liverpool,4,0,H,3,0,4,1,0,3,0,2,2,5,64,52,3,12,April,0.8660254037844388,-0.4999999999999998,28,25,1,0,4,0.6,1.6,51,27,24,47,31,16,"April, 2003"
2002-2003,32,2003-04-06,Everton,Newcastle,2,1,H,3,0,1,0,4,2,2,1,6,3,50,61,3,11,April,0.8660254037844388,-0.4999999999999998,18,30,1,1,3,1.2,2.4,39,36,3,54,35,19,"April, 2003"
2002-2003,32,2003-04-07,Fulham,Blackburn,0,4,A,0,3,3,1,1,2,2,1,13,7,38,46,6,8,April,0.8660254037844388,-0.4999999999999998,19,4,1,0,2,1.0,1.6666666666666667,35,40,-5,38,37,1,"April, 2003"
2002-2003,33,2003-04-12,West Ham,Aston Villa,2,2,D,1,1,3,1,1,2,1,2,18,16,31,37,2,6,April,0.8660254037844388,-0.4999999999999998,45,1,0,3,2,1.2,2.0,35,54,-19,34,38,-4,"April, 2003"
2002-2003,33,2003-04-12,West Brom,Everton,1,2,A,0,3,1,2,2,1,0,4,19,6,21,53,13,32,April,0.8660254037844388,-0.4999999999999998,44,18,0,0,1,0.0,1.0,21,50,-29,41,37,4,"April, 2003"
2002-2003,33,2003-04-12,Newcastle,Man United,2,6,A,0,3,2,2,1,4,1,0,3,2,61,67,1,6,April,0.8660254037844388,-0.4999999999999998,30,28,1,1,3,1.8,2.8,55,37,18,55,27,28,"April, 2003"
2002-2003,33,2003-04-12,Man City,Middlesbrough,0,0,D,1,1,3,0,2,1,0,4,12,10,41,45,2,4,April,0.8660254037844388,-0.4999999999999998,27,29,0,2,3,0.8,2.0,40,51,-11,42,35,7,"April, 2003"
2002-2003,33,2003-04-12,Liverpool,Fulham,2,0,H,3,0,3,0,2,3,1,1,6,14,52,38,8,14,April,0.8660254037844388,-0.4999999999999998,25,19,1,1,1,1.3333333333333333,1.0,47,35,12,35,44,-9,"April, 2003"
2002-2003,33,2003-04-12,Leeds,Tottenham,2,2,D,1,1,3,0,2,1,0,4,15,8,37,46,7,9,April,0.8660254037844388,-0.4999999999999998,23,42,3,0,2,1.8,1.8,44,46,-2,45,45,0,"April, 2003"
2002-2003,33,2003-04-12,Chelsea,Bolton,1,0,H,3,0,2,1,2,2,3,0,4,17,57,35,13,22,April,0.8660254037844388,-0.4999999999999998,14,6,2,2,1,2.0,1.0,59,32,27,36,47,-11,"April, 2003"
2002-2003,33,2003-04-12,Blackburn,Charlton,1,0,H,3,0,2,2,1,1,0,4,7,9,49,46,2,3,April,0.8660254037844388,-0.4999999999999998,4,13,3,1,1,1.6,0.8,42,37,5,41,45,-4,"April, 2003"
2002-2003,33,2003-04-12,Birmingham,Sunderland,2,0,H,3,0,3,1,1,0,0,5,17,20,35,19,3,16,April,0.8660254037844388,-0.4999999999999998,3,40,1,0,0,1.0,0.0,29,44,-15,20,52,-32,"April, 2003"
2002-2003,33,2003-04-16,Arsenal,Man United,2,2,D,1,1,3,1,1,4,1,0,2,1,67,70,1,3,April,0.8660254037844388,-0.4999999999999998,0,28,3,0,2,1.2,1.8,67,34,33,61,29,32,"April, 2003"
2002-2003,34,2003-04-18,Tottenham,Man City,0,2,A,0,3,1,0,4,3,0,2,8,12,47,42,4,5,April,0.8660254037844388,-0.4999999999999998,42,27,3,2,0,1.2,0.6,47,47,0,40,51,-11,"April, 2003"
2002-2003,34,2003-04-19,Sunderland,West Brom,1,2,A,0,3,0,0,5,1,2,2,20,19,19,21,1,2,April,0.8660254037844388,-0.4999999999999998,40,44,0,1,0,2.0,2.0,20,54,-34,22,52,-30,"April, 2003"
2002-2003,34,2003-04-19,Middlesbrough,Arsenal,0,2,A,0,3,1,0,4,3,1,1,9,2,46,68,7,22,April,0.8660254037844388,-0.4999999999999998,29,0,1,0,4,0.8,1.8,42,35,7,69,36,33,"April, 2003"
2002-2003,34,2003-04-19,Man United,Blackburn,3,1,H,3,0,4,1,0,2,2,1,1,7,71,52,6,19,April,0.8660254037844388,-0.4999999999999998,28,4,2,2,1,1.4,1.2,63,31,32,43,37,6,"April, 2003"
2002-2003,34,2003-04-19,Fulham,Newcastle,2,1,H,3,0,3,1,1,2,2,1,17,3,38,61,14,23,April,0.8660254037844388,-0.4999999999999998,19,30,1,1,1,1.3333333333333333,1.3333333333333333,35,46,-11,57,43,14,"April, 2003"
2002-2003,34,2003-04-19,Southampton,Leeds,3,2,H,3,0,1,1,3,3,0,2,11,16,45,38,5,7,April,0.8660254037844388,-0.4999999999999998,38,23,1,1,3,0.4,1.2,35,33,2,46,48,-2,"April, 2003"
2002-2003,34,2003-04-19,Charlton,Birmingham,0,2,A,0,3,1,0,4,3,1,1,10,17,46,38,7,8,April,0.8660254037844388,-0.4999999999999998,13,3,0,1,0,1.0,1.0,41,46,-5,31,44,-13,"April, 2003"
2002-2003,34,2003-04-19,Bolton,West Ham,1,0,H,3,0,2,3,0,3,1,1,17,18,35,32,1,3,April,0.8660254037844388,-0.4999999999999998,6,45,1,2,2,0.8,1.4,36,48,-12,37,56,-19,"April, 2003"
2002-2003,34,2003-04-19,Aston Villa,Chelsea,2,1,H,3,0,2,1,2,2,1,2,14,4,38,60,10,22,April,0.8660254037844388,-0.4999999999999998,1,14,1,2,2,1.0,1.2,36,40,-4,60,32,28,"April, 2003"
2002-2003,34,2003-04-19,Everton,Liverpool,1,2,A,0,3,1,0,4,3,0,2,5,6,56,55,1,1,April,0.8660254037844388,-0.4999999999999998,18,25,0,2,3,1.0,2.0,43,38,5,49,35,14,"April, 2003"
2002-2003,35,2003-04-21,West Ham,Middlesbrough,1,0,H,3,0,3,1,1,1,0,4,18,11,32,46,7,14,April,0.8660254037844388,-0.4999999999999998,45,29,2,1,2,1.0,1.2,37,57,-20,42,37,5,"April, 2003"
2002-2003,35,2003-04-21,West Brom,Tottenham,2,3,A,0,3,1,2,2,1,0,4,19,10,24,47,9,23,April,0.8660254037844388,-0.4999999999999998,44,42,0,0,1,1.0,3.0,24,53,-29,47,49,-2,"April, 2003"
2002-2003,35,2003-04-21,Newcastle,Aston Villa,1,1,D,1,1,2,2,1,2,1,2,5,14,61,41,9,20,April,0.8660254037844388,-0.4999999999999998,30,1,3,2,0,1.8,0.4,58,45,13,38,41,-3,"April, 2003"
2002-2003,35,2003-04-21,Man City,Sunderland,3,0,H,3,0,3,0,2,0,0,5,12,20,45,19,8,26,April,0.8660254037844388,-0.4999999999999998,27,40,2,0,1,2.333333333333333,1.0,42,51,-9,21,56,-35,"April, 2003"
2002-2003,35,2003-04-21,Chelsea,Everton,4,1,H,3,0,2,1,2,1,0,4,4,6,60,56,2,4,April,0.8660254037844388,-0.4999999999999998,14,18,3,1,1,1.8,0.8,61,34,27,44,40,4,"April, 2003"
2002-2003,35,2003-04-21,Blackburn,Bolton,0,0,D,1,1,2,2,1,2,3,0,7,17,52,38,10,14,April,0.8660254037844388,-0.4999999999999998,4,6,1,3,1,1.4,1.2,44,40,4,37,48,-11,"April, 2003"
2002-2003,35,2003-04-21,Birmingham,Southampton,3,2,H,3,0,3,1,1,1,1,3,15,8,41,48,7,7,April,0.8660254037844388,-0.4999999999999998,3,38,0,0,1,0.0,2.0,33,44,-11,38,35,3,"April, 2003"
2002-2003,35,2003-04-21,Liverpool,Charlton,2,1,H,3,0,3,0,2,1,0,4,5,11,58,46,6,12,April,0.8660254037844388,-0.4999999999999998,25,13,4,0,1,2.2,0.4,51,36,15,41,48,-7,"April, 2003"
2002-2003,35,2003-04-22,Leeds,Fulham,2,0,H,3,0,3,0,2,3,1,1,17,15,38,41,2,3,April,0.8660254037844388,-0.4999999999999998,23,19,0,1,2,0.0,0.6666666666666666,48,51,-3,37,47,-10,"April, 2003"
2002-2003,36,2003-04-26,Leeds,Blackburn,2,3,A,0,3,3,0,2,2,2,1,16,7,41,53,9,12,April,0.8660254037844388,-0.4999999999999998,23,4,3,0,2,1.2,0.8,50,51,-1,44,40,4,"April, 2003"
2002-2003,36,2003-04-26,West Brom,Liverpool,0,6,A,0,3,1,2,2,3,0,2,19,5,24,61,14,37,April,0.8660254037844388,-0.4999999999999998,44,25,0,0,1,0.0,2.0,26,56,-30,53,37,16,"April, 2003"
2002-2003,36,2003-04-26,Sunderland,Newcastle,0,1,A,0,3,0,0,5,2,2,1,20,4,19,62,16,43,April,0.8660254037844388,-0.4999999999999998,40,30,1,2,2,0.8,1.2,21,59,-38,59,46,13,"April, 2003"
2002-2003,36,2003-04-26,Everton,Aston Villa,2,1,H,3,0,1,0,4,2,1,2,6,14,56,42,8,14,April,0.8660254037844388,-0.4999999999999998,18,1,1,1,3,1.2,1.6,45,44,1,39,42,-3,"April, 2003"
2002-2003,36,2003-04-26,Birmingham,Middlesbrough,3,0,H,3,0,3,1,1,1,0,4,13,11,44,46,2,2,April,0.8660254037844388,-0.4999999999999998,3,29,0,0,1,0.0,1.0,36,46,-10,42,38,4,"April, 2003"
2002-2003,36,2003-04-26,Charlton,Southampton,2,1,H,3,0,1,0,4,1,1,3,13,9,46,48,4,2,April,0.8660254037844388,-0.4999999999999998,13,38,0,4,1,0.4,0.6,42,50,-8,40,38,2,"April, 2003"
2002-2003,36,2003-04-26,Bolton,Arsenal,2,2,D,1,1,2,3,0,3,1,1,17,2,39,71,15,32,April,0.8660254037844388,-0.4999999999999998,6,0,0,1,4,0.6,2.0,37,48,-11,71,36,35,"April, 2003"
2002-2003,36,2003-04-26,Chelsea,Fulham,1,1,D,1,1,2,1,2,3,1,1,3,16,63,41,13,22,April,0.8660254037844388,-0.4999999999999998,14,19,1,2,0,1.3333333333333333,1.0,65,35,30,37,49,-12,"April, 2003"
2002-2003,36,2003-04-27,Man City,West Ham,0,1,A,0,3,3,0,2,3,1,1,11,18,48,35,7,13,April,0.8660254037844388,-0.4999999999999998,27,45,2,1,2,1.2,1.8,45,51,-6,38,57,-19,"April, 2003"
2002-2003,36,2003-04-27,Tottenham,Man United,0,2,A,0,3,1,0,4,4,1,0,8,1,50,74,7,24,April,0.8660254037844388,-0.4999999999999998,42,28,1,0,4,1.2,2.6,50,51,-1,66,32,34,"April, 2003"
2002-2003,37,2003-05-03,Newcastle,Birmingham,1,0,H,3,0,2,2,1,3,1,1,3,13,65,47,10,18,May,0.4999999999999999,-0.8660254037844387,30,3,1,0,0,2.0,0.0,60,46,14,39,46,-7,"May, 2003"
2002-2003,37,2003-05-03,West Ham,Chelsea,1,0,H,3,0,3,1,1,2,1,2,18,4,38,64,14,26,May,0.4999999999999999,-0.8660254037844387,45,14,2,0,3,1.6,2.8,39,57,-18,66,36,30,"May, 2003"
2002-2003,37,2003-05-03,Southampton,Bolton,0,0,D,1,1,1,1,3,2,3,0,12,17,48,40,5,8,May,0.4999999999999999,-0.8660254037844387,38,6,1,3,1,0.4,0.4,41,40,1,39,50,-11,"May, 2003"
2002-2003,37,2003-05-03,Man United,Charlton,4,1,H,3,0,4,1,0,1,0,4,1,10,77,49,9,28,May,0.4999999999999999,-0.8660254037844387,28,13,3,2,0,2.0,1.0,68,32,36,44,51,-7,"May, 2003"
2002-2003,37,2003-05-03,Middlesbrough,Tottenham,5,1,H,3,0,1,0,4,1,0,4,13,9,46,50,4,4,May,0.4999999999999999,-0.8660254037844387,29,42,1,3,1,1.2,0.8,42,41,1,50,53,-3,"May, 2003"
2002-2003,37,2003-05-03,Liverpool,Man City,1,2,A,0,3,3,0,2,3,0,2,5,11,64,48,6,16,May,0.4999999999999999,-0.8660254037844387,25,27,3,2,0,3.0,1.0,59,37,22,45,52,-7,"May, 2003"
2002-2003,37,2003-05-03,Fulham,Everton,2,0,H,3,0,3,1,1,1,0,4,15,6,42,59,9,17,May,0.4999999999999999,-0.8660254037844387,19,18,1,0,2,1.0,1.3333333333333333,38,50,-12,47,45,2,"May, 2003"
2002-2003,37,2003-05-03,Blackburn,West Brom,1,1,D,1,1,2,2,1,1,2,2,7,19,56,24,12,32,May,0.4999999999999999,-0.8660254037844387,4,44,1,0,0,2.0,0.0,47,42,5,26,62,-36,"May, 2003"
2002-2003,37,2003-05-03,Aston Villa,Sunderland,1,0,H,3,0,2,1,2,0,0,5,14,20,42,19,6,23,May,0.4999999999999999,-0.8660254037844387,1,40,0,4,1,0.4,0.6,40,44,-4,21,60,-39,"May, 2003"
2002-2003,37,2003-05-04,Arsenal,Leeds,2,3,A,0,3,3,1,1,3,0,2,2,16,72,41,14,31,May,0.4999999999999999,-0.8660254037844387,0,23,2,1,2,1.6,1.2,73,38,35,52,54,-2,"May, 2003"
2002-2003,37,2003-05-07,Arsenal,Southampton,6,1,H,3,0,3,1,1,1,1,3,2,11,72,49,9,23,May,0.4999999999999999,-0.8660254037844387,0,38,2,1,2,1.6,1.4,75,41,34,41,40,1,"May, 2003"
2002-2003,38,2003-05-11,West Brom,Newcastle,2,2,D,1,1,1,2,2,2,2,1,19,3,25,68,16,43,May,0.4999999999999999,-0.8660254037844387,44,30,0,0,1,1.0,2.0,27,63,-36,61,46,15,"May, 2003"
2002-2003,38,2003-05-11,Tottenham,Blackburn,0,4,A,0,3,1,0,4,2,2,1,10,7,50,57,3,7,May,0.4999999999999999,-0.8660254037844387,42,4,3,1,1,1.4,1.0,51,58,-7,48,43,5,"May, 2003"
2002-2003,38,2003-05-11,Sunderland,Arsenal,0,4,A,0,3,0,0,5,3,1,1,20,2,19,75,18,56,May,0.4999999999999999,-0.8660254037844387,40,0,1,2,2,1.0,1.8,21,61,-40,81,42,39,"May, 2003"
2002-2003,38,2003-05-11,Man City,Southampton,0,1,A,0,3,3,0,2,1,1,3,8,11,51,49,3,2,May,0.4999999999999999,-0.8660254037844387,27,38,2,1,2,1.0,1.0,47,53,-6,42,46,-4,"May, 2003"
2002-2003,38,2003-05-11,Leeds,Aston Villa,3,1,H,3,0,3,0,2,2,1,2,16,15,44,45,1,1,May,0.4999999999999999,-0.8660254037844387,23,1,2,2,1,1.0,0.8,55,56,-1,41,44,-3,"May, 2003"
2002-2003,38,2003-05-11,Chelsea,Liverpool,2,1,H,3,0,2,1,2,3,0,2,4,5,64,64,1,0,May,0.4999999999999999,-0.8660254037844387,14,25,2,1,2,1.8,0.8,66,37,29,60,39,21,"May, 2003"
2002-2003,38,2003-05-11,Charlton,Fulham,0,1,A,0,3,1,0,4,3,1,1,12,15,49,45,3,4,May,0.4999999999999999,-0.8660254037844387,13,19,0,2,1,0.3333333333333333,0.6666666666666666,45,55,-10,40,50,-10,"May, 2003"
2002-2003,38,2003-05-11,Bolton,Middlesbrough,2,1,H,3,0,2,3,0,1,0,4,18,10,41,49,8,8,May,0.4999999999999999,-0.8660254037844387,6,29,2,2,1,1.4,1.0,39,50,-11,47,42,5,"May, 2003"
2002-2003,38,2003-05-11,Birmingham,West Ham,2,2,D,1,1,3,1,1,3,1,1,13,18,47,41,5,6,May,0.4999999999999999,-0.8660254037844387,3,45,1,0,0,2.0,1.0,39,47,-8,40,57,-17,"May, 2003"
2002-2003,38,2003-05-11,Everton,Man United,1,2,A,0,3,1,0,4,4,1,0,6,1,59,80,5,21,May,0.4999999999999999,-0.8660254037844387,18,28,0,0,5,0.4,2.6,47,47,0,72,33,39,"May, 2003"
2003-2004,1,2003-08-16,Man United,Bolton,4,0,H,3,0,2,1,2,4,0,1,14,8,0,0,6,0,August,-0.8660254037844384,-0.5000000000000004,28,6,1,2,2,1.4,1.0,0,0,0,0,0,0,"August, 2003"
2003-2004,1,2003-08-16,Portsmouth,Aston Villa,2,1,H,3,0,2,2,1,2,2,1,15,8,0,0,7,0,August,-0.8660254037844384,-0.5000000000000004,33,1,0,0,0,0.0,0.0,0,0,0,0,0,0,"August, 2003"
2003-2004,1,2003-08-16,Fulham,Middlesbrough,3,2,H,3,0,2,2,1,1,0,4,8,14,0,0,6,0,August,-0.8660254037844384,-0.5000000000000004,19,29,2,1,1,1.5,1.25,0,0,0,0,0,0,"August, 2003"
2003-2004,1,2003-08-16,Leicester,Southampton,2,2,D,1,1,1,2,2,0,2,3,10,16,0,0,6,0,August,-0.8660254037844384,-0.5000000000000004,24,38,2,1,2,1.0,1.6,0,0,0,0,0,0,"August, 2003"
2003-2004,1,2003-08-16,Birmingham,Tottenham,1,0,H,3,0,0,4,1,2,1,2,3,18,0,0,15,0,August,-0.8660254037844384,-0.5000000000000004,3,42,0,1,1,1.0,1.5,0,0,0,0,0,0,"August, 2003"
2003-2004,1,2003-08-16,Arsenal,Everton,2,1,H,3,0,2,3,0,0,1,4,1,8,0,0,7,0,August,-0.8660254037844384,-0.5000000000000004,0,18,4,0,1,2.4,1.4,0,0,0,0,0,0,"August, 2003"
2003-2004,1,2003-08-16,Blackburn,Wolves,5,1,H,3,0,3,1,1,2,2,1,4,18,0,0,14,0,August,-0.8660254037844384,-0.5000000000000004,4,48,0,0,0,0.0,0.0,0,0,0,0,0,0,"August, 2003"
2003-2004,1,2003-08-17,Charlton,Man City,0,3,A,0,3,1,2,2,2,1,2,9,13,0,0,4,0,August,-0.8660254037844384,-0.5000000000000004,13,27,3,1,0,2.75,0.75,0,0,0,0,0,0,"August, 2003"
2003-2004,1,2003-08-17,Leeds,Newcastle,2,2,D,1,1,0,1,4,1,3,1,11,13,0,0,2,0,August,-0.8660254037844384,-0.5000000000000004,23,30,1,0,4,1.4,2.6,0,0,0,0,0,0,"August, 2003"
2003-2004,1,2003-08-17,Liverpool,Chelsea,1,2,A,0,3,3,2,0,2,2,1,13,12,0,0,1,0,August,-0.8660254037844384,-0.5000000000000004,25,14,2,1,2,1.0,1.6,0,0,0,0,0,0,"August, 2003"
2003-2004,2,2003-08-23,Newcastle,Man United,1,2,A,0,3,1,3,1,2,1,2,11,5,1,3,6,2,August,-0.8660254037844384,-0.5000000000000004,30,28,1,1,3,2.2,3.6,2,2,0,4,0,4,"August, 2003"
2003-2004,2,2003-08-23,Wolves,Charlton,0,4,A,0,3,2,2,1,1,2,2,20,19,0,0,1,0,August,-0.8660254037844384,-0.5000000000000004,48,13,0,0,0,0.0,0.0,1,5,-4,0,3,-3,"August, 2003"
2003-2004,2,2003-08-23,Tottenham,Leeds,2,1,H,3,0,2,1,2,0,1,4,18,11,0,1,7,1,August,-0.8660254037844384,-0.5000000000000004,42,23,2,1,2,1.6,1.4,0,1,-1,2,2,0,"August, 2003"
2003-2004,2,2003-08-23,Southampton,Birmingham,0,0,D,1,1,0,2,3,0,4,1,11,8,1,3,3,2,August,-0.8660254037844384,-0.5000000000000004,38,3,1,0,1,2.0,1.5,2,2,0,1,0,1,"August, 2003"
2003-2004,2,2003-08-23,Everton,Fulham,3,1,H,3,0,0,1,4,2,2,1,16,5,0,3,11,3,August,-0.8660254037844384,-0.5000000000000004,18,19,2,0,2,1.0,1.25,1,2,-1,3,2,1,"August, 2003"
2003-2004,2,2003-08-23,Chelsea,Leicester,2,1,H,3,0,2,2,1,1,2,2,6,10,3,1,4,2,August,-0.8660254037844384,-0.5000000000000004,14,24,2,1,2,1.4,1.4,2,1,1,2,2,0,"August, 2003"
2003-2004,2,2003-08-23,Bolton,Blackburn,2,2,D,1,1,4,0,1,3,1,1,20,1,0,3,19,3,August,-0.8660254037844384,-0.5000000000000004,6,4,1,4,0,1.0,0.8,0,4,-4,5,1,4,"August, 2003"
2003-2004,2,2003-08-23,Man City,Portsmouth,1,1,D,1,1,2,1,2,2,2,1,4,7,3,3,3,0,August,-0.8660254037844384,-0.5000000000000004,27,33,0,0,0,0.0,0.0,3,0,3,2,1,1,"August, 2003"
2003-2004,2,2003-08-24,Aston Villa,Liverpool,0,0,D,1,1,2,2,1,3,2,0,18,19,0,0,1,0,August,-0.8660254037844384,-0.5000000000000004,1,25,1,1,3,1.0,1.6,1,2,-1,1,2,-1,"August, 2003"
2003-2004,2,2003-08-24,Middlesbrough,Arsenal,0,4,A,0,3,1,0,4,2,3,0,19,9,0,3,10,3,August,-0.8660254037844384,-0.5000000000000004,29,0,1,0,4,0.8,2.0,2,3,-1,2,1,1,"August, 2003"
2003-2004,2,2003-08-25,Blackburn,Man City,2,3,A,0,3,3,1,1,2,1,2,4,5,4,4,1,0,August,-0.8660254037844384,-0.5000000000000004,4,27,2,2,0,1.5,0.75,7,3,4,4,1,3,"August, 2003"
2003-2004,2,2003-08-26,Leicester,Middlesbrough,0,0,D,1,1,1,2,2,1,0,4,14,19,1,0,5,1,August,-0.8660254037844384,-0.5000000000000004,24,29,2,0,3,1.2,1.4,3,4,-1,2,7,-5,"August, 2003"
2003-2004,2,2003-08-26,Portsmouth,Bolton,4,0,H,3,0,2,2,1,4,0,1,8,18,4,1,10,3,August,-0.8660254037844384,-0.5000000000000004,33,6,0,0,0,0.0,0.0,3,2,1,2,6,-4,"August, 2003"
2003-2004,2,2003-08-26,Charlton,Everton,2,2,D,1,1,1,2,2,0,1,4,8,9,3,3,1,0,August,-0.8660254037844384,-0.5000000000000004,13,18,3,0,2,1.4,0.8,4,3,1,4,3,1,"August, 2003"
2003-2004,2,2003-08-26,Leeds,Southampton,0,0,D,1,1,0,1,4,0,2,3,13,12,1,2,1,1,August,-0.8660254037844384,-0.5000000000000004,23,38,3,1,1,1.6,0.8,3,4,-1,2,2,0,"August, 2003"
2003-2004,2,2003-08-27,Liverpool,Tottenham,0,0,D,1,1,3,2,0,2,1,2,16,11,1,3,5,2,August,-0.8660254037844384,-0.5000000000000004,25,42,4,0,1,1.8,1.0,1,2,-1,2,2,0,"August, 2003"
2003-2004,2,2003-08-27,Man United,Wolves,1,0,H,3,0,2,1,2,2,2,1,4,20,6,0,16,6,August,-0.8660254037844384,-0.5000000000000004,28,48,0,0,0,0.0,0.0,6,1,5,1,9,-8,"August, 2003"
2003-2004,2,2003-08-27,Arsenal,Aston Villa,2,0,H,3,0,2,3,0,2,2,1,3,16,6,1,13,5,August,-0.8660254037844384,-0.5000000000000004,0,1,3,2,0,1.8,1.0,6,1,5,1,2,-1,"August, 2003"
2003-2004,3,2003-08-30,Aston Villa,Leicester,3,1,H,3,0,2,2,1,1,2,2,17,14,1,2,3,1,August,-0.8660254037844384,-0.5000000000000004,1,24,1,3,1,1.2,1.4,1,4,-3,3,4,-1,"August, 2003"
2003-2004,3,2003-08-30,Bolton,Charlton,0,0,D,1,1,4,0,1,1,2,2,19,7,1,4,12,3,August,-0.8660254037844384,-0.5000000000000004,6,13,1,2,1,1.0,1.0,2,10,-8,6,5,1,"August, 2003"
2003-2004,3,2003-08-30,Chelsea,Blackburn,2,2,D,1,1,2,2,1,3,1,1,5,7,6,4,2,2,August,-0.8660254037844384,-0.5000000000000004,14,4,1,3,1,1.0,1.0,4,2,2,9,6,3,"August, 2003"
2003-2004,3,2003-08-30,Everton,Liverpool,0,3,A,0,3,0,1,4,3,2,0,8,15,4,2,7,2,August,-0.8660254037844384,-0.5000000000000004,18,25,0,2,3,1.0,1.8,6,5,1,1,2,-1,"August, 2003"
2003-2004,3,2003-08-30,Middlesbrough,Leeds,2,3,A,0,3,1,0,4,0,1,4,19,15,1,2,4,1,August,-0.8660254037844384,-0.5000000000000004,29,23,1,3,1,1.6,1.6,2,7,-5,3,4,-1,"August, 2003"
2003-2004,3,2003-08-30,Newcastle,Birmingham,0,1,A,0,3,1,3,1,0,4,1,18,10,1,4,8,3,August,-0.8660254037844384,-0.5000000000000004,30,3,2,0,0,1.5,0.0,3,4,-1,1,0,1,"August, 2003"
2003-2004,3,2003-08-30,Tottenham,Fulham,0,3,A,0,3,2,1,2,2,2,1,11,15,4,3,4,1,August,-0.8660254037844384,-0.5000000000000004,42,19,2,1,1,2.25,1.0,2,2,0,4,5,-1,"August, 2003"
2003-2004,3,2003-08-30,Wolves,Portsmouth,0,0,D,1,1,2,2,1,2,2,1,20,3,0,7,17,7,August,-0.8660254037844384,-0.5000000000000004,48,33,0,0,0,0.0,0.0,1,10,-9,7,2,5,"August, 2003"
2003-2004,3,2003-08-31,Man City,Arsenal,1,2,A,0,3,2,1,2,2,3,0,4,1,7,9,3,2,August,-0.8660254037844384,-0.5000000000000004,27,0,0,0,5,0.6,3.8,7,3,4,8,1,7,"August, 2003"
2003-2004,3,2003-08-31,Southampton,Man United,1,0,H,3,0,0,2,3,2,1,2,15,2,3,9,13,6,August,-0.8660254037844384,-0.5000000000000004,38,28,1,0,4,1.0,2.8,2,2,0,7,1,6,"August, 2003"
2003-2004,4,2003-09-13,Southampton,Wolves,2,0,H,3,0,0,2,3,2,2,1,9,20,6,1,11,5,September,-1.0,-1.8369701987210287e-16,38,48,0,0,0,0.0,0.0,3,2,1,1,10,-9,"September, 2003"
2003-2004,4,2003-09-13,Everton,Newcastle,2,2,D,1,1,0,1,4,1,3,1,15,18,4,1,3,3,September,-1.0,-1.8369701987210287e-16,18,30,1,1,3,1.4,2.6,6,8,-2,3,5,-2,"September, 2003"
2003-2004,4,2003-09-13,Chelsea,Tottenham,4,2,H,3,0,2,2,1,2,1,2,6,16,7,4,10,3,September,-1.0,-1.8369701987210287e-16,14,42,3,2,0,2.2,0.6,6,4,2,2,5,-3,"September, 2003"
2003-2004,4,2003-09-13,Blackburn,Liverpool,1,3,A,0,3,3,1,1,3,2,0,9,10,5,5,1,0,September,-1.0,-1.8369701987210287e-16,4,25,0,3,2,1.6,2.2,11,8,3,4,2,2,"September, 2003"
2003-2004,4,2003-09-13,Bolton,Middlesbrough,2,0,H,3,0,4,0,1,1,0,4,17,19,2,1,2,1,September,-1.0,-1.8369701987210287e-16,6,29,3,1,1,1.6,1.0,2,10,-8,4,10,-6,"September, 2003"
2003-2004,4,2003-09-13,Arsenal,Portsmouth,1,1,D,1,1,2,3,0,2,2,1,1,3,12,8,2,4,September,-1.0,-1.8369701987210287e-16,0,33,0,0,0,0.0,0.0,10,2,8,7,2,5,"September, 2003"
2003-2004,4,2003-09-13,Charlton,Man United,0,2,A,0,3,1,2,2,2,1,2,11,3,5,9,8,4,September,-1.0,-1.8369701987210287e-16,13,28,0,1,4,0.6,2.2,6,5,1,7,2,5,"September, 2003"
2003-2004,4,2003-09-14,Birmingham,Fulham,2,2,D,1,1,0,4,1,2,2,1,8,9,7,6,1,1,September,-1.0,-1.8369701987210287e-16,3,19,1,1,0,0.5,0.0,2,0,2,7,5,2,"September, 2003"
2003-2004,4,2003-09-14,Man City,Aston Villa,4,1,H,3,0,2,1,2,2,2,1,8,15,7,4,7,3,September,-1.0,-1.8369701987210287e-16,27,1,2,1,2,1.4,1.4,8,5,3,4,5,-1,"September, 2003"
2003-2004,4,2003-09-15,Leicester,Leeds,4,0,H,3,0,1,2,2,0,1,4,18,11,2,5,7,3,September,-1.0,-1.8369701987210287e-16,24,23,2,1,2,1.6,1.8,4,7,-3,6,6,0,"September, 2003"
2003-2004,5,2003-09-20,Tottenham,Southampton,1,3,A,0,3,2,1,2,0,2,3,17,8,4,9,9,5,September,-1.0,-1.8369701987210287e-16,42,38,2,1,2,0.8,0.6,4,9,-5,5,2,3,"September, 2003"
2003-2004,5,2003-09-20,Portsmouth,Blackburn,1,2,A,0,3,2,2,1,3,1,1,7,12,9,5,5,4,September,-1.0,-1.8369701987210287e-16,33,4,0,0,0,0.0,0.0,8,3,5,12,11,1,"September, 2003"
2003-2004,5,2003-09-20,Wolves,Chelsea,0,5,A,0,3,2,2,1,2,2,1,20,7,1,10,13,9,September,-1.0,-1.8369701987210287e-16,48,14,0,0,0,0.0,0.0,1,12,-11,10,6,4,"September, 2003"
2003-2004,5,2003-09-20,Newcastle,Bolton,0,0,D,1,1,1,3,1,4,0,1,18,16,2,5,2,3,September,-1.0,-1.8369701987210287e-16,30,6,4,0,1,2.6,1.4,5,7,-2,4,10,-6,"September, 2003"
2003-2004,5,2003-09-20,Fulham,Man City,2,2,D,1,1,2,2,1,2,1,2,9,3,7,10,6,3,September,-1.0,-1.8369701987210287e-16,19,27,0,0,2,0.5,2.5,9,7,2,12,6,6,"September, 2003"
2003-2004,5,2003-09-20,Leeds,Birmingham,0,2,A,0,3,0,1,4,0,4,1,15,9,5,8,6,3,September,-1.0,-1.8369701987210287e-16,23,3,1,0,1,1.5,1.0,6,10,-4,4,2,2,"September, 2003"
2003-2004,5,2003-09-20,Aston Villa,Charlton,2,1,H,3,0,2,2,1,1,2,2,16,12,4,5,4,1,September,-1.0,-1.8369701987210287e-16,1,13,3,1,1,1.6,1.4,5,9,-4,6,7,-1,"September, 2003"
2003-2004,5,2003-09-20,Liverpool,Leicester,2,1,H,3,0,3,2,0,1,2,2,8,12,8,5,4,3,September,-1.0,-1.8369701987210287e-16,25,24,3,0,2,1.2,1.0,7,3,4,8,7,1,"September, 2003"
2003-2004,5,2003-09-21,Man United,Arsenal,0,0,D,1,1,2,1,2,2,3,0,3,2,12,13,1,1,September,-1.0,-1.8369701987210287e-16,28,0,2,1,2,2.2,1.4,9,2,7,11,3,8,"September, 2003"
2003-2004,5,2003-09-21,Middlesbrough,Everton,1,0,H,3,0,1,0,4,0,1,4,19,14,1,5,5,4,September,-1.0,-1.8369701987210287e-16,29,18,1,2,2,1.0,1.4,4,12,-8,8,10,-2,"September, 2003"
2003-2004,6,2003-09-26,Arsenal,Newcastle,3,2,H,3,0,2,3,0,1,3,1,1,19,14,3,18,11,September,-1.0,-1.8369701987210287e-16,0,30,2,2,1,1.0,0.8,11,3,8,5,7,-2,"September, 2003"
2003-2004,6,2003-09-27,Birmingham,Portsmouth,2,0,H,3,0,0,4,1,2,2,1,7,8,11,9,1,2,September,-1.0,-1.8369701987210287e-16,3,33,0,0,0,0.0,0.0,6,2,4,9,5,4,"September, 2003"
2003-2004,6,2003-09-27,Bolton,Wolves,1,1,D,1,1,4,0,1,2,2,1,12,20,6,1,8,5,September,-1.0,-1.8369701987210287e-16,6,48,0,0,0,0.0,0.0,4,10,-6,1,17,-16,"September, 2003"
2003-2004,6,2003-09-27,Chelsea,Aston Villa,1,0,H,3,0,2,2,1,2,2,1,3,11,13,7,8,6,September,-1.0,-1.8369701987210287e-16,14,1,2,1,2,1.2,1.2,15,6,9,7,10,-3,"September, 2003"
2003-2004,6,2003-09-27,Leicester,Man United,1,4,A,0,3,1,2,2,2,1,2,13,4,5,13,9,8,September,-1.0,-1.8369701987210287e-16,24,28,0,0,5,0.0,2.0,9,9,0,9,2,7,"September, 2003"
2003-2004,6,2003-09-27,Southampton,Middlesbrough,0,1,A,0,3,0,2,3,1,0,4,5,17,12,4,12,8,September,-1.0,-1.8369701987210287e-16,38,29,2,3,0,1.4,0.8,8,3,5,5,12,-7,"September, 2003"
2003-2004,6,2003-09-28,Man City,Tottenham,0,0,D,1,1,2,1,2,2,1,2,6,18,11,4,12,7,September,-1.0,-1.8369701987210287e-16,27,42,1,1,3,0.8,1.0,14,8,6,5,12,-7,"September, 2003"
2003-2004,6,2003-09-28,Blackburn,Fulham,0,2,A,0,3,3,1,1,2,2,1,9,10,8,8,1,0,September,-1.0,-1.8369701987210287e-16,4,19,3,0,1,2.25,0.75,14,12,2,11,9,2,"September, 2003"
2003-2004,6,2003-09-28,Charlton,Liverpool,3,2,H,3,0,1,2,2,3,2,0,14,7,5,11,7,6,September,-1.0,-1.8369701987210287e-16,13,25,1,0,4,0.6,2.0,7,9,-2,9,4,5,"September, 2003"
2003-2004,6,2003-09-28,Everton,Leeds,4,0,H,3,0,0,1,4,0,1,4,16,17,5,5,1,0,September,-1.0,-1.8369701987210287e-16,18,23,2,2,1,1.4,1.0,8,11,-3,6,12,-6,"September, 2003"
2003-2004,7,2003-10-04,Tottenham,Everton,3,0,H,3,0,2,1,2,0,1,4,19,11,5,8,8,3,October,-0.8660254037844386,0.5,42,18,1,4,0,1.6,1.4,5,12,-7,12,11,1,"October, 2003"
2003-2004,7,2003-10-04,Portsmouth,Charlton,1,2,A,0,3,2,2,1,1,2,2,9,12,9,8,3,1,October,-0.8660254037844386,0.5,33,13,0,0,0,0.0,0.0,9,7,2,10,11,-1,"October, 2003"
2003-2004,7,2003-10-04,Wolves,Man City,1,0,H,3,0,2,2,1,2,1,2,20,6,2,12,14,10,October,-0.8660254037844386,0.5,48,27,0,0,0,0.0,0.0,2,18,-16,14,8,6,"October, 2003"
2003-2004,7,2003-10-04,Newcastle,Southampton,1,0,H,3,0,1,3,1,0,2,3,19,7,3,12,12,9,October,-0.8660254037844386,0.5,30,38,2,2,1,1.6,1.4,7,10,-3,8,4,4,"October, 2003"
2003-2004,7,2003-10-04,Man United,Birmingham,3,0,H,3,0,2,1,2,0,4,1,3,5,16,14,2,2,October,-0.8660254037844386,0.5,28,3,2,0,0,1.5,0.0,13,3,10,8,2,6,"October, 2003"
2003-2004,7,2003-10-04,Liverpool,Arsenal,1,2,A,0,3,3,2,0,2,3,0,8,1,11,17,7,6,October,-0.8660254037844386,0.5,25,0,1,3,1,1.8,1.2,11,7,4,14,5,9,"October, 2003"
2003-2004,7,2003-10-04,Leeds,Blackburn,2,1,H,3,0,0,1,4,3,1,1,18,11,5,8,7,3,October,-0.8660254037844386,0.5,23,4,2,0,3,1.4,1.4,6,16,-10,14,14,0,"October, 2003"
2003-2004,7,2003-10-04,Fulham,Leicester,2,0,H,3,0,2,2,1,1,2,2,7,16,11,5,9,6,October,-0.8660254037844386,0.5,19,24,0,2,0,0.0,0.0,13,9,4,10,13,-3,"October, 2003"
2003-2004,7,2003-10-05,Aston Villa,Bolton,1,1,D,1,1,2,2,1,4,0,1,15,17,7,7,2,0,October,-0.8660254037844386,0.5,1,6,2,0,3,1.6,1.8,7,11,-4,5,11,-6,"October, 2003"
2003-2004,7,2003-10-05,Middlesbrough,Chelsea,1,2,A,0,3,1,0,4,2,2,1,17,3,7,16,14,9,October,-0.8660254037844386,0.5,29,14,0,2,3,0.8,1.6,6,12,-6,16,6,10,"October, 2003"
2003-2004,7,2003-10-14,Birmingham,Chelsea,0,0,D,1,1,0,4,1,2,2,1,5,3,14,19,2,5,October,-0.8660254037844386,0.5,3,14,0,0,2,0.5,3.0,8,5,3,18,7,11,"October, 2003"
2003-2004,8,2003-10-18,Portsmouth,Liverpool,1,0,H,3,0,2,2,1,3,2,0,10,8,9,11,2,2,October,-0.8660254037844386,0.5,33,25,0,0,0,0.0,0.0,10,9,1,12,9,3,"October, 2003"
2003-2004,8,2003-10-18,Middlesbrough,Newcastle,0,1,A,0,3,1,0,4,1,3,1,17,18,7,6,1,1,October,-0.8660254037844386,0.5,29,30,2,0,3,0.8,2.0,7,14,-7,8,10,-2,"October, 2003"
2003-2004,8,2003-10-18,Man City,Bolton,6,2,H,3,0,2,1,2,4,0,1,6,15,12,8,9,4,October,-0.8660254037844386,0.5,27,6,2,1,1,1.0,0.75,14,9,5,6,12,-6,"October, 2003"
2003-2004,8,2003-10-18,Fulham,Wolves,0,0,D,1,1,2,2,1,2,2,1,5,20,14,5,15,9,October,-0.8660254037844386,0.5,19,48,0,0,0,0.0,0.0,15,9,6,3,18,-15,"October, 2003"
2003-2004,8,2003-10-18,Arsenal,Chelsea,2,1,H,3,0,2,3,0,2,2,1,2,1,20,20,1,0,October,-0.8660254037844386,0.5,0,14,2,3,0,1.6,1.2,16,6,10,18,7,11,"October, 2003"
2003-2004,8,2003-10-18,Leeds,Man United,0,1,A,0,3,0,1,4,2,1,2,16,3,8,19,13,11,October,-0.8660254037844386,0.5,23,28,1,2,2,1.4,1.6,8,17,-9,16,3,13,"October, 2003"
2003-2004,8,2003-10-19,Birmingham,Aston Villa,0,0,D,1,1,0,4,1,2,2,1,6,14,15,8,8,7,October,-0.8660254037844386,0.5,3,1,2,0,0,2.5,0.0,8,5,3,8,12,-4,"October, 2003"
2003-2004,8,2003-10-19,Everton,Southampton,0,0,D,1,1,0,1,4,0,2,3,14,7,8,12,7,4,October,-0.8660254037844386,0.5,18,38,3,0,2,1.0,0.6,12,14,-2,8,5,3,"October, 2003"
2003-2004,8,2003-10-19,Leicester,Tottenham,1,2,A,0,3,1,2,2,2,1,2,20,15,5,8,5,3,October,-0.8660254037844386,0.5,24,42,2,0,3,1.4,1.8,10,15,-5,8,12,-4,"October, 2003"
2003-2004,8,2003-10-20,Blackburn,Charlton,0,1,A,0,3,3,1,1,1,2,2,15,10,8,11,5,3,October,-0.8660254037844386,0.5,4,13,3,1,1,1.6,0.8,15,16,-1,12,12,0,"October, 2003"
2003-2004,8,2003-10-21,Fulham,Newcastle,2,3,A,0,3,2,2,1,1,3,1,6,12,15,9,6,6,October,-0.8660254037844386,0.5,19,30,2,1,1,1.5,1.25,15,9,6,9,10,-1,"October, 2003"
2003-2004,9,2003-10-25,Southampton,Blackburn,2,0,H,3,0,0,2,3,3,1,1,10,15,13,8,5,5,October,-0.8660254037844386,0.5,38,4,0,2,3,1.0,1.8,8,5,3,15,17,-2,"October, 2003"
2003-2004,9,2003-10-25,Wolves,Leicester,4,3,H,3,0,2,2,1,1,2,2,19,20,6,5,1,1,October,-0.8660254037844386,0.5,48,24,0,0,0,0.0,0.0,3,18,-15,11,17,-6,"October, 2003"
2003-2004,9,2003-10-25,Newcastle,Portsmouth,3,0,H,3,0,1,3,1,2,2,1,11,10,12,12,1,0,October,-0.8660254037844386,0.5,30,33,0,0,0,0.0,0.0,12,12,0,11,9,2,"October, 2003"
2003-2004,9,2003-10-25,Man United,Fulham,1,3,A,0,3,2,1,2,2,2,1,3,6,22,15,3,7,October,-0.8660254037844386,0.5,28,19,3,1,0,2.5,1.25,17,3,14,17,12,5,"October, 2003"
2003-2004,9,2003-10-25,Chelsea,Man City,1,0,H,3,0,2,2,1,2,1,2,3,5,20,15,2,5,October,-0.8660254037844386,0.5,14,27,4,1,0,2.6,0.6,19,9,10,20,11,9,"October, 2003"
2003-2004,9,2003-10-25,Bolton,Birmingham,0,1,A,0,3,4,0,1,0,4,1,16,4,8,16,12,8,October,-0.8660254037844386,0.5,6,3,1,0,1,2.5,2.5,8,18,-10,8,5,3,"October, 2003"
2003-2004,9,2003-10-25,Aston Villa,Everton,0,0,D,1,1,2,2,1,0,1,4,14,13,9,9,1,0,October,-0.8660254037844386,0.5,1,18,2,1,2,1.6,1.6,8,12,-4,12,14,-2,"October, 2003"
2003-2004,9,2003-10-25,Liverpool,Leeds,3,1,H,3,0,3,2,0,0,1,4,11,16,11,8,5,3,October,-0.8660254037844386,0.5,25,23,3,1,1,2.0,0.8,12,10,2,8,18,-10,"October, 2003"
2003-2004,9,2003-10-26,Charlton,Arsenal,1,1,D,1,1,1,2,2,2,3,0,10,2,14,23,8,9,October,-0.8660254037844386,0.5,13,0,2,0,3,1.0,2.0,13,12,1,18,7,11,"October, 2003"
2003-2004,9,2003-10-26,Tottenham,Middlesbrough,0,0,D,1,1,2,1,2,1,0,4,12,19,11,7,7,4,October,-0.8660254037844386,0.5,42,29,1,2,2,0.8,2.0,10,13,-3,7,15,-8,"October, 2003"
2003-2004,10,2003-11-01,Southampton,Man City,0,2,A,0,3,0,2,3,2,1,2,6,8,16,15,2,1,November,-0.5000000000000004,0.8660254037844384,38,27,3,0,2,1.0,0.8,10,5,5,20,12,8,"November, 2003"
2003-2004,10,2003-11-01,Tottenham,Bolton,0,1,A,0,3,2,1,2,4,0,1,11,18,12,8,7,4,November,-0.5000000000000004,0.8660254037844384,42,6,3,1,1,1.6,1.0,10,13,-3,8,19,-11,"November, 2003"
2003-2004,10,2003-11-01,Newcastle,Aston Villa,1,1,D,1,1,1,3,1,2,2,1,8,15,15,10,7,5,November,-0.5000000000000004,0.8660254037844384,30,1,3,2,0,1.8,0.4,15,12,3,8,12,-4,"November, 2003"
2003-2004,10,2003-11-01,Man United,Portsmouth,3,0,H,3,0,2,1,2,2,2,1,3,11,22,12,8,10,November,-0.5000000000000004,0.8660254037844384,28,33,0,0,0,0.0,0.0,18,6,12,11,12,-1,"November, 2003"
2003-2004,10,2003-11-01,Leeds,Arsenal,1,4,A,0,3,0,1,4,2,3,0,19,2,8,24,17,16,November,-0.5000000000000004,0.8660254037844384,23,0,2,1,2,1.6,2.0,9,21,-12,19,8,11,"November, 2003"
2003-2004,10,2003-11-01,Everton,Chelsea,0,1,A,0,3,0,1,4,2,2,1,13,2,10,23,11,13,November,-0.5000000000000004,0.8660254037844384,18,14,0,1,4,0.6,2.4,12,14,-2,20,9,11,"November, 2003"
2003-2004,10,2003-11-01,Middlesbrough,Wolves,2,0,H,3,0,1,0,4,2,2,1,17,15,8,9,2,1,November,-0.5000000000000004,0.8660254037844384,29,48,0,0,0,0.0,0.0,7,15,-8,7,21,-14,"November, 2003"
2003-2004,10,2003-11-02,Fulham,Liverpool,1,2,A,0,3,2,2,1,3,2,0,6,10,18,14,4,4,November,-0.5000000000000004,0.8660254037844384,19,25,1,1,2,0.75,1.5,20,13,7,15,11,4,"November, 2003"
2003-2004,10,2003-11-02,Leicester,Blackburn,2,0,H,3,0,1,2,2,3,1,1,20,18,5,8,2,3,November,-0.5000000000000004,0.8660254037844384,24,4,1,2,2,1.2,1.6,14,21,-7,15,19,-4,"November, 2003"
2003-2004,10,2003-11-03,Birmingham,Charlton,1,2,A,0,3,0,4,1,1,2,2,4,10,19,15,6,4,November,-0.5000000000000004,0.8660254037844384,3,13,1,1,0,1.5,0.5,9,5,4,14,13,1,"November, 2003"
2003-2004,11,2003-11-08,Portsmouth,Leeds,6,1,H,3,0,2,2,1,0,1,4,12,20,12,8,8,4,November,-0.5000000000000004,0.8660254037844384,33,23,0,0,0,0.0,0.0,11,15,-4,10,25,-15,"November, 2003"
2003-2004,11,2003-11-08,Charlton,Fulham,3,1,H,3,0,1,2,2,2,2,1,7,6,18,18,1,0,November,-0.5000000000000004,0.8660254037844384,13,19,0,2,2,0.25,0.75,16,14,2,21,15,6,"November, 2003"
2003-2004,11,2003-11-08,Wolves,Birmingham,1,1,D,1,1,2,2,1,0,4,1,17,5,9,19,12,10,November,-0.5000000000000004,0.8660254037844384,48,3,0,0,0,0.0,0.0,7,23,-16,10,7,3,"November, 2003"
2003-2004,11,2003-11-08,Aston Villa,Middlesbrough,0,2,A,0,3,2,2,1,1,0,4,13,14,11,11,1,0,November,-0.5000000000000004,0.8660254037844384,1,29,2,2,1,1.6,1.0,9,13,-4,9,15,-6,"November, 2003"
2003-2004,11,2003-11-08,Arsenal,Tottenham,2,1,H,3,0,2,3,0,2,1,2,1,12,27,12,11,15,November,-0.5000000000000004,0.8660254037844384,0,42,3,2,0,1.8,0.6,23,9,14,10,14,-4,"November, 2003"
2003-2004,11,2003-11-08,Bolton,Southampton,0,0,D,1,1,4,0,1,0,2,3,15,10,11,16,5,5,November,-0.5000000000000004,0.8660254037844384,6,38,0,4,1,0.2,0.4,9,19,-10,10,7,3,"November, 2003"
2003-2004,11,2003-11-09,Man City,Leicester,0,3,A,0,3,2,1,2,1,2,2,6,18,18,8,12,10,November,-0.5000000000000004,0.8660254037844384,27,24,1,0,1,1.0,1.0,22,12,10,16,21,-5,"November, 2003"
2003-2004,11,2003-11-09,Chelsea,Newcastle,5,0,H,3,0,2,2,1,1,3,1,2,10,26,16,8,10,November,-0.5000000000000004,0.8660254037844384,14,30,3,1,1,2.0,1.0,21,9,12,16,13,3,"November, 2003"
2003-2004,11,2003-11-09,Liverpool,Man United,1,2,A,0,3,3,2,0,2,1,2,8,3,17,25,5,8,November,-0.5000000000000004,0.8660254037844384,25,28,3,0,2,1.4,1.4,17,12,5,21,6,15,"November, 2003"
2003-2004,11,2003-11-10,Blackburn,Everton,2,1,H,3,0,3,1,1,0,1,4,19,17,8,10,2,2,November,-0.5000000000000004,0.8660254037844384,4,18,2,0,3,1.0,1.2,15,21,-6,12,15,-3,"November, 2003"
2003-2004,12,2003-11-22,Newcastle,Man City,3,0,H,3,0,1,3,1,2,1,2,10,6,16,18,4,2,November,-0.5000000000000004,0.8660254037844384,30,27,2,1,2,1.2,1.0,16,18,-2,22,15,7,"November, 2003"
2003-2004,12,2003-11-22,Middlesbrough,Liverpool,0,0,D,1,1,1,0,4,3,2,0,13,8,14,17,5,3,November,-0.5000000000000004,0.8660254037844384,29,25,1,2,2,0.6,1.0,11,15,-4,18,14,4,"November, 2003"
2003-2004,12,2003-11-22,Man United,Blackburn,2,1,H,3,0,2,1,2,3,1,1,3,17,28,11,14,17,November,-0.5000000000000004,0.8660254037844384,28,4,2,2,1,1.4,1.0,23,7,16,17,22,-5,"November, 2003"
2003-2004,12,2003-11-22,Southampton,Chelsea,0,1,A,0,3,0,2,3,2,2,1,10,3,17,29,7,12,November,-0.5000000000000004,0.8660254037844384,38,14,1,2,2,1.0,1.2,10,7,3,26,9,17,"November, 2003"
2003-2004,12,2003-11-22,Leeds,Bolton,0,2,A,0,3,0,1,4,4,0,1,20,15,8,12,5,4,November,-0.5000000000000004,0.8660254037844384,23,6,3,1,1,2.2,1.2,11,31,-20,9,19,-10,"November, 2003"
2003-2004,12,2003-11-22,Everton,Wolves,2,0,H,3,0,0,1,4,2,2,1,18,19,10,10,1,0,November,-0.5000000000000004,0.8660254037844384,18,48,0,0,0,0.0,0.0,13,17,-4,8,24,-16,"November, 2003"
2003-2004,12,2003-11-22,Birmingham,Arsenal,0,3,A,0,3,0,4,1,2,3,0,5,1,20,30,4,10,November,-0.5000000000000004,0.8660254037844384,3,0,0,0,2,0.0,3.0,11,8,3,25,10,15,"November, 2003"
2003-2004,12,2003-11-22,Leicester,Charlton,1,1,D,1,1,1,2,2,1,2,2,16,4,11,21,12,10,November,-0.5000000000000004,0.8660254037844384,24,13,1,2,2,1.0,1.4,19,21,-2,19,15,4,"November, 2003"
2003-2004,12,2003-11-23,Tottenham,Aston Villa,2,1,H,3,0,2,1,2,2,2,1,16,18,12,11,2,1,November,-0.5000000000000004,0.8660254037844384,42,1,2,3,0,0.6,0.2,11,16,-5,9,15,-6,"November, 2003"
2003-2004,12,2003-11-24,Fulham,Portsmouth,2,0,H,3,0,2,2,1,2,2,1,7,11,18,15,4,3,November,-0.5000000000000004,0.8660254037844384,19,33,0,0,0,0.0,0.0,22,18,4,17,16,1,"November, 2003"
2003-2004,13,2003-11-29,Aston Villa,Southampton,1,0,H,3,0,2,2,1,0,2,3,18,10,11,17,8,6,November,-0.5000000000000004,0.8660254037844384,1,38,2,2,1,1.4,1.0,10,17,-7,10,8,2,"November, 2003"
2003-2004,13,2003-11-29,Blackburn,Tottenham,1,0,H,3,0,3,1,1,2,1,2,18,12,11,15,6,4,November,-0.5000000000000004,0.8660254037844384,4,42,2,1,2,1.6,1.0,18,24,-6,13,17,-4,"November, 2003"
2003-2004,13,2003-11-29,Bolton,Everton,2,0,H,3,0,4,0,1,0,1,4,14,17,15,13,3,2,November,-0.5000000000000004,0.8660254037844384,6,18,0,2,3,1.2,2.0,11,19,-8,15,17,-2,"November, 2003"
2003-2004,13,2003-11-29,Charlton,Leeds,0,1,A,0,3,1,2,2,0,1,4,4,20,22,8,16,14,November,-0.5000000000000004,0.8660254037844384,13,23,1,1,3,0.8,2.2,20,16,4,11,33,-22,"November, 2003"
2003-2004,13,2003-11-29,Portsmouth,Leicester,0,2,A,0,3,2,2,1,1,2,2,12,18,15,12,6,3,November,-0.5000000000000004,0.8660254037844384,33,24,0,0,0,0.0,0.0,17,18,-1,20,22,-2,"November, 2003"
2003-2004,13,2003-11-29,Wolves,Newcastle,1,1,D,1,1,2,2,1,1,3,1,20,7,10,19,13,9,November,-0.5000000000000004,0.8660254037844384,48,30,0,0,0,0.0,0.0,8,26,-18,19,18,1,"November, 2003"
2003-2004,13,2003-11-30,Man City,Middlesbrough,0,1,A,0,3,2,1,2,1,0,4,9,14,18,15,5,3,November,-0.5000000000000004,0.8660254037844384,27,29,0,3,2,0.8,1.8,22,18,4,11,15,-4,"November, 2003"
2003-2004,13,2003-11-30,Liverpool,Birmingham,3,1,H,3,0,3,2,0,0,4,1,9,7,18,20,2,2,November,-0.5000000000000004,0.8660254037844384,25,3,0,1,1,1.5,2.0,18,14,4,11,11,0,"November, 2003"
2003-2004,13,2003-11-30,Chelsea,Man United,1,0,H,3,0,2,2,1,2,1,2,2,3,32,31,1,1,November,-0.5000000000000004,0.8660254037844384,14,28,1,2,2,1.4,1.6,27,9,18,25,8,17,"November, 2003"
2003-2004,13,2003-11-30,Arsenal,Fulham,0,0,D,1,1,2,3,0,2,2,1,1,5,33,21,4,12,November,-0.5000000000000004,0.8660254037844384,0,19,4,0,0,2.5,0.75,28,10,18,24,18,6,"November, 2003"
2003-2004,14,2003-12-06,Newcastle,Liverpool,1,1,D,1,1,1,3,1,3,2,0,7,6,20,21,1,1,December,-2.4492935982947064e-16,1.0,30,25,1,1,3,0.6,2.0,20,19,1,21,15,6,"December, 2003"
2003-2004,14,2003-12-06,Middlesbrough,Portsmouth,0,0,D,1,1,1,0,4,2,2,1,10,15,18,15,5,3,December,-2.4492935982947064e-16,1.0,29,33,0,0,0,0.0,0.0,12,15,-3,17,20,-3,"December, 2003"
2003-2004,14,2003-12-06,Man United,Aston Villa,4,0,H,3,0,2,1,2,2,2,1,3,17,31,14,14,17,December,-2.4492935982947064e-16,1.0,28,1,3,2,0,1.2,0.4,25,9,16,11,17,-6,"December, 2003"
2003-2004,14,2003-12-06,Tottenham,Wolves,5,2,H,3,0,2,1,2,2,2,1,16,20,15,11,4,4,December,-2.4492935982947064e-16,1.0,42,48,0,0,0,0.0,0.0,13,18,-5,9,27,-18,"December, 2003"
2003-2004,14,2003-12-06,Leeds,Chelsea,1,1,D,1,1,0,1,4,2,2,1,20,1,11,35,19,24,December,-2.4492935982947064e-16,1.0,23,14,2,1,2,1.2,1.0,12,33,-21,28,9,19,"December, 2003"
2003-2004,14,2003-12-06,Fulham,Bolton,2,1,H,3,0,2,2,1,4,0,1,4,11,22,18,7,4,December,-2.4492935982947064e-16,1.0,19,6,2,2,0,1.75,0.25,24,18,6,13,19,-6,"December, 2003"
2003-2004,14,2003-12-06,Birmingham,Blackburn,0,4,A,0,3,0,4,1,3,1,1,8,16,20,14,8,6,December,-2.4492935982947064e-16,1.0,3,4,0,1,1,0.5,1.0,12,14,-2,19,24,-5,"December, 2003"
2003-2004,14,2003-12-06,Leicester,Arsenal,1,1,D,1,1,1,2,2,2,3,0,14,2,15,34,12,19,December,-2.4492935982947064e-16,1.0,24,0,0,1,4,0.4,3.2,22,22,0,28,10,18,"December, 2003"
2003-2004,14,2003-12-07,Everton,Man City,0,0,D,1,1,0,1,4,2,1,2,18,10,13,18,8,5,December,-2.4492935982947064e-16,1.0,18,27,2,1,2,1.6,2.2,15,19,-4,22,19,3,"December, 2003"
2003-2004,14,2003-12-07,Southampton,Charlton,3,2,H,3,0,0,2,3,1,2,2,13,6,17,22,7,5,December,-2.4492935982947064e-16,1.0,38,13,1,3,1,0.6,0.6,10,9,1,20,17,3,"December, 2003"
2003-2004,15,2003-12-13,Newcastle,Tottenham,4,0,H,3,0,1,3,1,2,1,2,9,13,21,18,4,3,December,-2.4492935982947064e-16,1.0,30,42,3,0,2,1.6,1.6,21,20,1,18,20,-2,"December, 2003"
2003-2004,15,2003-12-13,Chelsea,Bolton,1,2,A,0,3,2,2,1,4,0,1,1,13,36,18,12,18,December,-2.4492935982947064e-16,1.0,14,6,3,2,0,2.2,0.8,29,10,19,14,21,-7,"December, 2003"
2003-2004,15,2003-12-13,Leicester,Birmingham,0,2,A,0,3,1,2,2,0,4,1,15,10,16,20,5,4,December,-2.4492935982947064e-16,1.0,24,3,0,0,0,0.0,0.0,23,23,0,12,18,-6,"December, 2003"
2003-2004,15,2003-12-13,Liverpool,Southampton,1,2,A,0,3,3,2,0,0,2,3,6,10,22,20,4,2,December,-2.4492935982947064e-16,1.0,25,38,3,1,1,1.4,0.8,22,16,6,13,11,2,"December, 2003"
2003-2004,15,2003-12-13,Man United,Man City,3,1,H,3,0,2,1,2,2,1,2,3,11,34,19,8,15,December,-2.4492935982947064e-16,1.0,28,27,2,2,1,1.4,1.4,29,9,20,22,19,3,"December, 2003"
2003-2004,15,2003-12-13,Middlesbrough,Charlton,0,0,D,1,1,1,0,4,1,2,2,12,8,19,22,4,3,December,-2.4492935982947064e-16,1.0,29,13,0,4,1,0.2,0.4,12,15,-3,22,20,2,"December, 2003"
2003-2004,15,2003-12-13,Portsmouth,Everton,1,2,A,0,3,2,2,1,0,1,4,16,17,16,14,1,2,December,-2.4492935982947064e-16,1.0,33,18,0,0,0,0.0,0.0,17,20,-3,15,19,-4,"December, 2003"
2003-2004,15,2003-12-14,Aston Villa,Wolves,3,2,H,3,0,2,2,1,2,2,1,18,20,14,11,2,3,December,-2.4492935982947064e-16,1.0,1,48,0,0,0,0.0,0.0,11,21,-10,11,32,-21,"December, 2003"
2003-2004,15,2003-12-14,Arsenal,Blackburn,1,0,H,3,0,2,3,0,3,1,1,3,14,35,17,11,18,December,-2.4492935982947064e-16,1.0,0,4,2,1,2,1.6,1.8,29,11,18,23,24,-1,"December, 2003"
2003-2004,15,2003-12-14,Leeds,Fulham,3,2,H,3,0,0,1,4,2,2,1,19,4,12,25,15,13,December,-2.4492935982947064e-16,1.0,23,19,1,1,2,0.5,0.5,13,34,-21,26,19,7,"December, 2003"
2003-2004,16,2003-12-20,Everton,Leicester,3,2,H,3,0,0,1,4,1,2,2,15,17,17,16,2,1,December,-2.4492935982947064e-16,1.0,18,24,1,4,0,1.2,1.0,17,20,-3,23,25,-2,"December, 2003"
2003-2004,16,2003-12-20,Charlton,Newcastle,0,0,D,1,1,1,2,2,1,3,1,7,5,23,24,2,1,December,-2.4492935982947064e-16,1.0,13,30,1,1,3,0.8,1.6,22,20,2,25,20,5,"December, 2003"
2003-2004,16,2003-12-20,Fulham,Chelsea,0,1,A,0,3,2,2,1,2,2,1,4,3,25,36,1,11,December,-2.4492935982947064e-16,1.0,19,14,0,3,1,1.0,1.25,28,22,6,30,12,18,"December, 2003"
2003-2004,16,2003-12-20,Blackburn,Aston Villa,0,2,A,0,3,3,1,1,2,2,1,14,16,17,17,2,0,December,-2.4492935982947064e-16,1.0,4,1,2,1,2,1.2,1.2,23,25,-2,14,23,-9,"December, 2003"
2003-2004,16,2003-12-20,Bolton,Arsenal,1,1,D,1,1,4,0,1,2,3,0,10,1,21,38,9,17,December,-2.4492935982947064e-16,1.0,6,0,0,2,3,0.8,1.6,16,22,-6,30,11,19,"December, 2003"
2003-2004,16,2003-12-21,Southampton,Portsmouth,3,0,H,3,0,0,2,3,2,2,1,7,18,23,16,11,7,December,-2.4492935982947064e-16,1.0,38,33,0,0,0,0.0,0.0,15,12,3,18,22,-4,"December, 2003"
2003-2004,16,2003-12-21,Tottenham,Man United,1,2,A,0,3,2,1,2,2,1,2,15,3,18,37,12,19,December,-2.4492935982947064e-16,1.0,42,28,1,0,4,1.2,2.6,18,24,-6,32,10,22,"December, 2003"
2003-2004,16,2003-12-22,Man City,Leeds,1,1,D,1,1,2,1,2,0,1,4,14,19,19,15,5,4,December,-2.4492935982947064e-16,1.0,27,23,3,0,2,1.0,1.8,23,22,1,16,36,-20,"December, 2003"
2003-2004,17,2003-12-26,Portsmouth,Tottenham,2,0,H,3,0,2,2,1,2,1,2,19,16,16,18,3,2,December,-2.4492935982947064e-16,1.0,33,42,0,0,0,0.0,0.0,18,25,-7,19,26,-7,"December, 2003"
2003-2004,17,2003-12-26,Man United,Everton,3,2,H,3,0,2,1,2,0,1,4,2,14,40,20,12,20,December,-2.4492935982947064e-16,1.0,28,18,5,0,0,2.4,0.4,34,11,23,20,22,-2,"December, 2003"
2003-2004,17,2003-12-26,Liverpool,Bolton,3,1,H,3,0,3,2,0,4,0,1,9,10,22,22,1,0,December,-2.4492935982947064e-16,1.0,25,6,3,1,1,1.8,1.2,23,18,5,17,23,-6,"December, 2003"
2003-2004,17,2003-12-26,Leicester,Newcastle,1,1,D,1,1,1,2,2,1,3,1,18,8,16,25,10,9,December,-2.4492935982947064e-16,1.0,24,30,1,2,2,0.6,0.6,25,28,-3,25,20,5,"December, 2003"
2003-2004,17,2003-12-26,Leeds,Aston Villa,0,0,D,1,1,0,1,4,2,2,1,19,14,16,20,5,4,December,-2.4492935982947064e-16,1.0,23,1,3,2,0,1.4,0.6,17,37,-20,16,23,-7,"December, 2003"
2003-2004,17,2003-12-26,Charlton,Chelsea,4,2,H,3,0,1,2,2,2,2,1,8,3,24,39,5,15,December,-2.4492935982947064e-16,1.0,13,14,3,0,2,1.4,1.6,22,20,2,31,12,19,"December, 2003"
2003-2004,17,2003-12-26,Blackburn,Middlesbrough,2,2,D,1,1,3,1,1,1,0,4,16,13,17,20,3,3,December,-2.4492935982947064e-16,1.0,4,29,2,1,2,0.8,0.6,23,27,-4,12,15,-3,"December, 2003"
2003-2004,17,2003-12-26,Birmingham,Man City,2,1,H,3,0,0,4,1,2,1,2,8,11,23,20,3,3,December,-2.4492935982947064e-16,1.0,3,27,0,0,2,0.0,1.5,14,18,-4,24,23,1,"December, 2003"
2003-2004,17,2003-12-26,Arsenal,Wolves,3,0,H,3,0,2,3,0,2,2,1,2,20,39,11,18,28,December,-2.4492935982947064e-16,1.0,0,48,0,0,0,0.0,0.0,31,12,19,13,35,-22,"December, 2003"
2003-2004,17,2003-12-26,Fulham,Southampton,2,0,H,3,0,2,2,1,0,2,3,7,5,25,26,2,1,December,-2.4492935982947064e-16,1.0,19,38,1,2,1,1.75,2.0,28,23,5,18,12,6,"December, 2003"
2003-2004,18,2003-12-28,Middlesbrough,Man United,0,1,A,0,3,1,0,4,2,1,2,14,1,21,43,13,22,December,-2.4492935982947064e-16,1.0,29,28,2,0,3,0.8,1.0,14,17,-3,37,13,24,"December, 2003"
2003-2004,18,2003-12-28,Wolves,Leeds,3,1,H,3,0,2,2,1,0,1,4,20,19,11,17,1,6,December,-2.4492935982947064e-16,1.0,48,23,0,0,0,0.0,0.0,13,38,-25,17,37,-20,"December, 2003"
2003-2004,18,2003-12-28,Newcastle,Blackburn,0,1,A,0,3,1,3,1,3,1,1,7,17,26,18,10,8,December,-2.4492935982947064e-16,1.0,30,4,2,2,1,2.4,2.0,26,21,5,25,29,-4,"December, 2003"
2003-2004,18,2003-12-28,Man City,Liverpool,2,2,D,1,1,2,1,2,3,2,0,14,9,20,25,5,5,December,-2.4492935982947064e-16,1.0,27,25,1,2,2,1.4,2.0,25,25,0,26,19,7,"December, 2003"
2003-2004,18,2003-12-28,Tottenham,Charlton,0,1,A,0,3,2,1,2,1,2,2,18,5,18,27,13,9,December,-2.4492935982947064e-16,1.0,42,13,1,2,2,0.8,1.2,19,28,-9,26,22,4,"December, 2003"
2003-2004,18,2003-12-28,Chelsea,Portsmouth,3,0,H,3,0,2,2,1,2,2,1,3,15,39,19,12,20,December,-2.4492935982947064e-16,1.0,14,33,0,0,0,0.0,0.0,33,16,17,20,25,-5,"December, 2003"
2003-2004,18,2003-12-28,Bolton,Leicester,2,2,D,1,1,4,0,1,1,2,2,11,18,22,17,7,5,December,-2.4492935982947064e-16,1.0,6,24,2,2,0,2.25,0.5,18,26,-8,26,29,-3,"December, 2003"
2003-2004,18,2003-12-28,Aston Villa,Fulham,3,0,H,3,0,2,2,1,2,2,1,12,4,21,28,8,7,December,-2.4492935982947064e-16,1.0,1,19,2,1,1,1.5,0.75,16,23,-7,30,23,7,"December, 2003"
2003-2004,18,2003-12-28,Everton,Birmingham,1,0,H,3,0,0,1,4,0,4,1,14,8,20,26,6,6,December,-2.4492935982947064e-16,1.0,18,3,0,2,0,1.0,1.0,22,25,-3,16,19,-3,"December, 2003"
2003-2004,18,2003-12-29,Southampton,Arsenal,0,1,A,0,3,0,2,3,2,3,0,8,2,26,42,6,16,December,-2.4492935982947064e-16,1.0,38,0,2,1,2,1.6,2.6,18,14,4,34,12,22,"December, 2003"
2003-2004,19,2004-01-06,Aston Villa,Portsmouth,2,1,H,3,0,2,2,1,2,2,1,10,16,24,19,6,5,January,0.4999999999999999,0.8660254037844387,1,33,0,0,1,1.0,2.0,19,23,-4,20,28,-8,"January, 2004"
2003-2004,19,2004-01-07,Wolves,Blackburn,2,2,D,1,1,2,2,1,3,1,1,20,15,14,21,5,7,January,0.4999999999999999,0.8660254037844387,48,4,0,0,1,1.0,5.0,16,39,-23,26,29,-3,"January, 2004"
2003-2004,19,2004-01-07,Tottenham,Birmingham,4,1,H,3,0,2,1,2,0,4,1,18,10,18,26,8,8,January,0.4999999999999999,0.8660254037844387,42,3,1,1,1,1.0,1.0,19,29,-10,16,20,-4,"January, 2004"
2003-2004,19,2004-01-07,Southampton,Leicester,0,0,D,1,1,0,2,3,1,2,2,9,17,26,18,8,8,January,0.4999999999999999,0.8660254037844387,38,24,2,2,1,1.8,1.0,18,15,3,28,31,-3,"January, 2004"
2003-2004,19,2004-01-07,Middlesbrough,Fulham,2,1,H,3,0,1,0,4,2,2,1,15,6,21,28,9,7,January,0.4999999999999999,0.8660254037844387,29,19,1,1,3,1.4,1.8,14,18,-4,30,26,4,"January, 2004"
2003-2004,19,2004-01-07,Newcastle,Leeds,1,0,H,3,0,1,3,1,0,1,4,8,19,26,17,11,9,January,0.4999999999999999,0.8660254037844387,30,23,3,1,1,2.4,1.6,26,22,4,18,40,-22,"January, 2004"
2003-2004,19,2004-01-07,Everton,Arsenal,1,1,D,1,1,0,1,4,2,3,0,11,2,23,45,9,22,January,0.4999999999999999,0.8660254037844387,18,0,1,0,4,1.4,2.0,23,25,-2,35,12,23,"January, 2004"
2003-2004,19,2004-01-07,Chelsea,Liverpool,0,1,A,0,3,2,2,1,3,2,0,3,7,42,26,4,16,January,0.4999999999999999,0.8660254037844387,14,25,3,0,2,1.6,0.8,36,16,20,28,21,7,"January, 2004"
2003-2004,19,2004-01-07,Bolton,Man United,1,2,A,0,3,4,0,1,2,1,2,12,1,23,46,11,23,January,0.4999999999999999,0.8660254037844387,6,28,2,1,2,0.8,2.0,20,28,-8,38,13,25,"January, 2004"
2003-2004,19,2004-01-07,Man City,Charlton,1,1,D,1,1,2,1,2,1,2,2,13,4,21,30,9,9,January,0.4999999999999999,0.8660254037844387,27,13,1,1,3,1.2,2.2,27,27,0,27,22,5,"January, 2004"
2003-2004,20,2004-01-10,Liverpool,Aston Villa,1,0,H,3,0,3,2,0,2,2,1,6,10,29,27,4,2,January,0.4999999999999999,0.8660254037844387,25,1,2,2,1,1.0,1.0,29,21,8,21,24,-3,"January, 2004"
2003-2004,20,2004-01-10,Arsenal,Middlesbrough,4,1,H,3,0,2,3,0,1,0,4,2,12,46,24,10,22,January,0.4999999999999999,0.8660254037844387,0,29,5,0,0,2.8,0.2,36,13,23,16,19,-3,"January, 2004"
2003-2004,20,2004-01-10,Birmingham,Southampton,2,1,H,3,0,0,4,1,0,2,3,10,8,26,27,2,1,January,0.4999999999999999,0.8660254037844387,3,38,1,1,1,1.0,1.3333333333333333,17,24,-7,18,15,3,"January, 2004"
2003-2004,20,2004-01-10,Blackburn,Bolton,3,4,A,0,3,3,1,1,4,0,1,15,13,22,23,2,1,January,0.4999999999999999,0.8660254037844387,4,6,0,5,0,1.0,1.0,28,31,-3,21,30,-9,"January, 2004"
2003-2004,20,2004-01-10,Charlton,Wolves,2,0,H,3,0,1,2,2,2,2,1,4,20,31,15,16,16,January,0.4999999999999999,0.8660254037844387,13,48,1,0,0,4.0,0.0,28,23,5,18,41,-23,"January, 2004"
2003-2004,20,2004-01-10,Fulham,Everton,2,1,H,3,0,2,2,1,0,1,4,8,12,28,24,4,4,January,0.4999999999999999,0.8660254037844387,19,18,2,0,3,1.2,1.4,31,28,3,24,26,-2,"January, 2004"
2003-2004,20,2004-01-10,Leeds,Tottenham,0,1,A,0,3,0,1,4,2,1,2,19,16,17,21,3,4,January,0.4999999999999999,0.8660254037844387,23,42,1,1,3,1.2,1.8,18,41,-23,23,30,-7,"January, 2004"
2003-2004,20,2004-01-10,Portsmouth,Man City,4,2,H,3,0,2,2,1,2,1,2,18,15,19,22,3,3,January,0.4999999999999999,0.8660254037844387,33,27,0,1,0,1.0,1.0,21,30,-9,28,28,0,"January, 2004"
2003-2004,20,2004-01-11,Man United,Newcastle,0,0,D,1,1,2,1,2,1,3,1,2,7,49,29,5,20,January,0.4999999999999999,0.8660254037844387,28,30,4,0,1,3.8,2.2,40,14,26,27,22,5,"January, 2004"
2003-2004,20,2004-01-11,Leicester,Chelsea,0,4,A,0,3,1,2,2,2,2,1,18,3,19,42,15,23,January,0.4999999999999999,0.8660254037844387,24,14,2,0,3,1.4,1.6,28,31,-3,36,17,19,"January, 2004"
2003-2004,21,2004-01-17,Bolton,Portsmouth,1,0,H,3,0,4,0,1,2,2,1,11,17,26,22,6,4,January,0.4999999999999999,0.8660254037844387,6,33,0,0,1,0.0,4.0,25,33,-8,25,32,-7,"January, 2004"
2003-2004,21,2004-01-17,Everton,Charlton,0,1,A,0,3,0,1,4,1,2,2,12,4,24,34,8,10,January,0.4999999999999999,0.8660254037844387,18,13,2,1,2,1.2,1.6,25,28,-3,30,23,7,"January, 2004"
2003-2004,21,2004-01-17,Man City,Blackburn,1,1,D,1,1,2,1,2,3,1,1,15,16,22,22,1,0,January,0.4999999999999999,0.8660254037844387,27,4,1,2,2,1.2,1.6,30,32,-2,31,35,-4,"January, 2004"
2003-2004,21,2004-01-17,Middlesbrough,Leicester,3,3,D,1,1,1,0,4,1,2,2,14,18,24,19,4,5,January,0.4999999999999999,0.8660254037844387,29,24,3,1,1,1.2,0.8,17,23,-6,28,35,-7,"January, 2004"
2003-2004,21,2004-01-17,Southampton,Leeds,2,1,H,3,0,0,2,3,0,1,4,10,19,27,17,9,10,January,0.4999999999999999,0.8660254037844387,38,23,1,2,2,0.8,1.2,19,17,2,18,42,-24,"January, 2004"
2003-2004,21,2004-01-17,Tottenham,Liverpool,2,1,H,3,0,2,1,2,3,2,0,14,5,24,32,9,8,January,0.4999999999999999,0.8660254037844387,42,25,1,1,3,0.8,1.2,24,30,-6,30,21,9,"January, 2004"
2003-2004,21,2004-01-17,Wolves,Man United,1,0,H,3,0,2,2,1,2,1,2,20,1,15,50,19,35,January,0.4999999999999999,0.8660254037844387,48,28,0,0,1,0.0,1.0,18,43,-25,40,14,26,"January, 2004"
2003-2004,21,2004-01-18,Aston Villa,Arsenal,0,2,A,0,3,2,2,1,2,3,0,11,2,27,49,9,22,January,0.4999999999999999,0.8660254037844387,1,0,0,1,4,1.0,2.2,21,25,-4,40,14,26,"January, 2004"
2003-2004,21,2004-01-18,Chelsea,Birmingham,0,0,D,1,1,2,2,1,0,4,1,3,9,45,29,6,16,January,0.4999999999999999,0.8660254037844387,14,3,2,1,0,2.0,0.3333333333333333,40,17,23,19,25,-6,"January, 2004"
2003-2004,21,2004-01-19,Newcastle,Fulham,3,1,H,3,0,1,3,1,2,2,1,7,6,30,31,1,1,January,0.4999999999999999,0.8660254037844387,30,19,2,1,2,1.6,1.6,27,22,5,33,29,4,"January, 2004"
2003-2004,21,2004-01-21,Wolves,Liverpool,1,1,D,1,1,2,2,1,3,2,0,19,6,18,32,13,14,January,0.4999999999999999,0.8660254037844387,48,25,0,0,0,0.0,0.0,19,43,-24,31,23,8,"January, 2004"
2003-2004,22,2004-01-31,Portsmouth,Wolves,0,0,D,1,1,2,2,1,2,2,1,17,19,22,19,2,3,January,0.4999999999999999,0.8660254037844387,33,48,0,1,0,0.0,0.0,25,33,-8,20,44,-24,"January, 2004"
2003-2004,22,2004-01-31,Man United,Southampton,3,2,H,3,0,2,1,2,0,2,3,2,10,50,30,8,20,January,0.4999999999999999,0.8660254037844387,28,38,4,0,1,2.6,0.8,40,15,25,21,18,3,"January, 2004"
2003-2004,22,2004-01-31,Liverpool,Everton,0,0,D,1,1,3,2,0,0,1,4,7,14,33,24,7,9,January,0.4999999999999999,0.8660254037844387,25,18,3,2,0,1.8,0.6,32,24,8,25,29,-4,"January, 2004"
2003-2004,22,2004-01-31,Leicester,Aston Villa,0,5,A,0,3,1,2,2,2,2,1,18,13,20,27,5,7,January,0.4999999999999999,0.8660254037844387,24,1,1,2,2,1.2,1.4,31,38,-7,21,27,-6,"January, 2004"
2003-2004,22,2004-01-31,Birmingham,Newcastle,1,1,D,1,1,0,4,1,1,3,1,9,6,30,33,3,3,January,0.4999999999999999,0.8660254037844387,3,30,1,0,2,0.3333333333333333,1.0,19,25,-6,30,23,7,"January, 2004"
2003-2004,22,2004-01-31,Fulham,Tottenham,2,1,H,3,0,2,2,1,2,1,2,8,11,31,27,3,4,January,0.4999999999999999,0.8660254037844387,19,42,2,1,2,1.4,1.8,34,32,2,26,31,-5,"January, 2004"
2003-2004,22,2004-01-31,Charlton,Bolton,1,2,A,0,3,1,2,2,4,0,1,4,10,37,29,6,8,January,0.4999999999999999,0.8660254037844387,13,6,1,3,1,0.8,0.8,31,23,8,26,33,-7,"January, 2004"
2003-2004,22,2004-01-31,Leeds,Middlesbrough,0,3,A,0,3,0,1,4,1,0,4,20,13,17,25,7,8,January,0.4999999999999999,0.8660254037844387,23,29,2,2,1,2.0,1.8,19,44,-25,20,26,-6,"January, 2004"
2003-2004,22,2004-02-01,Arsenal,Man City,2,1,H,3,0,2,3,0,2,1,2,2,15,52,23,13,29,February,0.8660254037844386,0.5000000000000001,0,27,5,0,0,3.6,0.6,42,14,28,31,33,-2,"February, 2004"
2003-2004,22,2004-02-01,Blackburn,Chelsea,2,3,A,0,3,3,1,1,2,2,1,16,3,23,46,13,23,February,0.8660254037844386,0.5000000000000001,4,14,1,3,1,1.2,1.2,32,36,-4,40,17,23,"February, 2004"
2003-2004,23,2004-02-07,Southampton,Fulham,0,0,D,1,1,0,2,3,2,2,1,11,7,30,34,4,4,February,0.8660254037844386,0.5000000000000001,38,19,1,2,2,1.6,1.8,23,21,2,36,33,3,"February, 2004"
2003-2004,23,2004-02-07,Wolves,Arsenal,1,3,A,0,3,2,2,1,2,3,0,19,2,20,55,17,35,February,0.8660254037844386,0.5000000000000001,48,0,0,0,1,0.0,3.0,20,44,-24,44,15,29,"February, 2004"
2003-2004,23,2004-02-07,Tottenham,Portsmouth,4,3,H,3,0,2,1,2,2,2,1,13,17,27,23,4,4,February,0.8660254037844386,0.5000000000000001,42,33,0,0,1,0.0,2.0,27,33,-6,25,33,-8,"February, 2004"
2003-2004,23,2004-02-07,Newcastle,Leicester,3,1,H,3,0,1,3,1,1,2,2,6,18,34,20,12,14,February,0.8660254037844386,0.5000000000000001,30,24,2,3,0,0.8,0.4,31,24,7,31,43,-12,"February, 2004"
2003-2004,23,2004-02-07,Aston Villa,Leeds,2,0,H,3,0,2,2,1,0,1,4,11,20,30,17,9,13,February,0.8660254037844386,0.5000000000000001,1,23,0,3,2,0.4,1.0,26,27,-1,19,47,-28,"February, 2004"
2003-2004,23,2004-02-07,Everton,Man United,3,4,A,0,3,0,1,4,2,1,2,14,2,25,53,12,28,February,0.8660254037844386,0.5000000000000001,18,28,0,0,5,0.8,2.8,25,29,-4,43,17,26,"February, 2004"
2003-2004,23,2004-02-07,Bolton,Liverpool,2,2,D,1,1,4,0,1,3,2,0,9,5,32,34,4,2,February,0.8660254037844386,0.5000000000000001,6,25,1,1,3,1.2,2.0,28,34,-6,32,24,8,"February, 2004"
2003-2004,23,2004-02-07,Middlesbrough,Blackburn,0,1,A,0,3,1,0,4,3,1,1,12,16,28,23,4,5,February,0.8660254037844386,0.5000000000000001,29,4,2,1,2,1.0,1.2,23,26,-3,34,39,-5,"February, 2004"
2003-2004,23,2004-02-08,Chelsea,Charlton,1,0,H,3,0,2,2,1,1,2,2,3,5,49,37,2,12,February,0.8660254037844386,0.5000000000000001,14,13,2,0,3,2.0,2.0,43,19,24,32,25,7,"February, 2004"
2003-2004,23,2004-02-08,Man City,Birmingham,0,0,D,1,1,2,1,2,0,4,1,16,11,23,31,5,8,February,0.8660254037844386,0.5000000000000001,27,3,2,0,1,1.3333333333333333,0.6666666666666666,32,35,-3,20,26,-6,"February, 2004"
2003-2004,24,2004-02-10,Arsenal,Southampton,2,0,H,3,0,2,3,0,0,2,3,1,11,58,31,10,27,February,0.8660254037844386,0.5000000000000001,0,38,3,1,1,2.4,1.0,47,16,31,23,21,2,"February, 2004"
2003-2004,24,2004-02-10,Leeds,Wolves,4,1,H,3,0,0,1,4,2,2,1,20,19,17,20,1,3,February,0.8660254037844386,0.5000000000000001,23,48,0,0,1,1.0,3.0,19,49,-30,21,47,-26,"February, 2004"
2003-2004,24,2004-02-10,Leicester,Bolton,1,1,D,1,1,1,2,2,4,0,1,18,9,20,33,9,13,February,0.8660254037844386,0.5000000000000001,24,6,0,3,2,0.8,2.2,32,46,-14,30,36,-6,"February, 2004"
2003-2004,24,2004-02-11,Portsmouth,Chelsea,0,2,A,0,3,2,2,1,2,2,1,17,3,23,52,14,29,February,0.8660254037844386,0.5000000000000001,33,14,0,0,1,0.0,3.0,28,37,-9,44,19,25,"February, 2004"
2003-2004,24,2004-02-11,Man United,Middlesbrough,2,3,A,0,3,2,1,2,1,0,4,2,13,56,28,11,28,February,0.8660254037844386,0.5000000000000001,28,29,3,0,2,0.8,0.8,47,20,27,23,27,-4,"February, 2004"
2003-2004,24,2004-02-11,Liverpool,Man City,2,1,H,3,0,3,2,0,2,1,2,7,16,35,24,9,11,February,0.8660254037844386,0.5000000000000001,25,27,2,2,1,2.0,1.4,34,26,8,32,35,-3,"February, 2004"
2003-2004,24,2004-02-11,Birmingham,Everton,3,0,H,3,0,0,4,1,0,1,4,10,15,32,25,5,7,February,0.8660254037844386,0.5000000000000001,3,18,0,2,1,0.6666666666666666,1.0,20,26,-6,28,33,-5,"February, 2004"
2003-2004,24,2004-02-11,Charlton,Tottenham,2,4,A,0,3,1,2,2,2,1,2,5,12,37,30,7,7,February,0.8660254037844386,0.5000000000000001,13,42,3,1,1,1.4,0.8,32,26,6,31,36,-5,"February, 2004"
2003-2004,24,2004-02-11,Blackburn,Newcastle,1,1,D,1,1,3,1,1,1,3,1,14,4,26,37,10,11,February,0.8660254037844386,0.5000000000000001,4,30,2,1,2,2.0,2.2,35,39,-4,34,25,9,"February, 2004"
2003-2004,24,2004-02-11,Fulham,Aston Villa,1,2,A,0,3,2,2,1,2,2,1,7,10,35,33,3,2,February,0.8660254037844386,0.5000000000000001,19,1,1,1,3,0.6,1.8,36,33,3,28,27,1,"February, 2004"
2003-2004,25,2004-02-21,Wolves,Fulham,2,1,H,3,0,2,2,1,2,2,1,20,8,20,35,12,15,February,0.8660254037844386,0.5000000000000001,48,19,0,1,0,0.0,0.0,22,51,-29,37,35,2,"February, 2004"
2003-2004,25,2004-02-21,Southampton,Everton,3,3,D,1,1,0,2,3,0,1,4,12,16,31,25,4,6,February,0.8660254037844386,0.5000000000000001,38,18,1,1,3,0.4,1.0,23,23,0,28,36,-8,"February, 2004"
2003-2004,25,2004-02-21,Newcastle,Middlesbrough,2,1,H,3,0,1,3,1,1,0,4,6,13,38,31,7,7,February,0.8660254037844386,0.5000000000000001,30,29,4,0,1,2.0,0.4,35,26,9,26,29,-3,"February, 2004"
2003-2004,25,2004-02-21,Chelsea,Arsenal,1,2,A,0,3,2,2,1,2,3,0,3,1,55,61,2,6,February,0.8660254037844386,0.5000000000000001,14,0,0,2,3,1.2,1.8,46,19,27,49,16,33,"February, 2004"
2003-2004,25,2004-02-21,Charlton,Blackburn,3,2,H,3,0,1,2,2,3,1,1,6,15,37,27,9,10,February,0.8660254037844386,0.5000000000000001,13,4,2,0,3,1.0,1.6,34,30,4,36,40,-4,"February, 2004"
2003-2004,25,2004-02-21,Bolton,Man City,1,3,A,0,3,4,0,1,2,1,2,10,16,34,24,6,10,February,0.8660254037844386,0.5000000000000001,6,27,1,1,3,1.0,2.0,31,37,-6,33,37,-4,"February, 2004"
2003-2004,25,2004-02-21,Man United,Leeds,1,1,D,1,1,2,1,2,0,1,4,2,19,56,20,17,36,February,0.8660254037844386,0.5000000000000001,28,23,3,1,1,1.6,1.2,49,23,26,23,50,-27,"February, 2004"
2003-2004,25,2004-02-22,Aston Villa,Birmingham,2,2,D,1,1,2,2,1,0,4,1,7,9,36,35,2,1,February,0.8660254037844386,0.5000000000000001,1,3,0,1,2,0.0,1.6666666666666667,30,28,2,23,26,-3,"February, 2004"
2003-2004,25,2004-02-22,Tottenham,Leicester,4,4,D,1,1,2,1,2,1,2,2,11,19,33,21,8,12,February,0.8660254037844386,0.5000000000000001,42,24,3,0,2,2.0,1.6,35,38,-3,33,47,-14,"February, 2004"
2003-2004,26,2004-02-28,Man City,Chelsea,0,1,A,0,3,2,1,2,2,2,1,16,3,27,55,13,28,February,0.8660254037844386,0.5000000000000001,27,14,0,0,5,0.4,2.6,36,38,-2,47,21,26,"February, 2004"
2003-2004,26,2004-02-28,Leicester,Wolves,0,0,D,1,1,1,2,2,2,2,1,19,18,22,23,1,1,February,0.8660254037844386,0.5000000000000001,24,48,0,0,1,3.0,4.0,37,51,-14,24,52,-28,"February, 2004"
2003-2004,26,2004-02-28,Fulham,Man United,1,1,D,1,1,2,2,1,2,1,2,9,2,35,57,7,22,February,0.8660254037844386,0.5000000000000001,19,28,1,1,3,1.6,2.2,38,37,1,50,24,26,"February, 2004"
2003-2004,26,2004-02-28,Blackburn,Southampton,1,1,D,1,1,3,1,1,0,2,3,15,12,27,32,3,5,February,0.8660254037844386,0.5000000000000001,4,38,3,1,1,1.2,0.8,38,43,-5,26,26,0,"February, 2004"
2003-2004,26,2004-02-28,Arsenal,Charlton,2,1,H,3,0,2,3,0,1,2,2,1,5,64,40,4,24,February,0.8660254037844386,0.5000000000000001,0,13,3,1,1,2.2,1.0,51,17,34,37,32,5,"February, 2004"
2003-2004,26,2004-02-28,Everton,Aston Villa,2,0,H,3,0,0,1,4,2,2,1,16,7,26,37,9,11,February,0.8660254037844386,0.5000000000000001,18,1,2,2,1,1.4,1.2,31,39,-8,32,30,2,"February, 2004"
2003-2004,26,2004-02-29,Leeds,Liverpool,2,2,D,1,1,0,1,4,3,2,0,20,6,21,38,14,17,February,0.8660254037844386,0.5000000000000001,23,25,0,1,4,0.6,2.4,24,51,-27,36,27,9,"February, 2004"
2003-2004,26,2004-02-29,Portsmouth,Newcastle,1,1,D,1,1,2,2,1,1,3,1,18,4,23,41,14,18,February,0.8660254037844386,0.5000000000000001,33,30,0,0,1,0.0,3.0,28,39,-11,37,27,10,"February, 2004"
2003-2004,26,2004-03-03,Birmingham,Middlesbrough,3,1,H,3,0,0,4,1,1,0,4,9,13,36,31,4,5,March,1.0,6.123233995736766e-17,3,29,1,0,1,1.5,0.5,25,28,-3,27,31,-4,"March, 2004"
2003-2004,26,2004-03-06,Birmingham,Bolton,2,0,H,3,0,0,4,1,4,0,1,7,11,39,34,4,5,March,1.0,6.123233995736766e-17,3,6,2,0,1,2.0,1.6666666666666667,28,29,-1,32,40,-8,"March, 2004"
2003-2004,26,2004-03-09,Middlesbrough,Tottenham,1,0,H,3,0,1,0,4,2,1,2,13,10,31,34,3,3,March,1.0,6.123233995736766e-17,29,42,2,2,1,2.0,0.8,28,34,-6,39,42,-3,"March, 2004"
2003-2004,27,2004-03-13,Fulham,Leeds,2,0,H,3,0,2,2,1,0,1,4,9,20,36,22,11,14,March,1.0,6.123233995736766e-17,19,23,2,1,2,0.8,1.0,39,38,1,26,53,-27,"March, 2004"
2003-2004,27,2004-03-13,Everton,Portsmouth,1,0,H,3,0,0,1,4,2,2,1,14,18,29,24,4,5,March,1.0,6.123233995736766e-17,18,33,1,0,0,2.0,1.0,33,39,-6,29,40,-11,"March, 2004"
2003-2004,27,2004-03-13,Charlton,Middlesbrough,1,0,H,3,0,1,2,2,1,0,4,6,11,40,34,5,6,March,1.0,6.123233995736766e-17,13,29,1,4,0,0.4,0.2,38,34,4,29,34,-5,"March, 2004"
2003-2004,27,2004-03-13,Blackburn,Arsenal,0,2,A,0,3,3,1,1,2,3,0,15,1,28,67,14,39,March,1.0,6.123233995736766e-17,4,0,2,1,2,1.8,1.6,39,44,-5,53,18,35,"March, 2004"
2003-2004,27,2004-03-13,Birmingham,Leicester,0,1,A,0,3,0,4,1,1,2,2,5,19,42,23,14,19,March,1.0,6.123233995736766e-17,3,24,1,0,0,2.0,0.0,30,29,1,37,51,-14,"March, 2004"
2003-2004,27,2004-03-13,Bolton,Chelsea,0,2,A,0,3,4,0,1,2,2,1,12,2,34,58,10,24,March,1.0,6.123233995736766e-17,6,14,1,2,2,1.2,2.0,32,42,-10,48,21,27,"March, 2004"
2003-2004,27,2004-03-14,Man City,Man United,4,1,H,3,0,2,1,2,2,1,2,16,3,27,58,13,31,March,1.0,6.123233995736766e-17,27,28,1,2,2,1.2,1.4,36,39,-3,51,25,26,"March, 2004"
2003-2004,27,2004-03-14,Southampton,Liverpool,2,0,H,3,0,0,2,3,3,2,0,13,7,33,39,6,6,March,1.0,6.123233995736766e-17,38,25,2,1,2,1.0,1.2,27,27,0,38,29,9,"March, 2004"
2003-2004,27,2004-03-14,Tottenham,Newcastle,1,0,H,3,0,2,1,2,1,3,1,11,5,34,42,6,8,March,1.0,6.123233995736766e-17,42,30,1,0,4,0.8,2.0,39,43,-4,38,28,10,"March, 2004"
2003-2004,27,2004-03-14,Wolves,Aston Villa,0,4,A,0,3,2,2,1,2,2,1,19,9,24,37,10,13,March,1.0,6.123233995736766e-17,48,1,0,0,1,2.0,3.0,24,52,-28,32,32,0,"March, 2004"
2003-2004,27,2004-03-17,Liverpool,Portsmouth,3,0,H,3,0,3,2,0,2,2,1,8,18,39,24,10,15,March,1.0,6.123233995736766e-17,25,33,0,0,1,0.0,1.0,38,31,7,29,41,-12,"March, 2004"
2003-2004,28,2004-03-20,Chelsea,Fulham,2,1,H,3,0,2,2,1,2,2,1,2,9,61,39,7,22,March,1.0,6.123233995736766e-17,14,19,2,3,0,1.2,0.8,50,21,29,41,38,3,"March, 2004"
2003-2004,28,2004-03-20,Newcastle,Charlton,3,1,H,3,0,1,3,1,1,2,2,6,5,42,43,1,1,March,1.0,6.123233995736766e-17,30,13,3,2,0,1.6,0.4,38,29,9,39,34,5,"March, 2004"
2003-2004,28,2004-03-20,Middlesbrough,Birmingham,5,3,H,3,0,1,0,4,0,4,1,12,7,34,42,5,8,March,1.0,6.123233995736766e-17,29,3,1,0,2,0.6666666666666666,2.0,29,35,-6,30,30,0,"March, 2004"
2003-2004,28,2004-03-20,Man United,Tottenham,3,0,H,3,0,2,1,2,2,1,2,3,10,58,37,7,21,March,1.0,6.123233995736766e-17,28,42,5,0,0,2.8,0.8,52,29,23,40,43,-3,"March, 2004"
2003-2004,28,2004-03-20,Arsenal,Bolton,2,1,H,3,0,2,3,0,4,0,1,1,13,70,34,12,36,March,1.0,6.123233995736766e-17,0,6,2,3,0,1.6,1.0,55,18,37,32,44,-12,"March, 2004"
2003-2004,28,2004-03-20,Leicester,Everton,1,1,D,1,1,1,2,2,0,1,4,17,14,26,32,3,6,March,1.0,6.123233995736766e-17,24,18,0,3,2,1.2,1.6,38,51,-13,34,39,-5,"March, 2004"
2003-2004,28,2004-03-20,Aston Villa,Blackburn,0,2,A,0,3,2,2,1,3,1,1,8,16,40,28,8,12,March,1.0,6.123233995736766e-17,1,4,3,1,1,1.4,0.6,36,32,4,39,46,-7,"March, 2004"
2003-2004,28,2004-03-20,Liverpool,Wolves,1,0,H,3,0,3,2,0,2,2,1,5,19,42,24,14,18,March,1.0,6.123233995736766e-17,25,48,0,1,0,1.0,1.0,41,31,10,24,56,-32,"March, 2004"
2003-2004,28,2004-03-21,Portsmouth,Southampton,1,0,H,3,0,2,2,1,0,2,3,18,12,24,36,6,12,March,1.0,6.123233995736766e-17,33,38,0,0,1,0.0,3.0,29,44,-15,29,27,2,"March, 2004"
2003-2004,28,2004-03-22,Leeds,Man City,2,1,H,3,0,0,1,4,2,1,2,20,16,22,30,4,8,March,1.0,6.123233995736766e-17,23,27,2,1,2,2.0,1.0,26,55,-29,40,40,0,"March, 2004"
2003-2004,29,2004-03-27,Everton,Middlesbrough,1,1,D,1,1,0,1,4,1,0,4,14,10,33,37,4,4,March,1.0,6.123233995736766e-17,18,29,2,1,2,1.0,0.8,35,40,-5,34,38,-4,"March, 2004"
2003-2004,29,2004-03-27,Man City,Fulham,0,0,D,1,1,2,1,2,2,2,1,16,9,30,39,7,9,March,1.0,6.123233995736766e-17,27,19,2,1,0,2.333333333333333,1.0,41,42,-1,42,40,2,"March, 2004"
2003-2004,29,2004-03-27,Chelsea,Wolves,5,2,H,3,0,2,2,1,2,2,1,2,20,64,24,18,40,March,1.0,6.123233995736766e-17,14,48,1,0,0,5.0,0.0,52,22,30,24,57,-33,"March, 2004"
2003-2004,29,2004-03-27,Southampton,Tottenham,1,0,H,3,0,0,2,3,2,1,2,12,11,36,37,1,1,March,1.0,6.123233995736766e-17,38,42,3,0,2,1.2,1.0,29,28,1,40,46,-6,"March, 2004"
2003-2004,29,2004-03-27,Blackburn,Portsmouth,1,2,A,0,3,3,1,1,2,2,1,15,18,31,27,3,4,March,1.0,6.123233995736766e-17,4,33,1,0,0,2.0,1.0,41,46,-5,30,44,-14,"March, 2004"
2003-2004,29,2004-03-27,Birmingham,Leeds,4,1,H,3,0,0,4,1,0,1,4,7,19,42,25,12,17,March,1.0,6.123233995736766e-17,3,23,2,0,1,1.3333333333333333,1.0,33,35,-2,28,56,-28,"March, 2004"
2003-2004,29,2004-03-27,Charlton,Aston Villa,1,2,A,0,3,1,2,2,2,2,1,7,8,43,40,1,3,March,1.0,6.123233995736766e-17,13,1,1,0,4,1.0,1.4,40,37,3,36,34,2,"March, 2004"
2003-2004,29,2004-03-28,Arsenal,Man United,1,1,D,1,1,2,3,0,2,1,2,1,3,73,61,2,12,March,1.0,6.123233995736766e-17,0,28,2,2,1,1.2,1.0,57,19,38,55,29,26,"March, 2004"
2003-2004,29,2004-03-28,Bolton,Newcastle,1,0,H,3,0,4,0,1,1,3,1,14,5,34,45,9,11,March,1.0,6.123233995736766e-17,6,30,1,1,3,1.2,2.2,33,46,-13,41,30,11,"March, 2004"
2003-2004,29,2004-03-28,Leicester,Liverpool,0,0,D,1,1,1,2,2,3,2,0,18,4,27,45,14,18,March,1.0,6.123233995736766e-17,24,25,1,0,4,0.8,1.6,39,52,-13,42,31,11,"March, 2004"
2003-2004,30,2004-04-03,Wolves,Southampton,1,4,A,0,3,2,2,1,0,2,3,20,11,24,39,9,15,April,0.8660254037844388,-0.4999999999999998,48,38,0,0,1,0.0,2.0,26,62,-36,30,28,2,"April, 2004"
2003-2004,30,2004-04-03,Newcastle,Everton,4,2,H,3,0,1,3,1,0,1,4,6,14,45,34,8,11,April,0.8660254037844388,-0.4999999999999998,30,18,3,1,1,2.8,1.6,41,31,10,36,41,-5,"April, 2004"
2003-2004,30,2004-04-03,Tottenham,Chelsea,0,1,A,0,3,2,1,2,2,2,1,12,2,37,67,10,30,April,0.8660254037844388,-0.4999999999999998,42,14,0,2,3,1.0,2.4,40,47,-7,57,24,33,"April, 2004"
2003-2004,30,2004-04-03,Fulham,Birmingham,0,0,D,1,1,2,2,1,0,4,1,9,6,40,45,3,5,April,0.8660254037844388,-0.4999999999999998,19,3,0,2,1,0.6666666666666666,1.0,42,40,2,37,36,1,"April, 2004"
2003-2004,30,2004-04-03,Middlesbrough,Bolton,2,0,H,3,0,1,0,4,4,0,1,11,13,38,37,2,1,April,0.8660254037844388,-0.4999999999999998,29,6,1,1,3,0.8,1.2,35,39,-4,34,46,-12,"April, 2004"
2003-2004,30,2004-04-04,Aston Villa,Man City,1,1,D,1,1,2,2,1,2,1,2,7,15,43,31,8,12,April,0.8660254037844388,-0.4999999999999998,1,27,2,1,2,1.6,2.0,38,35,3,41,42,-1,"April, 2004"
2003-2004,30,2004-04-04,Liverpool,Blackburn,4,0,H,3,0,3,2,0,3,1,1,5,16,46,31,11,15,April,0.8660254037844388,-0.4999999999999998,25,4,2,3,0,2.2,1.6,42,31,11,42,48,-6,"April, 2004"
2003-2004,30,2004-04-05,Leeds,Leicester,3,2,H,3,0,0,1,4,1,2,2,19,18,25,28,1,3,April,0.8660254037844388,-0.4999999999999998,23,24,2,1,2,1.6,2.0,29,60,-31,39,52,-13,"April, 2004"
2003-2004,31,2004-04-09,Arsenal,Liverpool,4,2,H,3,0,2,3,0,3,2,0,1,4,74,49,3,25,April,0.8660254037844388,-0.4999999999999998,0,25,2,3,0,1.6,1.2,58,20,38,46,31,15,"April, 2004"
2003-2004,31,2004-04-09,Everton,Tottenham,3,1,H,3,0,0,1,4,2,1,2,14,12,34,37,2,3,April,0.8660254037844388,-0.4999999999999998,18,42,0,3,2,1.4,2.2,38,45,-7,40,48,-8,"April, 2004"
2003-2004,31,2004-04-10,Chelsea,Middlesbrough,0,0,D,1,1,2,2,1,1,0,4,2,11,70,41,9,29,April,0.8660254037844388,-0.4999999999999998,14,29,3,2,0,1.6,0.8,58,24,34,37,39,-2,"April, 2004"
2003-2004,31,2004-04-10,Leicester,Fulham,0,2,A,0,3,1,2,2,2,2,1,19,11,28,41,8,13,April,0.8660254037844388,-0.4999999999999998,24,19,0,2,1,0.0,0.6666666666666666,41,55,-14,42,40,2,"April, 2004"
2003-2004,31,2004-04-10,Charlton,Portsmouth,1,1,D,1,1,1,2,2,2,2,1,8,18,43,30,10,13,April,0.8660254037844388,-0.4999999999999998,13,33,1,0,0,2.0,1.0,41,39,2,32,45,-13,"April, 2004"
2003-2004,31,2004-04-10,Man City,Wolves,3,3,D,1,1,2,1,2,2,2,1,15,20,32,24,5,8,April,0.8660254037844388,-0.4999999999999998,27,48,0,0,1,0.0,1.0,42,43,-1,27,66,-39,"April, 2004"
2003-2004,31,2004-04-10,Blackburn,Leeds,1,2,A,0,3,3,1,1,0,1,4,16,19,31,28,3,3,April,0.8660254037844388,-0.4999999999999998,4,23,2,0,3,1.4,1.8,42,52,-10,32,62,-30,"April, 2004"
2003-2004,31,2004-04-10,Birmingham,Man United,1,2,A,0,3,0,4,1,2,1,2,6,3,46,62,3,16,April,0.8660254037844388,-0.4999999999999998,3,28,0,0,3,0.0,2.0,37,36,1,56,30,26,"April, 2004"
2003-2004,31,2004-04-10,Bolton,Aston Villa,2,2,D,1,1,4,0,1,2,2,1,14,7,37,44,7,7,April,0.8660254037844388,-0.4999999999999998,6,1,2,1,2,1.4,1.6,34,48,-14,39,36,3,"April, 2004"
2003-2004,31,2004-04-11,Newcastle,Arsenal,0,0,D,1,1,1,3,1,2,3,0,5,1,48,77,4,29,April,0.8660254037844388,-0.4999999999999998,30,0,1,1,3,1.2,1.6,45,33,12,62,22,40,"April, 2004"
2003-2004,31,2004-04-12,Aston Villa,Chelsea,3,2,H,3,0,2,2,1,2,2,1,7,2,45,71,5,26,April,0.8660254037844388,-0.4999999999999998,1,14,2,1,2,1.2,1.2,41,38,3,58,24,34,"April, 2004"
2003-2004,31,2004-04-12,Fulham,Blackburn,3,4,A,0,3,2,2,1,3,1,1,8,16,44,31,8,13,April,0.8660254037844388,-0.4999999999999998,19,4,2,0,3,1.0,1.8,44,40,4,43,54,-11,"April, 2004"
2003-2004,31,2004-04-12,Liverpool,Charlton,0,1,A,0,3,3,2,0,1,2,2,4,9,49,44,5,5,April,0.8660254037844388,-0.4999999999999998,25,13,3,0,2,1.6,1.2,48,35,13,42,40,2,"April, 2004"
2003-2004,31,2004-04-12,Middlesbrough,Southampton,3,1,H,3,0,1,0,4,0,2,3,11,10,42,42,1,0,April,0.8660254037844388,-0.4999999999999998,29,38,1,3,1,1.0,1.2,37,39,-2,34,29,5,"April, 2004"
2003-2004,31,2004-04-12,Portsmouth,Birmingham,3,1,H,3,0,2,2,1,0,4,1,17,8,31,46,9,15,April,0.8660254037844388,-0.4999999999999998,33,3,0,0,1,0.0,2.0,33,46,-13,38,38,0,"April, 2004"
2003-2004,31,2004-04-12,Tottenham,Man City,1,1,D,1,1,2,1,2,2,1,2,14,17,37,33,3,4,April,0.8660254037844388,-0.4999999999999998,42,27,2,2,1,0.8,0.8,41,51,-10,45,46,-1,"April, 2004"
2003-2004,31,2004-04-12,Wolves,Bolton,1,2,A,0,3,2,2,1,4,0,1,20,13,25,38,7,13,April,0.8660254037844388,-0.4999999999999998,48,6,0,1,0,1.0,1.0,30,69,-39,36,50,-14,"April, 2004"
2003-2004,31,2004-04-13,Man United,Leicester,1,0,H,3,0,2,1,2,1,2,2,3,19,65,28,16,37,April,0.8660254037844388,-0.4999999999999998,28,24,5,0,0,2.4,0.2,58,31,27,41,57,-16,"April, 2004"
2003-2004,31,2004-04-13,Leeds,Everton,1,1,D,1,1,0,1,4,0,1,4,18,14,31,37,4,6,April,0.8660254037844388,-0.4999999999999998,23,18,1,1,3,0.6,1.8,34,63,-29,41,46,-5,"April, 2004"
2003-2004,32,2004-04-16,Arsenal,Leeds,5,0,H,3,0,2,3,0,0,1,4,1,18,78,32,17,46,April,0.8660254037844388,-0.4999999999999998,0,23,2,1,2,2.4,1.6,62,22,40,35,64,-29,"April, 2004"
2003-2004,32,2004-04-17,Blackburn,Leicester,1,0,H,3,0,3,1,1,1,2,2,16,19,34,28,3,6,April,0.8660254037844388,-0.4999999999999998,4,24,1,2,2,0.6,1.0,47,57,-10,41,58,-17,"April, 2004"
2003-2004,32,2004-04-17,Bolton,Tottenham,2,0,H,3,0,4,0,1,2,1,2,12,14,41,38,2,3,April,0.8660254037844388,-0.4999999999999998,6,42,2,1,2,1.2,1.4,38,51,-13,42,52,-10,"April, 2004"
2003-2004,32,2004-04-17,Charlton,Birmingham,1,1,D,1,1,1,2,2,0,4,1,7,8,47,46,1,1,April,0.8660254037844388,-0.4999999999999998,13,3,1,1,1,1.0,1.3333333333333333,43,40,3,39,41,-2,"April, 2004"
2003-2004,32,2004-04-17,Chelsea,Everton,0,0,D,1,1,2,2,1,0,1,4,2,13,71,38,11,33,April,0.8660254037844388,-0.4999999999999998,14,18,4,1,0,2.2,0.4,60,27,33,42,47,-5,"April, 2004"
2003-2004,32,2004-04-17,Liverpool,Fulham,0,0,D,1,1,3,2,0,2,2,1,4,10,49,44,6,5,April,0.8660254037844388,-0.4999999999999998,25,19,3,1,1,1.6,0.8,48,36,12,47,44,3,"April, 2004"
2003-2004,32,2004-04-17,Man City,Southampton,1,3,A,0,3,2,1,2,0,2,3,16,12,34,42,4,8,April,0.8660254037844388,-0.4999999999999998,27,38,2,0,3,0.8,0.8,46,47,-1,35,32,3,"April, 2004"
2003-2004,32,2004-04-17,Portsmouth,Man United,1,0,H,3,0,2,2,1,2,1,2,17,3,34,68,14,34,April,0.8660254037844388,-0.4999999999999998,33,28,0,0,1,0.0,3.0,36,47,-11,59,31,28,"April, 2004"
2003-2004,32,2004-04-17,Wolves,Middlesbrough,2,0,H,3,0,2,2,1,1,0,4,20,11,25,45,9,20,April,0.8660254037844388,-0.4999999999999998,48,29,0,0,1,0.0,2.0,31,71,-40,40,40,0,"April, 2004"
2003-2004,32,2004-04-18,Aston Villa,Newcastle,0,0,D,1,1,2,2,1,1,3,1,6,5,48,49,1,1,April,0.8660254037844388,-0.4999999999999998,1,30,0,3,2,0.6,1.4,44,40,4,45,33,12,"April, 2004"
2003-2004,32,2004-04-20,Man United,Charlton,2,0,H,3,0,2,1,2,1,2,2,3,7,68,48,4,20,April,0.8660254037844388,-0.4999999999999998,28,13,4,1,0,2.2,0.4,59,32,27,44,41,3,"April, 2004"
2003-2004,33,2004-04-24,Southampton,Bolton,1,2,A,0,3,0,2,3,4,0,1,10,12,45,44,2,1,April,0.8660254037844388,-0.4999999999999998,38,6,1,4,0,0.4,0.2,38,33,5,40,51,-11,"April, 2004"
2003-2004,33,2004-04-24,Man United,Liverpool,0,1,A,0,3,2,1,2,3,2,0,3,4,71,50,1,21,April,0.8660254037844388,-0.4999999999999998,28,25,3,0,2,1.8,1.2,61,32,29,48,36,12,"April, 2004"
2003-2004,33,2004-04-24,Middlesbrough,Aston Villa,1,2,A,0,3,1,0,4,2,2,1,11,6,45,49,5,4,April,0.8660254037844388,-0.4999999999999998,29,1,2,1,2,1.2,1.4,40,42,-2,44,40,4,"April, 2004"
2003-2004,33,2004-04-24,Fulham,Charlton,2,0,H,3,0,2,2,1,1,2,2,10,7,45,48,3,3,April,0.8660254037844388,-0.4999999999999998,19,13,2,2,1,0.8,0.8,47,44,3,44,43,1,"April, 2004"
2003-2004,33,2004-04-24,Leicester,Man City,1,1,D,1,1,1,2,2,2,1,2,19,17,28,34,2,6,April,0.8660254037844388,-0.4999999999999998,24,27,2,0,1,1.6666666666666667,0.6666666666666666,41,59,-18,47,50,-3,"April, 2004"
2003-2004,33,2004-04-24,Everton,Blackburn,0,1,A,0,3,0,1,4,3,1,1,13,15,39,37,2,2,April,0.8660254037844388,-0.4999999999999998,18,4,2,0,3,1.0,1.2,42,47,-5,48,57,-9,"April, 2004"
2003-2004,33,2004-04-25,Birmingham,Wolves,2,2,D,1,1,0,4,1,2,2,1,9,20,47,28,11,19,April,0.8660254037844388,-0.4999999999999998,3,48,0,1,0,1.0,1.0,40,42,-2,33,71,-38,"April, 2004"
2003-2004,33,2004-04-25,Leeds,Portsmouth,1,2,A,0,3,0,1,4,2,2,1,18,16,32,37,2,5,April,0.8660254037844388,-0.4999999999999998,23,33,0,0,1,1.0,6.0,35,69,-34,37,47,-10,"April, 2004"
2003-2004,33,2004-04-25,Newcastle,Chelsea,2,1,H,3,0,1,3,1,2,2,1,6,2,50,72,4,22,April,0.8660254037844388,-0.4999999999999998,30,14,1,1,3,0.8,2.4,45,33,12,60,27,33,"April, 2004"
2003-2004,33,2004-04-25,Tottenham,Arsenal,2,2,D,1,1,2,1,2,2,3,0,16,1,38,81,15,43,April,0.8660254037844388,-0.4999999999999998,42,0,0,2,3,0.8,1.8,42,54,-12,67,22,45,"April, 2004"
2003-2004,34,2004-05-01,Wolves,Everton,2,1,H,3,0,2,2,1,0,1,4,20,15,29,39,5,10,May,0.4999999999999999,-0.8660254037844387,48,18,0,0,1,0.0,2.0,35,73,-38,42,48,-6,"May, 2004"
2003-2004,34,2004-05-01,Portsmouth,Fulham,1,1,D,1,1,2,2,1,2,2,1,14,9,40,48,5,8,May,0.4999999999999999,-0.8660254037844387,33,19,0,0,1,0.0,2.0,39,48,-9,49,44,5,"May, 2004"
2003-2004,34,2004-05-01,Chelsea,Southampton,4,0,H,3,0,2,2,1,0,2,3,2,11,72,45,9,27,May,0.4999999999999999,-0.8660254037844387,14,38,2,2,1,1.2,1.0,61,29,32,39,35,4,"May, 2004"
2003-2004,34,2004-05-01,Man City,Newcastle,1,0,H,3,0,2,1,2,1,3,1,17,5,35,53,12,18,May,0.4999999999999999,-0.8660254037844387,27,30,2,0,3,0.4,1.2,48,51,-3,47,34,13,"May, 2004"
2003-2004,34,2004-05-01,Blackburn,Man United,1,0,H,3,0,3,1,1,2,1,2,13,3,40,71,10,31,May,0.4999999999999999,-0.8660254037844387,4,28,1,1,3,1.2,1.8,49,57,-8,61,33,28,"May, 2004"
2003-2004,34,2004-05-01,Arsenal,Birmingham,0,0,D,1,1,2,3,0,0,4,1,1,9,82,48,8,34,May,0.4999999999999999,-0.8660254037844387,0,3,3,0,0,3.0,0.0,69,24,45,42,44,-2,"May, 2004"
2003-2004,34,2004-05-01,Charlton,Leicester,2,2,D,1,1,1,2,2,1,2,2,9,19,48,29,10,19,May,0.4999999999999999,-0.8660254037844387,13,24,2,2,1,1.4,1.0,44,45,-1,42,60,-18,"May, 2004"
2003-2004,34,2004-05-02,Aston Villa,Tottenham,1,0,H,3,0,2,2,1,2,1,2,6,16,52,39,10,13,May,0.4999999999999999,-0.8660254037844387,1,42,0,2,3,0.4,1.0,46,41,5,44,56,-12,"May, 2004"
2003-2004,34,2004-05-02,Bolton,Leeds,4,1,H,3,0,4,0,1,0,1,4,10,18,47,32,8,15,May,0.4999999999999999,-0.8660254037844387,6,23,2,1,2,1.2,1.6,42,52,-10,36,71,-35,"May, 2004"
2003-2004,34,2004-05-02,Liverpool,Middlesbrough,2,0,H,3,0,3,2,0,1,0,4,5,12,53,45,7,8,May,0.4999999999999999,-0.8660254037844387,25,29,2,2,1,1.0,0.6,49,36,13,41,44,-3,"May, 2004"
2003-2004,34,2004-05-04,Portsmouth,Arsenal,1,1,D,1,1,2,2,1,2,3,0,14,1,41,83,13,42,May,0.4999999999999999,-0.8660254037844387,33,0,0,1,0,1.0,1.0,40,49,-9,69,24,45,"May, 2004"
2003-2004,35,2004-05-08,Middlesbrough,Man City,2,1,H,3,0,1,0,4,2,1,2,12,17,45,38,5,7,May,0.4999999999999999,-0.8660254037844387,29,27,2,3,0,1.2,0.6,41,46,-5,49,51,-2,"May, 2004"
2003-2004,35,2004-05-08,Tottenham,Blackburn,1,0,H,3,0,2,1,2,3,1,1,16,13,39,43,3,4,May,0.4999999999999999,-0.8660254037844387,42,4,2,0,3,0.8,1.6,44,57,-13,50,57,-7,"May, 2004"
2003-2004,35,2004-05-08,Southampton,Aston Villa,1,1,D,1,1,0,2,3,2,2,1,12,5,45,55,7,10,May,0.4999999999999999,-0.8660254037844387,38,1,1,1,3,1.0,1.6,39,39,0,47,41,6,"May, 2004"
2003-2004,35,2004-05-08,Leicester,Portsmouth,3,1,H,3,0,1,2,2,2,2,1,20,14,30,42,6,12,May,0.4999999999999999,-0.8660254037844387,24,33,1,0,0,2.0,0.0,44,62,-18,41,50,-9,"May, 2004"
2003-2004,35,2004-05-08,Leeds,Charlton,3,3,D,1,1,0,1,4,1,2,2,19,9,32,49,10,17,May,0.4999999999999999,-0.8660254037844387,23,13,3,1,1,2.0,0.6,37,75,-38,46,47,-1,"May, 2004"
2003-2004,35,2004-05-08,Everton,Bolton,1,2,A,0,3,0,1,4,4,0,1,15,7,39,50,8,11,May,0.4999999999999999,-0.8660254037844387,18,6,2,2,1,1.4,1.2,43,50,-7,46,53,-7,"May, 2004"
2003-2004,35,2004-05-08,Birmingham,Liverpool,0,3,A,0,3,0,4,1,3,2,0,10,4,49,56,6,7,May,0.4999999999999999,-0.8660254037844387,3,25,1,1,1,1.6666666666666667,2.0,42,44,-2,51,36,15,"May, 2004"
2003-2004,35,2004-05-08,Man United,Chelsea,1,1,D,1,1,2,1,2,2,2,1,3,2,71,75,1,4,May,0.4999999999999999,-0.8660254037844387,28,14,2,1,2,1.4,1.4,61,34,27,65,29,36,"May, 2004"
2003-2004,35,2004-05-09,Fulham,Arsenal,0,1,A,0,3,2,2,1,2,3,0,9,1,49,84,8,35,May,0.4999999999999999,-0.8660254037844387,19,0,0,1,4,0.6,2.0,50,45,5,70,25,45,"May, 2004"
2003-2004,35,2004-05-09,Newcastle,Wolves,1,1,D,1,1,1,3,1,2,2,1,6,20,53,32,14,21,May,0.4999999999999999,-0.8660254037844387,30,48,0,1,0,1.0,1.0,47,35,12,37,74,-37,"May, 2004"
2003-2004,35,2004-05-12,Southampton,Newcastle,3,3,D,1,1,0,2,3,1,3,1,12,6,46,54,6,8,May,0.4999999999999999,-0.8660254037844387,38,30,1,1,3,1.2,1.6,40,40,0,48,36,12,"May, 2004"
2003-2004,36,2004-05-15,Portsmouth,Middlesbrough,5,1,H,3,0,2,2,1,1,0,4,14,11,42,48,3,6,May,0.4999999999999999,-0.8660254037844387,33,29,0,1,0,0.0,0.0,42,53,-11,43,47,-4,"May, 2004"
2003-2004,36,2004-05-15,Arsenal,Leicester,2,1,H,3,0,2,3,0,1,2,2,1,18,87,33,17,54,May,0.4999999999999999,-0.8660254037844387,0,24,3,2,0,2.8,0.6,71,25,46,47,63,-16,"May, 2004"
2003-2004,36,2004-05-15,Aston Villa,Man United,0,2,A,0,3,2,2,1,2,1,2,5,3,56,72,2,16,May,0.4999999999999999,-0.8660254037844387,1,28,0,2,3,0.4,1.6,48,42,6,62,35,27,"May, 2004"
2003-2004,36,2004-05-15,Blackburn,Birmingham,1,1,D,1,1,3,1,1,0,4,1,13,10,43,49,3,6,May,0.4999999999999999,-0.8660254037844387,4,3,2,1,0,2.0,0.3333333333333333,50,58,-8,42,47,-5,"May, 2004"
2003-2004,36,2004-05-15,Bolton,Fulham,0,2,A,0,3,4,0,1,2,2,1,7,10,53,49,3,4,May,0.4999999999999999,-0.8660254037844387,6,19,0,2,3,0.4,1.8,48,54,-6,50,46,4,"May, 2004"
2003-2004,36,2004-05-15,Charlton,Southampton,2,1,H,3,0,1,2,2,0,2,3,9,12,50,47,3,3,May,0.4999999999999999,-0.8660254037844387,13,38,1,2,2,1.0,1.2,49,50,-1,43,43,0,"May, 2004"
2003-2004,36,2004-05-15,Chelsea,Leeds,1,0,H,3,0,2,2,1,0,1,4,2,20,76,33,18,43,May,0.4999999999999999,-0.8660254037844387,14,23,2,2,1,1.2,1.0,66,30,36,40,78,-38,"May, 2004"
2003-2004,36,2004-05-15,Liverpool,Newcastle,1,1,D,1,1,3,2,0,1,3,1,4,6,59,55,2,4,May,0.4999999999999999,-0.8660254037844387,25,30,2,2,1,1.6,0.8,54,36,18,51,39,12,"May, 2004"
2003-2004,36,2004-05-15,Man City,Everton,5,1,H,3,0,2,1,2,0,1,4,17,16,38,39,1,1,May,0.4999999999999999,-0.8660254037844387,27,18,2,2,1,2.2,1.2,50,53,-3,44,52,-8,"May, 2004"
2003-2004,36,2004-05-15,Wolves,Tottenham,0,2,A,0,3,2,2,1,2,1,2,19,15,33,42,4,9,May,0.4999999999999999,-0.8660254037844387,48,42,0,0,1,2.0,5.0,38,75,-37,45,57,-12,"May, 2004"
2004-2005,1,2004-08-14,Tottenham,Liverpool,1,1,D,1,1,1,2,2,2,1,2,18,16,0,0,2,0,August,-0.8660254037844384,-0.5000000000000004,42,25,2,1,2,1.2,1.2,0,0,0,0,0,0,"August, 2004"
2004-2005,1,2004-08-14,Norwich,Crystal Palace,1,1,D,1,1,3,0,2,1,3,1,16,12,0,0,4,0,August,-0.8660254037844384,-0.5000000000000004,31,16,0,0,0,0.0,0.0,0,0,0,0,0,0,"August, 2004"
2004-2005,1,2004-08-14,Middlesbrough,Newcastle,2,2,D,1,1,2,3,0,1,3,1,14,15,0,0,1,0,August,-0.8660254037844384,-0.5000000000000004,29,30,1,0,4,0.4,1.6,0,0,0,0,0,0,"August, 2004"
2004-2005,1,2004-08-14,Portsmouth,Birmingham,1,1,D,1,1,1,1,3,2,1,2,17,12,0,0,5,0,August,-0.8660254037844384,-0.5000000000000004,33,3,1,0,1,1.5,1.5,0,0,0,0,0,0,"August, 2004"
2004-2005,1,2004-08-14,Bolton,Charlton,4,1,H,3,0,1,3,1,0,2,3,6,7,0,0,1,0,August,-0.8660254037844384,-0.5000000000000004,6,13,2,2,1,1.2,1.0,0,0,0,0,0,0,"August, 2004"
2004-2005,1,2004-08-14,Blackburn,West Brom,1,1,D,1,1,0,3,2,1,2,2,4,19,0,0,15,0,August,-0.8660254037844384,-0.5000000000000004,4,44,1,1,0,1.5,0.5,0,0,0,0,0,0,"August, 2004"
2004-2005,1,2004-08-14,Man City,Fulham,1,1,D,1,1,3,2,0,3,0,2,12,10,0,0,2,0,August,-0.8660254037844384,-0.5000000000000004,27,19,2,2,0,1.75,0.75,0,0,0,0,0,0,"August, 2004"
2004-2005,1,2004-08-14,Aston Villa,Southampton,2,0,H,3,0,0,2,3,1,2,2,2,18,0,0,16,0,August,-0.8660254037844384,-0.5000000000000004,1,38,2,2,1,1.2,1.0,0,0,0,0,0,0,"August, 2004"
2004-2005,1,2004-08-15,Chelsea,Man United,1,0,H,3,0,4,1,0,3,1,1,16,18,0,0,2,0,August,-0.8660254037844384,-0.5000000000000004,14,28,1,2,2,1.0,1.6,0,0,0,0,0,0,"August, 2004"
2004-2005,1,2004-08-15,Everton,Arsenal,1,4,A,0,3,1,1,3,4,0,1,17,16,0,0,1,0,August,-0.8660254037844384,-0.5000000000000004,18,0,1,1,3,1.6,2.0,0,0,0,0,0,0,"August, 2004"
2004-2005,2,2004-08-21,Southampton,Blackburn,3,2,H,3,0,1,2,2,0,3,2,20,12,0,1,8,1,August,-0.8660254037844384,-0.5000000000000004,38,4,1,2,2,0.8,1.0,0,2,-2,1,1,0,"August, 2004"
2004-2005,2,2004-08-21,Newcastle,Tottenham,0,1,A,0,3,1,3,1,1,2,2,11,13,1,1,2,0,August,-0.8660254037844384,-0.5000000000000004,30,42,4,0,1,2.0,0.6,2,2,0,1,1,0,"August, 2004"
2004-2005,2,2004-08-21,Man United,Norwich,2,1,H,3,0,3,1,1,3,0,2,19,12,0,1,7,1,August,-0.8660254037844384,-0.5000000000000004,28,31,0,0,0,0.0,0.0,0,1,-1,1,1,0,"August, 2004"
2004-2005,2,2004-08-21,Liverpool,Man City,2,1,H,3,0,2,1,2,3,2,0,11,12,1,1,1,0,August,-0.8660254037844384,-0.5000000000000004,25,27,2,2,1,1.8,1.2,1,1,0,1,1,0,"August, 2004"
2004-2005,2,2004-08-21,Fulham,Bolton,2,0,H,3,0,3,0,2,1,3,1,10,3,1,3,7,2,August,-0.8660254037844384,-0.5000000000000004,19,6,4,1,0,2.2,0.4,1,1,0,4,1,3,"August, 2004"
2004-2005,2,2004-08-21,Crystal Palace,Everton,1,3,A,0,3,1,3,1,1,1,3,9,20,1,0,11,1,August,-0.8660254037844384,-0.5000000000000004,16,18,1,0,1,1.5,2.0,1,1,0,1,4,-3,"August, 2004"
2004-2005,2,2004-08-21,Charlton,Portsmouth,2,1,H,3,0,0,2,3,1,1,3,19,13,0,1,6,1,August,-0.8660254037844384,-0.5000000000000004,13,33,1,1,0,1.5,1.0,1,4,-3,1,1,0,"August, 2004"
2004-2005,2,2004-08-21,Birmingham,Chelsea,0,1,A,0,3,2,1,2,4,1,0,7,4,1,3,3,2,August,-0.8660254037844384,-0.5000000000000004,3,14,0,2,2,0.25,1.5,1,1,0,1,0,1,"August, 2004"
2004-2005,2,2004-08-22,Arsenal,Middlesbrough,5,3,H,3,0,4,0,1,2,3,0,5,12,3,1,7,2,August,-0.8660254037844384,-0.5000000000000004,0,29,5,0,0,2.8,0.4,4,1,3,2,2,0,"August, 2004"
2004-2005,2,2004-08-22,West Brom,Aston Villa,1,1,D,1,1,1,2,2,0,2,3,12,6,1,3,6,2,August,-0.8660254037844384,-0.5000000000000004,44,1,0,1,1,0.5,1.0,1,1,0,2,0,2,"August, 2004"
2004-2005,3,2004-08-24,Birmingham,Man City,1,0,H,3,0,2,1,2,3,2,0,18,14,1,1,4,0,August,-0.8660254037844384,-0.5000000000000004,3,27,1,1,2,0.5,1.0,1,2,-1,2,3,-1,"August, 2004"
2004-2005,3,2004-08-24,Crystal Palace,Chelsea,0,2,A,0,3,1,3,1,4,1,0,19,2,1,6,17,5,August,-0.8660254037844384,-0.5000000000000004,16,14,0,0,2,1.0,4.5,2,4,-2,2,0,2,"August, 2004"
2004-2005,3,2004-08-25,Southampton,Bolton,1,2,A,0,3,1,2,2,1,3,1,13,10,3,3,3,0,August,-0.8660254037844384,-0.5000000000000004,38,6,0,4,1,0.4,0.6,3,4,-1,4,3,1,"August, 2004"
2004-2005,3,2004-08-25,Newcastle,Norwich,2,2,D,1,1,1,3,1,3,0,2,15,16,1,1,1,0,August,-0.8660254037844384,-0.5000000000000004,30,31,0,0,0,0.0,0.0,2,3,-1,2,3,-1,"August, 2004"
2004-2005,3,2004-08-25,West Brom,Tottenham,1,1,D,1,1,1,2,2,1,2,2,14,6,2,4,8,2,August,-0.8660254037844384,-0.5000000000000004,44,42,0,0,2,1.5,3.0,2,2,0,2,1,1,"August, 2004"
2004-2005,3,2004-08-25,Charlton,Aston Villa,3,0,H,3,0,0,2,3,0,2,3,12,3,3,4,9,1,August,-0.8660254037844384,-0.5000000000000004,13,1,1,0,4,1.2,1.6,3,5,-2,3,1,2,"August, 2004"
2004-2005,3,2004-08-25,Arsenal,Blackburn,3,0,H,3,0,4,0,1,0,3,2,2,14,6,1,12,5,August,-0.8660254037844384,-0.5000000000000004,0,4,3,0,2,1.4,1.2,9,4,5,3,4,-1,"August, 2004"
2004-2005,3,2004-08-25,Fulham,Middlesbrough,0,2,A,0,3,3,0,2,2,3,0,4,17,4,1,13,3,August,-0.8660254037844384,-0.5000000000000004,19,29,2,1,2,1.6,1.6,3,1,2,5,7,-2,"August, 2004"
2004-2005,4,2004-08-28,Aston Villa,Newcastle,4,2,H,3,0,0,2,3,1,3,1,10,15,4,2,5,2,August,-0.8660254037844384,-0.5000000000000004,1,30,0,4,1,0.6,0.8,3,4,-1,4,5,-1,"August, 2004"
2004-2005,4,2004-08-28,Blackburn,Man United,1,1,D,1,1,0,3,2,3,1,1,19,12,1,3,7,2,August,-0.8660254037844384,-0.5000000000000004,4,28,2,0,3,1.0,1.4,3,7,-4,2,2,0,"August, 2004"
2004-2005,4,2004-08-28,Chelsea,Southampton,2,1,H,3,0,4,1,0,1,2,2,2,14,9,3,12,6,August,-0.8660254037844384,-0.5000000000000004,14,38,2,2,1,1.6,1.0,4,0,4,4,6,-2,"August, 2004"
2004-2005,4,2004-08-28,Everton,West Brom,2,1,H,3,0,1,1,3,1,2,2,13,12,3,3,1,0,August,-0.8660254037844384,-0.5000000000000004,18,44,2,0,0,1.5,0.5,4,5,-1,3,3,0,"August, 2004"
2004-2005,4,2004-08-28,Man City,Charlton,4,0,H,3,0,3,2,0,0,2,3,19,5,1,6,14,5,August,-0.8660254037844384,-0.5000000000000004,27,13,1,2,2,1.4,1.6,2,4,-2,6,5,1,"August, 2004"
2004-2005,4,2004-08-28,Middlesbrough,Crystal Palace,2,1,H,3,0,2,3,0,1,3,1,10,20,4,1,10,3,August,-0.8660254037844384,-0.5000000000000004,29,16,0,0,0,0.0,0.0,7,7,0,2,6,-4,"August, 2004"
2004-2005,4,2004-08-28,Norwich,Arsenal,1,4,A,0,3,3,0,2,4,0,1,16,2,2,9,14,7,August,-0.8660254037844384,-0.5000000000000004,31,0,0,0,0,0.0,0.0,4,5,-1,12,4,8,"August, 2004"
2004-2005,4,2004-08-28,Tottenham,Birmingham,1,0,H,3,0,1,2,2,2,1,2,8,13,5,4,5,1,August,-0.8660254037844384,-0.5000000000000004,42,3,2,1,1,1.75,1.0,3,2,1,2,2,0,"August, 2004"
2004-2005,4,2004-08-29,Bolton,Liverpool,1,0,H,3,0,1,3,1,2,1,2,6,10,6,4,4,2,August,-0.8660254037844384,-0.5000000000000004,6,25,0,2,3,1.2,2.2,6,4,2,3,2,1,"August, 2004"
2004-2005,4,2004-08-30,Portsmouth,Fulham,4,3,H,3,0,1,1,3,3,0,2,19,11,1,4,8,3,August,-0.8660254037844384,-0.5000000000000004,33,19,0,1,1,0.5,1.5,2,3,-1,3,3,0,"August, 2004"
2004-2005,4,2004-08-30,Man United,Everton,0,0,D,1,1,3,1,1,1,1,3,12,7,4,6,5,2,August,-0.8660254037844384,-0.5000000000000004,28,18,5,0,0,2.8,1.2,3,3,0,6,6,0,"August, 2004"
2004-2005,5,2004-09-11,Aston Villa,Chelsea,0,0,D,1,1,0,2,3,4,1,0,6,2,7,12,4,5,September,-1.0,-1.8369701987210287e-16,1,14,3,0,2,1.6,1.4,7,6,1,6,1,5,"September, 2004"
2004-2005,5,2004-09-11,Bolton,Man United,2,2,D,1,1,1,3,1,3,1,1,3,9,9,5,6,4,September,-1.0,-1.8369701987210287e-16,6,28,1,1,3,0.6,2.2,7,4,3,3,3,0,"September, 2004"
2004-2005,5,2004-09-11,Fulham,Arsenal,0,3,A,0,3,3,0,2,4,0,1,13,2,4,12,11,8,September,-1.0,-1.8369701987210287e-16,19,0,0,1,4,0.4,1.6,6,7,-1,16,5,11,"September, 2004"
2004-2005,5,2004-09-11,Liverpool,West Brom,3,0,H,3,0,2,1,2,1,2,2,12,15,4,3,3,1,September,-1.0,-1.8369701987210287e-16,25,44,2,0,0,4.0,0.0,3,3,0,4,5,-1,"September, 2004"
2004-2005,5,2004-09-11,Man City,Everton,0,1,A,0,3,3,2,0,1,1,3,11,8,4,7,3,3,September,-1.0,-1.8369701987210287e-16,27,18,2,2,1,2.2,1.4,6,4,2,6,6,0,"September, 2004"
2004-2005,5,2004-09-11,Middlesbrough,Birmingham,2,1,H,3,0,2,3,0,2,1,2,8,13,7,4,5,3,September,-1.0,-1.8369701987210287e-16,29,3,2,0,2,1.75,2.25,9,8,1,2,3,-1,"September, 2004"
2004-2005,5,2004-09-11,Newcastle,Blackburn,3,0,H,3,0,1,3,1,0,3,2,17,19,2,2,2,0,September,-1.0,-1.8369701987210287e-16,30,4,1,2,2,2.0,2.0,6,9,-3,4,8,-4,"September, 2004"
2004-2005,5,2004-09-11,Portsmouth,Crystal Palace,3,1,H,3,0,1,1,3,1,3,1,13,20,4,1,7,3,September,-1.0,-1.8369701987210287e-16,33,16,0,0,0,0.0,0.0,6,6,0,3,8,-5,"September, 2004"
2004-2005,5,2004-09-12,Tottenham,Norwich,0,0,D,1,1,1,2,2,3,0,2,6,18,8,2,12,6,September,-1.0,-1.8369701987210287e-16,42,31,0,0,0,0.0,0.0,4,2,2,5,9,-4,"September, 2004"
2004-2005,5,2004-09-13,Charlton,Southampton,0,0,D,1,1,0,2,3,1,2,2,11,16,6,3,5,3,September,-1.0,-1.8369701987210287e-16,13,38,2,2,1,1.4,1.2,6,9,-3,5,8,-3,"September, 2004"
2004-2005,6,2004-09-18,Crystal Palace,Man City,1,2,A,0,3,1,3,1,3,2,0,20,15,1,4,5,3,September,-1.0,-1.8369701987210287e-16,16,27,0,0,0,0.0,0.0,4,11,-7,6,5,1,"September, 2004"
2004-2005,6,2004-09-18,Norwich,Aston Villa,0,0,D,1,1,3,0,2,0,2,3,18,7,3,8,11,5,September,-1.0,-1.8369701987210287e-16,31,1,0,0,0,0.0,0.0,5,9,-4,7,6,1,"September, 2004"
2004-2005,6,2004-09-18,West Brom,Fulham,1,1,D,1,1,1,2,2,3,0,2,19,17,3,4,2,1,September,-1.0,-1.8369701987210287e-16,44,19,1,0,1,0.5,1.5,4,8,-4,6,10,-4,"September, 2004"
2004-2005,6,2004-09-18,Blackburn,Portsmouth,1,0,H,3,0,0,3,2,1,1,3,19,10,2,7,9,5,September,-1.0,-1.8369701987210287e-16,4,33,1,0,1,1.5,1.5,4,11,-7,9,7,2,"September, 2004"
2004-2005,6,2004-09-18,Arsenal,Bolton,2,2,D,1,1,4,0,1,1,3,1,1,3,15,10,2,5,September,-1.0,-1.8369701987210287e-16,0,6,3,2,0,1.8,1.0,19,5,14,9,6,3,"September, 2004"
2004-2005,6,2004-09-18,Birmingham,Charlton,1,1,D,1,1,2,1,2,0,2,3,14,10,4,7,4,3,September,-1.0,-1.8369701987210287e-16,3,13,1,2,1,1.25,1.0,3,5,-2,6,9,-3,"September, 2004"
2004-2005,6,2004-09-19,Chelsea,Tottenham,0,0,D,1,1,4,1,0,1,2,2,2,6,13,9,4,4,September,-1.0,-1.8369701987210287e-16,14,42,3,2,0,2.0,0.6,6,1,5,4,2,2,"September, 2004"
2004-2005,6,2004-09-19,Everton,Middlesbrough,1,0,H,3,0,1,1,3,2,3,0,6,4,10,10,2,0,September,-1.0,-1.8369701987210287e-16,18,29,1,2,2,0.8,1.0,7,6,1,11,9,2,"September, 2004"
2004-2005,6,2004-09-19,Southampton,Newcastle,1,2,A,0,3,1,2,2,1,3,1,17,13,4,5,4,1,September,-1.0,-1.8369701987210287e-16,38,30,1,2,2,1.6,1.6,5,8,-3,9,9,0,"September, 2004"
2004-2005,6,2004-09-20,Man United,Liverpool,2,1,H,3,0,3,1,1,2,1,2,13,10,6,7,3,1,September,-1.0,-1.8369701987210287e-16,28,25,3,0,2,1.6,0.8,5,5,0,6,3,3,"September, 2004"
2004-2005,7,2004-09-25,Aston Villa,Crystal Palace,1,1,D,1,1,0,2,3,1,3,1,7,20,9,1,13,8,September,-1.0,-1.8369701987210287e-16,1,16,1,1,0,2.0,1.0,7,6,1,5,13,-8,"September, 2004"
2004-2005,7,2004-09-25,Bolton,Birmingham,1,1,D,1,1,1,3,1,2,1,2,4,14,11,5,10,6,September,-1.0,-1.8369701987210287e-16,6,3,1,0,3,1.25,2.0,11,8,3,4,6,-2,"September, 2004"
2004-2005,7,2004-09-25,Fulham,Southampton,1,0,H,3,0,3,0,2,1,2,2,15,17,5,4,2,1,September,-1.0,-1.8369701987210287e-16,19,38,1,3,1,1.4,1.4,7,11,-4,6,10,-4,"September, 2004"
2004-2005,7,2004-09-25,Liverpool,Norwich,3,0,H,3,0,2,1,2,3,0,2,13,17,7,4,4,3,September,-1.0,-1.8369701987210287e-16,25,31,0,0,0,0.0,0.0,7,5,2,5,9,-4,"September, 2004"
2004-2005,7,2004-09-25,Man City,Arsenal,0,1,A,0,3,3,2,0,4,0,1,13,1,7,16,12,9,September,-1.0,-1.8369701987210287e-16,27,0,0,0,5,0.8,3.0,8,6,2,21,7,14,"September, 2004"
2004-2005,7,2004-09-25,Middlesbrough,Chelsea,0,1,A,0,3,2,3,0,4,1,0,7,2,10,14,5,4,September,-1.0,-1.8369701987210287e-16,29,14,0,2,3,0.4,1.2,11,10,1,6,1,5,"September, 2004"
2004-2005,7,2004-09-25,Newcastle,West Brom,3,1,H,3,0,1,3,1,1,2,2,10,17,8,4,7,4,September,-1.0,-1.8369701987210287e-16,30,44,1,1,0,2.0,1.5,11,10,1,5,9,-4,"September, 2004"
2004-2005,7,2004-09-25,Tottenham,Man United,0,1,A,0,3,1,2,2,3,1,1,7,10,10,9,3,1,September,-1.0,-1.8369701987210287e-16,42,28,0,0,5,0.2,2.4,4,2,2,7,6,1,"September, 2004"
2004-2005,7,2004-09-26,Portsmouth,Everton,0,1,A,0,3,1,1,3,1,1,3,13,3,7,13,10,6,September,-1.0,-1.8369701987210287e-16,33,18,0,0,2,0.5,1.5,9,8,1,8,6,2,"September, 2004"
2004-2005,7,2004-09-27,Charlton,Blackburn,1,0,H,3,0,0,2,3,0,3,2,12,16,8,5,4,3,September,-1.0,-1.8369701987210287e-16,13,4,3,0,2,1.6,1.6,7,10,-3,5,11,-6,"September, 2004"
2004-2005,8,2004-10-02,Southampton,Man City,0,0,D,1,1,1,2,2,3,2,0,18,14,4,7,4,3,October,-0.8660254037844386,0.5,38,27,4,0,1,1.4,0.6,6,11,-5,8,7,1,"October, 2004"
2004-2005,8,2004-10-02,Norwich,Portsmouth,2,2,D,1,1,3,0,2,1,1,3,19,14,4,7,5,3,October,-0.8660254037844386,0.5,31,33,0,0,0,0.0,0.0,5,12,-7,9,9,0,"October, 2004"
2004-2005,8,2004-10-02,West Brom,Bolton,2,1,H,3,0,1,2,2,1,3,1,19,5,4,12,14,8,October,-0.8660254037844386,0.5,44,6,0,2,0,1.0,1.0,6,12,-6,12,9,3,"October, 2004"
2004-2005,8,2004-10-02,Blackburn,Aston Villa,2,2,D,1,1,0,3,2,0,2,3,16,9,5,10,7,5,October,-0.8660254037844386,0.5,4,1,2,1,2,1.0,1.0,5,12,-7,8,7,1,"October, 2004"
2004-2005,8,2004-10-02,Arsenal,Charlton,4,0,H,3,0,4,0,1,0,2,3,1,7,19,11,6,8,October,-0.8660254037844386,0.5,0,13,4,1,0,2.2,0.4,22,7,15,8,10,-2,"October, 2004"
2004-2005,8,2004-10-02,Everton,Tottenham,0,1,A,0,3,1,1,3,1,2,2,3,10,16,10,7,6,October,-0.8660254037844386,0.5,18,42,1,2,2,1.8,2.2,9,6,3,4,3,1,"October, 2004"
2004-2005,8,2004-10-03,Man United,Middlesbrough,1,1,D,1,1,3,1,1,2,3,0,7,11,12,10,4,2,October,-0.8660254037844386,0.5,28,29,2,0,3,1.0,1.4,8,6,2,11,11,0,"October, 2004"
2004-2005,8,2004-10-03,Birmingham,Newcastle,2,2,D,1,1,2,1,2,1,3,1,16,7,6,11,9,5,October,-0.8660254037844386,0.5,3,30,1,1,2,0.5,1.0,5,7,-2,14,11,3,"October, 2004"
2004-2005,8,2004-10-03,Chelsea,Liverpool,1,0,H,3,0,4,1,0,2,1,2,2,10,17,10,8,7,October,-0.8660254037844386,0.5,14,25,2,0,3,0.8,1.0,7,1,6,10,5,5,"October, 2004"
2004-2005,8,2004-10-04,Crystal Palace,Fulham,2,0,H,3,0,1,3,1,3,0,2,20,14,2,8,6,6,October,-0.8660254037844386,0.5,16,19,0,0,0,0.0,0.0,6,14,-8,8,11,-3,"October, 2004"
2004-2005,9,2004-10-16,West Brom,Norwich,0,0,D,1,1,1,2,2,3,0,2,16,20,7,5,4,2,October,-0.8660254037844386,0.5,44,31,0,0,0,0.0,0.0,8,13,-5,7,14,-7,"October, 2004"
2004-2005,9,2004-10-16,Man City,Chelsea,1,0,H,3,0,3,2,0,4,1,0,12,2,8,20,10,12,October,-0.8660254037844386,0.5,27,14,0,0,5,0.2,2.4,8,7,1,8,1,7,"October, 2004"
2004-2005,9,2004-10-16,Fulham,Liverpool,2,4,A,0,3,3,0,2,2,1,2,15,11,8,10,4,2,October,-0.8660254037844386,0.5,19,25,1,1,3,0.8,1.6,8,13,-5,10,6,4,"October, 2004"
2004-2005,9,2004-10-16,Everton,Southampton,1,0,H,3,0,1,1,3,1,2,2,3,18,16,5,15,11,October,-0.8660254037844386,0.5,18,38,2,2,1,1.2,1.0,9,7,2,6,11,-5,"October, 2004"
2004-2005,9,2004-10-16,Blackburn,Middlesbrough,0,4,A,0,3,0,3,2,2,3,0,17,8,6,11,9,5,October,-0.8660254037844386,0.5,4,29,3,1,1,1.4,0.8,7,14,-7,12,12,0,"October, 2004"
2004-2005,9,2004-10-16,Birmingham,Man United,0,0,D,1,1,2,1,2,3,1,1,15,4,7,13,11,6,October,-0.8660254037844386,0.5,3,28,0,0,4,0.25,2.0,7,9,-2,9,7,2,"October, 2004"
2004-2005,9,2004-10-16,Arsenal,Aston Villa,3,1,H,3,0,4,0,1,0,2,3,1,8,22,11,7,11,October,-0.8660254037844386,0.5,0,1,4,1,0,2.0,0.6,26,7,19,10,9,1,"October, 2004"
2004-2005,9,2004-10-16,Bolton,Crystal Palace,1,0,H,3,0,1,3,1,1,3,1,8,19,12,5,11,7,October,-0.8660254037844386,0.5,6,16,1,1,0,3.5,2.0,13,11,2,8,14,-6,"October, 2004"
2004-2005,9,2004-10-17,Charlton,Newcastle,1,1,D,1,1,0,2,3,1,3,1,12,9,11,12,3,1,October,-0.8660254037844386,0.5,13,30,0,1,4,0.4,2.0,8,14,-6,16,13,3,"October, 2004"
2004-2005,9,2004-10-18,Portsmouth,Tottenham,1,0,H,3,0,1,1,3,1,2,2,13,9,8,13,4,5,October,-0.8660254037844386,0.5,33,42,1,0,1,2.5,2.0,11,11,0,5,3,2,"October, 2004"
2004-2005,10,2004-10-23,Tottenham,Bolton,1,2,A,0,3,1,2,2,1,3,1,10,5,13,15,5,2,October,-0.8660254037844386,0.5,42,6,1,1,3,0.8,1.2,5,4,1,14,11,3,"October, 2004"
2004-2005,10,2004-10-23,Aston Villa,Fulham,2,0,H,3,0,0,2,3,3,0,2,13,16,11,8,3,3,October,-0.8660254037844386,0.5,1,19,3,1,1,1.8,0.8,11,12,-1,10,17,-7,"October, 2004"
2004-2005,10,2004-10-23,Chelsea,Blackburn,4,0,H,3,0,4,1,0,0,3,2,2,18,20,6,16,14,October,-0.8660254037844386,0.5,14,4,2,2,1,1.8,1.6,8,2,6,7,18,-11,"October, 2004"
2004-2005,10,2004-10-23,Crystal Palace,West Brom,3,0,H,3,0,1,3,1,1,2,2,20,15,5,8,5,3,October,-0.8660254037844386,0.5,16,44,0,0,0,0.0,0.0,8,15,-7,8,13,-5,"October, 2004"
2004-2005,10,2004-10-23,Liverpool,Charlton,2,0,H,3,0,2,1,2,0,2,3,8,11,13,12,3,1,October,-0.8660254037844386,0.5,25,13,2,0,3,1.2,1.4,14,8,6,9,15,-6,"October, 2004"
2004-2005,10,2004-10-23,Norwich,Everton,2,3,A,0,3,3,0,2,1,1,3,18,3,6,19,15,13,October,-0.8660254037844386,0.5,31,18,0,0,0,0.0,0.0,7,14,-7,10,7,3,"October, 2004"
2004-2005,11,2004-10-24,Southampton,Birmingham,0,0,D,1,1,1,2,2,2,1,2,20,14,5,8,6,3,October,-0.8660254037844386,0.5,38,3,1,1,2,1.25,1.25,6,12,-6,7,9,-2,"October, 2004"
2004-2005,10,2004-10-24,Newcastle,Man City,4,3,H,3,0,1,3,1,3,2,0,9,13,13,11,4,2,October,-0.8660254037844386,0.5,30,27,2,0,3,1.0,0.6,17,14,3,9,7,2,"October, 2004"
2004-2005,10,2004-10-24,Man United,Arsenal,2,0,H,3,0,3,1,1,4,0,1,7,1,14,25,6,11,October,-0.8660254037844386,0.5,28,0,1,3,1,1.0,0.8,9,7,2,29,8,21,"October, 2004"
2004-2005,10,2004-10-24,Middlesbrough,Portsmouth,1,1,D,1,1,2,3,0,1,1,3,7,13,14,11,6,3,October,-0.8660254037844386,0.5,29,33,0,1,1,0.5,2.5,16,12,4,12,11,1,"October, 2004"
2004-2005,11,2004-10-30,Arsenal,Southampton,2,2,D,1,1,4,0,1,1,2,2,1,18,25,6,17,19,October,-0.8660254037844386,0.5,0,38,3,1,1,2.4,1.0,29,10,19,6,12,-6,"October, 2004"
2004-2005,11,2004-10-30,Birmingham,Crystal Palace,0,1,A,0,3,2,1,2,1,3,1,14,15,9,8,1,1,October,-0.8660254037844386,0.5,3,16,0,0,0,0.0,0.0,7,9,-2,11,15,-4,"October, 2004"
2004-2005,11,2004-10-30,Blackburn,Liverpool,2,2,D,1,1,0,3,2,2,1,2,20,6,6,16,14,10,October,-0.8660254037844386,0.5,4,25,0,2,3,1.4,2.8,7,22,-15,16,8,8,"October, 2004"
2004-2005,11,2004-10-30,Charlton,Middlesbrough,1,2,A,0,3,0,2,3,2,3,0,12,8,12,15,4,3,October,-0.8660254037844386,0.5,13,29,2,3,0,0.6,0.2,9,17,-8,17,13,4,"October, 2004"
2004-2005,11,2004-10-30,Everton,Aston Villa,1,1,D,1,1,1,1,3,0,2,3,3,9,22,14,6,8,October,-0.8660254037844386,0.5,18,1,2,2,1,1.2,0.8,13,9,4,13,12,1,"October, 2004"
2004-2005,11,2004-10-30,Fulham,Tottenham,2,0,H,3,0,3,0,2,1,2,2,17,10,8,13,7,5,October,-0.8660254037844386,0.5,19,42,3,1,1,1.8,1.2,10,19,-9,6,6,0,"October, 2004"
2004-2005,11,2004-10-30,Portsmouth,Man United,2,0,H,3,0,1,1,3,3,1,1,11,7,12,17,4,5,October,-0.8660254037844386,0.5,33,28,1,0,1,0.5,1.5,13,12,1,11,7,4,"October, 2004"
2004-2005,11,2004-10-30,West Brom,Chelsea,1,4,A,0,3,1,2,2,4,1,0,17,2,8,23,15,15,October,-0.8660254037844386,0.5,44,14,0,0,2,0.0,2.0,8,16,-8,12,2,10,"October, 2004"
2004-2005,11,2004-10-31,Bolton,Newcastle,2,1,H,3,0,1,3,1,1,3,1,5,8,18,16,3,2,October,-0.8660254037844386,0.5,6,30,2,1,2,1.4,1.4,16,12,4,21,17,4,"October, 2004"
2004-2005,11,2004-11-01,Man City,Norwich,1,1,D,1,1,3,2,0,3,0,2,13,20,11,6,7,5,November,-0.5000000000000004,0.8660254037844384,27,31,0,0,0,0.0,0.0,12,11,1,9,17,-8,"November, 2004"
2004-2005,12,2004-11-06,Tottenham,Charlton,2,3,A,0,3,1,2,2,0,2,3,11,15,13,12,4,1,November,-0.5000000000000004,0.8660254037844384,42,13,2,1,2,1.4,1.2,6,8,-2,10,19,-9,"November, 2004"
2004-2005,12,2004-11-06,Southampton,West Brom,2,2,D,1,1,1,2,2,1,2,2,20,18,7,8,2,1,November,-0.5000000000000004,0.8660254037844384,38,44,1,0,1,0.5,0.5,8,14,-6,9,20,-11,"November, 2004"
2004-2005,12,2004-11-06,Norwich,Blackburn,1,1,D,1,1,3,0,2,0,3,2,19,20,7,7,1,0,November,-0.5000000000000004,0.8660254037844384,31,4,0,0,0,0.0,0.0,10,18,-8,9,24,-15,"November, 2004"
2004-2005,12,2004-11-06,Aston Villa,Portsmouth,3,0,H,3,0,0,2,3,1,1,3,10,9,15,15,1,0,November,-0.5000000000000004,0.8660254037844384,1,33,1,0,1,1.5,1.5,14,13,1,15,12,3,"November, 2004"
2004-2005,12,2004-11-06,Crystal Palace,Arsenal,1,1,D,1,1,1,3,1,4,0,1,14,2,11,26,12,15,November,-0.5000000000000004,0.8660254037844384,16,0,0,1,1,0.0,0.5,12,15,-3,31,12,19,"November, 2004"
2004-2005,12,2004-11-06,Chelsea,Everton,1,0,H,3,0,4,1,0,1,1,3,2,3,26,23,1,3,November,-0.5000000000000004,0.8660254037844384,14,18,4,1,0,2.2,0.4,16,3,13,14,10,4,"November, 2004"
2004-2005,12,2004-11-06,Liverpool,Birmingham,0,1,A,0,3,2,1,2,2,1,2,7,16,17,9,9,8,November,-0.5000000000000004,0.8660254037844384,25,3,2,1,1,2.25,1.25,18,10,8,7,10,-3,"November, 2004"
2004-2005,12,2004-11-07,Man United,Man City,0,0,D,1,1,3,1,1,3,2,0,8,13,17,12,5,5,November,-0.5000000000000004,0.8660254037844384,28,27,1,2,2,1.4,2.0,11,9,2,13,12,1,"November, 2004"
2004-2005,12,2004-11-07,Middlesbrough,Bolton,1,1,D,1,1,2,3,0,1,3,1,5,4,18,21,1,3,November,-0.5000000000000004,0.8660254037844384,29,6,2,1,2,1.2,1.0,19,14,5,18,13,5,"November, 2004"
2004-2005,12,2004-11-07,Newcastle,Fulham,1,4,A,0,3,1,3,1,3,0,2,9,16,16,11,7,5,November,-0.5000000000000004,0.8660254037844384,30,19,3,1,1,2.0,1.2,22,19,3,12,19,-7,"November, 2004"
2004-2005,13,2004-11-13,Man City,Blackburn,1,1,D,1,1,3,2,0,0,3,2,13,20,13,8,7,5,November,-0.5000000000000004,0.8660254037844384,27,4,1,3,1,1.4,1.4,13,12,1,10,25,-15,"November, 2004"
2004-2005,13,2004-11-13,Tottenham,Arsenal,4,5,A,0,3,1,2,2,4,0,1,14,2,13,27,12,14,November,-0.5000000000000004,0.8660254037844384,42,0,0,2,3,1.0,2.0,8,11,-3,32,13,19,"November, 2004"
2004-2005,13,2004-11-13,Southampton,Portsmouth,2,1,H,3,0,1,2,2,1,1,3,19,11,8,15,8,7,November,-0.5000000000000004,0.8660254037844384,38,33,1,0,1,1.5,0.5,10,16,-6,15,15,0,"November, 2004"
2004-2005,13,2004-11-13,Liverpool,Crystal Palace,3,2,H,3,0,2,1,2,1,3,1,9,15,17,12,6,5,November,-0.5000000000000004,0.8660254037844384,25,16,2,0,0,2.5,0.5,18,11,7,13,16,-3,"November, 2004"
2004-2005,13,2004-11-13,Birmingham,Everton,0,1,A,0,3,2,1,2,1,1,3,15,3,12,23,12,11,November,-0.5000000000000004,0.8660254037844384,3,18,1,2,1,1.25,0.75,8,10,-2,14,11,3,"November, 2004"
2004-2005,13,2004-11-13,Charlton,Norwich,4,0,H,3,0,0,2,3,3,0,2,11,19,15,8,8,7,November,-0.5000000000000004,0.8660254037844384,13,31,0,0,0,0.0,0.0,13,21,-8,11,19,-8,"November, 2004"
2004-2005,13,2004-11-13,Bolton,Aston Villa,1,2,A,0,3,1,3,1,0,2,3,4,6,22,18,2,4,November,-0.5000000000000004,0.8660254037844384,6,1,2,2,1,1.4,1.4,19,14,5,17,13,4,"November, 2004"
2004-2005,13,2004-11-13,Fulham,Chelsea,1,4,A,0,3,3,0,2,4,1,0,12,1,14,29,11,15,November,-0.5000000000000004,0.8660254037844384,19,14,0,2,3,0.8,1.4,16,20,-4,17,3,14,"November, 2004"
2004-2005,13,2004-11-14,Newcastle,Man United,1,3,A,0,3,1,3,1,3,1,1,10,8,16,18,2,2,November,-0.5000000000000004,0.8660254037844384,30,28,0,1,4,1.4,3.2,23,23,0,11,9,2,"November, 2004"
2004-2005,13,2004-11-14,West Brom,Middlesbrough,1,2,A,0,3,1,2,2,2,3,0,18,8,9,19,10,10,November,-0.5000000000000004,0.8660254037844384,44,29,1,0,1,0.5,1.5,11,22,-11,20,15,5,"November, 2004"
2004-2005,14,2004-11-20,Portsmouth,Man City,1,3,A,0,3,1,1,3,3,2,0,11,12,15,14,1,1,November,-0.5000000000000004,0.8660254037844384,33,27,1,1,0,2.5,1.5,16,17,-1,14,13,1,"November, 2004"
2004-2005,14,2004-11-20,Norwich,Southampton,2,1,H,3,0,3,0,2,1,2,2,20,17,8,11,3,3,November,-0.5000000000000004,0.8660254037844384,31,38,0,0,0,0.0,0.0,11,23,-12,12,17,-5,"November, 2004"
2004-2005,14,2004-11-20,Middlesbrough,Liverpool,2,0,H,3,0,2,3,0,2,1,2,6,8,22,20,2,2,November,-0.5000000000000004,0.8660254037844384,29,25,1,2,2,0.6,1.0,22,16,6,21,13,8,"November, 2004"
2004-2005,14,2004-11-20,Man United,Charlton,2,0,H,3,0,3,1,1,0,2,3,7,10,21,18,3,3,November,-0.5000000000000004,0.8660254037844384,28,13,4,1,0,2.2,0.4,14,10,4,17,21,-4,"November, 2004"
2004-2005,14,2004-11-20,Everton,Fulham,1,0,H,3,0,1,1,3,3,0,2,3,13,26,14,10,12,November,-0.5000000000000004,0.8660254037844384,18,19,3,0,2,1.6,1.2,15,11,4,17,24,-7,"November, 2004"
2004-2005,14,2004-11-20,Chelsea,Bolton,2,2,D,1,1,4,1,0,1,3,1,1,5,32,22,4,10,November,-0.5000000000000004,0.8660254037844384,14,6,2,2,1,1.4,1.0,21,4,17,20,16,4,"November, 2004"
2004-2005,14,2004-11-20,Arsenal,West Brom,1,1,D,1,1,4,0,1,1,2,2,2,18,30,9,16,21,November,-0.5000000000000004,0.8660254037844384,0,44,2,0,0,3.5,1.5,37,17,20,12,24,-12,"November, 2004"
2004-2005,14,2004-11-20,Crystal Palace,Newcastle,0,2,A,0,3,1,3,1,1,3,1,16,10,12,16,6,4,November,-0.5000000000000004,0.8660254037844384,16,30,1,0,1,1.5,1.5,15,19,-4,24,26,-2,"November, 2004"
2004-2005,14,2004-11-21,Blackburn,Birmingham,3,3,D,1,1,0,3,2,2,1,2,20,15,9,12,5,3,November,-0.5000000000000004,0.8660254037844384,4,3,2,2,0,1.75,0.5,11,26,-15,8,11,-3,"November, 2004"
2004-2005,14,2004-11-22,Aston Villa,Tottenham,1,0,H,3,0,0,2,3,1,2,2,7,15,21,13,8,8,November,-0.5000000000000004,0.8660254037844384,1,42,1,1,3,0.6,1.0,19,14,5,12,16,-4,"November, 2004"
2004-2005,15,2004-11-27,Southampton,Crystal Palace,2,2,D,1,1,1,2,2,1,3,1,19,17,11,12,2,1,November,-0.5000000000000004,0.8660254037844384,38,16,1,1,0,1.0,0.5,13,19,-6,15,21,-6,"November, 2004"
2004-2005,15,2004-11-27,West Brom,Man United,0,3,A,0,3,1,2,2,3,1,1,20,5,10,24,15,14,November,-0.5000000000000004,0.8660254037844384,44,28,0,0,2,0.5,2.0,13,25,-12,16,10,6,"November, 2004"
2004-2005,15,2004-11-27,Man City,Aston Villa,2,0,H,3,0,3,2,0,0,2,3,12,5,17,24,7,7,November,-0.5000000000000004,0.8660254037844384,27,1,2,1,2,1.8,1.4,17,14,3,20,14,6,"November, 2004"
2004-2005,15,2004-11-27,Bolton,Portsmouth,0,1,A,0,3,1,3,1,1,1,3,7,12,23,15,5,8,November,-0.5000000000000004,0.8660254037844384,6,33,1,0,1,0.5,2.0,22,18,4,17,20,-3,"November, 2004"
2004-2005,15,2004-11-27,Charlton,Chelsea,0,4,A,0,3,0,2,3,4,1,0,11,1,18,33,10,15,November,-0.5000000000000004,0.8660254037844384,13,14,2,0,3,1.8,2.2,17,23,-6,23,6,17,"November, 2004"
2004-2005,15,2004-11-27,Fulham,Blackburn,0,2,A,0,3,3,0,2,0,3,2,14,20,14,10,6,4,November,-0.5000000000000004,0.8660254037844384,19,4,1,0,4,1.2,2.6,17,25,-8,14,29,-15,"November, 2004"
2004-2005,15,2004-11-27,Birmingham,Norwich,1,1,D,1,1,2,1,2,3,0,2,14,18,13,11,4,2,November,-0.5000000000000004,0.8660254037844384,3,31,0,0,0,0.0,0.0,11,14,-3,13,24,-11,"November, 2004"
2004-2005,15,2004-11-28,Liverpool,Arsenal,2,1,H,3,0,2,1,2,4,0,1,8,2,20,31,6,11,November,-0.5000000000000004,0.8660254037844384,25,0,0,3,2,1.4,2.0,21,15,6,38,18,20,"November, 2004"
2004-2005,15,2004-11-28,Newcastle,Everton,1,1,D,1,1,1,3,1,1,1,3,10,3,19,29,7,10,November,-0.5000000000000004,0.8660254037844384,30,18,3,1,1,3.0,1.8,26,26,0,16,11,5,"November, 2004"
2004-2005,15,2004-11-28,Tottenham,Middlesbrough,2,0,H,3,0,1,2,2,2,3,0,15,5,13,25,10,12,November,-0.5000000000000004,0.8660254037844384,42,29,0,2,3,0.4,2.0,12,17,-5,24,16,8,"November, 2004"
2004-2005,16,2004-12-04,Portsmouth,West Brom,3,2,H,3,0,1,1,3,1,2,2,12,20,18,10,8,8,December,-2.4492935982947064e-16,1.0,33,44,0,0,0,0.0,0.0,18,20,-2,13,28,-15,"December, 2004"
2004-2005,16,2004-12-04,Norwich,Fulham,0,1,A,0,3,3,0,2,3,0,2,19,15,12,14,4,2,December,-2.4492935982947064e-16,1.0,31,19,0,0,0,0.0,0.0,14,25,-11,17,27,-10,"December, 2004"
2004-2005,16,2004-12-04,Man United,Southampton,3,0,H,3,0,3,1,1,1,2,2,4,18,27,12,14,15,December,-2.4492935982947064e-16,1.0,28,38,4,0,1,2.0,1.0,19,10,9,15,21,-6,"December, 2004"
2004-2005,16,2004-12-04,Everton,Bolton,3,2,H,3,0,1,1,3,1,3,1,3,8,30,23,5,7,December,-2.4492935982947064e-16,1.0,18,6,2,1,2,1.2,1.2,17,12,5,22,19,3,"December, 2004"
2004-2005,16,2004-12-04,Chelsea,Newcastle,4,0,H,3,0,4,1,0,1,3,1,1,10,36,20,9,16,December,-2.4492935982947064e-16,1.0,14,30,3,0,2,2.4,1.0,27,6,21,27,27,0,"December, 2004"
2004-2005,16,2004-12-04,Blackburn,Tottenham,0,1,A,0,3,0,3,2,1,2,2,17,13,13,16,4,3,December,-2.4492935982947064e-16,1.0,4,42,2,0,3,1.2,0.8,16,29,-13,14,17,-3,"December, 2004"
2004-2005,16,2004-12-04,Aston Villa,Liverpool,1,1,D,1,1,0,2,3,2,1,2,6,7,24,23,1,1,December,-2.4492935982947064e-16,1.0,1,25,0,2,3,0.4,1.0,20,16,4,23,16,7,"December, 2004"
2004-2005,16,2004-12-04,Arsenal,Birmingham,3,0,H,3,0,4,0,1,2,1,2,2,14,31,14,12,17,December,-2.4492935982947064e-16,1.0,0,3,3,1,0,2.25,0.0,39,20,19,12,15,-3,"December, 2004"
2004-2005,16,2004-12-05,Crystal Palace,Charlton,0,1,A,0,3,1,3,1,0,2,3,16,13,13,18,3,5,December,-2.4492935982947064e-16,1.0,16,13,0,0,0,0.0,0.0,17,23,-6,17,27,-10,"December, 2004"
2004-2005,16,2004-12-06,Middlesbrough,Man City,3,2,H,3,0,2,3,0,3,2,0,5,11,25,20,6,5,December,-2.4492935982947064e-16,1.0,29,27,3,2,0,1.4,0.6,24,18,6,19,14,5,"December, 2004"
2004-2005,17,2004-12-11,West Brom,Charlton,0,1,A,0,3,1,2,2,0,2,3,20,12,10,21,8,11,December,-2.4492935982947064e-16,1.0,44,13,0,0,2,0.0,1.0,15,31,-16,18,27,-9,"December, 2004"
2004-2005,17,2004-12-11,Southampton,Middlesbrough,2,2,D,1,1,1,2,2,2,3,0,19,5,12,28,14,16,December,-2.4492935982947064e-16,1.0,38,29,0,3,2,0.8,1.4,15,24,-9,27,20,7,"December, 2004"
2004-2005,17,2004-12-11,Newcastle,Portsmouth,1,1,D,1,1,1,3,1,1,1,3,13,10,20,21,3,1,December,-2.4492935982947064e-16,1.0,30,33,1,1,0,2.0,0.5,27,31,-4,21,22,-1,"December, 2004"
2004-2005,17,2004-12-11,Norwich,Bolton,3,2,H,3,0,3,0,2,1,3,1,19,8,12,23,11,11,December,-2.4492935982947064e-16,1.0,31,6,0,0,0,0.0,0.0,14,26,-12,24,22,2,"December, 2004"
2004-2005,17,2004-12-11,Everton,Liverpool,1,0,H,3,0,1,1,3,2,1,2,3,7,33,24,4,9,December,-2.4492935982947064e-16,1.0,18,25,0,3,2,0.4,1.2,20,14,6,24,17,7,"December, 2004"
2004-2005,17,2004-12-11,Crystal Palace,Blackburn,0,0,D,1,1,1,3,1,0,3,2,16,17,13,13,1,0,December,-2.4492935982947064e-16,1.0,16,4,0,1,1,1.5,2.0,17,24,-7,16,30,-14,"December, 2004"
2004-2005,17,2004-12-11,Man City,Tottenham,0,1,A,0,3,3,2,0,1,2,2,11,13,20,19,2,1,December,-2.4492935982947064e-16,1.0,27,42,1,2,2,1.0,1.0,21,17,4,15,17,-2,"December, 2004"
2004-2005,17,2004-12-12,Arsenal,Chelsea,2,2,D,1,1,4,0,1,4,1,0,3,1,34,39,2,5,December,-2.4492935982947064e-16,1.0,0,14,4,1,0,2.0,1.2,42,20,22,31,6,25,"December, 2004"
2004-2005,17,2004-12-12,Aston Villa,Birmingham,1,2,A,0,3,0,2,3,2,1,2,6,16,25,14,10,11,December,-2.4492935982947064e-16,1.0,1,3,0,2,2,0.5,1.75,21,17,4,12,18,-6,"December, 2004"
2004-2005,17,2004-12-13,Fulham,Man United,1,1,D,1,1,3,0,2,3,1,1,15,4,17,30,11,13,December,-2.4492935982947064e-16,1.0,19,28,1,2,2,1.4,1.8,18,27,-9,22,10,12,"December, 2004"
2004-2005,17,2004-12-14,Liverpool,Portsmouth,1,1,D,1,1,2,1,2,1,1,3,7,10,24,22,3,2,December,-2.4492935982947064e-16,1.0,25,33,1,0,1,1.5,0.5,24,18,6,22,23,-1,"December, 2004"
2004-2005,18,2004-12-18,Chelsea,Norwich,4,0,H,3,0,4,1,0,3,0,2,1,16,40,15,15,25,December,-2.4492935982947064e-16,1.0,14,31,0,0,0,0.0,0.0,33,8,25,17,28,-11,"December, 2004"
2004-2005,18,2004-12-18,Tottenham,Southampton,5,1,H,3,0,1,2,2,1,2,2,12,19,22,13,7,9,December,-2.4492935982947064e-16,1.0,42,38,1,0,4,0.6,1.4,16,17,-1,17,26,-9,"December, 2004"
2004-2005,18,2004-12-18,Middlesbrough,Aston Villa,3,0,H,3,0,2,3,0,0,2,3,5,7,29,25,2,4,December,-2.4492935982947064e-16,1.0,29,1,2,0,3,1.4,1.8,29,22,7,22,19,3,"December, 2004"
2004-2005,18,2004-12-18,Man United,Crystal Palace,5,2,H,3,0,3,1,1,1,3,1,4,18,31,14,14,17,December,-2.4492935982947064e-16,1.0,28,16,2,0,0,2.5,0.0,23,11,12,17,24,-7,"December, 2004"
2004-2005,18,2004-12-18,Blackburn,Everton,0,0,D,1,1,0,3,2,1,1,3,18,2,14,36,16,22,December,-2.4492935982947064e-16,1.0,4,18,3,0,2,1.2,1.0,16,30,-14,21,14,7,"December, 2004"
2004-2005,18,2004-12-18,Birmingham,West Brom,4,0,H,3,0,2,1,2,1,2,2,15,20,17,10,5,7,December,-2.4492935982947064e-16,1.0,3,44,1,1,0,1.0,0.5,14,19,-5,15,32,-17,"December, 2004"
2004-2005,18,2004-12-18,Bolton,Man City,0,1,A,0,3,1,3,1,3,2,0,9,13,23,20,4,3,December,-2.4492935982947064e-16,1.0,6,27,1,1,3,1.2,2.4,26,25,1,21,18,3,"December, 2004"
2004-2005,18,2004-12-19,Liverpool,Newcastle,3,1,H,3,0,2,1,2,1,3,1,6,13,25,21,7,4,December,-2.4492935982947064e-16,1.0,25,30,1,3,1,1.4,1.0,25,19,6,28,32,-4,"December, 2004"
2004-2005,18,2004-12-19,Portsmouth,Arsenal,0,1,A,0,3,1,1,3,4,0,1,12,3,23,35,9,12,December,-2.4492935982947064e-16,1.0,33,0,0,2,0,1.0,1.0,23,24,-1,44,22,22,"December, 2004"
2004-2005,18,2004-12-20,Charlton,Fulham,2,1,H,3,0,0,2,3,3,0,2,9,15,24,18,6,6,December,-2.4492935982947064e-16,1.0,13,19,1,1,3,0.6,1.0,19,27,-8,19,28,-9,"December, 2004"
2004-2005,19,2004-12-26,Norwich,Tottenham,0,2,A,0,3,3,0,2,1,2,2,17,9,15,25,8,10,December,-2.4492935982947064e-16,1.0,31,42,0,1,0,0.0,0.0,17,32,-15,21,18,3,"December, 2004"
2004-2005,19,2004-12-26,Man United,Bolton,2,0,H,3,0,3,1,1,1,3,1,4,13,34,23,9,11,December,-2.4492935982947064e-16,1.0,28,6,2,2,1,1.8,1.0,28,13,15,26,26,0,"December, 2004"
2004-2005,19,2004-12-26,West Brom,Liverpool,0,5,A,0,3,1,2,2,2,1,2,20,6,10,28,14,18,December,-2.4492935982947064e-16,1.0,44,25,0,0,3,0.0,3.6666666666666665,15,36,-21,28,20,8,"December, 2004"
2004-2005,19,2004-12-26,Everton,Man City,2,1,H,3,0,1,1,3,3,2,0,3,11,37,23,8,14,December,-2.4492935982947064e-16,1.0,18,27,1,2,2,1.0,2.0,21,14,7,22,18,4,"December, 2004"
2004-2005,19,2004-12-26,Southampton,Charlton,0,0,D,1,1,1,2,2,0,2,3,19,8,13,27,11,14,December,-2.4492935982947064e-16,1.0,38,13,1,2,2,1.0,1.2,18,31,-13,21,28,-7,"December, 2004"
2004-2005,19,2004-12-26,Chelsea,Aston Villa,1,0,H,3,0,4,1,0,0,2,3,1,9,43,25,8,18,December,-2.4492935982947064e-16,1.0,14,1,2,1,2,1.2,1.0,37,8,29,22,22,0,"December, 2004"
2004-2005,19,2004-12-26,Blackburn,Newcastle,2,2,D,1,1,0,3,2,1,3,1,16,14,15,21,2,6,December,-2.4492935982947064e-16,1.0,4,30,2,1,2,1.6,2.2,16,30,-14,29,35,-6,"December, 2004"
2004-2005,19,2004-12-26,Birmingham,Middlesbrough,2,0,H,3,0,2,1,2,2,3,0,14,5,20,32,9,12,December,-2.4492935982947064e-16,1.0,3,29,2,0,3,2.0,1.8,18,19,-1,32,22,10,"December, 2004"
2004-2005,19,2004-12-26,Arsenal,Fulham,2,0,H,3,0,4,0,1,3,0,2,2,15,38,18,13,20,December,-2.4492935982947064e-16,1.0,0,19,4,1,0,1.4,0.2,45,22,23,20,30,-10,"December, 2004"
2004-2005,19,2004-12-26,Crystal Palace,Portsmouth,0,1,A,0,3,1,3,1,1,1,3,18,13,14,23,5,9,December,-2.4492935982947064e-16,1.0,16,33,0,0,1,1.0,3.0,19,29,-10,23,25,-2,"December, 2004"
2004-2005,20,2004-12-28,Tottenham,Crystal Palace,1,1,D,1,1,1,2,2,1,3,1,8,18,28,14,10,14,December,-2.4492935982947064e-16,1.0,42,16,1,0,1,1.5,1.0,23,18,5,19,30,-11,"December, 2004"
2004-2005,20,2004-12-28,Portsmouth,Chelsea,0,2,A,0,3,1,1,3,4,1,0,10,1,26,46,9,20,December,-2.4492935982947064e-16,1.0,33,14,0,0,2,0.0,2.5,24,25,-1,38,8,30,"December, 2004"
2004-2005,20,2004-12-28,Middlesbrough,Norwich,2,0,H,3,0,2,3,0,3,0,2,6,17,32,15,11,17,December,-2.4492935982947064e-16,1.0,29,31,0,0,0,0.0,0.0,32,24,8,17,34,-17,"December, 2004"
2004-2005,20,2004-12-28,Man City,West Brom,1,1,D,1,1,3,2,0,1,2,2,12,20,23,10,8,13,December,-2.4492935982947064e-16,1.0,27,44,1,0,1,1.5,1.5,23,20,3,15,41,-26,"December, 2004"
2004-2005,20,2004-12-28,Liverpool,Southampton,1,0,H,3,0,2,1,2,1,2,2,6,19,31,14,13,17,December,-2.4492935982947064e-16,1.0,25,38,2,1,2,1.2,1.0,33,20,13,18,31,-13,"December, 2004"
2004-2005,20,2004-12-28,Fulham,Birmingham,2,3,A,0,3,3,0,2,2,1,2,16,12,18,23,4,5,December,-2.4492935982947064e-16,1.0,19,3,0,3,1,0.5,0.75,20,32,-12,20,19,1,"December, 2004"
2004-2005,20,2004-12-28,Charlton,Everton,2,0,H,3,0,0,2,3,1,1,3,8,4,28,40,4,12,December,-2.4492935982947064e-16,1.0,13,18,3,1,1,1.6,0.8,21,28,-7,23,15,8,"December, 2004"
2004-2005,20,2004-12-28,Bolton,Blackburn,0,1,A,0,3,1,3,1,0,3,2,13,16,23,16,3,7,December,-2.4492935982947064e-16,1.0,6,4,1,4,0,1.6,1.4,26,28,-2,18,32,-14,"December, 2004"
2004-2005,20,2004-12-28,Aston Villa,Man United,0,1,A,0,3,0,2,3,3,1,1,10,4,25,37,6,12,December,-2.4492935982947064e-16,1.0,1,28,0,1,4,0.2,1.8,22,23,-1,30,13,17,"December, 2004"
2004-2005,20,2004-12-29,Newcastle,Arsenal,0,1,A,0,3,1,3,1,4,0,1,14,2,22,41,12,19,December,-2.4492935982947064e-16,1.0,30,0,0,2,3,0.6,1.4,31,37,-6,47,22,25,"December, 2004"
2004-2005,21,2005-01-01,Portsmouth,Norwich,1,1,D,1,1,1,1,3,3,0,2,12,18,26,15,6,11,January,0.4999999999999999,0.8660254037844387,33,31,0,1,0,2.0,2.0,24,27,-3,17,36,-19,"January, 2005"
2004-2005,21,2005-01-01,Newcastle,Birmingham,2,1,H,3,0,1,3,1,2,1,2,14,11,22,26,3,4,January,0.4999999999999999,0.8660254037844387,30,3,2,2,1,1.2,0.8,31,38,-7,23,21,2,"January, 2005"
2004-2005,21,2005-01-01,Middlesbrough,Man United,0,2,A,0,3,2,3,0,3,1,1,5,3,35,40,2,5,January,0.4999999999999999,0.8660254037844387,29,28,2,1,2,1.4,1.2,34,24,10,31,13,18,"January, 2005"
2004-2005,21,2005-01-01,Man City,Southampton,2,1,H,3,0,3,2,0,1,2,2,12,19,24,14,7,10,January,0.4999999999999999,0.8660254037844387,27,38,1,1,3,0.6,1.2,24,21,3,18,32,-14,"January, 2005"
2004-2005,21,2005-01-01,Tottenham,Everton,5,2,H,3,0,1,2,2,1,1,3,8,4,29,40,4,11,January,0.4999999999999999,0.8660254037844387,42,18,3,1,1,2.2,1.6,24,19,5,23,17,6,"January, 2005"
2004-2005,21,2005-01-01,Fulham,Crystal Palace,3,1,H,3,0,3,0,2,1,3,1,16,17,18,15,1,3,January,0.4999999999999999,0.8660254037844387,19,16,0,0,1,0.0,2.0,22,35,-13,20,31,-11,"January, 2005"
2004-2005,21,2005-01-01,Charlton,Arsenal,1,3,A,0,3,0,2,3,4,0,1,7,2,31,44,5,13,January,0.4999999999999999,0.8660254037844387,13,0,0,1,4,0.4,2.4,23,28,-5,48,22,26,"January, 2005"
2004-2005,21,2005-01-01,Bolton,West Brom,1,1,D,1,1,1,3,1,1,2,2,13,20,23,11,7,12,January,0.4999999999999999,0.8660254037844387,6,44,0,2,1,1.0,1.3333333333333333,26,29,-3,16,42,-26,"January, 2005"
2004-2005,21,2005-01-01,Aston Villa,Blackburn,1,0,H,3,0,0,2,3,0,3,2,11,15,25,19,4,6,January,0.4999999999999999,0.8660254037844387,1,4,2,2,1,1.4,0.8,22,24,-2,19,32,-13,"January, 2005"
2004-2005,21,2005-01-01,Liverpool,Chelsea,0,1,A,0,3,2,1,2,4,1,0,6,1,34,49,5,15,January,0.4999999999999999,0.8660254037844387,25,14,2,0,3,0.8,1.0,34,20,14,40,8,32,"January, 2005"
2004-2005,22,2005-01-03,Blackburn,Charlton,1,0,H,3,0,0,3,2,0,2,3,16,8,19,31,8,12,January,0.4999999999999999,0.8660254037844387,4,13,1,0,4,0.8,1.6,19,33,-14,24,31,-7,"January, 2005"
2004-2005,22,2005-01-03,Crystal Palace,Aston Villa,2,0,H,3,0,1,3,1,0,2,3,18,9,15,28,9,13,January,0.4999999999999999,0.8660254037844387,16,1,0,2,1,1.0,1.6666666666666667,21,34,-13,23,24,-1,"January, 2005"
2004-2005,22,2005-01-03,Norwich,Liverpool,1,2,A,0,3,3,0,2,2,1,2,18,6,16,34,12,18,January,0.4999999999999999,0.8660254037844387,31,25,0,0,1,0.0,3.0,18,37,-19,34,21,13,"January, 2005"
2004-2005,22,2005-01-03,West Brom,Newcastle,0,0,D,1,1,1,2,2,1,3,1,20,13,12,25,7,13,January,0.4999999999999999,0.8660254037844387,44,30,0,1,2,1.3333333333333333,2.333333333333333,17,43,-26,33,39,-6,"January, 2005"
2004-2005,22,2005-01-04,Arsenal,Man City,1,1,D,1,1,4,0,1,3,2,0,2,10,47,27,8,20,January,0.4999999999999999,0.8660254037844387,0,27,5,0,0,2.4,0.8,51,23,28,26,22,4,"January, 2005"
2004-2005,22,2005-01-04,Birmingham,Bolton,1,2,A,0,3,2,1,2,1,3,1,12,14,26,24,2,2,January,0.4999999999999999,0.8660254037844387,3,6,3,1,1,1.8,1.2,24,23,1,27,30,-3,"January, 2005"
2004-2005,22,2005-01-04,Chelsea,Middlesbrough,2,0,H,3,0,4,1,0,2,3,0,1,6,52,35,5,17,January,0.4999999999999999,0.8660254037844387,14,29,3,2,0,1.0,0.4,41,8,33,34,26,8,"January, 2005"
2004-2005,22,2005-01-04,Everton,Portsmouth,2,1,H,3,0,1,1,3,1,1,3,4,12,40,27,8,13,January,0.4999999999999999,0.8660254037844387,18,33,3,0,0,1.3333333333333333,0.3333333333333333,25,22,3,25,28,-3,"January, 2005"
2004-2005,22,2005-01-04,Man United,Tottenham,0,0,D,1,1,3,1,1,1,2,2,3,7,43,32,4,11,January,0.4999999999999999,0.8660254037844387,28,42,5,0,0,1.8,0.2,33,13,20,29,21,8,"January, 2005"
2004-2005,22,2005-01-05,Southampton,Fulham,3,3,D,1,1,1,2,2,3,0,2,19,16,14,21,3,7,January,0.4999999999999999,0.8660254037844387,38,19,1,2,2,1.2,1.4,19,34,-15,25,36,-11,"January, 2005"
2004-2005,23,2005-01-15,Aston Villa,Norwich,3,0,H,3,0,0,2,3,3,0,2,10,18,28,16,8,12,January,0.4999999999999999,0.8660254037844387,1,31,0,1,0,0.0,0.0,23,26,-3,19,39,-20,"January, 2005"
2004-2005,23,2005-01-15,Bolton,Arsenal,1,0,H,3,0,1,3,1,4,0,1,11,2,27,48,9,21,January,0.4999999999999999,0.8660254037844387,6,0,0,3,2,1.4,1.8,29,31,-2,52,24,28,"January, 2005"
2004-2005,23,2005-01-15,Charlton,Birmingham,3,1,H,3,0,0,2,3,2,1,2,9,13,31,26,4,5,January,0.4999999999999999,0.8660254037844387,13,3,1,3,1,1.0,1.2,24,32,-8,25,25,0,"January, 2005"
2004-2005,23,2005-01-15,Liverpool,Man United,0,1,A,0,3,2,1,2,3,1,1,5,3,37,44,2,7,January,0.4999999999999999,0.8660254037844387,25,28,1,0,4,0.8,2.0,36,22,14,33,13,20,"January, 2005"
2004-2005,23,2005-01-15,Man City,Crystal Palace,3,1,H,3,0,3,2,0,1,3,1,11,17,28,18,6,10,January,0.4999999999999999,0.8660254037844387,27,16,1,0,0,2.0,1.0,27,23,4,23,34,-11,"January, 2005"
2004-2005,23,2005-01-15,Newcastle,Southampton,2,1,H,3,0,1,3,1,1,2,2,14,19,26,15,5,11,January,0.4999999999999999,0.8660254037844387,30,38,3,2,0,1.8,1.2,33,39,-6,22,37,-15,"January, 2005"
2004-2005,23,2005-01-15,Portsmouth,Blackburn,0,1,A,0,3,1,1,3,0,3,2,13,16,27,22,3,5,January,0.4999999999999999,0.8660254037844387,33,4,1,0,2,1.0,1.3333333333333333,26,30,-4,20,33,-13,"January, 2005"
2004-2005,23,2005-01-15,Tottenham,Chelsea,0,2,A,0,3,1,2,2,4,1,0,8,1,33,55,7,22,January,0.4999999999999999,0.8660254037844387,42,14,0,3,2,0.6,1.2,29,21,8,43,8,35,"January, 2005"
2004-2005,23,2005-01-16,Fulham,West Brom,1,0,H,3,0,3,0,2,1,2,2,16,20,22,13,4,9,January,0.4999999999999999,0.8660254037844387,19,44,1,1,1,1.3333333333333333,0.6666666666666666,28,39,-11,17,43,-26,"January, 2005"
2004-2005,23,2005-01-16,Middlesbrough,Everton,1,1,D,1,1,2,3,0,1,1,3,6,4,35,43,2,8,January,0.4999999999999999,0.8660254037844387,29,18,1,2,2,0.8,1.0,34,28,6,27,23,4,"January, 2005"
2004-2005,24,2005-01-22,Southampton,Liverpool,2,0,H,3,0,1,2,2,2,1,2,19,5,15,37,14,22,January,0.4999999999999999,0.8660254037844387,38,25,2,0,3,0.8,1.2,23,39,-16,36,23,13,"January, 2005"
2004-2005,24,2005-01-22,Norwich,Middlesbrough,4,4,D,1,1,3,0,2,2,3,0,18,7,16,36,11,20,January,0.4999999999999999,0.8660254037844387,31,29,0,0,1,0.0,2.0,19,42,-23,35,29,6,"January, 2005"
2004-2005,24,2005-01-22,West Brom,Man City,2,0,H,3,0,1,2,2,3,2,0,20,9,13,31,11,18,January,0.4999999999999999,0.8660254037844387,44,27,1,1,1,1.3333333333333333,1.3333333333333333,17,44,-27,30,24,6,"January, 2005"
2004-2005,24,2005-01-22,Man United,Aston Villa,3,1,H,3,0,3,1,1,0,2,3,3,10,47,31,7,16,January,0.4999999999999999,0.8660254037844387,28,1,4,1,0,1.8,0.2,34,13,21,26,26,0,"January, 2005"
2004-2005,24,2005-01-22,Crystal Palace,Tottenham,3,0,H,3,0,1,3,1,1,2,2,17,8,18,33,9,15,January,0.4999999999999999,0.8660254037844387,16,42,1,1,1,1.0,1.3333333333333333,24,37,-13,29,23,6,"January, 2005"
2004-2005,24,2005-01-22,Chelsea,Portsmouth,3,0,H,3,0,4,1,0,1,1,3,1,14,58,27,13,31,January,0.4999999999999999,0.8660254037844387,14,33,3,0,0,2.333333333333333,0.0,45,8,37,26,31,-5,"January, 2005"
2004-2005,24,2005-01-22,Everton,Charlton,0,1,A,0,3,1,1,3,0,2,3,4,7,44,34,3,10,January,0.4999999999999999,0.8660254037844387,18,13,1,1,3,0.8,1.4,28,24,4,27,33,-6,"January, 2005"
2004-2005,24,2005-01-22,Birmingham,Fulham,1,2,A,0,3,2,1,2,3,0,2,14,15,26,25,1,1,January,0.4999999999999999,0.8660254037844387,3,19,2,3,0,1.2,0.8,26,28,-2,29,39,-10,"January, 2005"
2004-2005,24,2005-01-23,Arsenal,Newcastle,1,0,H,3,0,4,0,1,1,3,1,3,12,48,29,9,19,January,0.4999999999999999,0.8660254037844387,0,30,3,2,0,1.2,0.6,52,25,27,35,40,-5,"January, 2005"
2004-2005,24,2005-01-24,Blackburn,Bolton,0,1,A,0,3,0,3,2,1,3,1,16,11,25,30,5,5,January,0.4999999999999999,0.8660254037844387,4,6,1,3,1,1.4,1.4,21,33,-12,30,31,-1,"January, 2005"
2004-2005,25,2005-02-01,Arsenal,Man United,2,4,A,0,3,4,0,1,3,1,1,2,3,51,50,1,1,February,0.8660254037844386,0.5000000000000001,0,28,0,3,2,0.6,1.4,53,25,28,37,14,23,"February, 2005"
2004-2005,25,2005-02-01,Bolton,Tottenham,3,1,H,3,0,1,3,1,1,2,2,9,8,33,33,1,0,February,0.8660254037844386,0.5000000000000001,6,42,4,0,1,1.4,0.8,31,31,0,29,26,3,"February, 2005"
2004-2005,25,2005-02-01,Charlton,Liverpool,1,2,A,0,3,0,2,3,2,1,2,7,5,37,37,2,0,February,0.8660254037844386,0.5000000000000001,13,25,3,0,2,1.4,1.2,28,33,-5,36,25,11,"February, 2005"
2004-2005,25,2005-02-01,Portsmouth,Middlesbrough,2,1,H,3,0,1,1,3,2,3,0,14,6,27,37,8,10,February,0.8660254037844386,0.5000000000000001,33,29,1,2,0,2.0,0.6666666666666666,26,34,-8,39,33,6,"February, 2005"
2004-2005,25,2005-02-01,West Brom,Crystal Palace,2,2,D,1,1,1,2,2,1,3,1,20,17,16,21,3,5,February,0.8660254037844386,0.5000000000000001,44,16,0,0,1,0.0,3.0,19,44,-25,27,37,-10,"February, 2005"
2004-2005,25,2005-02-02,Birmingham,Southampton,2,1,H,3,0,2,1,2,1,2,2,15,18,26,18,3,8,February,0.8660254037844386,0.5000000000000001,3,38,2,2,1,1.0,1.0,27,30,-3,25,39,-14,"February, 2005"
2004-2005,25,2005-02-02,Blackburn,Chelsea,0,1,A,0,3,0,3,2,4,1,0,16,1,25,61,15,36,February,0.8660254037844386,0.5000000000000001,4,14,1,1,3,1.6,2.6,21,34,-13,48,8,40,"February, 2005"
2004-2005,25,2005-02-02,Everton,Norwich,1,0,H,3,0,1,1,3,3,0,2,4,19,44,17,15,27,February,0.8660254037844386,0.5000000000000001,18,31,1,0,0,3.0,2.0,28,25,3,23,46,-23,"February, 2005"
2004-2005,25,2005-02-02,Fulham,Aston Villa,1,1,D,1,1,3,0,2,0,2,3,15,11,28,31,4,3,February,0.8660254037844386,0.5000000000000001,19,1,1,0,4,0.8,2.2,31,40,-9,27,29,-2,"February, 2005"
2004-2005,25,2005-02-02,Man City,Newcastle,1,1,D,1,1,3,2,0,1,3,1,11,14,31,29,3,2,February,0.8660254037844386,0.5000000000000001,27,30,2,0,3,1.0,1.8,30,26,4,35,41,-6,"February, 2005"
2004-2005,26,2005-02-05,Tottenham,Portsmouth,3,1,H,3,0,1,2,2,1,1,3,9,13,33,30,4,3,February,0.8660254037844386,0.5000000000000001,42,33,1,0,2,1.3333333333333333,2.0,30,29,1,28,35,-7,"February, 2005"
2004-2005,26,2005-02-05,Newcastle,Charlton,1,1,D,1,1,1,3,1,0,2,3,12,8,30,37,4,7,February,0.8660254037844386,0.5000000000000001,30,13,3,2,0,1.6,0.6,36,42,-6,29,35,-6,"February, 2005"
2004-2005,26,2005-02-05,Middlesbrough,Blackburn,1,0,H,3,0,2,3,0,0,3,2,7,16,37,25,9,12,February,0.8660254037844386,0.5000000000000001,29,4,2,1,2,1.4,0.8,40,35,5,21,35,-14,"February, 2005"
2004-2005,26,2005-02-05,Norwich,West Brom,3,2,H,3,0,3,0,2,1,2,2,19,20,17,17,1,0,February,0.8660254037844386,0.5000000000000001,31,44,0,1,0,0.0,0.0,23,47,-24,21,46,-25,"February, 2005"
2004-2005,26,2005-02-05,Liverpool,Fulham,3,1,H,3,0,2,1,2,3,0,2,5,15,40,29,10,11,February,0.8660254037844386,0.5000000000000001,25,19,3,1,1,2.0,1.2,38,26,12,32,41,-9,"February, 2005"
2004-2005,26,2005-02-05,Crystal Palace,Bolton,0,1,A,0,3,1,3,1,1,3,1,17,8,22,36,9,14,February,0.8660254037844386,0.5000000000000001,16,6,0,1,2,1.3333333333333333,2.6666666666666665,29,39,-10,34,32,2,"February, 2005"
2004-2005,26,2005-02-05,Man United,Birmingham,2,0,H,3,0,3,1,1,2,1,2,3,14,53,29,11,24,February,0.8660254037844386,0.5000000000000001,28,3,4,1,0,1.6,0.2,41,16,25,29,31,-2,"February, 2005"
2004-2005,26,2005-02-05,Aston Villa,Arsenal,1,3,A,0,3,0,2,3,4,0,1,11,3,32,51,8,19,February,0.8660254037844386,0.5000000000000001,1,0,0,1,4,0.6,2.2,28,30,-2,55,29,26,"February, 2005"
2004-2005,26,2005-02-06,Chelsea,Man City,0,0,D,1,1,4,1,0,3,2,0,1,10,64,32,9,32,February,0.8660254037844386,0.5000000000000001,14,27,4,0,1,2.0,0.2,49,8,41,31,27,4,"February, 2005"
2004-2005,26,2005-02-06,Southampton,Everton,2,2,D,1,1,1,2,2,1,1,3,19,4,18,47,15,29,February,0.8660254037844386,0.5000000000000001,38,18,1,2,2,1.0,1.2,26,41,-15,29,25,4,"February, 2005"
2004-2005,27,2005-02-12,Birmingham,Liverpool,2,0,H,3,0,2,1,2,2,1,2,14,5,29,43,9,14,February,0.8660254037844386,0.5000000000000001,3,25,2,1,2,1.2,1.8,29,33,-4,41,27,14,"February, 2005"
2004-2005,27,2005-02-12,Blackburn,Norwich,3,0,H,3,0,0,3,2,3,0,2,16,18,25,20,2,5,February,0.8660254037844386,0.5000000000000001,4,31,0,1,0,1.0,1.0,21,36,-15,26,49,-23,"February, 2005"
2004-2005,27,2005-02-12,Bolton,Middlesbrough,0,0,D,1,1,1,3,1,2,3,0,7,6,39,40,1,1,February,0.8660254037844386,0.5000000000000001,6,29,2,1,2,1.0,1.2,35,32,3,41,35,6,"February, 2005"
2004-2005,27,2005-02-12,Everton,Chelsea,0,1,A,0,3,1,1,3,4,1,0,4,1,48,65,3,17,February,0.8660254037844386,0.5000000000000001,18,14,0,1,4,0.4,1.8,31,27,4,49,8,41,"February, 2005"
2004-2005,27,2005-02-12,Portsmouth,Aston Villa,1,2,A,0,3,1,1,3,0,2,3,14,12,30,32,2,2,February,0.8660254037844386,0.5000000000000001,33,1,1,0,2,1.0,2.0,29,38,-9,29,33,-4,"February, 2005"
2004-2005,27,2005-02-13,Man City,Man United,0,2,A,0,3,3,2,0,3,1,1,11,2,33,56,9,23,February,0.8660254037844386,0.5000000000000001,27,28,2,2,1,1.8,1.2,31,27,4,43,16,27,"February, 2005"
2004-2005,27,2005-02-14,Arsenal,Crystal Palace,5,1,H,3,0,4,0,1,1,3,1,3,17,54,22,14,32,February,0.8660254037844386,0.5000000000000001,0,16,1,2,0,0.6666666666666666,0.3333333333333333,58,30,28,29,40,-11,"February, 2005"
2004-2005,27,2005-02-22,West Brom,Southampton,0,0,D,1,1,1,2,2,1,2,2,20,19,17,19,1,2,February,0.8660254037844386,0.5000000000000001,44,38,1,1,1,1.0,1.0,23,49,-26,28,43,-15,"February, 2005"
2004-2005,28,2005-02-26,Aston Villa,Everton,1,3,A,0,3,0,2,3,1,1,3,10,4,35,48,6,13,February,0.8660254037844386,0.5000000000000001,1,18,1,2,2,1.0,1.4,31,34,-3,31,28,3,"February, 2005"
2004-2005,28,2005-02-26,Crystal Palace,Birmingham,2,0,H,3,0,1,3,1,2,1,2,17,12,22,32,5,10,February,0.8660254037844386,0.5000000000000001,16,3,1,0,0,1.0,0.0,30,45,-15,31,33,-2,"February, 2005"
2004-2005,28,2005-02-26,Man United,Portsmouth,2,1,H,3,0,3,1,1,1,1,3,2,14,59,30,12,29,February,0.8660254037844386,0.5000000000000001,28,33,1,0,2,1.0,1.0,45,16,29,30,40,-10,"February, 2005"
2004-2005,28,2005-02-26,Southampton,Arsenal,1,1,D,1,1,1,2,2,4,0,1,18,3,20,57,15,37,February,0.8660254037844386,0.5000000000000001,38,0,1,1,3,1.2,2.6,28,43,-15,63,31,32,"February, 2005"
2004-2005,28,2005-02-26,Tottenham,Fulham,2,0,H,3,0,1,2,2,3,0,2,9,15,36,29,6,7,February,0.8660254037844386,0.5000000000000001,42,19,0,1,4,0.8,2.2,33,30,3,33,44,-11,"February, 2005"
2004-2005,28,2005-02-27,Middlesbrough,Charlton,2,2,D,1,1,2,3,0,0,2,3,6,9,41,38,3,3,February,0.8660254037844386,0.5000000000000001,29,13,1,2,2,0.6,0.8,41,35,6,30,36,-6,"February, 2005"
2004-2005,28,2005-02-27,Newcastle,Bolton,2,1,H,3,0,1,3,1,1,3,1,13,7,31,40,6,9,February,0.8660254037844386,0.5000000000000001,30,6,1,1,3,1.0,1.4,37,43,-6,35,32,3,"February, 2005"
2004-2005,28,2005-02-28,Norwich,Man City,2,3,A,0,3,3,0,2,3,2,0,19,12,20,33,7,13,February,0.8660254037844386,0.5000000000000001,31,27,0,1,0,1.0,1.0,26,52,-26,31,29,2,"February, 2005"
2004-2005,29,2005-03-05,Norwich,Chelsea,1,3,A,0,3,3,0,2,4,1,0,19,1,20,68,18,48,March,1.0,6.123233995736766e-17,31,14,0,0,1,0.0,4.0,28,55,-27,50,8,42,"March, 2005"
2004-2005,29,2005-03-05,Newcastle,Liverpool,1,0,H,3,0,1,3,1,2,1,2,12,5,34,43,7,9,March,1.0,6.123233995736766e-17,30,25,1,3,1,1.2,1.4,39,44,-5,41,29,12,"March, 2005"
2004-2005,29,2005-03-05,Southampton,Tottenham,1,0,H,3,0,1,2,2,1,2,2,18,9,21,39,9,18,March,1.0,6.123233995736766e-17,38,42,3,0,2,1.4,1.6,29,44,-15,35,30,5,"March, 2005"
2004-2005,29,2005-03-05,Crystal Palace,Man United,0,0,D,1,1,1,3,1,3,1,1,17,2,25,62,15,37,March,1.0,6.123233995736766e-17,16,28,0,0,3,0.6666666666666666,3.333333333333333,32,45,-13,47,17,30,"March, 2005"
2004-2005,29,2005-03-05,Aston Villa,Middlesbrough,2,0,H,3,0,0,2,3,2,3,0,11,6,35,42,5,7,March,1.0,6.123233995736766e-17,1,29,3,0,2,1.6,1.6,32,37,-5,43,37,6,"March, 2005"
2004-2005,29,2005-03-05,Arsenal,Portsmouth,3,0,H,3,0,4,0,1,1,1,3,3,14,58,30,11,28,March,1.0,6.123233995736766e-17,0,33,1,2,0,1.0,0.6666666666666666,64,32,32,31,42,-11,"March, 2005"
2004-2005,29,2005-03-05,Fulham,Charlton,0,0,D,1,1,3,0,2,0,2,3,15,9,29,39,6,10,March,1.0,6.123233995736766e-17,19,13,3,0,2,1.2,1.0,33,46,-13,32,38,-6,"March, 2005"
2004-2005,29,2005-03-06,Everton,Blackburn,0,1,A,0,3,1,1,3,0,3,2,4,16,51,28,12,23,March,1.0,6.123233995736766e-17,18,4,2,1,2,0.8,0.8,34,29,5,24,36,-12,"March, 2005"
2004-2005,29,2005-03-06,West Brom,Birmingham,2,0,H,3,0,1,2,2,2,1,2,20,13,18,32,7,14,March,1.0,6.123233995736766e-17,44,3,0,1,2,0.3333333333333333,2.0,23,49,-26,31,35,-4,"March, 2005"
2004-2005,29,2005-03-07,Man City,Bolton,0,1,A,0,3,3,2,0,1,3,1,12,7,36,40,5,4,March,1.0,6.123233995736766e-17,27,6,4,0,1,2.4,1.0,34,31,3,36,34,2,"March, 2005"
2004-2005,30,2005-03-15,Chelsea,West Brom,1,0,H,3,0,4,1,0,1,2,2,1,19,71,21,18,50,March,1.0,6.123233995736766e-17,14,44,3,0,0,2.6666666666666665,0.3333333333333333,53,9,44,25,49,-24,"March, 2005"
2004-2005,30,2005-03-16,Charlton,Tottenham,2,0,H,3,0,0,2,3,1,2,2,8,9,40,39,1,1,March,1.0,6.123233995736766e-17,13,42,2,1,2,1.6,1.8,32,38,-6,35,31,4,"March, 2005"
2004-2005,30,2005-03-16,Liverpool,Blackburn,0,0,D,1,1,2,1,2,0,3,2,5,14,43,31,9,12,March,1.0,6.123233995736766e-17,25,4,2,3,0,2.4,1.2,41,30,11,25,36,-11,"March, 2005"
2004-2005,31,2005-03-19,Tottenham,Man City,2,1,H,3,0,1,2,2,3,2,0,9,12,39,36,3,3,March,1.0,6.123233995736766e-17,42,27,2,2,1,1.0,1.0,35,33,2,34,32,2,"March, 2005"
2004-2005,31,2005-03-19,Portsmouth,Newcastle,1,1,D,1,1,1,1,3,1,3,1,16,11,30,37,5,7,March,1.0,6.123233995736766e-17,33,30,0,2,1,0.6666666666666666,1.6666666666666667,31,45,-14,40,44,-4,"March, 2005"
2004-2005,31,2005-03-19,Man United,Fulham,1,0,H,3,0,3,1,1,3,0,2,3,15,63,30,12,33,March,1.0,6.123233995736766e-17,28,19,1,3,1,1.4,1.2,47,17,30,33,46,-13,"March, 2005"
2004-2005,31,2005-03-19,Charlton,West Brom,1,4,A,0,3,0,2,3,1,2,2,7,19,43,21,12,22,March,1.0,6.123233995736766e-17,13,44,3,0,0,1.0,0.0,34,38,-4,25,50,-25,"March, 2005"
2004-2005,31,2005-03-19,Bolton,Norwich,1,0,H,3,0,1,3,1,3,0,2,6,20,43,20,14,23,March,1.0,6.123233995736766e-17,6,31,0,0,1,2.0,3.0,37,34,3,29,58,-29,"March, 2005"
2004-2005,31,2005-03-19,Blackburn,Arsenal,0,1,A,0,3,0,3,2,4,0,1,14,3,32,61,11,29,March,1.0,6.123233995736766e-17,4,0,2,0,3,0.8,1.4,25,36,-11,67,32,35,"March, 2005"
2004-2005,31,2005-03-19,Chelsea,Crystal Palace,4,1,H,3,0,4,1,0,1,3,1,1,17,74,26,16,48,March,1.0,6.123233995736766e-17,14,16,3,0,0,3.6666666666666665,0.6666666666666666,54,9,45,32,45,-13,"March, 2005"
2004-2005,31,2005-03-20,Birmingham,Aston Villa,2,0,H,3,0,2,1,2,0,2,3,13,10,32,38,3,6,March,1.0,6.123233995736766e-17,3,1,3,2,0,1.8,0.6,31,37,-6,34,37,-3,"March, 2005"
2004-2005,31,2005-03-20,Liverpool,Everton,2,1,H,3,0,2,1,2,1,1,3,6,4,44,51,2,7,March,1.0,6.123233995736766e-17,25,18,2,2,1,1.0,0.4,41,30,11,34,30,4,"March, 2005"
2004-2005,31,2005-03-20,Middlesbrough,Southampton,1,3,A,0,3,2,3,0,1,2,2,8,18,42,24,10,18,March,1.0,6.123233995736766e-17,29,38,2,3,0,1.6,1.0,43,39,4,30,44,-14,"March, 2005"
2004-2005,32,2005-04-02,Man United,Blackburn,0,0,D,1,1,3,1,1,0,3,2,3,14,66,32,11,34,April,0.8660254037844388,-0.4999999999999998,28,4,2,1,2,1.2,1.0,48,17,31,25,37,-12,"April, 2005"
2004-2005,32,2005-04-02,Newcastle,Aston Villa,0,3,A,0,3,1,3,1,0,2,3,10,11,38,38,1,0,April,0.8660254037844388,-0.4999999999999998,30,1,1,3,1,1.0,1.2,41,45,-4,34,39,-5,"April, 2005"
2004-2005,32,2005-04-02,Southampton,Chelsea,1,3,A,0,3,1,2,2,4,1,0,17,1,27,77,16,50,April,0.8660254037844388,-0.4999999999999998,38,14,0,2,3,0.4,1.6,33,45,-12,58,10,48,"April, 2005"
2004-2005,32,2005-04-02,Liverpool,Bolton,1,0,H,3,0,2,1,2,1,3,1,5,6,47,46,1,1,April,0.8660254037844388,-0.4999999999999998,25,6,3,1,1,2.0,1.2,43,31,12,38,34,4,"April, 2005"
2004-2005,32,2005-04-02,Birmingham,Tottenham,1,1,D,1,1,2,1,2,1,2,2,13,8,35,42,5,7,April,0.8660254037844388,-0.4999999999999998,3,42,1,1,3,0.8,1.6,33,37,-4,37,34,3,"April, 2005"
2004-2005,32,2005-04-02,Charlton,Man City,2,2,D,1,1,0,2,3,3,2,0,8,12,43,36,4,7,April,0.8660254037844388,-0.4999999999999998,13,27,1,2,2,0.8,2.0,35,42,-7,35,34,1,"April, 2005"
2004-2005,32,2005-04-02,Arsenal,Norwich,4,1,H,3,0,4,0,1,3,0,2,3,20,64,20,17,44,April,0.8660254037844388,-0.4999999999999998,0,31,1,0,0,4.0,1.0,68,32,36,29,59,-30,"April, 2005"
2004-2005,32,2005-04-02,Crystal Palace,Middlesbrough,0,1,A,0,3,1,3,1,2,3,0,18,9,26,42,9,16,April,0.8660254037844388,-0.4999999999999998,16,29,0,0,1,1.0,2.0,33,49,-16,44,42,2,"April, 2005"
2004-2005,32,2005-04-03,Fulham,Portsmouth,3,1,H,3,0,3,0,2,1,1,3,16,15,30,31,1,1,April,0.8660254037844388,-0.4999999999999998,19,33,1,1,1,2.0,1.6666666666666667,33,47,-14,32,46,-14,"April, 2005"
2004-2005,32,2005-04-03,West Brom,Everton,1,0,H,3,0,1,2,2,1,1,3,19,4,24,51,15,27,April,0.8660254037844388,-0.4999999999999998,44,18,0,0,3,0.6666666666666666,1.6666666666666667,29,51,-22,35,32,3,"April, 2005"
2004-2005,33,2005-04-09,Portsmouth,Charlton,4,2,H,3,0,1,1,3,0,2,3,16,8,31,44,8,13,April,0.8660254037844388,-0.4999999999999998,33,13,0,1,2,1.0,1.6666666666666667,33,49,-16,37,44,-7,"April, 2005"
2004-2005,33,2005-04-09,Norwich,Man United,2,0,H,3,0,3,0,2,3,1,1,20,3,20,67,17,47,April,0.8660254037844388,-0.4999999999999998,31,28,0,0,1,1.0,2.0,30,63,-33,48,17,31,"April, 2005"
2004-2005,33,2005-04-09,Middlesbrough,Arsenal,0,1,A,0,3,2,3,0,4,0,1,7,2,45,67,5,22,April,0.8660254037844388,-0.4999999999999998,29,0,0,0,5,0.8,3.4,45,42,3,72,33,39,"April, 2005"
2004-2005,33,2005-04-09,Man City,Liverpool,1,0,H,3,0,3,2,0,2,1,2,12,5,37,50,7,13,April,0.8660254037844388,-0.4999999999999998,27,25,1,1,3,1.2,2.0,37,36,1,44,31,13,"April, 2005"
2004-2005,33,2005-04-09,Bolton,Fulham,3,1,H,3,0,1,3,1,3,0,2,6,15,46,33,9,13,April,0.8660254037844388,-0.4999999999999998,6,19,0,1,4,0.4,2.0,38,35,3,36,48,-12,"April, 2005"
2004-2005,33,2005-04-09,Blackburn,Southampton,3,0,H,3,0,0,3,2,1,2,2,15,17,33,27,2,6,April,0.8660254037844388,-0.4999999999999998,4,38,1,2,2,1.0,1.4,25,37,-12,34,48,-14,"April, 2005"
2004-2005,33,2005-04-09,Chelsea,Birmingham,1,1,D,1,1,4,1,0,2,1,2,1,13,80,36,12,44,April,0.8660254037844388,-0.4999999999999998,14,3,3,2,0,1.4,0.2,61,11,50,34,38,-4,"April, 2005"
2004-2005,33,2005-04-10,Aston Villa,West Brom,1,1,D,1,1,0,2,3,1,2,2,10,18,41,27,8,14,April,0.8660254037844388,-0.4999999999999998,1,44,1,2,0,1.0,0.6666666666666666,37,39,-2,30,51,-21,"April, 2005"
2004-2005,33,2005-04-10,Everton,Crystal Palace,4,0,H,3,0,1,1,3,1,3,1,4,19,51,26,15,25,April,0.8660254037844388,-0.4999999999999998,18,16,2,0,1,2.333333333333333,1.3333333333333333,35,33,2,33,50,-17,"April, 2005"
2004-2005,33,2005-04-10,Tottenham,Newcastle,1,0,H,3,0,1,2,2,1,3,1,9,12,43,38,3,5,April,0.8660254037844388,-0.4999999999999998,42,30,2,0,3,0.6,1.4,38,35,3,41,48,-7,"April, 2005"
2004-2005,34,2005-04-16,Southampton,Aston Villa,2,3,A,0,3,1,2,2,0,2,3,18,10,27,42,8,15,April,0.8660254037844388,-0.4999999999999998,38,1,1,2,2,0.8,1.2,34,51,-17,38,40,-2,"April, 2005"
2004-2005,34,2005-04-16,Liverpool,Tottenham,2,2,D,1,1,2,1,2,1,2,2,6,7,50,46,1,4,April,0.8660254037844388,-0.4999999999999998,25,42,2,2,1,1.4,1.2,44,32,12,39,35,4,"April, 2005"
2004-2005,34,2005-04-16,Fulham,Man City,1,1,D,1,1,3,0,2,3,2,0,16,11,33,40,5,7,April,0.8660254037844388,-0.4999999999999998,19,27,0,3,2,0.8,1.6,37,51,-14,38,36,2,"April, 2005"
2004-2005,34,2005-04-16,Charlton,Bolton,1,2,A,0,3,0,2,3,1,3,1,9,6,44,49,3,5,April,0.8660254037844388,-0.4999999999999998,13,6,1,2,2,1.0,1.6,39,48,-9,41,36,5,"April, 2005"
2004-2005,34,2005-04-16,Birmingham,Portsmouth,0,0,D,1,1,2,1,2,1,1,3,13,15,37,34,2,3,April,0.8660254037844388,-0.4999999999999998,3,33,1,1,1,1.3333333333333333,1.3333333333333333,35,39,-4,37,51,-14,"April, 2005"
2004-2005,34,2005-04-16,Crystal Palace,Norwich,3,3,D,1,1,1,3,1,3,0,2,19,20,26,23,1,3,April,0.8660254037844388,-0.4999999999999998,16,31,0,1,0,1.0,1.0,33,54,-21,32,63,-31,"April, 2005"
2004-2005,35,2005-04-19,Bolton,Southampton,1,1,D,1,1,1,3,1,1,2,2,5,18,52,27,13,25,April,0.8660254037844388,-0.4999999999999998,6,38,2,3,0,1.0,0.6,43,37,6,36,54,-18,"April, 2005"
2004-2005,35,2005-04-19,Middlesbrough,Fulham,1,1,D,1,1,2,3,0,3,0,2,8,16,45,34,8,11,April,0.8660254037844388,-0.4999999999999998,29,19,2,1,2,1.6,1.4,45,43,2,38,52,-14,"April, 2005"
2004-2005,35,2005-04-20,Tottenham,West Brom,1,1,D,1,1,1,2,2,1,2,2,7,18,47,28,11,19,April,0.8660254037844388,-0.4999999999999998,42,44,2,1,0,2.333333333333333,1.3333333333333333,41,37,4,31,52,-21,"April, 2005"
2004-2005,35,2005-04-20,Norwich,Newcastle,2,1,H,3,0,3,0,2,1,3,1,20,14,24,38,6,14,April,0.8660254037844388,-0.4999999999999998,31,30,0,1,0,2.0,2.0,35,66,-31,41,49,-8,"April, 2005"
2004-2005,35,2005-04-20,Man City,Birmingham,3,0,H,3,0,3,2,0,2,1,2,11,13,41,38,2,3,April,0.8660254037844388,-0.4999999999999998,27,3,2,1,2,0.8,0.6,39,37,2,35,39,-4,"April, 2005"
2004-2005,35,2005-04-20,Portsmouth,Liverpool,1,2,A,0,3,1,1,3,2,1,2,16,6,35,51,10,16,April,0.8660254037844388,-0.4999999999999998,33,25,1,1,1,0.6666666666666666,1.3333333333333333,37,51,-14,46,34,12,"April, 2005"
2004-2005,35,2005-04-20,Chelsea,Arsenal,0,0,D,1,1,4,1,0,4,0,1,1,2,81,70,1,11,April,0.8660254037844388,-0.4999999999999998,14,0,0,2,3,1.4,2.0,62,12,50,73,33,40,"April, 2005"
2004-2005,35,2005-04-20,Blackburn,Crystal Palace,1,0,H,3,0,0,3,2,1,3,1,14,19,36,27,5,9,April,0.8660254037844388,-0.4999999999999998,4,16,1,2,0,1.3333333333333333,1.0,28,37,-9,36,57,-21,"April, 2005"
2004-2005,35,2005-04-20,Aston Villa,Charlton,0,0,D,1,1,0,2,3,0,2,3,9,10,45,44,1,1,April,0.8660254037844388,-0.4999999999999998,1,13,3,0,2,1.2,1.6,41,42,-1,40,50,-10,"April, 2005"
2004-2005,35,2005-04-20,Everton,Man United,1,0,H,3,0,1,1,3,3,1,1,4,3,54,67,1,13,April,0.8660254037844388,-0.4999999999999998,18,28,0,1,4,1.2,2.4,39,33,6,48,19,29,"April, 2005"
2004-2005,36,2005-04-23,Middlesbrough,West Brom,4,0,H,3,0,2,3,0,1,2,2,9,18,46,29,9,17,April,0.8660254037844388,-0.4999999999999998,29,44,2,0,1,1.6666666666666667,0.6666666666666666,46,44,2,32,53,-21,"April, 2005"
2004-2005,36,2005-04-23,Aston Villa,Bolton,1,1,D,1,1,0,2,3,1,3,1,9,6,46,53,3,7,April,0.8660254037844388,-0.4999999999999998,1,6,2,2,1,1.4,1.0,41,42,-1,44,38,6,"April, 2005"
2004-2005,36,2005-04-23,Blackburn,Man City,0,0,D,1,1,0,3,2,3,2,0,12,11,39,44,1,5,April,0.8660254037844388,-0.4999999999999998,4,27,1,3,1,1.4,1.4,29,37,-8,42,37,5,"April, 2005"
2004-2005,36,2005-04-23,Chelsea,Fulham,3,1,H,3,0,4,1,0,3,0,2,1,15,82,35,14,47,April,0.8660254037844388,-0.4999999999999998,14,19,3,2,0,1.6,0.6,62,12,50,39,53,-14,"April, 2005"
2004-2005,36,2005-04-23,Crystal Palace,Liverpool,1,0,H,3,0,1,3,1,2,1,2,19,5,27,54,14,27,April,0.8660254037844388,-0.4999999999999998,16,25,0,0,3,1.0,2.6666666666666665,36,58,-22,48,35,13,"April, 2005"
2004-2005,36,2005-04-23,Everton,Birmingham,1,1,D,1,1,1,1,3,2,1,2,4,13,57,38,9,19,April,0.8660254037844388,-0.4999999999999998,18,3,2,2,1,0.8,1.0,40,33,7,35,42,-7,"April, 2005"
2004-2005,36,2005-04-23,Norwich,Charlton,1,0,H,3,0,3,0,2,0,2,3,20,11,27,45,9,18,April,0.8660254037844388,-0.4999999999999998,31,13,0,0,1,0.0,4.0,37,67,-30,40,50,-10,"April, 2005"
2004-2005,36,2005-04-24,Portsmouth,Southampton,4,1,H,3,0,1,1,3,1,2,2,15,20,35,28,5,7,April,0.8660254037844388,-0.4999999999999998,33,38,1,0,2,0.6666666666666666,1.6666666666666667,38,53,-15,37,55,-18,"April, 2005"
2004-2005,36,2005-04-24,Man United,Newcastle,2,1,H,3,0,3,1,1,1,3,1,3,14,67,38,11,29,April,0.8660254037844388,-0.4999999999999998,28,30,4,1,0,3.2,1.4,48,20,28,42,51,-9,"April, 2005"
2004-2005,36,2005-04-25,Arsenal,Tottenham,1,0,H,3,0,4,0,1,1,2,2,2,8,71,48,6,23,April,0.8660254037844388,-0.4999999999999998,0,42,3,2,0,2.6,1.6,73,33,40,42,38,4,"April, 2005"
2004-2005,36,2005-04-26,West Brom,Blackburn,1,1,D,1,1,1,2,2,0,3,2,19,12,29,40,7,11,April,0.8660254037844388,-0.4999999999999998,44,4,0,2,1,0.6666666666666666,1.3333333333333333,32,57,-25,29,37,-8,"April, 2005"
2004-2005,36,2005-04-27,Newcastle,Middlesbrough,0,0,D,1,1,1,3,1,2,3,0,14,7,38,49,7,11,April,0.8660254037844388,-0.4999999999999998,30,29,3,1,1,1.4,0.8,43,53,-10,50,44,6,"April, 2005"
2004-2005,37,2005-04-30,Newcastle,Crystal Palace,0,0,D,1,1,1,3,1,1,3,1,14,17,39,30,3,9,April,0.8660254037844388,-0.4999999999999998,30,16,2,0,1,1.6666666666666667,1.0,43,53,-10,37,58,-21,"April, 2005"
2004-2005,37,2005-04-30,Birmingham,Blackburn,2,1,H,3,0,2,1,2,0,3,2,13,12,39,41,1,2,April,0.8660254037844388,-0.4999999999999998,3,4,0,3,2,1.0,2.0,36,43,-7,30,38,-8,"April, 2005"
2004-2005,37,2005-04-30,Bolton,Chelsea,0,2,A,0,3,1,3,1,4,1,0,6,1,54,85,5,31,April,0.8660254037844388,-0.4999999999999998,6,14,1,2,2,1.0,1.4,45,39,6,65,13,52,"April, 2005"
2004-2005,37,2005-04-30,Fulham,Everton,2,0,H,3,0,3,0,2,1,1,3,16,4,35,58,12,23,April,0.8660254037844388,-0.4999999999999998,19,18,2,0,3,1.0,1.4,40,56,-16,41,34,7,"April, 2005"
2004-2005,37,2005-04-30,Liverpool,Middlesbrough,1,1,D,1,1,2,1,2,2,3,0,5,7,54,50,2,4,April,0.8660254037844388,-0.4999999999999998,25,29,1,2,2,0.6,0.8,48,36,12,50,44,6,"April, 2005"
2004-2005,37,2005-04-30,Man City,Portsmouth,2,0,H,3,0,3,2,0,1,1,3,10,15,45,38,5,7,April,0.8660254037844388,-0.4999999999999998,27,33,1,1,1,2.0,2.0,42,37,5,42,54,-12,"April, 2005"
2004-2005,37,2005-04-30,Southampton,Norwich,4,3,H,3,0,1,2,2,3,0,2,20,19,28,30,1,2,April,0.8660254037844388,-0.4999999999999998,38,31,0,0,1,1.0,2.0,38,59,-21,38,67,-29,"April, 2005"
2004-2005,37,2005-05-01,Charlton,Man United,0,4,A,0,3,0,2,3,3,1,1,11,3,45,70,8,25,May,0.4999999999999999,-0.8660254037844387,13,28,0,0,5,0.4,2.6,40,51,-11,50,21,29,"May, 2005"
2004-2005,37,2005-05-01,Tottenham,Aston Villa,5,1,H,3,0,1,2,2,0,2,3,9,10,48,47,1,1,May,0.4999999999999999,-0.8660254037844387,42,1,3,0,2,0.8,0.6,42,39,3,42,43,-1,"May, 2005"
2004-2005,37,2005-05-02,West Brom,Arsenal,0,2,A,0,3,1,2,2,4,0,1,19,2,30,74,17,44,May,0.4999999999999999,-0.8660254037844387,44,0,0,1,2,1.3333333333333333,2.6666666666666665,33,58,-25,74,33,41,"May, 2005"
2004-2005,37,2005-05-04,Fulham,Newcastle,1,3,A,0,3,3,0,2,1,3,1,15,14,38,40,1,2,May,0.4999999999999999,-0.8660254037844387,19,30,2,0,3,1.8,2.0,42,56,-14,43,53,-10,"May, 2005"
2004-2005,38,2005-05-07,Middlesbrough,Tottenham,1,0,H,3,0,2,3,0,1,2,2,9,8,51,51,1,0,May,0.4999999999999999,-0.8660254037844387,29,42,3,1,1,1.8,0.6,51,45,6,47,40,7,"May, 2005"
2004-2005,38,2005-05-07,Man United,West Brom,1,1,D,1,1,3,1,1,1,2,2,3,19,73,30,16,43,May,0.4999999999999999,-0.8660254037844387,28,44,3,0,0,2.333333333333333,0.3333333333333333,54,21,33,33,60,-27,"May, 2005"
2004-2005,38,2005-05-07,Norwich,Birmingham,1,0,H,3,0,3,0,2,2,1,2,20,13,30,42,7,12,May,0.4999999999999999,-0.8660254037844387,31,3,0,1,0,1.0,1.0,41,71,-30,38,44,-6,"May, 2005"
2004-2005,38,2005-05-07,Everton,Newcastle,2,0,H,3,0,1,1,3,1,3,1,4,12,58,43,8,15,May,0.4999999999999999,-0.8660254037844387,18,30,1,2,2,1.6,2.0,41,36,5,46,54,-8,"May, 2005"
2004-2005,38,2005-05-07,Portsmouth,Bolton,1,1,D,1,1,1,1,3,1,3,1,16,7,38,54,9,16,May,0.4999999999999999,-0.8660254037844387,33,6,2,0,1,1.6666666666666667,0.3333333333333333,42,56,-14,45,41,4,"May, 2005"
2004-2005,38,2005-05-07,Chelsea,Charlton,1,0,H,3,0,4,1,0,0,2,3,1,11,88,45,10,43,May,0.4999999999999999,-0.8660254037844387,14,13,4,0,1,2.8,1.4,67,13,54,40,55,-15,"May, 2005"
2004-2005,38,2005-05-07,Blackburn,Fulham,1,3,A,0,3,0,3,2,3,0,2,14,16,41,38,2,3,May,0.4999999999999999,-0.8660254037844387,4,19,4,0,1,2.4,1.2,31,40,-9,43,59,-16,"May, 2005"
2004-2005,38,2005-05-07,Aston Villa,Man City,1,2,A,0,3,0,2,3,3,2,0,10,9,47,48,1,1,May,0.4999999999999999,-0.8660254037844387,1,27,1,1,3,0.8,2.0,43,48,-5,44,37,7,"May, 2005"
2004-2005,38,2005-05-07,Crystal Palace,Southampton,2,2,D,1,1,1,3,1,1,2,2,18,17,31,31,1,0,May,0.4999999999999999,-0.8660254037844387,16,38,0,2,1,1.0,1.3333333333333333,37,58,-21,42,62,-20,"May, 2005"
2004-2005,38,2005-05-08,Arsenal,Liverpool,3,1,H,3,0,4,0,1,2,1,2,2,5,77,55,3,22,May,0.4999999999999999,-0.8660254037844387,0,25,2,2,1,2.0,1.6,76,33,43,49,37,12,"May, 2005"
2004-2005,38,2005-05-10,Man United,Chelsea,1,3,A,0,3,3,1,1,4,1,0,3,1,74,91,2,17,May,0.4999999999999999,-0.8660254037844387,28,14,1,2,2,1.0,1.2,55,22,33,68,13,55,"May, 2005"
2004-2005,38,2005-05-11,Arsenal,Everton,7,0,H,3,0,4,0,1,1,1,3,2,4,80,61,2,19,May,0.4999999999999999,-0.8660254037844387,0,18,3,1,1,2.0,1.2,79,34,45,43,36,7,"May, 2005"
2004-2005,39,2005-05-15,Birmingham,Arsenal,2,1,H,3,0,2,1,2,4,0,1,13,2,42,83,11,41,May,0.4999999999999999,-0.8660254037844387,3,0,0,1,4,0.0,2.4,38,45,-7,86,34,52,"May, 2005"
2004-2005,39,2005-05-15,Bolton,Everton,3,2,H,3,0,1,3,1,1,1,3,6,4,55,61,2,6,May,0.4999999999999999,-0.8660254037844387,6,18,2,1,2,1.4,1.2,46,42,4,43,43,0,"May, 2005"
2004-2005,39,2005-05-15,Charlton,Crystal Palace,2,2,D,1,1,0,2,3,1,3,1,12,19,45,32,7,13,May,0.4999999999999999,-0.8660254037844387,13,16,1,0,0,1.0,0.0,40,56,-16,39,60,-21,"May, 2005"
2004-2005,39,2005-05-15,Fulham,Norwich,6,0,H,3,0,3,0,2,3,0,2,15,18,41,33,3,8,May,0.4999999999999999,-0.8660254037844387,19,31,1,0,0,1.0,0.0,46,60,-14,42,71,-29,"May, 2005"
2004-2005,39,2005-05-15,Liverpool,Aston Villa,2,1,H,3,0,2,1,2,0,2,3,6,10,55,47,4,8,May,0.4999999999999999,-0.8660254037844387,25,1,2,3,0,0.8,0.4,50,40,10,44,50,-6,"May, 2005"
2004-2005,39,2005-05-15,Man City,Middlesbrough,1,1,D,1,1,3,2,0,2,3,0,8,7,51,54,1,3,May,0.4999999999999999,-0.8660254037844387,27,29,0,1,4,0.8,1.8,46,38,8,52,45,7,"May, 2005"
2004-2005,39,2005-05-15,Newcastle,Chelsea,1,1,D,1,1,1,3,1,4,1,0,14,1,43,94,13,51,May,0.4999999999999999,-0.8660254037844387,30,14,2,0,3,0.8,2.8,46,56,-10,71,14,57,"May, 2005"
2004-2005,39,2005-05-15,Southampton,Man United,1,2,A,0,3,1,2,2,3,1,1,19,3,32,74,16,42,May,0.4999999999999999,-0.8660254037844387,38,28,1,0,4,0.8,2.0,44,64,-20,56,25,31,"May, 2005"
2004-2005,39,2005-05-15,Tottenham,Blackburn,0,0,D,1,1,1,2,2,0,3,2,9,15,51,41,6,10,May,0.4999999999999999,-0.8660254037844387,42,4,3,0,2,0.8,1.2,47,41,6,32,43,-11,"May, 2005"
2004-2005,39,2005-05-15,West Brom,Portsmouth,2,0,H,3,0,1,2,2,1,1,3,20,16,31,39,4,8,May,0.4999999999999999,-0.8660254037844387,44,33,0,0,1,2.0,3.0,34,61,-27,43,57,-14,"May, 2005"
2005-2006,1,2005-08-13,West Ham,Blackburn,3,1,H,3,0,3,0,2,3,0,2,16,13,0,0,3,0,August,-0.8660254037844384,-0.5000000000000004,45,4,3,1,1,1.8,2.0,0,0,0,0,0,0,"August, 2005"
2005-2006,1,2005-08-13,Portsmouth,Tottenham,0,2,A,0,3,3,0,2,2,1,2,15,17,0,0,2,0,August,-0.8660254037844384,-0.5000000000000004,33,42,2,0,2,1.75,1.75,0,0,0,0,0,0,"August, 2005"
2005-2006,1,2005-08-13,Middlesbrough,Liverpool,0,0,D,1,1,1,2,2,5,0,0,13,12,0,0,1,0,August,-0.8660254037844384,-0.5000000000000004,29,25,1,3,1,0.8,0.8,0,0,0,0,0,0,"August, 2005"
2005-2006,1,2005-08-13,Sunderland,Charlton,1,3,A,0,3,1,0,4,1,0,4,16,13,0,0,3,0,August,-0.8660254037844384,-0.5000000000000004,40,13,1,3,1,1.8,2.0,0,0,0,0,0,0,"August, 2005"
2005-2006,1,2005-08-13,Fulham,Birmingham,0,0,D,1,1,4,0,1,1,2,2,9,5,0,0,4,0,August,-0.8660254037844384,-0.5000000000000004,19,3,1,2,2,1.2,1.4,0,0,0,0,0,0,"August, 2005"
2005-2006,1,2005-08-13,Everton,Man United,0,2,A,0,3,1,2,2,2,2,1,8,12,0,0,4,0,August,-0.8660254037844384,-0.5000000000000004,18,28,1,1,3,1.4,1.8,0,0,0,0,0,0,"August, 2005"
2005-2006,1,2005-08-13,Man City,West Brom,0,0,D,1,1,1,0,4,0,2,3,11,17,0,0,6,0,August,-0.8660254037844384,-0.5000000000000004,27,44,1,1,2,1.0,1.5,0,0,0,0,0,0,"August, 2005"
2005-2006,1,2005-08-13,Aston Villa,Bolton,2,2,D,1,1,2,0,3,2,2,1,2,5,0,0,3,0,August,-0.8660254037844384,-0.5000000000000004,1,6,2,3,0,1.6,1.0,0,0,0,0,0,0,"August, 2005"
2005-2006,1,2005-08-14,Wigan,Chelsea,0,1,A,0,3,1,0,4,3,0,2,15,14,0,0,1,0,August,-0.8660254037844384,-0.5000000000000004,46,14,0,0,0,0.0,0.0,0,0,0,0,0,0,"August, 2005"
2005-2006,1,2005-08-14,Arsenal,Newcastle,2,0,H,3,0,4,1,0,4,1,0,13,15,0,0,2,0,August,-0.8660254037844384,-0.5000000000000004,0,30,3,2,0,1.2,0.6,0,0,0,0,0,0,"August, 2005"
2005-2006,2,2005-08-20,Birmingham,Man City,1,2,A,0,3,1,2,2,1,0,4,9,12,1,1,3,0,August,-0.8660254037844384,-0.5000000000000004,3,27,2,1,2,0.6,1.0,0,0,0,0,0,0,"August, 2005"
2005-2006,2,2005-08-20,West Brom,Portsmouth,2,1,H,3,0,0,2,3,3,0,2,11,18,1,0,7,1,August,-0.8660254037844384,-0.5000000000000004,44,33,1,0,1,2.0,1.5,0,0,0,0,2,-2,"August, 2005"
2005-2006,2,2005-08-20,Newcastle,West Ham,0,0,D,1,1,4,1,0,3,0,2,17,5,0,3,12,3,August,-0.8660254037844384,-0.5000000000000004,30,45,3,1,1,2.2,1.4,0,2,-2,3,1,2,"August, 2005"
2005-2006,2,2005-08-20,Man United,Aston Villa,1,0,H,3,0,2,2,1,2,0,3,6,10,3,1,4,2,August,-0.8660254037844384,-0.5000000000000004,28,1,5,0,0,2.2,0.2,2,0,2,2,2,0,"August, 2005"
2005-2006,2,2005-08-20,Tottenham,Middlesbrough,2,0,H,3,0,2,1,2,1,2,2,7,11,3,1,4,2,August,-0.8660254037844384,-0.5000000000000004,42,29,1,1,3,0.6,1.4,2,0,2,0,0,0,"August, 2005"
2005-2006,2,2005-08-20,Charlton,Wigan,1,0,H,3,0,1,0,4,1,0,4,2,16,3,0,14,3,August,-0.8660254037844384,-0.5000000000000004,13,46,0,0,0,0.0,0.0,3,1,2,0,1,-1,"August, 2005"
2005-2006,2,2005-08-20,Blackburn,Fulham,2,1,H,3,0,3,0,2,4,0,1,16,10,0,1,6,1,August,-0.8660254037844384,-0.5000000000000004,4,19,3,0,2,2.2,1.6,1,3,-2,0,0,0,"August, 2005"
2005-2006,2,2005-08-20,Liverpool,Sunderland,1,0,H,3,0,5,0,0,1,0,4,11,16,1,0,5,1,August,-0.8660254037844384,-0.5000000000000004,25,40,2,2,1,0.8,0.6,0,0,0,1,3,-2,"August, 2005"
2005-2006,2,2005-08-21,Bolton,Everton,0,1,A,0,3,2,2,1,1,2,2,11,17,1,0,6,1,August,-0.8660254037844384,-0.5000000000000004,6,18,3,0,2,2.0,1.6,2,2,0,0,2,-2,"August, 2005"
2005-2006,2,2005-08-21,Chelsea,Arsenal,1,0,H,3,0,3,0,2,4,1,0,9,8,3,3,1,0,August,-0.8660254037844384,-0.5000000000000004,14,0,0,2,3,1.2,1.8,1,0,1,2,0,2,"August, 2005"
2005-2006,3,2005-08-23,Birmingham,Middlesbrough,0,3,A,0,3,1,2,2,1,2,2,14,16,1,1,2,0,August,-0.8660254037844384,-0.5000000000000004,3,29,3,0,2,2.4,1.6,1,2,-1,0,2,-2,"August, 2005"
2005-2006,3,2005-08-23,Portsmouth,Aston Villa,1,1,D,1,1,3,0,2,2,0,3,19,13,0,1,6,1,August,-0.8660254037844384,-0.5000000000000004,33,1,1,0,3,1.0,2.0,1,4,-3,2,3,-1,"August, 2005"
2005-2006,3,2005-08-23,Sunderland,Man City,1,2,A,0,3,1,0,4,1,0,4,20,7,0,4,13,4,August,-0.8660254037844384,-0.5000000000000004,40,27,1,0,3,0.75,2.5,1,4,-3,2,1,1,"August, 2005"
2005-2006,3,2005-08-24,Arsenal,Fulham,4,1,H,3,0,4,1,0,4,0,1,10,15,3,1,5,2,August,-0.8660254037844384,-0.5000000000000004,0,19,4,1,0,1.6,0.2,2,1,1,1,2,-1,"August, 2005"
2005-2006,3,2005-08-24,Blackburn,Tottenham,0,0,D,1,1,3,0,2,2,1,2,11,3,3,6,8,3,August,-0.8660254037844384,-0.5000000000000004,4,42,2,1,2,1.0,0.4,3,4,-1,4,0,4,"August, 2005"
2005-2006,3,2005-08-24,Bolton,Newcastle,2,0,H,3,0,2,2,1,4,1,0,14,15,1,1,1,0,August,-0.8660254037844384,-0.5000000000000004,6,30,2,1,2,0.8,0.8,2,3,-1,0,2,-2,"August, 2005"
2005-2006,3,2005-08-24,Chelsea,West Brom,4,0,H,3,0,3,0,2,0,2,3,6,10,6,4,4,2,August,-0.8660254037844384,-0.5000000000000004,14,44,4,0,0,2.25,0.25,2,0,2,2,1,1,"August, 2005"
2005-2006,4,2005-08-27,West Brom,Birmingham,2,3,A,0,3,0,2,3,1,2,2,14,17,4,1,3,3,August,-0.8660254037844384,-0.5000000000000004,44,3,1,1,2,0.75,1.5,2,5,-3,1,5,-4,"August, 2005"
2005-2006,4,2005-08-27,Wigan,Sunderland,1,0,H,3,0,1,0,4,1,0,4,19,20,0,0,1,0,August,-0.8660254037844384,-0.5000000000000004,46,40,0,0,0,0.0,0.0,0,2,-2,2,6,-4,"August, 2005"
2005-2006,4,2005-08-27,West Ham,Bolton,1,2,A,0,3,3,0,2,2,2,1,8,9,4,4,1,0,August,-0.8660254037844384,-0.5000000000000004,45,6,1,2,2,0.8,1.0,3,1,2,4,3,1,"August, 2005"
2005-2006,4,2005-08-27,Tottenham,Chelsea,0,2,A,0,3,2,1,2,3,0,2,3,2,7,9,1,2,August,-0.8660254037844384,-0.5000000000000004,42,14,0,2,3,0.6,1.6,4,0,4,6,0,6,"August, 2005"
2005-2006,4,2005-08-27,Fulham,Everton,1,0,H,3,0,4,0,1,1,2,2,16,14,1,3,2,2,August,-0.8660254037844384,-0.5000000000000004,19,18,3,0,2,1.4,1.0,2,6,-4,1,2,-1,"August, 2005"
2005-2006,4,2005-08-27,Aston Villa,Blackburn,1,0,H,3,0,2,0,3,3,0,2,14,11,2,4,3,2,August,-0.8660254037844384,-0.5000000000000004,1,4,3,1,1,1.6,0.8,3,4,-1,3,4,-1,"August, 2005"
2005-2006,4,2005-08-27,Man City,Portsmouth,2,1,H,3,0,1,0,4,3,0,2,3,16,7,1,13,6,August,-0.8660254037844384,-0.5000000000000004,27,33,2,1,1,2.0,1.5,4,2,2,2,5,-3,"August, 2005"
2005-2006,4,2005-08-28,Middlesbrough,Charlton,0,3,A,0,3,1,2,2,1,0,4,10,6,4,6,4,2,August,-0.8660254037844384,-0.5000000000000004,29,13,1,3,1,1.0,1.0,3,2,1,4,1,3,"August, 2005"
2005-2006,4,2005-08-28,Newcastle,Man United,0,2,A,0,3,4,1,0,2,2,1,19,7,1,6,12,5,August,-0.8660254037844384,-0.5000000000000004,30,28,0,1,4,1.0,2.6,0,4,-4,3,0,3,"August, 2005"
2005-2006,5,2005-09-10,West Brom,Wigan,1,2,A,0,3,0,2,3,1,0,4,16,17,4,3,1,1,September,-1.0,-1.8369701987210287e-16,44,46,0,0,0,0.0,0.0,4,8,-4,1,2,-1,"September, 2005"
2005-2006,5,2005-09-10,Tottenham,Liverpool,0,0,D,1,1,2,1,2,5,0,0,6,12,7,4,6,3,September,-1.0,-1.8369701987210287e-16,42,25,1,3,1,1.4,1.4,4,2,2,1,0,1,"September, 2005"
2005-2006,5,2005-09-10,Middlesbrough,Arsenal,2,1,H,3,0,1,2,2,4,1,0,12,7,4,6,5,2,September,-1.0,-1.8369701987210287e-16,29,0,0,0,5,0.8,3.2,3,5,-2,6,2,4,"September, 2005"
2005-2006,5,2005-09-10,Newcastle,Fulham,1,1,D,1,1,4,1,0,4,0,1,19,14,1,4,5,3,September,-1.0,-1.8369701987210287e-16,30,19,3,0,2,2.2,2.0,0,6,-6,3,6,-3,"September, 2005"
2005-2006,5,2005-09-10,Everton,Portsmouth,0,1,A,0,3,1,2,2,3,0,2,17,18,3,1,1,2,September,-1.0,-1.8369701987210287e-16,18,33,4,0,0,1.5,0.5,1,3,-2,3,7,-4,"September, 2005"
2005-2006,5,2005-09-10,Chelsea,Sunderland,2,0,H,3,0,3,0,2,1,0,4,1,20,12,0,19,12,September,-1.0,-1.8369701987210287e-16,14,40,3,1,1,2.2,1.0,8,0,8,2,7,-5,"September, 2005"
2005-2006,5,2005-09-10,Birmingham,Charlton,0,1,A,0,3,1,2,2,1,0,4,13,3,4,9,10,5,September,-1.0,-1.8369701987210287e-16,3,13,1,2,2,1.2,1.4,4,7,-3,7,1,6,"September, 2005"
2005-2006,5,2005-09-10,Man United,Man City,1,1,D,1,1,2,2,1,1,0,4,4,3,9,10,1,1,September,-1.0,-1.8369701987210287e-16,28,27,2,2,1,1.4,1.2,5,0,5,6,3,3,"September, 2005"
2005-2006,5,2005-09-11,Bolton,Blackburn,0,0,D,1,1,2,2,1,3,0,2,6,14,7,4,8,3,September,-1.0,-1.8369701987210287e-16,6,4,2,2,1,1.4,1.2,6,4,2,3,5,-2,"September, 2005"
2005-2006,5,2005-09-12,West Ham,Aston Villa,4,0,H,3,0,3,0,2,2,0,3,14,11,4,5,3,1,September,-1.0,-1.8369701987210287e-16,45,1,0,3,2,1.4,2.2,4,3,1,4,4,0,"September, 2005"
2005-2006,6,2005-09-17,Aston Villa,Tottenham,1,1,D,1,1,2,0,3,2,1,2,14,6,5,8,8,3,September,-1.0,-1.8369701987210287e-16,1,42,2,0,3,0.8,1.6,4,8,-4,4,2,2,"September, 2005"
2005-2006,6,2005-09-17,Charlton,Chelsea,0,2,A,0,3,1,0,4,3,0,2,2,1,12,15,1,3,September,-1.0,-1.8369701987210287e-16,13,14,1,0,4,1.0,2.4,8,1,7,10,0,10,"September, 2005"
2005-2006,6,2005-09-17,Fulham,West Ham,1,2,A,0,3,4,0,1,3,0,2,14,7,5,7,7,2,September,-1.0,-1.8369701987210287e-16,19,45,1,1,2,0.75,0.75,4,7,-3,8,3,5,"September, 2005"
2005-2006,6,2005-09-17,Portsmouth,Birmingham,1,1,D,1,1,3,0,2,1,2,2,15,16,4,4,1,0,September,-1.0,-1.8369701987210287e-16,33,3,1,2,1,1.0,1.0,4,7,-3,4,8,-4,"September, 2005"
2005-2006,6,2005-09-17,Sunderland,West Brom,1,1,D,1,1,1,0,4,0,2,3,20,17,0,4,3,4,September,-1.0,-1.8369701987210287e-16,40,44,0,1,1,1.5,2.0,2,9,-7,5,10,-5,"September, 2005"
2005-2006,6,2005-09-18,Wigan,Middlesbrough,1,1,D,1,1,1,0,4,1,2,2,11,8,6,7,3,1,September,-1.0,-1.8369701987210287e-16,46,29,0,0,0,0.0,0.0,3,3,0,5,6,-1,"September, 2005"
2005-2006,6,2005-09-18,Man City,Bolton,0,1,A,0,3,1,0,4,2,2,1,4,7,11,8,3,3,September,-1.0,-1.8369701987210287e-16,27,6,3,0,2,2.0,1.2,7,4,3,6,4,2,"September, 2005"
2005-2006,6,2005-09-18,Blackburn,Newcastle,0,3,A,0,3,3,0,2,4,1,0,13,19,5,2,6,3,September,-1.0,-1.8369701987210287e-16,4,30,1,2,2,1.0,2.2,3,5,-2,1,7,-6,"September, 2005"
2005-2006,6,2005-09-18,Liverpool,Man United,0,0,D,1,1,5,0,0,2,2,1,12,5,5,10,7,5,September,-1.0,-1.8369701987210287e-16,25,28,1,0,4,0.6,1.8,1,0,1,6,1,5,"September, 2005"
2005-2006,6,2005-09-19,Arsenal,Everton,2,0,H,3,0,4,1,0,1,2,2,10,19,6,3,9,3,September,-1.0,-1.8369701987210287e-16,0,18,4,1,0,3.2,0.8,7,4,3,1,4,-3,"September, 2005"
2005-2006,7,2005-09-24,West Ham,Arsenal,0,0,D,1,1,3,0,2,4,1,0,6,8,10,9,2,1,September,-1.0,-1.8369701987210287e-16,45,0,0,2,3,0.8,2.2,10,4,6,9,4,5,"September, 2005"
2005-2006,7,2005-09-24,Newcastle,Man City,1,0,H,3,0,4,1,0,1,0,4,15,5,5,11,10,6,September,-1.0,-1.8369701987210287e-16,30,27,3,1,1,2.0,1.0,4,7,-3,7,5,2,"September, 2005"
2005-2006,7,2005-09-24,Man United,Blackburn,1,2,A,0,3,2,2,1,3,0,2,4,18,11,5,14,6,September,-1.0,-1.8369701987210287e-16,28,4,2,2,1,1.2,0.8,6,1,5,3,8,-5,"September, 2005"
2005-2006,7,2005-09-24,West Brom,Charlton,1,2,A,0,3,0,2,3,1,0,4,18,3,5,12,15,7,September,-1.0,-1.8369701987210287e-16,44,13,1,0,3,1.0,1.0,6,11,-5,8,3,5,"September, 2005"
2005-2006,7,2005-09-24,Chelsea,Aston Villa,2,1,H,3,0,3,0,2,2,0,3,1,13,18,6,12,12,September,-1.0,-1.8369701987210287e-16,14,1,2,1,2,1.0,1.0,12,0,12,5,9,-4,"September, 2005"
2005-2006,7,2005-09-24,Bolton,Portsmouth,1,0,H,3,0,2,2,1,3,0,2,4,14,11,5,10,6,September,-1.0,-1.8369701987210287e-16,6,33,1,1,2,0.5,1.5,7,4,3,5,8,-3,"September, 2005"
2005-2006,7,2005-09-24,Birmingham,Liverpool,2,2,D,1,1,1,2,2,5,0,0,15,11,5,6,4,1,September,-1.0,-1.8369701987210287e-16,3,25,3,0,2,1.2,1.4,5,9,-4,1,0,1,"September, 2005"
2005-2006,7,2005-09-24,Everton,Wigan,0,1,A,0,3,1,2,2,1,0,4,19,11,3,7,8,4,September,-1.0,-1.8369701987210287e-16,18,46,0,0,0,0.0,0.0,1,6,-5,4,4,0,"September, 2005"
2005-2006,7,2005-09-25,Middlesbrough,Sunderland,0,2,A,0,3,1,2,2,1,0,4,10,20,8,1,10,7,September,-1.0,-1.8369701987210287e-16,29,40,4,1,0,1.8,0.2,6,7,-1,3,10,-7,"September, 2005"
2005-2006,7,2005-09-26,Tottenham,Fulham,1,0,H,3,0,2,1,2,4,0,1,9,16,9,5,7,4,September,-1.0,-1.8369701987210287e-16,42,19,1,1,3,0.8,1.6,5,3,2,5,9,-4,"September, 2005"
2005-2006,8,2005-10-01,Portsmouth,Newcastle,0,0,D,1,1,3,0,2,4,1,0,16,11,5,8,5,3,October,-0.8660254037844386,0.5,33,30,0,3,1,0.75,1.5,5,9,-4,5,7,-2,"October, 2005"
2005-2006,8,2005-10-01,Blackburn,West Brom,2,0,H,3,0,3,0,2,0,2,3,12,18,8,5,6,3,October,-0.8660254037844386,0.5,4,44,1,3,0,1.25,0.75,5,9,-4,7,13,-6,"October, 2005"
2005-2006,8,2005-10-01,Charlton,Tottenham,2,3,A,0,3,1,0,4,2,1,2,2,4,15,12,2,3,October,-0.8660254037844386,0.5,13,42,3,1,1,2.0,1.6,10,4,6,6,3,3,"October, 2005"
2005-2006,8,2005-10-01,Fulham,Man United,2,3,A,0,3,4,0,1,2,2,1,17,6,5,11,11,6,October,-0.8660254037844386,0.5,19,28,1,2,2,1.0,1.4,5,10,-5,7,3,4,"October, 2005"
2005-2006,8,2005-10-01,Sunderland,West Ham,1,1,D,1,1,1,0,4,3,0,2,19,6,4,11,13,7,October,-0.8660254037844386,0.5,40,45,2,0,3,0.6,1.2,5,10,-5,10,4,6,"October, 2005"
2005-2006,8,2005-10-02,Wigan,Bolton,2,1,H,3,0,1,0,4,2,2,1,11,5,10,14,6,4,October,-0.8660254037844386,0.5,46,6,0,0,0,0.0,0.0,5,4,1,8,4,4,"October, 2005"
2005-2006,8,2005-10-02,Liverpool,Chelsea,1,4,A,0,3,5,0,0,3,0,2,13,1,7,21,12,14,October,-0.8660254037844386,0.5,25,14,1,0,4,0.6,1.2,3,2,1,14,1,13,"October, 2005"
2005-2006,8,2005-10-02,Man City,Everton,2,0,H,3,0,1,0,4,1,2,2,8,20,11,3,12,8,October,-0.8660254037844386,0.5,27,18,1,2,2,1.6,1.2,7,6,1,1,7,-6,"October, 2005"
2005-2006,8,2005-10-02,Arsenal,Birmingham,1,0,H,3,0,4,1,0,1,2,2,9,14,10,6,5,4,October,-0.8660254037844386,0.5,0,3,3,1,1,2.2,0.4,9,4,5,7,11,-4,"October, 2005"
2005-2006,8,2005-10-02,Aston Villa,Middlesbrough,2,3,A,0,3,2,0,3,1,2,2,16,12,6,8,4,2,October,-0.8660254037844386,0.5,1,29,3,0,2,1.8,1.6,6,11,-5,6,9,-3,"October, 2005"
2005-2006,9,2005-10-15,Chelsea,Bolton,5,1,H,3,0,3,0,2,2,2,1,1,5,24,14,4,10,October,-0.8660254037844386,0.5,14,6,3,1,1,1.6,0.8,18,2,16,9,6,3,"October, 2005"
2005-2006,9,2005-10-15,Liverpool,Blackburn,1,0,H,3,0,5,0,0,3,0,2,13,11,7,11,2,4,October,-0.8660254037844386,0.5,25,4,2,3,0,2.0,0.8,4,6,-2,7,9,-2,"October, 2005"
2005-2006,9,2005-10-15,Middlesbrough,Portsmouth,1,1,D,1,1,1,2,2,3,0,2,10,14,11,6,4,5,October,-0.8660254037844386,0.5,29,33,0,2,2,0.75,2.0,9,11,-2,5,9,-4,"October, 2005"
2005-2006,9,2005-10-15,Sunderland,Man United,1,3,A,0,3,1,0,4,2,2,1,17,4,5,14,13,9,October,-0.8660254037844386,0.5,40,28,0,1,4,0.8,2.2,6,11,-5,10,5,5,"October, 2005"
2005-2006,9,2005-10-15,Tottenham,Everton,2,0,H,3,0,2,1,2,1,2,2,4,20,15,3,16,12,October,-0.8660254037844386,0.5,42,18,4,0,1,2.8,1.6,9,5,4,1,9,-8,"October, 2005"
2005-2006,9,2005-10-15,West Brom,Arsenal,2,1,H,3,0,0,2,3,4,1,0,19,7,5,13,12,8,October,-0.8660254037844386,0.5,44,0,0,1,3,1.0,2.5,7,15,-8,10,4,6,"October, 2005"
2005-2006,9,2005-10-15,Wigan,Newcastle,1,0,H,3,0,1,0,4,4,1,0,8,13,13,9,5,4,October,-0.8660254037844386,0.5,46,30,0,0,0,0.0,0.0,7,5,2,5,7,-2,"October, 2005"
2005-2006,9,2005-10-16,Birmingham,Aston Villa,0,1,A,0,3,1,2,2,2,0,3,16,17,6,6,1,0,October,-0.8660254037844386,0.5,3,1,3,2,0,1.6,0.6,7,12,-5,8,14,-6,"October, 2005"
2005-2006,9,2005-10-16,Man City,West Ham,2,1,H,3,0,1,0,4,3,0,2,6,9,14,12,3,2,October,-0.8660254037844386,0.5,27,45,1,1,3,0.8,1.8,9,6,3,11,5,6,"October, 2005"
2005-2006,9,2005-10-17,Charlton,Fulham,1,1,D,1,1,1,0,4,4,0,1,6,18,15,5,12,10,October,-0.8660254037844386,0.5,13,19,2,1,2,1.0,1.0,12,7,5,7,13,-6,"October, 2005"
2005-2006,10,2005-10-22,Portsmouth,Charlton,1,2,A,0,3,3,0,2,1,0,4,17,7,7,16,10,9,October,-0.8660254037844386,0.5,33,13,1,1,2,1.75,1.75,6,10,-4,13,8,5,"October, 2005"
2005-2006,10,2005-10-22,Man United,Tottenham,1,1,D,1,1,2,2,1,2,1,2,4,3,17,18,1,1,October,-0.8660254037844386,0.5,28,42,4,1,0,1.6,0.2,13,6,7,11,5,6,"October, 2005"
2005-2006,10,2005-10-22,Fulham,Liverpool,2,0,H,3,0,4,0,1,5,0,0,17,12,6,10,5,4,October,-0.8660254037844386,0.5,19,25,0,1,4,0.8,2.2,8,14,-6,5,6,-1,"October, 2005"
2005-2006,10,2005-10-22,Arsenal,Man City,1,0,H,3,0,4,1,0,1,0,4,8,4,13,17,4,4,October,-0.8660254037844386,0.5,0,27,4,1,0,2.2,0.8,11,6,5,11,7,4,"October, 2005"
2005-2006,10,2005-10-22,Aston Villa,Wigan,0,2,A,0,3,2,0,3,1,0,4,14,7,9,16,7,7,October,-0.8660254037844386,0.5,1,46,0,0,0,0.0,0.0,9,14,-5,8,5,3,"October, 2005"
2005-2006,10,2005-10-22,Blackburn,Birmingham,2,0,H,3,0,3,0,2,1,2,2,11,18,11,6,7,5,October,-0.8660254037844386,0.5,4,3,1,3,1,2.0,1.4,7,10,-3,7,13,-6,"October, 2005"
2005-2006,10,2005-10-23,Bolton,West Brom,2,0,H,3,0,2,2,1,0,2,3,8,16,14,8,8,6,October,-0.8660254037844386,0.5,6,44,0,3,1,1.0,1.25,10,11,-1,9,16,-7,"October, 2005"
2005-2006,10,2005-10-23,Everton,Chelsea,1,1,D,1,1,1,2,2,3,0,2,20,1,3,27,19,24,October,-0.8660254037844386,0.5,18,14,0,1,4,0.2,1.4,1,11,-10,23,3,20,"October, 2005"
2005-2006,10,2005-10-23,Newcastle,Sunderland,3,2,H,3,0,4,1,0,1,0,4,13,19,9,5,6,4,October,-0.8660254037844386,0.5,30,40,3,2,0,1.2,0.4,5,8,-3,7,14,-7,"October, 2005"
2005-2006,10,2005-10-23,West Ham,Middlesbrough,2,1,H,3,0,3,0,2,1,2,2,10,11,12,12,1,0,October,-0.8660254037844386,0.5,45,29,2,1,2,1.0,1.2,12,7,5,10,12,-2,"October, 2005"
2005-2006,11,2005-10-29,Sunderland,Portsmouth,1,4,A,0,3,1,0,4,3,0,2,20,17,5,7,3,2,October,-0.8660254037844386,0.5,40,33,0,0,0,0.0,0.0,9,17,-8,7,12,-5,"October, 2005"
2005-2006,11,2005-10-29,Wigan,Fulham,1,0,H,3,0,1,0,4,4,0,1,5,15,19,9,10,10,October,-0.8660254037844386,0.5,46,19,0,0,0,0.0,0.0,10,5,5,10,14,-4,"October, 2005"
2005-2006,11,2005-10-29,Tottenham,Arsenal,1,1,D,1,1,2,1,2,4,1,0,3,8,19,16,5,3,October,-0.8660254037844386,0.5,42,0,0,2,3,1.6,2.2,12,6,6,12,6,6,"October, 2005"
2005-2006,11,2005-10-29,Middlesbrough,Man United,4,1,H,3,0,1,2,2,2,2,1,13,6,12,18,7,6,October,-0.8660254037844386,0.5,29,28,2,1,2,1.4,1.4,11,14,-3,14,7,7,"October, 2005"
2005-2006,11,2005-10-29,Birmingham,Everton,0,1,A,0,3,1,2,2,1,2,2,18,20,6,4,2,2,October,-0.8660254037844386,0.5,3,18,1,2,2,1.0,0.8,7,15,-8,2,12,-10,"October, 2005"
2005-2006,11,2005-10-29,Chelsea,Blackburn,4,2,H,3,0,3,0,2,3,0,2,1,10,28,14,9,14,October,-0.8660254037844386,0.5,14,4,3,1,1,2.2,1.2,24,4,20,9,10,-1,"October, 2005"
2005-2006,11,2005-10-29,Charlton,Bolton,0,1,A,0,3,1,0,4,2,2,1,2,7,19,17,5,2,October,-0.8660254037844386,0.5,13,6,0,2,3,0.8,1.8,15,9,6,12,11,1,"October, 2005"
2005-2006,11,2005-10-29,Liverpool,West Ham,2,0,H,3,0,5,0,0,3,0,2,13,9,10,15,4,5,October,-0.8660254037844386,0.5,25,45,4,1,0,2.2,0.4,5,8,-3,14,8,6,"October, 2005"
2005-2006,11,2005-10-30,West Brom,Newcastle,0,3,A,0,3,0,2,3,4,1,0,17,13,8,12,4,4,October,-0.8660254037844386,0.5,44,30,0,2,2,1.0,1.75,9,18,-9,8,10,-2,"October, 2005"
2005-2006,11,2005-10-31,Man City,Aston Villa,3,1,H,3,0,1,0,4,2,0,3,8,16,17,9,8,8,October,-0.8660254037844386,0.5,27,1,4,1,0,2.4,0.8,11,8,3,9,16,-7,"October, 2005"
2005-2006,12,2005-11-05,West Ham,West Brom,1,0,H,3,0,3,0,2,0,2,3,12,17,15,8,5,7,November,-0.5000000000000004,0.8660254037844384,45,44,1,0,1,1.0,1.0,14,10,4,9,21,-12,"November, 2005"
2005-2006,12,2005-11-05,Portsmouth,Wigan,0,2,A,0,3,3,0,2,1,0,4,15,2,10,22,13,12,November,-0.5000000000000004,0.8660254037844384,33,46,0,0,0,0.0,0.0,11,13,-2,11,5,6,"November, 2005"
2005-2006,12,2005-11-05,Newcastle,Birmingham,1,0,H,3,0,4,1,0,1,2,2,12,19,15,6,7,9,November,-0.5000000000000004,0.8660254037844384,30,3,2,2,1,1.2,1.0,11,10,1,7,16,-9,"November, 2005"
2005-2006,12,2005-11-05,Fulham,Man City,2,1,H,3,0,4,0,1,1,0,4,15,5,9,20,10,11,November,-0.5000000000000004,0.8660254037844384,19,27,0,4,1,1.0,1.6,10,15,-5,14,9,5,"November, 2005"
2005-2006,12,2005-11-05,Aston Villa,Liverpool,0,2,A,0,3,2,0,3,5,0,0,16,13,9,13,3,4,November,-0.5000000000000004,0.8660254037844384,1,25,0,3,2,0.6,1.0,10,19,-9,7,8,-1,"November, 2005"
2005-2006,12,2005-11-05,Arsenal,Sunderland,3,1,H,3,0,4,1,0,1,0,4,8,20,17,5,12,12,November,-0.5000000000000004,0.8660254037844384,0,40,3,2,0,2.6,0.8,13,7,6,10,21,-11,"November, 2005"
2005-2006,12,2005-11-05,Blackburn,Charlton,4,1,H,3,0,3,0,2,1,0,4,13,7,14,19,6,5,November,-0.5000000000000004,0.8660254037844384,4,13,2,0,3,0.8,1.0,11,14,-3,15,10,5,"November, 2005"
2005-2006,12,2005-11-06,Everton,Middlesbrough,1,0,H,3,0,1,2,2,1,2,2,18,13,7,15,5,8,November,-0.5000000000000004,0.8660254037844384,18,29,1,3,1,0.8,0.8,3,12,-9,15,15,0,"November, 2005"
2005-2006,12,2005-11-06,Man United,Chelsea,1,0,H,3,0,2,2,1,3,0,2,9,1,18,31,8,13,November,-0.5000000000000004,0.8660254037844384,28,14,1,1,3,0.8,1.4,15,11,4,28,6,22,"November, 2005"
2005-2006,12,2005-11-07,Bolton,Tottenham,1,0,H,3,0,2,2,1,2,1,2,7,5,20,20,2,0,November,-0.5000000000000004,0.8660254037844384,6,42,5,0,0,1.8,0.4,13,11,2,13,7,6,"November, 2005"
2005-2006,13,2005-11-19,Wigan,Arsenal,2,3,A,0,3,1,0,4,4,1,0,2,6,25,20,4,5,November,-0.5000000000000004,0.8660254037844384,46,0,0,0,0,0.0,0.0,13,5,8,16,8,8,"November, 2005"
2005-2006,13,2005-11-19,West Brom,Everton,4,0,H,3,0,0,2,3,1,2,2,18,17,8,10,1,2,November,-0.5000000000000004,0.8660254037844384,44,18,1,0,3,0.75,1.25,9,22,-13,4,12,-8,"November, 2005"
2005-2006,13,2005-11-19,Sunderland,Aston Villa,1,3,A,0,3,1,0,4,2,0,3,20,17,5,9,3,4,November,-0.5000000000000004,0.8660254037844384,40,1,1,3,1,0.6,0.6,11,24,-13,10,21,-11,"November, 2005"
2005-2006,13,2005-11-19,Chelsea,Newcastle,3,0,H,3,0,3,0,2,4,1,0,1,10,31,18,9,13,November,-0.5000000000000004,0.8660254037844384,14,30,2,1,2,2.4,1.0,28,7,21,12,10,2,"November, 2005"
2005-2006,13,2005-11-19,Liverpool,Portsmouth,3,0,H,3,0,5,0,0,3,0,2,12,15,16,10,3,6,November,-0.5000000000000004,0.8660254037844384,25,33,2,1,1,1.5,0.75,9,8,1,11,15,-4,"November, 2005"
2005-2006,13,2005-11-19,Man City,Blackburn,0,0,D,1,1,1,0,4,3,0,2,7,12,20,17,5,3,November,-0.5000000000000004,0.8660254037844384,27,4,1,3,1,1.0,1.0,15,11,4,15,15,0,"November, 2005"
2005-2006,13,2005-11-19,Charlton,Man United,1,3,A,0,3,1,0,4,2,2,1,8,4,19,21,4,2,November,-0.5000000000000004,0.8660254037844384,13,28,0,0,5,0.2,2.8,16,14,2,16,11,5,"November, 2005"
2005-2006,13,2005-11-20,Middlesbrough,Fulham,3,2,H,3,0,1,2,2,4,0,1,13,14,15,12,1,3,November,-0.5000000000000004,0.8660254037844384,29,19,2,1,2,1.4,1.2,15,16,-1,12,16,-4,"November, 2005"
2005-2006,13,2005-11-20,Tottenham,West Ham,1,1,D,1,1,2,1,2,3,0,2,7,10,20,18,3,2,November,-0.5000000000000004,0.8660254037844384,42,45,2,2,1,1.0,1.0,13,8,5,15,10,5,"November, 2005"
2005-2006,14,2005-11-26,Sunderland,Birmingham,0,1,A,0,3,1,0,4,1,2,2,20,19,5,6,1,1,November,-0.5000000000000004,0.8660254037844384,40,3,0,0,2,0.0,1.5,12,27,-15,7,17,-10,"November, 2005"
2005-2006,14,2005-11-26,Portsmouth,Chelsea,0,2,A,0,3,3,0,2,3,0,2,17,1,10,34,16,24,November,-0.5000000000000004,0.8660254037844384,33,14,0,0,4,0.0,2.5,11,18,-7,31,7,24,"November, 2005"
2005-2006,14,2005-11-26,Wigan,Tottenham,1,2,A,0,3,1,0,4,2,1,2,3,7,25,21,4,4,November,-0.5000000000000004,0.8660254037844384,46,42,0,0,0,0.0,0.0,15,8,7,14,9,5,"November, 2005"
2005-2006,14,2005-11-26,Aston Villa,Charlton,1,0,H,3,0,2,0,3,1,0,4,15,10,12,19,5,7,November,-0.5000000000000004,0.8660254037844384,1,13,2,1,2,0.8,1.6,13,22,-9,17,17,0,"November, 2005"
2005-2006,14,2005-11-26,Arsenal,Blackburn,3,0,H,3,0,4,1,0,3,0,2,4,12,23,18,8,5,November,-0.5000000000000004,0.8660254037844384,0,4,4,0,1,1.4,0.4,19,10,9,15,15,0,"November, 2005"
2005-2006,14,2005-11-26,Man City,Liverpool,0,1,A,0,3,1,0,4,5,0,0,7,9,21,19,2,2,November,-0.5000000000000004,0.8660254037844384,27,25,2,1,2,1.4,1.4,15,11,4,12,8,4,"November, 2005"
2005-2006,14,2005-11-27,Everton,Newcastle,1,0,H,3,0,1,2,2,4,1,0,18,12,10,18,6,8,November,-0.5000000000000004,0.8660254037844384,18,30,2,2,1,1.8,1.6,4,16,-12,12,13,-1,"November, 2005"
2005-2006,14,2005-11-27,Fulham,Bolton,2,1,H,3,0,4,0,1,2,2,1,16,6,12,23,10,11,November,-0.5000000000000004,0.8660254037844384,19,6,3,1,1,1.4,0.8,14,19,-5,14,11,3,"November, 2005"
2005-2006,14,2005-11-27,Middlesbrough,West Brom,2,2,D,1,1,1,2,2,0,2,3,11,17,18,11,6,7,November,-0.5000000000000004,0.8660254037844384,29,44,3,0,1,2.25,0.5,18,18,0,13,22,-9,"November, 2005"
2005-2006,14,2005-11-27,West Ham,Man United,1,2,A,0,3,3,0,2,2,2,1,9,4,19,24,5,5,November,-0.5000000000000004,0.8660254037844384,45,28,1,1,3,1.2,2.4,16,11,5,19,12,7,"November, 2005"
2005-2006,14,2005-11-30,Sunderland,Liverpool,0,2,A,0,3,1,0,4,5,0,0,20,7,5,22,13,17,November,-0.5000000000000004,0.8660254037844384,40,25,1,1,3,0.4,0.8,12,28,-16,13,8,5,"November, 2005"
2005-2006,15,2005-12-03,Tottenham,Sunderland,3,2,H,3,0,2,1,2,1,0,4,7,20,24,5,13,19,December,-2.4492935982947064e-16,1.0,42,40,4,0,1,2.2,1.4,16,10,6,12,30,-18,"December, 2005"
2005-2006,15,2005-12-03,West Brom,Fulham,0,0,D,1,1,0,2,3,4,0,1,17,16,12,15,1,3,December,-2.4492935982947064e-16,1.0,44,19,1,1,2,0.5,1.25,15,24,-9,16,20,-4,"December, 2005"
2005-2006,15,2005-12-03,Man United,Portsmouth,3,0,H,3,0,2,2,1,3,0,2,3,18,27,10,15,17,December,-2.4492935982947064e-16,1.0,28,33,2,0,2,1.25,1.0,21,13,8,11,20,-9,"December, 2005"
2005-2006,15,2005-12-03,Newcastle,Aston Villa,1,1,D,1,1,4,1,0,2,0,3,12,16,18,15,4,3,December,-2.4492935982947064e-16,1.0,30,1,0,3,2,0.8,1.8,12,14,-2,14,22,-8,"December, 2005"
2005-2006,15,2005-12-03,Chelsea,Middlesbrough,1,0,H,3,0,3,0,2,1,2,2,1,10,37,19,9,18,December,-2.4492935982947064e-16,1.0,14,29,3,2,0,1.2,0.4,33,7,26,20,20,0,"December, 2005"
2005-2006,15,2005-12-03,Bolton,Arsenal,2,0,H,3,0,2,2,1,4,1,0,7,3,23,26,4,3,December,-2.4492935982947064e-16,1.0,6,0,1,3,1,1.4,1.4,15,13,2,22,10,12,"December, 2005"
2005-2006,15,2005-12-03,Blackburn,Everton,0,2,A,0,3,3,0,2,1,2,2,13,16,18,13,3,5,December,-2.4492935982947064e-16,1.0,4,18,3,1,1,1.0,0.6,15,18,-3,5,16,-11,"December, 2005"
2005-2006,15,2005-12-03,Liverpool,Wigan,3,0,H,3,0,5,0,0,1,0,4,5,6,25,25,1,0,December,-2.4492935982947064e-16,1.0,25,46,0,0,0,0.0,0.0,15,8,7,16,10,6,"December, 2005"
2005-2006,15,2005-12-04,Charlton,Man City,2,5,A,0,3,1,0,4,1,0,4,11,8,19,21,3,2,December,-2.4492935982947064e-16,1.0,13,27,0,3,2,1.0,2.4,17,18,-1,15,12,3,"December, 2005"
2005-2006,15,2005-12-05,Birmingham,West Ham,1,2,A,0,3,1,2,2,3,0,2,19,9,9,19,10,10,December,-2.4492935982947064e-16,1.0,3,45,1,1,0,2.0,1.5,8,17,-9,17,13,4,"December, 2005"
2005-2006,16,2005-12-10,West Brom,Man City,2,0,H,3,0,0,2,3,1,0,4,17,8,13,24,9,11,December,-2.4492935982947064e-16,1.0,44,27,2,2,1,1.2,0.8,15,24,-9,20,14,6,"December, 2005"
2005-2006,16,2005-12-10,Newcastle,Arsenal,1,0,H,3,0,4,1,0,4,1,0,12,6,19,26,6,7,December,-2.4492935982947064e-16,1.0,30,0,0,1,4,0.4,1.4,13,15,-2,22,12,10,"December, 2005"
2005-2006,16,2005-12-10,Liverpool,Middlesbrough,2,0,H,3,0,5,0,0,1,2,2,3,12,28,19,9,9,December,-2.4492935982947064e-16,1.0,25,29,1,3,1,0.6,0.6,18,8,10,20,21,-1,"December, 2005"
2005-2006,16,2005-12-10,Chelsea,Wigan,1,0,H,3,0,3,0,2,1,0,4,1,7,40,25,6,15,December,-2.4492935982947064e-16,1.0,14,46,1,0,0,1.0,0.0,34,7,27,16,13,3,"December, 2005"
2005-2006,16,2005-12-10,Bolton,Aston Villa,1,1,D,1,1,2,2,1,2,0,3,6,15,26,16,9,10,December,-2.4492935982947064e-16,1.0,6,1,0,4,1,1.4,1.6,17,13,4,15,23,-8,"December, 2005"
2005-2006,16,2005-12-10,Blackburn,West Ham,3,2,H,3,0,3,0,2,3,0,2,13,9,18,22,4,4,December,-2.4492935982947064e-16,1.0,4,45,1,1,3,2.2,2.0,15,20,-5,19,14,5,"December, 2005"
2005-2006,16,2005-12-10,Birmingham,Fulham,1,0,H,3,0,1,2,2,4,0,1,19,14,9,16,5,7,December,-2.4492935982947064e-16,1.0,3,19,1,3,1,1.2,1.2,9,19,-10,16,20,-4,"December, 2005"
2005-2006,16,2005-12-10,Charlton,Sunderland,2,0,H,3,0,1,0,4,1,0,4,13,20,19,5,7,14,December,-2.4492935982947064e-16,1.0,13,40,2,3,0,2.2,1.4,19,23,-4,14,33,-19,"December, 2005"
2005-2006,16,2005-12-11,Man United,Everton,1,1,D,1,1,2,2,1,1,2,2,3,17,30,16,14,14,December,-2.4492935982947064e-16,1.0,28,18,3,1,1,1.8,1.2,24,13,11,7,16,-9,"December, 2005"
2005-2006,16,2005-12-12,Tottenham,Portsmouth,3,1,H,3,0,2,1,2,3,0,2,4,19,27,10,15,17,December,-2.4492935982947064e-16,1.0,42,33,3,0,2,1.8,1.4,19,12,7,11,23,-12,"December, 2005"
2005-2006,16,2005-12-14,Everton,West Ham,1,2,A,0,3,1,2,2,3,0,2,15,9,17,22,6,5,December,-2.4492935982947064e-16,1.0,18,45,3,1,1,1.6,0.2,8,17,-9,21,17,4,"December, 2005"
2005-2006,16,2005-12-14,Man United,Wigan,4,0,H,3,0,2,2,1,1,0,4,3,8,31,25,5,6,December,-2.4492935982947064e-16,1.0,28,46,0,0,0,0.0,0.0,25,14,11,16,14,2,"December, 2005"
2005-2006,17,2005-12-17,Portsmouth,West Brom,1,0,H,3,0,3,0,2,0,2,3,19,17,10,16,2,6,December,-2.4492935982947064e-16,1.0,33,44,1,0,2,1.3333333333333333,2.0,12,26,-14,17,24,-7,"December, 2005"
2005-2006,17,2005-12-17,West Ham,Newcastle,2,4,A,0,3,3,0,2,4,1,0,8,10,25,22,2,3,December,-2.4492935982947064e-16,1.0,45,30,1,2,2,1.2,1.8,23,18,5,14,15,-1,"December, 2005"
2005-2006,17,2005-12-17,Man City,Birmingham,4,1,H,3,0,1,0,4,1,2,2,9,18,24,12,9,12,December,-2.4492935982947064e-16,1.0,27,3,2,1,2,1.2,0.8,20,16,4,10,19,-9,"December, 2005"
2005-2006,17,2005-12-17,Wigan,Charlton,3,0,H,3,0,1,0,4,1,0,4,10,11,25,22,1,3,December,-2.4492935982947064e-16,1.0,46,13,0,0,1,0.0,1.0,16,18,-2,21,23,-2,"December, 2005"
2005-2006,17,2005-12-17,Everton,Bolton,0,4,A,0,3,1,2,2,2,2,1,15,5,17,27,10,10,December,-2.4492935982947064e-16,1.0,18,6,2,0,3,1.4,1.8,9,19,-10,18,14,4,"December, 2005"
2005-2006,17,2005-12-17,Aston Villa,Man United,0,2,A,0,3,2,0,3,2,2,1,14,2,17,34,12,17,December,-2.4492935982947064e-16,1.0,1,28,0,0,5,0.2,2.2,16,24,-8,29,14,15,"December, 2005"
2005-2006,17,2005-12-17,Fulham,Blackburn,2,1,H,3,0,4,0,1,3,0,2,16,12,16,21,4,5,December,-2.4492935982947064e-16,1.0,19,4,2,0,3,1.8,1.8,16,21,-5,18,22,-4,"December, 2005"
2005-2006,17,2005-12-18,Arsenal,Chelsea,0,2,A,0,3,4,1,0,3,0,2,8,1,26,43,7,17,December,-2.4492935982947064e-16,1.0,0,14,2,2,1,1.2,1.0,22,13,9,35,7,28,"December, 2005"
2005-2006,17,2005-12-18,Middlesbrough,Tottenham,3,3,D,1,1,1,2,2,2,1,2,13,4,19,30,9,11,December,-2.4492935982947064e-16,1.0,29,42,2,1,2,0.4,0.8,20,23,-3,22,13,9,"December, 2005"
2005-2006,18,2005-12-26,Wigan,Man City,4,3,H,3,0,1,0,4,1,0,4,7,8,28,27,1,1,December,-2.4492935982947064e-16,1.0,46,27,0,0,0,0.0,0.0,19,18,1,24,17,7,"December, 2005"
2005-2006,18,2005-12-26,Sunderland,Bolton,0,0,D,1,1,1,0,4,2,2,1,20,5,5,30,15,25,December,-2.4492935982947064e-16,1.0,40,6,2,1,1,1.0,0.75,14,35,-21,22,14,8,"December, 2005"
2005-2006,18,2005-12-26,Portsmouth,West Ham,1,1,D,1,1,3,0,2,3,0,2,18,9,13,25,9,12,December,-2.4492935982947064e-16,1.0,33,45,0,0,0,0.0,0.0,13,26,-13,25,22,3,"December, 2005"
2005-2006,18,2005-12-26,Middlesbrough,Blackburn,0,2,A,0,3,1,2,2,3,0,2,13,12,20,21,1,1,December,-2.4492935982947064e-16,1.0,29,4,2,1,2,1.4,0.8,23,26,-3,19,24,-5,"December, 2005"
2005-2006,18,2005-12-26,Tottenham,Birmingham,2,0,H,3,0,2,1,2,1,2,2,4,19,31,12,15,19,December,-2.4492935982947064e-16,1.0,42,3,3,1,1,1.6,0.8,25,16,9,11,23,-12,"December, 2005"
2005-2006,18,2005-12-26,Liverpool,Newcastle,2,0,H,3,0,5,0,0,4,1,0,3,10,31,25,7,6,December,-2.4492935982947064e-16,1.0,25,30,1,2,2,1.0,1.0,20,8,12,18,17,1,"December, 2005"
2005-2006,18,2005-12-26,Chelsea,Fulham,3,2,H,3,0,3,0,2,4,0,1,1,15,46,19,14,27,December,-2.4492935982947064e-16,1.0,14,19,4,1,0,2.2,0.8,37,7,30,18,22,-4,"December, 2005"
2005-2006,18,2005-12-26,Charlton,Arsenal,0,1,A,0,3,1,0,4,4,1,0,11,8,22,26,3,4,December,-2.4492935982947064e-16,1.0,13,0,0,1,4,0.6,2.4,21,26,-5,22,15,7,"December, 2005"
2005-2006,18,2005-12-26,Aston Villa,Everton,4,0,H,3,0,2,0,3,1,2,2,15,16,17,17,1,0,December,-2.4492935982947064e-16,1.0,1,18,0,2,3,0.6,1.6,16,26,-10,9,23,-14,"December, 2005"
2005-2006,18,2005-12-26,Man United,West Brom,3,0,H,3,0,2,2,1,0,2,3,2,17,37,16,15,21,December,-2.4492935982947064e-16,1.0,28,44,3,1,0,2.0,0.5,31,14,17,17,25,-8,"December, 2005"
2005-2006,19,2005-12-28,West Ham,Wigan,0,2,A,0,3,3,0,2,1,0,4,9,7,26,31,2,5,December,-2.4492935982947064e-16,1.0,45,46,0,0,0,0.0,0.0,26,23,3,23,21,2,"December, 2005"
2005-2006,19,2005-12-28,West Brom,Tottenham,2,0,H,3,0,0,2,3,2,1,2,17,4,16,34,13,18,December,-2.4492935982947064e-16,1.0,44,42,0,2,2,1.25,2.0,17,28,-11,27,16,11,"December, 2005"
2005-2006,19,2005-12-28,Man City,Chelsea,0,1,A,0,3,1,0,4,3,0,2,8,1,27,49,7,22,December,-2.4492935982947064e-16,1.0,27,14,1,1,3,0.2,1.4,27,21,6,40,9,31,"December, 2005"
2005-2006,19,2005-12-28,Fulham,Aston Villa,3,3,D,1,1,4,0,1,2,0,3,15,14,19,20,1,1,December,-2.4492935982947064e-16,1.0,19,1,1,1,3,0.8,1.8,20,25,-5,20,26,-6,"December, 2005"
2005-2006,19,2005-12-28,Birmingham,Man United,2,2,D,1,1,1,2,2,2,2,1,19,2,12,40,17,28,December,-2.4492935982947064e-16,1.0,3,28,0,1,4,0.2,1.6,11,25,-14,34,14,20,"December, 2005"
2005-2006,19,2005-12-28,Arsenal,Portsmouth,4,0,H,3,0,4,1,0,3,0,2,7,18,29,14,11,15,December,-2.4492935982947064e-16,1.0,0,33,2,2,0,1.5,0.5,23,15,8,14,27,-13,"December, 2005"
2005-2006,19,2005-12-28,Everton,Liverpool,1,3,A,0,3,1,2,2,5,0,0,16,3,17,34,13,17,December,-2.4492935982947064e-16,1.0,18,25,1,1,3,0.6,1.4,9,27,-18,22,8,14,"December, 2005"
2005-2006,20,2005-12-31,Portsmouth,Fulham,1,0,H,3,0,3,0,2,4,0,1,18,15,14,20,3,6,December,-2.4492935982947064e-16,1.0,33,19,1,1,2,1.5,2.25,14,31,-17,23,28,-5,"December, 2005"
2005-2006,20,2005-12-31,Wigan,Blackburn,0,3,A,0,3,1,0,4,3,0,2,5,12,34,24,7,10,December,-2.4492935982947064e-16,1.0,46,4,0,0,0,0.0,0.0,25,21,4,21,24,-3,"December, 2005"
2005-2006,20,2005-12-31,Tottenham,Newcastle,2,0,H,3,0,2,1,2,4,1,0,4,10,34,25,6,9,December,-2.4492935982947064e-16,1.0,42,30,3,0,2,0.6,1.0,27,18,9,18,19,-1,"December, 2005"
2005-2006,20,2005-12-31,Sunderland,Everton,0,1,A,0,3,1,0,4,1,2,2,20,18,6,17,2,11,December,-2.4492935982947064e-16,1.0,40,18,1,1,3,0.8,1.2,14,35,-21,10,30,-20,"December, 2005"
2005-2006,20,2005-12-31,Middlesbrough,Man City,0,0,D,1,1,1,2,2,1,0,4,15,8,20,27,7,7,December,-2.4492935982947064e-16,1.0,29,27,3,2,0,1.4,0.8,23,28,-5,27,22,5,"December, 2005"
2005-2006,20,2005-12-31,Aston Villa,Arsenal,0,0,D,1,1,2,0,3,4,1,0,13,6,21,32,7,11,December,-2.4492935982947064e-16,1.0,1,0,0,1,4,0.6,2.2,23,29,-6,27,15,12,"December, 2005"
2005-2006,20,2005-12-31,Liverpool,West Brom,1,0,H,3,0,5,0,0,0,2,3,3,16,37,19,13,18,December,-2.4492935982947064e-16,1.0,25,44,4,0,0,4.0,0.0,25,9,16,19,28,-9,"December, 2005"
2005-2006,20,2005-12-31,Chelsea,Birmingham,2,0,H,3,0,3,0,2,1,2,2,1,19,52,13,18,39,December,-2.4492935982947064e-16,1.0,14,3,2,3,0,1.0,0.4,41,9,32,13,27,-14,"December, 2005"
2005-2006,20,2005-12-31,Charlton,West Ham,2,0,H,3,0,1,0,4,3,0,2,13,9,22,26,4,4,December,-2.4492935982947064e-16,1.0,13,45,2,2,1,2.2,1.8,21,27,-6,26,25,1,"December, 2005"
2005-2006,20,2005-12-31,Man United,Bolton,4,1,H,3,0,2,2,1,2,2,1,2,7,41,31,5,10,December,-2.4492935982947064e-16,1.0,28,6,3,2,0,2.2,0.8,36,16,20,22,14,8,"December, 2005"
2005-2006,21,2006-01-02,West Ham,Chelsea,1,3,A,0,3,3,0,2,3,0,2,10,1,26,55,9,29,January,0.4999999999999999,0.8660254037844387,45,14,3,0,2,1.4,2.0,26,27,-1,43,9,34,"January, 2006"
2005-2006,21,2006-01-02,West Brom,Aston Villa,1,2,A,0,3,0,2,3,2,0,3,17,16,19,22,1,3,January,0.4999999999999999,0.8660254037844387,44,1,0,3,1,0.75,1.0,19,29,-10,23,29,-6,"January, 2006"
2005-2006,21,2006-01-02,Newcastle,Middlesbrough,2,2,D,1,1,4,1,0,1,2,2,11,16,25,21,5,4,January,0.4999999999999999,0.8660254037844387,30,29,2,2,1,1.0,0.8,18,21,-3,23,28,-5,"January, 2006"
2005-2006,21,2006-01-02,Fulham,Sunderland,2,1,H,3,0,4,0,1,1,0,4,16,20,20,6,4,14,January,0.4999999999999999,0.8660254037844387,19,40,3,1,0,1.75,0.25,23,29,-6,14,36,-22,"January, 2006"
2005-2006,21,2006-01-02,Bolton,Liverpool,2,2,D,1,1,2,2,1,5,0,0,7,3,31,40,4,9,January,0.4999999999999999,0.8660254037844387,6,25,1,1,3,0.8,1.6,23,18,5,26,9,17,"January, 2006"
2005-2006,21,2006-01-02,Blackburn,Portsmouth,2,1,H,3,0,3,0,2,3,0,2,9,18,27,17,9,10,January,0.4999999999999999,0.8660254037844387,4,33,3,0,1,1.25,0.75,24,24,0,15,31,-16,"January, 2006"
2005-2006,21,2006-01-02,Birmingham,Wigan,2,0,H,3,0,1,2,2,1,0,4,19,5,13,34,14,21,January,0.4999999999999999,0.8660254037844387,3,46,0,0,0,0.0,0.0,13,29,-16,25,24,1,"January, 2006"
2005-2006,21,2006-01-02,Everton,Charlton,3,1,H,3,0,1,2,2,1,0,4,16,12,20,25,4,5,January,0.4999999999999999,0.8660254037844387,18,13,0,1,4,0.6,1.6,11,30,-19,23,27,-4,"January, 2006"
2005-2006,21,2006-01-03,Arsenal,Man United,0,0,D,1,1,4,1,0,2,2,1,6,2,33,44,4,11,January,0.4999999999999999,0.8660254037844387,0,28,0,3,2,1.0,1.8,27,15,12,40,17,23,"January, 2006"
2005-2006,21,2006-01-04,Man City,Tottenham,0,2,A,0,3,1,0,4,2,1,2,9,4,28,37,5,9,January,0.4999999999999999,0.8660254037844387,27,42,1,2,2,0.8,0.8,27,22,5,29,18,11,"January, 2006"
2005-2006,22,2006-01-14,Man City,Man United,3,1,H,3,0,1,0,4,2,2,1,10,2,28,45,8,17,January,0.4999999999999999,0.8660254037844387,27,28,1,2,2,1.2,1.4,27,24,3,40,17,23,"January, 2006"
2005-2006,22,2006-01-14,Portsmouth,Everton,0,1,A,0,3,3,0,2,1,2,2,18,15,17,23,3,6,January,0.4999999999999999,0.8660254037844387,33,18,1,0,4,0.6,1.2,16,33,-17,14,31,-17,"January, 2006"
2005-2006,22,2006-01-14,Liverpool,Tottenham,1,0,H,3,0,5,0,0,2,1,2,3,4,41,40,1,1,January,0.4999999999999999,0.8660254037844387,25,42,0,4,1,0.8,1.0,28,11,17,31,18,13,"January, 2006"
2005-2006,22,2006-01-14,Fulham,Newcastle,1,0,H,3,0,4,0,1,4,1,0,14,12,23,26,2,3,January,0.4999999999999999,0.8660254037844387,19,30,1,1,3,1.8,2.2,25,30,-5,20,23,-3,"January, 2006"
2005-2006,22,2006-01-14,Charlton,Birmingham,2,0,H,3,0,1,0,4,1,2,2,13,19,25,16,6,9,January,0.4999999999999999,0.8660254037844387,13,3,3,2,0,1.6,0.8,24,30,-6,15,29,-14,"January, 2006"
2005-2006,22,2006-01-14,Blackburn,Bolton,0,0,D,1,1,3,0,2,2,2,1,8,7,30,32,1,2,January,0.4999999999999999,0.8660254037844387,4,6,1,2,2,1.2,1.4,26,25,1,25,20,5,"January, 2006"
2005-2006,22,2006-01-14,Aston Villa,West Ham,1,2,A,0,3,2,0,3,3,0,2,12,10,25,26,2,1,January,0.4999999999999999,0.8660254037844387,1,45,2,2,1,1.8,1.8,25,30,-5,27,30,-3,"January, 2006"
2005-2006,22,2006-01-14,Arsenal,Middlesbrough,7,0,H,3,0,4,1,0,1,2,2,5,16,34,22,11,12,January,0.4999999999999999,0.8660254037844387,0,29,4,0,1,3.0,1.2,27,15,12,25,30,-5,"January, 2006"
2005-2006,22,2006-01-15,Sunderland,Chelsea,1,2,A,0,3,1,0,4,3,0,2,20,1,6,58,19,52,January,0.4999999999999999,0.8660254037844387,40,14,0,1,4,0.2,2.2,15,38,-23,46,10,36,"January, 2006"
2005-2006,22,2006-01-15,Wigan,West Brom,0,1,A,0,3,1,0,4,0,2,3,6,17,34,19,11,15,January,0.4999999999999999,0.8660254037844387,46,44,1,0,0,2.0,1.0,25,26,-1,20,31,-11,"January, 2006"
2005-2006,23,2006-01-21,West Brom,Sunderland,0,1,A,0,3,0,2,3,1,0,4,16,20,22,6,4,16,January,0.4999999999999999,0.8660254037844387,44,40,1,2,0,1.6666666666666667,1.3333333333333333,21,31,-10,16,40,-24,"January, 2006"
2005-2006,23,2006-01-21,Newcastle,Blackburn,0,1,A,0,3,4,1,0,3,0,2,14,9,26,31,5,5,January,0.4999999999999999,0.8660254037844387,30,4,2,2,1,1.8,0.8,20,24,-4,26,25,1,"January, 2006"
2005-2006,23,2006-01-21,Middlesbrough,Wigan,2,3,A,0,3,1,2,2,1,0,4,17,7,22,34,10,12,January,0.4999999999999999,0.8660254037844387,29,46,0,1,0,1.0,1.0,25,37,-12,25,27,-2,"January, 2006"
2005-2006,23,2006-01-21,Tottenham,Aston Villa,0,0,D,1,1,2,1,2,2,0,3,4,15,40,25,11,15,January,0.4999999999999999,0.8660254037844387,42,1,2,1,2,1.6,1.0,31,19,12,26,32,-6,"January, 2006"
2005-2006,23,2006-01-21,Bolton,Man City,2,0,H,3,0,2,2,1,1,0,4,7,8,33,31,1,2,January,0.4999999999999999,0.8660254037844387,6,27,2,0,3,1.0,2.0,25,20,5,30,25,5,"January, 2006"
2005-2006,23,2006-01-21,Birmingham,Portsmouth,5,0,H,3,0,1,2,2,3,0,2,19,18,16,17,1,1,January,0.4999999999999999,0.8660254037844387,3,33,1,3,1,1.0,1.0,15,31,-16,16,34,-18,"January, 2006"
2005-2006,23,2006-01-21,Everton,Arsenal,1,0,H,3,0,1,2,2,4,1,0,14,5,26,37,9,11,January,0.4999999999999999,0.8660254037844387,18,0,0,1,4,0.6,3.2,15,31,-16,34,15,19,"January, 2006"
2005-2006,23,2006-01-22,Chelsea,Charlton,1,1,D,1,1,3,0,2,1,0,4,1,12,61,28,11,33,January,0.4999999999999999,0.8660254037844387,14,13,4,0,1,2.0,0.8,48,11,37,26,30,-4,"January, 2006"
2005-2006,23,2006-01-22,Man United,Liverpool,1,0,H,3,0,2,2,1,5,0,0,2,3,45,44,1,1,January,0.4999999999999999,0.8660254037844387,28,25,3,1,1,1.0,0.6,41,20,21,29,11,18,"January, 2006"
2005-2006,23,2006-01-23,West Ham,Fulham,2,1,H,3,0,3,0,2,4,0,1,10,13,29,26,3,3,January,0.4999999999999999,0.8660254037844387,45,19,3,1,1,1.0,0.8,29,31,-2,26,30,-4,"January, 2006"
2005-2006,24,2006-01-31,Charlton,West Brom,0,0,D,1,1,1,0,4,0,2,3,11,16,29,22,5,7,January,0.4999999999999999,0.8660254037844387,13,44,4,0,1,1.2,1.0,27,31,-4,21,32,-11,"January, 2006"
2005-2006,24,2006-01-31,Fulham,Tottenham,1,0,H,3,0,4,0,1,2,1,2,13,4,26,41,9,15,January,0.4999999999999999,0.8660254037844387,19,42,3,0,2,1.4,0.8,27,32,-5,31,19,12,"January, 2006"
2005-2006,24,2006-01-31,Sunderland,Middlesbrough,0,3,A,0,3,1,0,4,1,2,2,20,17,9,22,3,13,January,0.4999999999999999,0.8660254037844387,40,29,1,0,4,0.6,1.8,17,40,-23,27,40,-13,"January, 2006"
2005-2006,24,2006-01-31,Wigan,Everton,1,1,D,1,1,1,0,4,1,2,2,6,13,37,29,7,8,January,0.4999999999999999,0.8660254037844387,46,18,1,0,0,1.0,0.0,28,29,-1,16,31,-15,"January, 2006"
2005-2006,24,2006-02-01,Man City,Newcastle,3,0,H,3,0,1,0,4,4,1,0,10,15,31,26,5,5,February,0.8660254037844386,0.5000000000000001,27,30,1,1,3,1.0,1.8,30,27,3,20,25,-5,"February, 2006"
2005-2006,24,2006-02-01,Portsmouth,Bolton,1,1,D,1,1,3,0,2,2,2,1,19,8,17,36,11,19,February,0.8660254037844386,0.5000000000000001,33,6,2,1,2,1.2,0.6,16,39,-23,27,20,7,"February, 2006"
2005-2006,24,2006-02-01,Liverpool,Birmingham,1,1,D,1,1,5,0,0,1,2,2,3,18,44,19,15,25,February,0.8660254037844386,0.5000000000000001,25,3,2,1,2,1.6,1.2,29,12,17,20,31,-11,"February, 2006"
2005-2006,24,2006-02-01,Blackburn,Man United,4,3,H,3,0,3,0,2,2,2,1,9,2,34,48,7,14,February,0.8660254037844386,0.5000000000000001,4,28,2,2,1,1.0,0.8,27,25,2,42,20,22,"February, 2006"
2005-2006,24,2006-02-01,Aston Villa,Chelsea,1,1,D,1,1,2,0,3,3,0,2,15,1,26,62,14,36,February,0.8660254037844386,0.5000000000000001,1,14,1,1,3,0.8,1.2,26,32,-6,49,12,37,"February, 2006"
2005-2006,24,2006-02-01,Arsenal,West Ham,2,3,A,0,3,4,1,0,3,0,2,6,9,37,32,3,5,February,0.8660254037844386,0.5000000000000001,0,45,2,3,0,1.6,0.8,34,16,18,31,32,-1,"February, 2006"
2005-2006,25,2006-02-04,Birmingham,Arsenal,0,2,A,0,3,1,2,2,4,1,0,18,6,20,37,12,17,February,0.8660254037844386,0.5000000000000001,3,0,1,1,3,0.4,1.6,21,32,-11,36,19,17,"February, 2006"
2005-2006,25,2006-02-04,Bolton,Wigan,1,1,D,1,1,2,2,1,1,0,4,7,6,37,38,1,1,February,0.8660254037844386,0.5000000000000001,6,46,0,0,1,1.0,2.0,28,21,7,29,30,-1,"February, 2006"
2005-2006,25,2006-02-04,Everton,Man City,1,0,H,3,0,1,2,2,1,0,4,12,10,30,34,2,4,February,0.8660254037844386,0.5000000000000001,18,27,2,1,2,0.8,1.6,17,32,-15,33,27,6,"February, 2006"
2005-2006,25,2006-02-04,Man United,Fulham,4,2,H,3,0,2,2,1,4,0,1,2,13,48,29,11,19,February,0.8660254037844386,0.5000000000000001,28,19,2,2,1,1.4,1.4,45,24,21,28,32,-4,"February, 2006"
2005-2006,25,2006-02-04,Middlesbrough,Aston Villa,0,4,A,0,3,1,2,2,2,0,3,16,14,25,27,2,2,February,0.8660254037844386,0.5000000000000001,29,1,3,0,2,1.8,1.2,30,40,-10,27,33,-6,"February, 2006"
2005-2006,25,2006-02-04,Newcastle,Portsmouth,2,0,H,3,0,4,1,0,3,0,2,15,19,26,18,4,8,February,0.8660254037844386,0.5000000000000001,30,33,1,4,0,1.2,0.6,20,28,-8,17,40,-23,"February, 2006"
2005-2006,25,2006-02-04,West Brom,Blackburn,2,0,H,3,0,0,2,3,3,0,2,17,8,23,37,9,14,February,0.8660254037844386,0.5000000000000001,44,4,0,3,2,0.6,1.4,21,32,-11,31,28,3,"February, 2006"
2005-2006,25,2006-02-04,West Ham,Sunderland,2,0,H,3,0,3,0,2,1,0,4,9,20,35,9,11,26,February,0.8660254037844386,0.5000000000000001,45,40,3,1,1,1.4,0.4,34,34,0,17,43,-26,"February, 2006"
2005-2006,25,2006-02-05,Tottenham,Charlton,3,1,H,3,0,2,1,2,1,0,4,4,13,41,30,9,11,February,0.8660254037844386,0.5000000000000001,42,13,2,0,3,1.8,2.0,31,20,11,27,31,-4,"February, 2006"
2005-2006,25,2006-02-05,Chelsea,Liverpool,2,0,H,3,0,3,0,2,5,0,0,1,3,63,45,2,18,February,0.8660254037844386,0.5000000000000001,14,25,4,0,1,1.6,0.6,50,13,37,30,13,17,"February, 2006"
2005-2006,25,2006-02-08,Charlton,Liverpool,2,0,H,3,0,1,0,4,5,0,0,13,3,30,45,10,15,February,0.8660254037844386,0.5000000000000001,13,25,2,0,3,1.2,1.6,28,34,-6,30,15,15,"February, 2006"
2005-2006,26,2006-02-11,Arsenal,Bolton,1,1,D,1,1,4,1,0,2,2,1,5,7,40,38,2,2,February,0.8660254037844386,0.5000000000000001,0,6,1,2,2,1.0,1.4,38,19,19,29,22,7,"February, 2006"
2005-2006,26,2006-02-11,Aston Villa,Newcastle,1,2,A,0,3,2,0,3,4,1,0,13,15,30,29,2,1,February,0.8660254037844386,0.5000000000000001,1,30,2,3,0,1.8,0.8,31,33,-2,22,28,-6,"February, 2006"
2005-2006,26,2006-02-11,Everton,Blackburn,1,0,H,3,0,1,2,2,3,0,2,12,9,33,37,3,4,February,0.8660254037844386,0.5000000000000001,18,4,1,1,3,0.6,0.8,18,32,-14,31,30,1,"February, 2006"
2005-2006,26,2006-02-11,Fulham,West Brom,6,1,H,3,0,4,0,1,0,2,3,15,16,29,26,1,3,February,0.8660254037844386,0.5000000000000001,19,44,2,2,1,1.0,0.4,30,36,-6,23,32,-9,"February, 2006"
2005-2006,26,2006-02-11,Portsmouth,Man United,1,3,A,0,3,3,0,2,2,2,1,19,2,18,51,17,33,February,0.8660254037844386,0.5000000000000001,33,28,2,0,3,0.8,1.6,17,42,-25,49,26,23,"February, 2006"
2005-2006,26,2006-02-11,Wigan,Liverpool,0,1,A,0,3,1,0,4,5,0,0,7,3,39,45,4,6,February,0.8660254037844386,0.5000000000000001,46,25,0,0,1,0.0,3.0,30,31,-1,30,17,13,"February, 2006"
2005-2006,26,2006-02-11,Middlesbrough,Chelsea,3,0,H,3,0,1,2,2,3,0,2,17,1,25,66,16,41,February,0.8660254037844386,0.5000000000000001,29,14,0,1,4,0.2,1.2,30,44,-14,52,13,39,"February, 2006"
2005-2006,26,2006-02-12,Sunderland,Tottenham,1,1,D,1,1,1,0,4,2,1,2,20,4,9,44,16,35,February,0.8660254037844386,0.5000000000000001,40,42,1,0,4,1.4,2.2,17,45,-28,34,21,13,"February, 2006"
2005-2006,26,2006-02-12,Man City,Charlton,3,2,H,3,0,1,0,4,1,0,4,11,12,34,33,1,1,February,0.8660254037844386,0.5000000000000001,27,13,3,2,0,3.0,1.0,33,28,5,30,34,-4,"February, 2006"
2005-2006,26,2006-02-13,West Ham,Birmingham,3,0,H,3,0,3,0,2,1,2,2,8,18,38,20,10,18,February,0.8660254037844386,0.5000000000000001,45,3,1,1,1,1.6666666666666667,1.6666666666666667,36,34,2,21,34,-13,"February, 2006"
2005-2006,26,2006-02-14,Liverpool,Arsenal,1,0,H,3,0,5,0,0,4,1,0,3,5,48,41,2,7,February,0.8660254037844386,0.5000000000000001,25,0,1,1,3,1.6,2.4,31,17,14,39,20,19,"February, 2006"
2005-2006,26,2006-02-15,Blackburn,Sunderland,2,0,H,3,0,3,0,2,1,0,4,10,20,37,10,10,27,February,0.8660254037844386,0.5000000000000001,4,40,1,2,2,0.2,0.8,31,31,0,18,46,-28,"February, 2006"
2005-2006,26,2006-02-19,Tottenham,Wigan,2,2,D,1,1,2,1,2,1,0,4,4,9,45,39,5,6,February,0.8660254037844386,0.5000000000000001,42,46,1,0,0,2.0,1.0,35,22,13,30,32,-2,"February, 2006"
2005-2006,26,2006-02-22,Newcastle,Charlton,0,0,D,1,1,4,1,0,1,0,4,14,12,32,33,2,1,February,0.8660254037844386,0.5000000000000001,30,13,2,3,0,1.4,0.6,24,29,-5,32,37,-5,"February, 2006"
2005-2006,27,2006-02-25,Birmingham,Sunderland,1,0,H,3,0,1,2,2,1,0,4,18,20,20,10,2,10,February,0.8660254037844386,0.5000000000000001,3,40,3,0,0,1.3333333333333333,0.0,21,37,-16,18,48,-30,"February, 2006"
2005-2006,27,2006-02-25,Blackburn,Arsenal,1,0,H,3,0,3,0,2,4,1,0,7,5,40,41,2,1,February,0.8660254037844386,0.5000000000000001,4,0,0,0,5,0.0,2.0,33,31,2,39,21,18,"February, 2006"
2005-2006,27,2006-02-25,Charlton,Aston Villa,0,0,D,1,1,1,0,4,2,0,3,12,15,34,30,3,4,February,0.8660254037844386,0.5000000000000001,13,1,1,1,3,1.0,1.0,32,37,-5,32,35,-3,"February, 2006"
2005-2006,27,2006-02-25,Chelsea,Portsmouth,2,0,H,3,0,3,0,2,3,0,2,1,19,66,18,18,48,February,0.8660254037844386,0.5000000000000001,14,33,5,0,0,2.4,0.0,52,16,36,18,45,-27,"February, 2006"
2005-2006,27,2006-02-25,Newcastle,Everton,2,0,H,3,0,4,1,0,1,2,2,13,11,33,36,2,3,February,0.8660254037844386,0.5000000000000001,30,18,1,2,2,1.4,1.6,24,29,-5,19,32,-13,"February, 2006"
2005-2006,27,2006-02-26,Bolton,Fulham,2,1,H,3,0,2,2,1,4,0,1,9,14,39,32,5,7,February,0.8660254037844386,0.5000000000000001,6,19,1,0,4,1.0,1.8,30,23,7,36,37,-1,"February, 2006"
2005-2006,27,2006-02-26,Liverpool,Man City,1,0,H,3,0,5,0,0,1,0,4,3,10,51,37,7,14,February,0.8660254037844386,0.5000000000000001,25,27,3,1,1,1.4,1.0,32,17,15,36,30,6,"February, 2006"
2005-2006,27,2006-02-26,West Brom,Middlesbrough,0,2,A,0,3,0,2,3,1,2,2,17,16,26,28,1,2,February,0.8660254037844386,0.5000000000000001,44,29,1,1,3,0.8,2.2,24,38,-14,33,44,-11,"February, 2006"
2005-2006,28,2006-03-04,West Ham,Everton,2,2,D,1,1,3,0,2,1,2,2,8,13,41,36,5,5,March,1.0,6.123233995736766e-17,45,18,2,1,2,0.6,1.4,39,34,5,19,34,-15,"March, 2006"
2005-2006,28,2006-03-04,Newcastle,Bolton,3,1,H,3,0,4,1,0,2,2,1,11,7,36,42,4,6,March,1.0,6.123233995736766e-17,30,6,1,1,3,0.6,1.2,26,29,-3,32,24,8,"March, 2006"
2005-2006,28,2006-03-04,Middlesbrough,Birmingham,1,0,H,3,0,1,2,2,1,2,2,16,18,31,23,2,8,March,1.0,6.123233995736766e-17,29,3,3,0,2,2.2,1.8,35,44,-9,22,37,-15,"March, 2006"
2005-2006,28,2006-03-04,West Brom,Chelsea,1,2,A,0,3,0,2,3,3,0,2,17,1,26,69,16,43,March,1.0,6.123233995736766e-17,44,14,0,0,5,0.2,2.6,24,40,-16,54,16,38,"March, 2006"
2005-2006,28,2006-03-04,Fulham,Arsenal,0,4,A,0,3,4,0,1,4,1,0,15,7,32,41,8,9,March,1.0,6.123233995736766e-17,19,0,0,1,4,0.2,2.0,37,39,-2,39,22,17,"March, 2006"
2005-2006,28,2006-03-04,Aston Villa,Portsmouth,1,0,H,3,0,2,0,3,3,0,2,15,19,31,18,4,13,March,1.0,6.123233995736766e-17,1,33,3,1,1,1.8,1.0,32,35,-3,18,47,-29,"March, 2006"
2005-2006,28,2006-03-04,Liverpool,Charlton,0,0,D,1,1,5,0,0,1,0,4,3,13,54,35,10,19,March,1.0,6.123233995736766e-17,25,13,2,0,3,1.2,1.4,33,17,16,32,37,-5,"March, 2006"
2005-2006,28,2006-03-05,Man City,Sunderland,2,1,H,3,0,1,0,4,1,0,4,11,20,37,10,9,27,March,1.0,6.123233995736766e-17,27,40,4,0,1,2.4,0.8,36,31,5,18,49,-31,"March, 2006"
2005-2006,28,2006-03-05,Tottenham,Blackburn,3,2,H,3,0,2,1,2,3,0,2,4,6,46,43,2,3,March,1.0,6.123233995736766e-17,42,4,2,2,1,0.4,0.2,37,24,13,34,31,3,"March, 2006"
2005-2006,28,2006-03-06,Wigan,Man United,1,2,A,0,3,1,0,4,2,2,1,10,3,40,54,7,14,March,1.0,6.123233995736766e-17,46,28,0,0,1,0.0,4.0,32,34,-2,52,27,25,"March, 2006"
2005-2006,29,2006-03-11,Sunderland,Wigan,0,1,A,0,3,1,0,4,1,0,4,20,10,10,40,10,30,March,1.0,6.123233995736766e-17,40,46,0,0,1,0.0,1.0,19,51,-32,33,36,-3,"March, 2006"
2005-2006,29,2006-03-11,Portsmouth,Man City,2,1,H,3,0,3,0,2,1,0,4,19,9,18,40,10,22,March,1.0,6.123233995736766e-17,33,27,1,1,3,1.4,2.0,18,48,-30,38,32,6,"March, 2006"
2005-2006,29,2006-03-11,Everton,Fulham,3,1,H,3,0,1,2,2,4,0,1,12,16,37,32,4,5,March,1.0,6.123233995736766e-17,18,19,2,0,3,1.0,1.2,21,36,-15,37,43,-6,"March, 2006"
2005-2006,29,2006-03-11,Chelsea,Tottenham,2,1,H,3,0,3,0,2,2,1,2,1,4,72,49,3,23,March,1.0,6.123233995736766e-17,14,42,4,1,0,1.8,0.4,56,17,39,40,26,14,"March, 2006"
2005-2006,29,2006-03-11,Blackburn,Aston Villa,2,0,H,3,0,3,0,2,2,0,3,6,14,43,34,8,9,March,1.0,6.123233995736766e-17,4,1,1,1,3,0.8,1.2,36,34,2,33,35,-2,"March, 2006"
2005-2006,29,2006-03-11,Birmingham,West Brom,1,1,D,1,1,1,2,2,0,2,3,18,17,23,26,1,3,March,1.0,6.123233995736766e-17,3,44,3,1,1,1.8,1.0,22,38,-16,25,42,-17,"March, 2006"
2005-2006,29,2006-03-11,Bolton,West Ham,4,1,H,3,0,2,2,1,3,0,2,7,8,42,42,1,0,March,1.0,6.123233995736766e-17,6,45,3,1,1,1.2,0.8,33,27,6,41,36,5,"March, 2006"
2005-2006,29,2006-03-12,Arsenal,Liverpool,2,1,H,3,0,4,1,0,5,0,0,7,3,44,55,4,11,March,1.0,6.123233995736766e-17,0,25,3,0,2,2.0,1.4,43,22,21,33,17,16,"March, 2006"
2005-2006,29,2006-03-12,Charlton,Middlesbrough,2,1,H,3,0,1,0,4,1,2,2,13,15,36,34,2,2,March,1.0,6.123233995736766e-17,13,29,2,2,1,1.4,0.8,32,37,-5,36,44,-8,"March, 2006"
2005-2006,29,2006-03-12,Man United,Newcastle,2,0,H,3,0,2,2,1,4,1,0,2,12,57,39,10,18,March,1.0,6.123233995736766e-17,28,30,4,1,0,1.8,0.6,54,28,26,29,30,-1,"March, 2006"
2005-2006,29,2006-03-15,Liverpool,Fulham,5,1,H,3,0,5,0,0,4,0,1,3,16,55,32,13,23,March,1.0,6.123233995736766e-17,25,19,3,1,1,1.8,1.2,34,19,15,38,46,-8,"March, 2006"
2005-2006,30,2006-03-18,Man City,Wigan,0,1,A,0,3,1,0,4,1,0,4,11,8,40,43,3,3,March,1.0,6.123233995736766e-17,27,46,0,0,1,3.0,4.0,39,34,5,34,36,-2,"March, 2006"
2005-2006,30,2006-03-18,West Brom,Man United,1,2,A,0,3,0,2,3,2,2,1,17,2,27,60,15,33,March,1.0,6.123233995736766e-17,44,28,0,1,4,0.4,2.2,26,43,-17,56,28,28,"March, 2006"
2005-2006,30,2006-03-18,Everton,Aston Villa,4,1,H,3,0,1,2,2,2,0,3,11,14,40,34,3,6,March,1.0,6.123233995736766e-17,18,1,2,2,1,1.2,1.2,24,37,-13,33,37,-4,"March, 2006"
2005-2006,30,2006-03-18,West Ham,Portsmouth,2,4,A,0,3,3,0,2,3,0,2,10,19,42,21,9,21,March,1.0,6.123233995736766e-17,45,33,0,1,0,1.0,1.0,42,40,2,20,49,-29,"March, 2006"
2005-2006,30,2006-03-18,Blackburn,Middlesbrough,3,2,H,3,0,3,0,2,1,2,2,6,15,46,34,9,12,March,1.0,6.123233995736766e-17,4,29,2,1,2,1.0,1.4,38,34,4,37,46,-9,"March, 2006"
2005-2006,30,2006-03-18,Birmingham,Tottenham,0,2,A,0,3,1,2,2,2,1,2,18,5,24,49,13,25,March,1.0,6.123233995736766e-17,3,42,1,1,3,0.6,1.6,23,39,-16,41,28,13,"March, 2006"
2005-2006,30,2006-03-18,Arsenal,Charlton,3,0,H,3,0,4,1,0,1,0,4,5,13,47,39,8,8,March,1.0,6.123233995736766e-17,0,13,4,1,0,2.2,0.6,45,23,22,34,38,-4,"March, 2006"
2005-2006,30,2006-03-18,Bolton,Sunderland,2,0,H,3,0,2,2,1,1,0,4,7,20,45,10,13,35,March,1.0,6.123233995736766e-17,6,40,1,2,2,0.6,0.8,37,28,9,19,52,-33,"March, 2006"
2005-2006,30,2006-03-19,Newcastle,Liverpool,1,3,A,0,3,4,1,0,5,0,0,12,3,39,58,9,19,March,1.0,6.123233995736766e-17,30,25,1,2,2,0.8,1.4,29,32,-3,39,20,19,"March, 2006"
2005-2006,30,2006-03-19,Fulham,Chelsea,1,0,H,3,0,4,0,1,3,0,2,16,1,32,75,15,43,March,1.0,6.123233995736766e-17,19,14,0,0,5,1.0,2.6,39,51,-12,58,18,40,"March, 2006"
2005-2006,31,2006-03-25,Aston Villa,Fulham,0,0,D,1,1,2,0,3,4,0,1,15,14,34,35,1,1,March,1.0,6.123233995736766e-17,1,19,3,2,0,2.2,1.0,34,41,-7,40,51,-11,"March, 2006"
2005-2006,31,2006-03-25,Chelsea,Man City,2,0,H,3,0,3,0,2,1,0,4,1,11,75,40,10,35,March,1.0,6.123233995736766e-17,14,27,3,1,1,0.6,0.2,58,19,39,39,35,4,"March, 2006"
2005-2006,31,2006-03-25,Liverpool,Everton,3,1,H,3,0,5,0,0,1,2,2,3,9,61,43,6,18,March,1.0,6.123233995736766e-17,25,18,3,1,1,1.6,0.6,42,21,21,28,38,-10,"March, 2006"
2005-2006,31,2006-03-25,Sunderland,Blackburn,0,1,A,0,3,1,0,4,3,0,2,20,6,10,49,14,39,March,1.0,6.123233995736766e-17,40,4,2,2,1,0.8,0.4,19,54,-35,41,36,5,"March, 2006"
2005-2006,31,2006-03-25,Wigan,West Ham,1,2,A,0,3,1,0,4,3,0,2,8,10,46,42,2,4,March,1.0,6.123233995736766e-17,46,45,1,0,0,2.0,0.0,35,36,-1,44,44,0,"March, 2006"
2005-2006,31,2006-03-26,Charlton,Newcastle,3,1,H,3,0,1,0,4,4,1,0,13,12,39,39,1,0,March,1.0,6.123233995736766e-17,13,30,0,4,1,0.6,1.0,34,41,-7,30,35,-5,"March, 2006"
2005-2006,31,2006-03-26,Man United,Birmingham,3,0,H,3,0,2,2,1,1,2,2,3,18,63,24,15,39,March,1.0,6.123233995736766e-17,28,3,3,2,0,1.8,0.6,58,29,29,23,41,-18,"March, 2006"
2005-2006,31,2006-03-26,Middlesbrough,Bolton,4,3,H,3,0,1,2,2,2,2,1,16,7,34,48,9,14,March,1.0,6.123233995736766e-17,29,6,1,2,2,0.8,1.0,39,49,-10,39,28,11,"March, 2006"
2005-2006,31,2006-03-27,Tottenham,West Brom,2,1,H,3,0,2,1,2,0,2,3,4,17,52,27,13,25,March,1.0,6.123233995736766e-17,42,44,2,2,1,1.6,1.4,43,28,15,27,45,-18,"March, 2006"
2005-2006,31,2006-03-29,Man United,West Ham,1,0,H,3,0,2,2,1,3,0,2,2,9,66,45,7,21,March,1.0,6.123233995736766e-17,28,45,3,1,1,2.2,1.2,61,29,32,46,45,1,"March, 2006"
2005-2006,32,2006-04-01,West Brom,Liverpool,0,2,A,0,3,0,2,3,5,0,0,17,3,27,64,14,37,April,0.8660254037844388,-0.4999999999999998,44,25,0,0,5,0.0,3.4,28,47,-19,45,22,23,"April, 2006"
2005-2006,32,2006-04-01,Newcastle,Tottenham,3,1,H,3,0,4,1,0,2,1,2,13,4,39,55,9,16,April,0.8660254037844388,-0.4999999999999998,30,42,1,0,4,0.8,1.0,31,38,-7,45,29,16,"April, 2006"
2005-2006,32,2006-04-01,Fulham,Portsmouth,1,3,A,0,3,4,0,1,3,0,2,15,19,36,24,4,12,April,0.8660254037844388,-0.4999999999999998,19,33,2,1,2,1.8,1.4,40,51,-11,24,51,-27,"April, 2006"
2005-2006,32,2006-04-01,Birmingham,Chelsea,0,0,D,1,1,1,2,2,3,0,2,18,1,24,78,17,54,April,0.8660254037844388,-0.4999999999999998,3,14,0,3,2,0.2,0.8,23,44,-21,60,19,41,"April, 2006"
2005-2006,32,2006-04-01,Bolton,Man United,1,2,A,0,3,2,2,1,2,2,1,7,2,48,69,5,21,April,0.8660254037844388,-0.4999999999999998,6,28,0,1,4,0.8,2.8,42,32,10,62,29,33,"April, 2006"
2005-2006,32,2006-04-01,Arsenal,Aston Villa,5,0,H,3,0,4,1,0,2,0,3,6,16,50,35,10,15,April,0.8660254037844388,-0.4999999999999998,0,1,4,1,0,2.0,0.4,48,23,25,34,41,-7,"April, 2006"
2005-2006,32,2006-04-01,Everton,Sunderland,2,2,D,1,1,1,2,2,1,0,4,10,20,43,10,10,33,April,0.8660254037844388,-0.4999999999999998,18,40,4,0,1,1.0,0.4,29,41,-12,19,55,-36,"April, 2006"
2005-2006,32,2006-04-02,Man City,Middlesbrough,0,1,A,0,3,1,0,4,1,2,2,13,14,40,37,1,3,April,0.8660254037844388,-0.4999999999999998,27,29,0,2,3,0.8,1.4,39,37,2,43,52,-9,"April, 2006"
2005-2006,32,2006-04-02,West Ham,Charlton,0,0,D,1,1,3,0,2,1,0,4,9,11,45,42,2,3,April,0.8660254037844388,-0.4999999999999998,45,13,1,1,3,1.6,2.4,46,46,0,37,42,-5,"April, 2006"
2005-2006,32,2006-04-03,Blackburn,Wigan,1,1,D,1,1,3,0,2,1,0,4,6,9,52,46,3,6,April,0.8660254037844388,-0.4999999999999998,4,46,1,0,0,3.0,0.0,42,36,6,36,38,-2,"April, 2006"
2005-2006,32,2006-04-04,Birmingham,Bolton,1,0,H,3,0,1,2,2,2,2,1,19,7,25,48,12,23,April,0.8660254037844388,-0.4999999999999998,3,6,2,1,2,1.4,1.4,23,44,-21,43,34,9,"April, 2006"
2005-2006,33,2006-04-08,Wigan,Birmingham,1,1,D,1,1,1,0,4,1,2,2,8,17,47,28,9,19,April,0.8660254037844388,-0.4999999999999998,46,3,0,0,1,0.0,2.0,37,39,-2,24,44,-20,"April, 2006"
2005-2006,33,2006-04-08,Tottenham,Man City,2,1,H,3,0,2,1,2,1,0,4,4,13,55,40,9,15,April,0.8660254037844388,-0.4999999999999998,42,27,3,2,0,1.2,0.4,46,32,14,39,38,1,"April, 2006"
2005-2006,33,2006-04-08,Charlton,Everton,0,0,D,1,1,1,0,4,1,2,2,11,10,43,44,1,1,April,0.8660254037844388,-0.4999999999999998,13,18,3,1,1,1.4,1.0,37,42,-5,31,43,-12,"April, 2006"
2005-2006,33,2006-04-08,Portsmouth,Blackburn,2,2,D,1,1,3,0,2,3,0,2,19,6,27,53,13,26,April,0.8660254037844388,-0.4999999999999998,33,4,1,0,4,0.8,1.4,27,52,-25,43,37,6,"April, 2006"
2005-2006,33,2006-04-09,Aston Villa,West Brom,0,0,D,1,1,2,0,3,0,2,3,16,19,35,27,3,8,April,0.8660254037844388,-0.4999999999999998,1,44,2,3,0,1.2,0.8,34,46,-12,28,49,-21,"April, 2006"
2005-2006,33,2006-04-09,Chelsea,West Ham,4,1,H,3,0,3,0,2,3,0,2,1,9,79,46,8,33,April,0.8660254037844388,-0.4999999999999998,14,45,2,0,3,2.2,1.6,60,19,41,46,46,0,"April, 2006"
2005-2006,33,2006-04-09,Liverpool,Bolton,1,0,H,3,0,5,0,0,2,2,1,3,7,67,48,4,19,April,0.8660254037844388,-0.4999999999999998,25,6,2,2,1,1.6,1.2,47,22,25,43,35,8,"April, 2006"
2005-2006,33,2006-04-09,Man United,Arsenal,2,0,H,3,0,2,2,1,4,1,0,2,6,72,53,4,19,April,0.8660254037844388,-0.4999999999999998,28,0,2,3,0,1.4,0.6,64,30,34,53,23,30,"April, 2006"
2005-2006,33,2006-04-09,Middlesbrough,Newcastle,1,2,A,0,3,1,2,2,4,1,0,14,12,40,42,2,2,April,0.8660254037844388,-0.4999999999999998,29,30,0,3,2,1.0,1.4,44,52,-8,34,39,-5,"April, 2006"
2005-2006,33,2006-04-12,Portsmouth,Arsenal,1,1,D,1,1,3,0,2,4,1,0,19,6,28,53,13,25,April,0.8660254037844388,-0.4999999999999998,33,0,0,2,3,0.4,2.0,29,54,-25,53,25,28,"April, 2006"
2005-2006,34,2006-04-14,Man United,Sunderland,0,0,D,1,1,2,2,1,1,0,4,2,20,75,11,18,64,April,0.8660254037844388,-0.4999999999999998,28,40,4,1,0,2.6,1.0,66,30,36,21,57,-36,"April, 2006"
2005-2006,34,2006-04-15,Bolton,Chelsea,0,2,A,0,3,2,2,1,3,0,2,7,1,48,82,6,34,April,0.8660254037844388,-0.4999999999999998,6,14,1,1,3,1.0,2.4,43,36,7,64,20,44,"April, 2006"
2005-2006,34,2006-04-15,West Ham,Man City,1,0,H,3,0,3,0,2,1,0,4,10,13,46,40,3,6,April,0.8660254037844388,-0.4999999999999998,45,27,2,1,2,1.2,0.8,47,50,-3,40,40,0,"April, 2006"
2005-2006,34,2006-04-15,Portsmouth,Middlesbrough,1,0,H,3,0,3,0,2,1,2,2,18,14,29,40,4,11,April,0.8660254037844388,-0.4999999999999998,33,29,2,3,0,1.8,0.8,30,55,-25,45,54,-9,"April, 2006"
2005-2006,34,2006-04-15,Newcastle,Wigan,3,1,H,3,0,4,1,0,1,0,4,10,8,45,48,2,3,April,0.8660254037844388,-0.4999999999999998,30,46,0,0,1,0.0,1.0,36,40,-4,38,40,-2,"April, 2006"
2005-2006,34,2006-04-15,Arsenal,West Brom,3,1,H,3,0,4,1,0,0,2,3,5,19,54,28,14,26,April,0.8660254037844388,-0.4999999999999998,0,44,3,1,1,2.2,1.2,54,26,28,28,49,-21,"April, 2006"
2005-2006,34,2006-04-15,Everton,Tottenham,0,1,A,0,3,1,2,2,2,1,2,11,4,45,58,7,13,April,0.8660254037844388,-0.4999999999999998,18,42,1,0,4,1.0,2.4,31,43,-12,48,33,15,"April, 2006"
2005-2006,34,2006-04-15,Fulham,Charlton,2,1,H,3,0,4,0,1,1,0,4,16,12,36,44,4,8,April,0.8660254037844388,-0.4999999999999998,19,13,1,2,2,1.0,1.2,41,54,-13,37,42,-5,"April, 2006"
2005-2006,34,2006-04-16,Aston Villa,Birmingham,3,1,H,3,0,2,0,3,1,2,2,16,18,36,29,2,7,April,0.8660254037844388,-0.4999999999999998,1,3,1,2,2,0.8,1.2,34,46,-12,25,45,-20,"April, 2006"
2005-2006,34,2006-04-16,Blackburn,Liverpool,0,1,A,0,3,3,0,2,5,0,0,6,3,54,70,3,16,April,0.8660254037844388,-0.4999999999999998,4,25,0,2,3,0.6,2.0,45,39,6,48,22,26,"April, 2006"
2005-2006,34,2006-04-17,Tottenham,Man United,1,2,A,0,3,2,1,2,2,2,1,4,2,61,76,2,15,April,0.8660254037844388,-0.4999999999999998,42,28,0,2,3,0.4,1.4,49,33,16,66,30,36,"April, 2006"
2005-2006,34,2006-04-17,West Brom,Bolton,0,0,D,1,1,0,2,3,2,2,1,19,9,28,48,10,20,April,0.8660254037844388,-0.4999999999999998,44,6,1,3,1,1.0,1.2,29,52,-23,43,38,5,"April, 2006"
2005-2006,34,2006-04-17,Sunderland,Newcastle,1,4,A,0,3,1,0,4,4,1,0,20,9,12,48,11,36,April,0.8660254037844388,-0.4999999999999998,40,30,0,1,4,0.6,1.6,21,57,-36,39,41,-2,"April, 2006"
2005-2006,34,2006-04-17,Chelsea,Everton,3,0,H,3,0,3,0,2,1,2,2,1,12,85,45,11,40,April,0.8660254037844388,-0.4999999999999998,14,18,3,2,0,0.8,0.2,66,20,46,31,44,-13,"April, 2006"
2005-2006,34,2006-04-17,Middlesbrough,West Ham,2,0,H,3,0,1,2,2,3,0,2,14,7,40,49,7,9,April,0.8660254037844388,-0.4999999999999998,29,45,1,1,3,1.0,1.2,45,55,-10,48,50,-2,"April, 2006"
2005-2006,34,2006-04-17,Charlton,Portsmouth,2,1,H,3,0,1,0,4,3,0,2,12,17,44,32,5,12,April,0.8660254037844388,-0.4999999999999998,13,33,3,1,1,1.8,1.6,38,44,-6,31,55,-24,"April, 2006"
2005-2006,34,2006-04-18,Wigan,Aston Villa,3,2,H,3,0,1,0,4,2,0,3,10,15,48,39,5,9,April,0.8660254037844388,-0.4999999999999998,46,1,1,0,0,2.0,0.0,39,43,-4,37,47,-10,"April, 2006"
2005-2006,34,2006-04-19,Birmingham,Blackburn,2,1,H,3,0,1,2,2,3,0,2,18,6,29,54,12,25,April,0.8660254037844388,-0.4999999999999998,3,4,1,2,2,1.2,2.2,26,48,-22,45,40,5,"April, 2006"
2005-2006,35,2006-04-22,Arsenal,Tottenham,1,1,D,1,1,4,1,0,2,1,2,5,4,57,61,1,4,April,0.8660254037844388,-0.4999999999999998,0,42,3,2,0,2.2,1.6,57,27,30,50,35,15,"April, 2006"
2005-2006,35,2006-04-22,Bolton,Charlton,4,1,H,3,0,2,2,1,1,0,4,9,11,49,47,2,2,April,0.8660254037844388,-0.4999999999999998,6,13,4,1,0,1.8,0.6,43,38,5,40,45,-5,"April, 2006"
2005-2006,35,2006-04-22,Everton,Birmingham,0,0,D,1,1,1,2,2,1,2,2,12,17,45,32,5,13,April,0.8660254037844388,-0.4999999999999998,18,3,3,1,1,0.8,0.8,31,47,-16,28,49,-21,"April, 2006"
2005-2006,35,2006-04-22,Newcastle,West Brom,3,0,H,3,0,4,1,0,0,2,3,8,19,51,29,11,22,April,0.8660254037844388,-0.4999999999999998,30,44,3,2,0,2.0,0.8,43,42,1,29,52,-23,"April, 2006"
2005-2006,35,2006-04-22,Portsmouth,Sunderland,2,1,H,3,0,3,0,2,1,0,4,18,20,32,12,2,20,April,0.8660254037844388,-0.4999999999999998,33,40,1,0,0,4.0,1.0,32,57,-25,22,61,-39,"April, 2006"
2005-2006,36,2006-04-24,Fulham,Wigan,1,0,H,3,0,4,0,1,1,0,4,16,9,39,51,7,12,April,0.8660254037844388,-0.4999999999999998,19,46,0,0,1,0.0,1.0,43,55,-12,42,45,-3,"April, 2006"
2005-2006,36,2006-04-25,Aston Villa,Man City,0,1,A,0,3,2,0,3,1,0,4,16,15,39,40,1,1,April,0.8660254037844388,-0.4999999999999998,1,27,0,1,4,0.8,2.4,39,50,-11,40,41,-1,"April, 2006"
2005-2006,36,2006-04-26,West Ham,Liverpool,1,2,A,0,3,3,0,2,5,0,0,10,3,49,73,7,24,April,0.8660254037844388,-0.4999999999999998,45,25,0,1,4,0.4,2.0,48,52,-4,49,22,27,"April, 2006"
2005-2006,37,2006-04-29,Birmingham,Newcastle,0,0,D,1,1,1,2,2,4,1,0,18,7,33,54,11,21,April,0.8660254037844388,-0.4999999999999998,3,30,1,2,2,1.0,1.2,28,49,-21,46,42,4,"April, 2006"
2005-2006,37,2006-04-29,Charlton,Blackburn,0,2,A,0,3,1,0,4,3,0,2,11,7,47,54,4,7,April,0.8660254037844388,-0.4999999999999998,13,4,3,0,2,1.2,1.4,41,49,-8,46,42,4,"April, 2006"
2005-2006,37,2006-04-29,Chelsea,Man United,3,0,H,3,0,3,0,2,2,2,1,1,2,88,79,1,9,April,0.8660254037844388,-0.4999999999999998,14,28,3,1,1,1.2,0.6,69,20,49,68,31,37,"April, 2006"
2005-2006,37,2006-04-29,Liverpool,Aston Villa,3,1,H,3,0,5,0,0,2,0,3,3,16,76,39,13,37,April,0.8660254037844388,-0.4999999999999998,25,1,3,2,0,1.2,0.4,51,23,28,39,51,-12,"April, 2006"
2005-2006,37,2006-04-29,Man City,Fulham,1,2,A,0,3,1,0,4,4,0,1,13,15,43,42,2,1,April,0.8660254037844388,-0.4999999999999998,27,19,0,4,1,1.0,1.2,41,41,0,44,55,-11,"April, 2006"
2005-2006,37,2006-04-29,Middlesbrough,Everton,0,1,A,0,3,1,2,2,1,2,2,15,12,43,46,3,3,April,0.8660254037844388,-0.4999999999999998,29,18,1,2,2,0.6,0.8,47,55,-8,31,47,-16,"April, 2006"
2005-2006,37,2006-04-29,Wigan,Portsmouth,1,2,A,0,3,1,0,4,3,0,2,9,17,51,35,8,16,April,0.8660254037844388,-0.4999999999999998,46,33,1,0,0,2.0,0.0,42,46,-4,34,58,-24,"April, 2006"
2005-2006,37,2006-04-30,Tottenham,Bolton,1,0,H,3,0,2,1,2,2,2,1,4,8,62,52,4,10,April,0.8660254037844388,-0.4999999999999998,42,6,0,0,5,0.4,1.8,51,36,15,47,39,8,"April, 2006"
2005-2006,37,2006-05-01,Man United,Middlesbrough,0,0,D,1,1,2,2,1,1,2,2,2,15,79,43,13,36,May,0.4999999999999999,-0.8660254037844387,28,29,2,1,2,1.4,1.6,68,34,34,47,56,-9,"May, 2006"
2005-2006,37,2006-05-01,Sunderland,Arsenal,0,3,A,0,3,1,0,4,4,1,0,20,5,12,58,15,46,May,0.4999999999999999,-0.8660254037844387,40,0,0,1,4,0.6,2.8,23,63,-40,58,28,30,"May, 2006"
2005-2006,37,2006-05-01,West Brom,West Ham,0,1,A,0,3,0,2,3,3,0,2,19,10,29,49,9,20,May,0.4999999999999999,-0.8660254037844387,44,45,1,0,2,0.6666666666666666,1.0,29,55,-26,49,54,-5,"May, 2006"
2005-2006,37,2006-05-02,Blackburn,Chelsea,1,0,H,3,0,3,0,2,3,0,2,6,1,57,91,5,34,May,0.4999999999999999,-0.8660254037844387,4,14,0,1,4,1.2,2.8,48,42,6,72,20,52,"May, 2006"
2005-2006,37,2006-05-03,Bolton,Middlesbrough,1,1,D,1,1,2,2,1,1,2,2,8,14,52,44,6,8,May,0.4999999999999999,-0.8660254037844387,6,29,1,2,2,1.2,1.4,47,40,7,47,56,-9,"May, 2006"
2005-2006,37,2006-05-04,Man City,Arsenal,1,3,A,0,3,1,0,4,4,1,0,15,5,43,61,10,18,May,0.4999999999999999,-0.8660254037844387,27,0,0,1,4,0.6,1.4,42,43,-1,61,28,33,"May, 2006"
2005-2006,37,2006-05-04,Sunderland,Fulham,2,1,H,3,0,1,0,4,4,0,1,20,14,12,45,6,33,May,0.4999999999999999,-0.8660254037844387,40,19,0,1,4,0.4,1.8,23,66,-43,46,56,-10,"May, 2006"
2005-2006,38,2006-05-07,Newcastle,Chelsea,1,0,H,3,0,4,1,0,3,0,2,8,1,55,91,7,36,May,0.4999999999999999,-0.8660254037844387,30,14,1,1,3,0.6,2.8,46,42,4,72,21,51,"May, 2006"
2005-2006,38,2006-05-07,Man United,Charlton,4,0,H,3,0,2,2,1,1,0,4,2,13,80,47,11,33,May,0.4999999999999999,-0.8660254037844387,28,13,5,0,0,2.6,0.2,68,34,34,41,51,-10,"May, 2006"
2005-2006,38,2006-05-07,Fulham,Middlesbrough,1,0,H,3,0,4,0,1,1,2,2,14,13,45,45,1,0,May,0.4999999999999999,-0.8660254037844387,19,29,1,1,3,1.4,2.0,47,58,-11,48,57,-9,"May, 2006"
2005-2006,38,2006-05-07,Everton,West Brom,2,2,D,1,1,1,2,2,0,2,3,11,19,49,29,8,20,May,0.4999999999999999,-0.8660254037844387,18,44,3,0,2,1.0,1.4,32,47,-15,29,56,-27,"May, 2006"
2005-2006,38,2006-05-07,Aston Villa,Sunderland,2,1,H,3,0,2,0,3,1,0,4,16,20,39,15,4,24,May,0.4999999999999999,-0.8660254037844387,1,40,2,2,1,1.0,0.6,40,54,-14,25,67,-42,"May, 2006"
2005-2006,38,2006-05-07,Blackburn,Man City,2,0,H,3,0,3,0,2,1,0,4,6,15,60,43,9,17,May,0.4999999999999999,-0.8660254037844387,4,27,0,4,1,0.8,1.0,49,42,7,43,46,-3,"May, 2006"
2005-2006,38,2006-05-07,Portsmouth,Liverpool,1,3,A,0,3,3,0,2,5,0,0,17,3,38,79,14,41,May,0.4999999999999999,-0.8660254037844387,33,25,1,1,3,0.6,1.8,36,59,-23,54,24,30,"May, 2006"
2005-2006,38,2006-05-07,Arsenal,Wigan,4,2,H,3,0,4,1,0,1,0,4,5,10,64,51,5,13,May,0.4999999999999999,-0.8660254037844387,0,46,1,0,0,3.0,2.0,64,29,35,43,48,-5,"May, 2006"
2005-2006,38,2006-05-07,Bolton,Birmingham,1,0,H,3,0,2,2,1,1,2,2,8,18,53,34,10,19,May,0.4999999999999999,-0.8660254037844387,6,3,1,1,3,0.6,1.2,48,41,7,28,49,-21,"May, 2006"
2005-2006,38,2006-05-07,West Ham,Tottenham,2,1,H,3,0,3,0,2,2,1,2,9,5,52,65,4,13,May,0.4999999999999999,-0.8660254037844387,45,42,1,2,2,1.2,1.2,50,54,-4,52,36,16,"May, 2006"
2006-2007,1,2006-08-19,Sheffield United,Liverpool,1,1,D,1,1,1,1,3,2,1,2,14,11,0,0,3,0,August,-0.8660254037844384,-0.5000000000000004,36,25,0,0,0,0.0,0.0,0,0,0,0,0,0,"August, 2006"
2006-2007,1,2006-08-19,West Ham,Charlton,3,1,H,3,0,4,0,1,0,2,3,15,10,0,0,5,0,August,-0.8660254037844384,-0.5000000000000004,45,13,1,1,3,0.8,1.6,0,0,0,0,0,0,"August, 2006"
2006-2007,1,2006-08-19,Portsmouth,Blackburn,3,0,H,3,0,2,2,1,2,3,0,14,6,0,0,8,0,August,-0.8660254037844384,-0.5000000000000004,33,4,1,1,3,1.0,1.4,0,0,0,0,0,0,"August, 2006"
2006-2007,1,2006-08-19,Reading,Middlesbrough,3,2,H,3,0,3,1,1,2,1,2,14,13,0,0,1,0,August,-0.8660254037844384,-0.5000000000000004,35,29,0,0,0,0.0,0.0,0,0,0,0,0,0,"August, 2006"
2006-2007,1,2006-08-19,Everton,Watford,2,1,H,3,0,2,1,2,1,2,2,7,17,0,0,10,0,August,-0.8660254037844384,-0.5000000000000004,18,43,2,0,0,3.5,1.5,0,0,0,0,0,0,"August, 2006"
2006-2007,1,2006-08-19,Newcastle,Wigan,2,1,H,3,0,0,2,3,1,1,3,13,18,0,0,5,0,August,-0.8660254037844384,-0.5000000000000004,30,46,1,0,1,1.5,1.0,0,0,0,0,0,0,"August, 2006"
2006-2007,1,2006-08-19,Bolton,Tottenham,2,0,H,3,0,0,2,3,3,2,0,4,17,0,0,13,0,August,-0.8660254037844384,-0.5000000000000004,6,42,4,0,1,1.6,0.6,0,0,0,0,0,0,"August, 2006"
2006-2007,1,2006-08-19,Arsenal,Aston Villa,1,1,D,1,1,2,3,0,3,2,0,1,2,0,0,1,0,August,-0.8660254037844384,-0.5000000000000004,0,1,4,1,0,2.6,0.4,0,0,0,0,0,0,"August, 2006"
2006-2007,1,2006-08-20,Chelsea,Man City,3,0,H,3,0,0,5,0,0,1,4,11,13,0,0,2,0,August,-0.8660254037844384,-0.5000000000000004,14,27,3,1,1,0.8,0.2,0,0,0,0,0,0,"August, 2006"
2006-2007,1,2006-08-20,Man United,Fulham,5,1,H,3,0,2,2,1,1,1,3,13,12,0,0,1,0,August,-0.8660254037844384,-0.5000000000000004,28,19,3,2,0,2.0,1.2,0,0,0,0,0,0,"August, 2006"
2006-2007,2,2006-08-22,Tottenham,Sheffield United,2,0,H,3,0,3,2,0,1,1,3,17,12,0,1,5,1,August,-0.8660254037844384,-0.5000000000000004,42,36,0,0,0,0.0,0.0,0,2,-2,1,1,0,"August, 2006"
2006-2007,2,2006-08-22,Watford,West Ham,1,1,D,1,1,1,2,2,4,0,1,15,4,0,3,11,3,August,-0.8660254037844384,-0.5000000000000004,43,45,0,0,2,0.5,1.5,1,2,-1,3,1,2,"August, 2006"
2006-2007,2,2006-08-23,Middlesbrough,Chelsea,2,1,H,3,0,2,1,2,0,5,0,18,7,0,3,11,3,August,-0.8660254037844384,-0.5000000000000004,29,14,1,1,3,0.6,0.8,2,3,-1,3,0,3,"August, 2006"
2006-2007,2,2006-08-23,Man City,Portsmouth,0,0,D,1,1,0,1,4,2,2,1,19,7,0,3,12,3,August,-0.8660254037844384,-0.5000000000000004,27,33,3,0,2,2.0,1.6,0,3,-3,3,0,3,"August, 2006"
2006-2007,2,2006-08-23,Fulham,Bolton,1,1,D,1,1,1,1,3,0,2,3,19,7,0,3,12,3,August,-0.8660254037844384,-0.5000000000000004,19,6,3,0,2,1.6,1.2,1,5,-4,2,0,2,"August, 2006"
2006-2007,2,2006-08-23,Charlton,Man United,0,3,A,0,3,0,2,3,2,2,1,18,4,0,3,14,3,August,-0.8660254037844384,-0.5000000000000004,13,28,0,0,5,0.2,3.0,1,3,-2,5,1,4,"August, 2006"
2006-2007,2,2006-08-23,Blackburn,Everton,1,1,D,1,1,2,3,0,2,1,2,18,7,0,3,11,3,August,-0.8660254037844384,-0.5000000000000004,4,18,2,1,2,0.4,0.6,0,3,-3,2,1,1,"August, 2006"
2006-2007,2,2006-08-23,Aston Villa,Reading,2,1,H,3,0,3,2,0,3,1,1,11,6,1,3,5,2,August,-0.8660254037844384,-0.5000000000000004,1,35,0,0,0,0.0,0.0,1,1,0,3,2,1,"August, 2006"
2006-2007,3,2006-08-26,Charlton,Bolton,2,0,H,3,0,0,2,3,0,2,3,20,4,0,4,16,4,August,-0.8660254037844384,-0.5000000000000004,13,6,0,0,5,0.8,2.6,1,6,-5,3,1,2,"August, 2006"
2006-2007,3,2006-08-26,Fulham,Sheffield United,1,0,H,3,0,1,1,3,1,1,3,19,16,1,1,3,0,August,-0.8660254037844384,-0.5000000000000004,19,36,0,0,0,0.0,0.0,2,6,-4,1,3,-2,"August, 2006"
2006-2007,3,2006-08-26,Liverpool,West Ham,2,1,H,3,0,2,1,2,4,0,1,15,3,1,4,12,3,August,-0.8660254037844384,-0.5000000000000004,25,45,4,1,0,2.0,0.4,1,1,0,4,2,2,"August, 2006"
2006-2007,3,2006-08-26,Man City,Arsenal,1,0,H,3,0,0,1,4,2,3,0,19,15,1,1,4,0,August,-0.8660254037844384,-0.5000000000000004,27,0,0,1,4,0.6,1.6,0,3,-3,1,1,0,"August, 2006"
2006-2007,3,2006-08-26,Tottenham,Everton,0,2,A,0,3,3,2,0,2,1,2,14,5,3,4,9,1,August,-0.8660254037844384,-0.5000000000000004,42,18,4,0,1,2.0,1.0,2,2,0,3,2,1,"August, 2006"
2006-2007,3,2006-08-26,Watford,Man United,1,2,A,0,3,1,2,2,2,2,1,16,2,1,6,14,5,August,-0.8660254037844384,-0.5000000000000004,43,28,0,0,2,1.5,3.5,2,3,-1,8,1,7,"August, 2006"
2006-2007,3,2006-08-26,Wigan,Reading,1,0,H,3,0,1,1,3,3,1,1,20,13,0,3,7,3,August,-0.8660254037844384,-0.5000000000000004,46,35,0,0,0,0.0,0.0,1,2,-1,4,4,0,"August, 2006"
2006-2007,3,2006-08-27,Blackburn,Chelsea,0,2,A,0,3,2,3,0,0,5,0,19,10,1,3,9,2,August,-0.8660254037844384,-0.5000000000000004,4,14,1,0,4,1.0,2.4,1,4,-3,4,2,2,"August, 2006"
2006-2007,3,2006-08-27,Aston Villa,Newcastle,2,0,H,3,0,3,2,0,0,2,3,5,11,4,3,6,1,August,-0.8660254037844384,-0.5000000000000004,1,30,2,2,1,1.8,1.0,3,2,1,2,1,1,"August, 2006"
2006-2007,3,2006-08-28,Middlesbrough,Portsmouth,0,4,A,0,3,2,1,2,2,2,1,11,5,3,4,6,1,August,-0.8660254037844384,-0.5000000000000004,29,33,0,2,3,0.8,2.0,4,4,0,3,0,3,"August, 2006"
2006-2007,4,2006-09-09,Arsenal,Middlesbrough,1,1,D,1,1,2,3,0,2,1,2,17,16,1,3,1,2,September,-1.0,-1.8369701987210287e-16,0,29,4,0,1,3.6,1.2,1,2,-1,4,8,-4,"September, 2006"
2006-2007,4,2006-09-09,Bolton,Watford,1,0,H,3,0,0,2,3,1,2,2,8,18,4,1,10,3,September,-1.0,-1.8369701987210287e-16,6,43,0,0,0,0.0,0.0,3,3,0,3,5,-2,"September, 2006"
2006-2007,4,2006-09-09,Chelsea,Charlton,2,1,H,3,0,0,5,0,0,2,3,6,16,6,3,10,3,September,-1.0,-1.8369701987210287e-16,14,13,4,1,0,1.8,0.2,6,2,4,3,6,-3,"September, 2006"
2006-2007,4,2006-09-09,Everton,Liverpool,3,0,H,3,0,2,1,2,2,1,2,5,8,7,4,3,3,September,-1.0,-1.8369701987210287e-16,18,25,1,1,3,0.8,1.6,5,2,3,3,2,1,"September, 2006"
2006-2007,4,2006-09-09,Man United,Tottenham,1,0,H,3,0,2,2,1,3,2,0,2,15,9,3,13,6,September,-1.0,-1.8369701987210287e-16,28,42,3,2,0,1.4,0.4,10,2,8,2,4,-2,"September, 2006"
2006-2007,4,2006-09-09,Newcastle,Fulham,1,2,A,0,3,0,2,3,1,1,3,14,10,3,4,4,1,September,-1.0,-1.8369701987210287e-16,30,19,2,1,2,1.6,1.6,2,3,-1,3,6,-3,"September, 2006"
2006-2007,4,2006-09-09,Portsmouth,Wigan,1,0,H,3,0,2,2,1,1,1,3,4,12,7,3,8,4,September,-1.0,-1.8369701987210287e-16,33,46,1,0,1,1.0,1.5,7,0,7,2,2,0,"September, 2006"
2006-2007,4,2006-09-09,Sheffield United,Blackburn,0,0,D,1,1,1,1,3,2,3,0,19,20,1,1,1,0,September,-1.0,-1.8369701987210287e-16,36,4,0,0,0,0.0,0.0,1,4,-3,1,6,-5,"September, 2006"
2006-2007,4,2006-09-10,West Ham,Aston Villa,1,1,D,1,1,4,0,1,3,2,0,8,5,4,7,3,3,September,-1.0,-1.8369701987210287e-16,45,1,2,1,2,2.0,1.8,5,4,1,5,2,3,"September, 2006"
2006-2007,4,2006-09-11,Reading,Man City,1,0,H,3,0,3,1,1,0,1,4,12,10,3,4,2,1,September,-1.0,-1.8369701987210287e-16,35,27,0,0,0,0.0,0.0,4,5,-1,1,3,-2,"September, 2006"
2006-2007,5,2006-09-16,Bolton,Middlesbrough,0,0,D,1,1,0,2,3,2,1,2,6,12,7,4,6,3,September,-1.0,-1.8369701987210287e-16,6,29,0,3,2,1.0,1.6,4,3,1,5,9,-4,"September, 2006"
2006-2007,5,2006-09-16,Charlton,Portsmouth,0,1,A,0,3,0,2,3,2,2,1,16,2,3,10,14,7,September,-1.0,-1.8369701987210287e-16,13,33,3,1,1,1.8,1.6,4,8,-4,8,0,8,"September, 2006"
2006-2007,5,2006-09-16,Everton,Wigan,2,2,D,1,1,2,1,2,1,1,3,3,13,10,3,10,7,September,-1.0,-1.8369701987210287e-16,18,46,0,1,1,0.5,1.0,8,2,6,2,3,-1,"September, 2006"
2006-2007,5,2006-09-16,Sheffield United,Reading,1,2,A,0,3,1,1,3,3,1,1,18,8,2,6,10,4,September,-1.0,-1.8369701987210287e-16,36,35,0,0,0,0.0,0.0,1,4,-3,5,5,0,"September, 2006"
2006-2007,5,2006-09-16,Watford,Aston Villa,0,0,D,1,1,1,2,2,3,2,0,20,6,1,8,14,7,September,-1.0,-1.8369701987210287e-16,43,1,0,0,2,0.0,2.5,3,6,-3,6,3,3,"September, 2006"
2006-2007,5,2006-09-17,Blackburn,Man City,4,2,H,3,0,2,3,0,0,1,4,20,13,2,4,7,2,September,-1.0,-1.8369701987210287e-16,4,27,1,4,0,0.8,0.4,1,6,-5,1,4,-3,"September, 2006"
2006-2007,5,2006-09-17,Chelsea,Liverpool,1,0,H,3,0,0,5,0,2,1,2,4,13,9,4,9,5,September,-1.0,-1.8369701987210287e-16,14,25,4,0,1,1.6,0.4,8,3,5,3,5,-2,"September, 2006"
2006-2007,5,2006-09-17,Man United,Arsenal,0,1,A,0,3,2,2,1,2,3,0,2,18,12,2,16,10,September,-1.0,-1.8369701987210287e-16,28,0,3,2,0,1.8,0.6,11,2,9,2,3,-1,"September, 2006"
2006-2007,5,2006-09-17,Tottenham,Fulham,0,0,D,1,1,3,2,0,1,1,3,17,8,3,7,9,4,September,-1.0,-1.8369701987210287e-16,42,19,2,0,3,0.8,1.0,2,5,-3,5,7,-2,"September, 2006"
2006-2007,5,2006-09-17,West Ham,Newcastle,0,2,A,0,3,4,0,1,0,2,3,9,17,5,3,8,2,September,-1.0,-1.8369701987210287e-16,45,30,0,2,3,1.0,2.6,6,5,1,3,5,-2,"September, 2006"
2006-2007,5,2006-09-20,Liverpool,Newcastle,2,0,H,3,0,2,1,2,0,2,3,15,9,4,6,6,2,September,-1.0,-1.8369701987210287e-16,25,30,3,1,1,1.8,0.8,3,6,-3,5,5,0,"September, 2006"
2006-2007,6,2006-09-23,Arsenal,Sheffield United,3,0,H,3,0,2,3,0,1,1,3,11,20,5,2,9,3,September,-1.0,-1.8369701987210287e-16,0,36,0,0,0,0.0,0.0,3,3,0,2,6,-4,"September, 2006"
2006-2007,6,2006-09-23,Aston Villa,Charlton,2,0,H,3,0,3,2,0,0,2,3,5,18,9,3,13,6,September,-1.0,-1.8369701987210287e-16,1,13,2,2,1,0.6,0.8,6,3,3,4,9,-5,"September, 2006"
2006-2007,6,2006-09-23,Fulham,Chelsea,0,2,A,0,3,1,1,3,0,5,0,9,3,8,12,6,4,September,-1.0,-1.8369701987210287e-16,19,14,1,0,4,1.2,2.4,5,7,-2,9,3,6,"September, 2006"
2006-2007,6,2006-09-23,Liverpool,Tottenham,3,0,H,3,0,2,1,2,3,2,0,10,16,7,4,6,3,September,-1.0,-1.8369701987210287e-16,25,42,1,3,1,1.0,1.0,5,6,-1,2,5,-3,"September, 2006"
2006-2007,6,2006-09-23,Man City,West Ham,2,0,H,3,0,0,1,4,4,0,1,16,12,4,5,4,1,September,-1.0,-1.8369701987210287e-16,27,45,2,1,2,0.6,0.6,3,8,-5,6,7,-1,"September, 2006"
2006-2007,6,2006-09-23,Middlesbrough,Blackburn,0,1,A,0,3,2,1,2,2,3,0,15,14,5,5,1,0,September,-1.0,-1.8369701987210287e-16,29,4,2,0,3,1.4,1.2,5,9,-4,5,8,-3,"September, 2006"
2006-2007,6,2006-09-23,Reading,Man United,1,1,D,1,1,3,1,1,2,2,1,7,3,9,12,4,3,September,-1.0,-1.8369701987210287e-16,35,28,0,0,0,0.0,0.0,7,6,1,11,3,8,"September, 2006"
2006-2007,6,2006-09-23,Wigan,Watford,1,1,D,1,1,1,1,3,1,2,2,16,19,4,2,3,2,September,-1.0,-1.8369701987210287e-16,46,43,0,0,0,0.0,0.0,4,5,-1,3,6,-3,"September, 2006"
2006-2007,6,2006-09-24,Newcastle,Everton,1,1,D,1,1,0,2,3,2,1,2,13,5,6,11,8,5,September,-1.0,-1.8369701987210287e-16,30,18,2,1,2,1.4,1.2,5,7,-2,10,4,6,"September, 2006"
2006-2007,6,2006-09-25,Portsmouth,Bolton,0,1,A,0,3,2,2,1,0,2,3,2,9,13,8,7,5,September,-1.0,-1.8369701987210287e-16,33,6,1,2,2,0.6,0.8,9,0,9,4,3,1,"September, 2006"
2006-2007,7,2006-09-30,Sheffield United,Middlesbrough,2,1,H,3,0,1,1,3,2,1,2,20,16,2,5,4,3,September,-1.0,-1.8369701987210287e-16,36,29,0,0,0,0.0,0.0,2,9,-7,5,10,-5,"September, 2006"
2006-2007,7,2006-09-30,Everton,Man City,1,1,D,1,1,2,1,2,0,1,4,6,13,12,7,7,5,September,-1.0,-1.8369701987210287e-16,18,27,3,0,2,1.0,1.6,11,5,6,5,8,-3,"September, 2006"
2006-2007,7,2006-09-30,Charlton,Arsenal,1,2,A,0,3,0,2,3,2,3,0,19,9,3,8,10,5,September,-1.0,-1.8369701987210287e-16,13,0,0,0,5,0.4,2.6,4,11,-7,6,3,3,"September, 2006"
2006-2007,7,2006-09-30,Bolton,Liverpool,2,0,H,3,0,0,2,3,2,1,2,6,7,11,10,1,1,September,-1.0,-1.8369701987210287e-16,6,25,1,2,2,1.0,1.2,5,3,2,8,6,2,"September, 2006"
2006-2007,7,2006-09-30,Chelsea,Aston Villa,1,1,D,1,1,0,5,0,3,2,0,1,6,15,12,5,3,September,-1.0,-1.8369701987210287e-16,14,1,2,2,1,1.2,1.0,11,3,8,8,3,5,"September, 2006"
2006-2007,7,2006-10-01,Blackburn,Wigan,2,1,H,3,0,2,3,0,1,1,3,10,14,8,5,4,3,October,-0.8660254037844386,0.5,4,46,1,1,0,2.0,0.5,6,8,-2,5,6,-1,"October, 2006"
2006-2007,7,2006-10-01,Man United,Newcastle,2,0,H,3,0,2,2,1,0,2,3,3,13,13,7,10,6,October,-0.8660254037844386,0.5,28,30,4,1,0,1.8,0.4,12,4,8,6,8,-2,"October, 2006"
2006-2007,7,2006-10-01,Tottenham,Portsmouth,2,1,H,3,0,3,2,0,2,2,1,18,4,4,13,14,9,October,-0.8660254037844386,0.5,42,33,4,0,1,2.4,1.2,2,8,-6,9,1,8,"October, 2006"
2006-2007,7,2006-10-01,West Ham,Reading,0,1,A,0,3,4,0,1,3,1,1,16,9,5,10,7,5,October,-0.8660254037844386,0.5,45,35,0,0,0,0.0,0.0,6,9,-3,8,7,1,"October, 2006"
2006-2007,7,2006-10-02,Watford,Fulham,3,3,D,1,1,1,2,2,1,1,3,19,12,3,8,7,5,October,-0.8660254037844386,0.5,43,19,0,0,0,0.0,0.0,4,7,-3,5,9,-4,"October, 2006"
2006-2007,8,2006-10-14,Portsmouth,West Ham,2,0,H,3,0,2,2,1,4,0,1,6,18,13,5,12,8,October,-0.8660254037844386,0.5,33,45,1,1,0,2.5,1.5,10,3,7,6,10,-4,"October, 2006"
2006-2007,8,2006-10-14,Wigan,Man United,1,3,A,0,3,1,1,3,2,2,1,17,2,5,16,15,11,October,-0.8660254037844386,0.5,46,28,0,0,2,0.5,3.0,6,8,-2,14,4,10,"October, 2006"
2006-2007,8,2006-10-14,Reading,Chelsea,0,1,A,0,3,3,1,1,0,5,0,8,3,13,16,5,3,October,-0.8660254037844386,0.5,35,14,0,0,0,0.0,0.0,9,7,2,12,4,8,"October, 2006"
2006-2007,8,2006-10-14,Middlesbrough,Everton,2,1,H,3,0,2,1,2,2,1,2,18,7,5,13,11,8,October,-0.8660254037844386,0.5,29,18,0,2,3,0.4,1.0,6,12,-6,12,6,6,"October, 2006"
2006-2007,8,2006-10-14,Aston Villa,Tottenham,1,1,D,1,1,3,2,0,3,2,0,7,14,13,7,7,6,October,-0.8660254037844386,0.5,1,42,2,2,1,0.8,1.2,9,4,5,4,9,-5,"October, 2006"
2006-2007,8,2006-10-14,Liverpool,Blackburn,1,1,D,1,1,2,1,2,2,3,0,10,9,10,11,1,1,October,-0.8660254037844386,0.5,25,4,3,2,0,1.6,0.4,8,8,0,8,9,-1,"October, 2006"
2006-2007,8,2006-10-14,Man City,Sheffield United,0,0,D,1,1,0,1,4,1,1,3,12,18,8,5,6,3,October,-0.8660254037844386,0.5,27,36,0,0,0,0.0,0.0,6,9,-3,4,10,-6,"October, 2006"
2006-2007,8,2006-10-14,Arsenal,Watford,3,0,H,3,0,2,3,0,1,2,2,8,19,11,4,11,7,October,-0.8660254037844386,0.5,0,43,2,0,0,2.0,1.0,8,4,4,7,10,-3,"October, 2006"
2006-2007,8,2006-10-15,Newcastle,Bolton,1,2,A,0,3,0,2,3,0,2,3,15,6,7,14,9,7,October,-0.8660254037844386,0.5,30,6,2,0,3,1.2,1.4,6,10,-4,7,3,4,"October, 2006"
2006-2007,8,2006-10-16,Fulham,Charlton,2,1,H,3,0,1,1,3,0,2,3,12,20,9,3,8,6,October,-0.8660254037844386,0.5,19,13,2,2,1,1.2,0.8,8,12,-4,5,13,-8,"October, 2006"
2006-2007,9,2006-10-21,Everton,Sheffield United,2,0,H,3,0,2,1,2,1,1,3,7,16,13,6,9,7,October,-0.8660254037844386,0.5,18,36,0,0,0,0.0,0.0,13,8,5,4,10,-6,"October, 2006"
2006-2007,9,2006-10-21,Chelsea,Portsmouth,2,1,H,3,0,0,5,0,2,2,1,2,4,19,16,2,3,October,-0.8660254037844386,0.5,14,33,5,0,0,2.2,0.0,13,4,9,12,3,9,"October, 2006"
2006-2007,9,2006-10-21,Wigan,Man City,4,0,H,3,0,1,1,3,0,1,4,17,12,5,9,5,4,October,-0.8660254037844386,0.5,46,27,2,0,0,2.5,1.5,7,11,-4,6,9,-3,"October, 2006"
2006-2007,9,2006-10-21,Aston Villa,Fulham,1,1,D,1,1,3,2,0,1,1,3,6,10,14,12,4,2,October,-0.8660254037844386,0.5,1,19,2,3,0,1.6,1.0,10,5,5,10,13,-3,"October, 2006"
2006-2007,9,2006-10-21,Charlton,Watford,0,0,D,1,1,0,2,3,1,2,2,20,19,3,4,1,1,October,-0.8660254037844386,0.5,13,43,0,0,0,0.0,0.0,6,15,-9,7,13,-6,"October, 2006"
2006-2007,9,2006-10-22,Blackburn,Bolton,0,1,A,0,3,2,3,0,0,2,3,10,3,12,17,7,5,October,-0.8660254037844386,0.5,4,6,1,2,2,0.8,1.0,9,10,-1,9,4,5,"October, 2006"
2006-2007,9,2006-10-22,Man United,Liverpool,2,0,H,3,0,2,2,1,2,1,2,3,11,19,11,8,8,October,-0.8660254037844386,0.5,28,25,3,1,1,0.8,0.4,17,5,12,9,9,0,"October, 2006"
2006-2007,9,2006-10-22,Middlesbrough,Newcastle,1,0,H,3,0,2,1,2,0,2,3,14,16,8,7,2,1,October,-0.8660254037844386,0.5,29,30,0,3,2,1.2,1.6,8,13,-5,7,12,-5,"October, 2006"
2006-2007,9,2006-10-22,Reading,Arsenal,0,4,A,0,3,3,1,1,2,3,0,8,7,13,14,1,1,October,-0.8660254037844386,0.5,35,0,0,0,0,0.0,0.0,9,8,1,11,4,7,"October, 2006"
2006-2007,9,2006-10-22,Tottenham,West Ham,1,0,H,3,0,3,2,0,4,0,1,15,19,8,5,4,3,October,-0.8660254037844386,0.5,42,45,1,2,2,1.2,1.6,5,10,-5,6,12,-6,"October, 2006"
2006-2007,10,2006-10-28,Portsmouth,Reading,3,1,H,3,0,2,2,1,3,1,1,6,9,16,13,3,3,October,-0.8660254037844386,0.5,33,35,0,0,0,0.0,0.0,13,5,8,9,12,-3,"October, 2006"
2006-2007,10,2006-10-28,Watford,Tottenham,0,0,D,1,1,1,2,2,3,2,0,18,14,5,11,4,6,October,-0.8660254037844386,0.5,43,42,0,1,1,0.5,2.5,7,13,-6,6,10,-4,"October, 2006"
2006-2007,10,2006-10-28,Sheffield United,Chelsea,0,2,A,0,3,1,1,3,0,5,0,17,2,6,22,15,16,October,-0.8660254037844386,0.5,36,14,0,0,0,0.0,0.0,4,12,-8,15,5,10,"October, 2006"
2006-2007,10,2006-10-28,Newcastle,Charlton,0,0,D,1,1,0,2,3,0,2,3,16,20,7,4,4,3,October,-0.8660254037844386,0.5,30,13,1,3,1,1.2,1.2,7,13,-6,6,15,-9,"October, 2006"
2006-2007,10,2006-10-28,Bolton,Man United,0,4,A,0,3,0,2,3,2,2,1,3,1,20,22,2,2,October,-0.8660254037844386,0.5,6,28,0,1,4,1.0,2.4,10,4,6,19,5,14,"October, 2006"
2006-2007,10,2006-10-28,Fulham,Wigan,0,1,A,0,3,1,1,3,1,1,3,8,15,13,8,7,5,October,-0.8660254037844386,0.5,19,46,1,0,1,0.5,0.5,11,14,-3,11,11,0,"October, 2006"
2006-2007,10,2006-10-28,Liverpool,Aston Villa,3,1,H,3,0,2,1,2,3,2,0,12,7,11,15,5,4,October,-0.8660254037844386,0.5,25,1,4,1,0,1.8,0.6,9,11,-2,11,6,5,"October, 2006"
2006-2007,10,2006-10-28,Arsenal,Everton,1,1,D,1,1,2,3,0,2,1,2,4,6,17,16,2,1,October,-0.8660254037844386,0.5,0,18,3,1,1,2.8,0.6,15,4,11,15,8,7,"October, 2006"
2006-2007,10,2006-10-29,West Ham,Blackburn,2,1,H,3,0,4,0,1,2,3,0,19,11,5,12,8,7,October,-0.8660254037844386,0.5,45,4,3,1,1,2.2,1.4,6,13,-7,9,11,-2,"October, 2006"
2006-2007,10,2006-10-30,Man City,Middlesbrough,1,0,H,3,0,0,1,4,2,1,2,15,14,9,11,1,2,October,-0.8660254037844386,0.5,27,29,0,2,3,0.8,1.4,6,13,-7,9,13,-4,"October, 2006"
2006-2007,11,2006-11-04,Watford,Middlesbrough,2,0,H,3,0,1,2,2,2,1,2,20,15,6,11,5,5,November,-0.5000000000000004,0.8660254037844384,43,29,0,1,1,1.0,2.0,7,13,-6,9,14,-5,"November, 2006"
2006-2007,11,2006-11-04,Newcastle,Sheffield United,0,1,A,0,3,0,2,3,1,1,3,17,20,8,6,3,2,November,-0.5000000000000004,0.8660254037844384,30,36,0,0,0,0.0,0.0,7,13,-6,4,14,-10,"November, 2006"
2006-2007,11,2006-11-04,Man United,Portsmouth,3,0,H,3,0,2,2,1,2,2,1,1,4,25,19,3,6,November,-0.5000000000000004,0.8660254037844384,28,33,3,0,2,1.6,1.0,23,5,18,16,6,10,"November, 2006"
2006-2007,11,2006-11-04,Liverpool,Reading,2,0,H,3,0,2,1,2,3,1,1,10,11,14,13,1,1,November,-0.5000000000000004,0.8660254037844384,25,35,0,0,0,0.0,0.0,12,12,0,10,15,-5,"November, 2006"
2006-2007,11,2006-11-04,Fulham,Everton,1,0,H,3,0,1,1,3,2,1,2,10,6,13,17,4,4,November,-0.5000000000000004,0.8660254037844384,19,18,3,0,2,1.2,1.0,11,15,-4,16,9,7,"November, 2006"
2006-2007,11,2006-11-04,Charlton,Man City,1,0,H,3,0,0,2,3,0,1,4,20,14,5,12,6,7,November,-0.5000000000000004,0.8660254037844384,13,27,0,2,3,1.4,3.0,6,15,-9,7,13,-6,"November, 2006"
2006-2007,11,2006-11-04,Bolton,Wigan,0,1,A,0,3,0,2,3,1,1,3,3,14,20,11,11,9,November,-0.5000000000000004,0.8660254037844384,6,46,0,1,1,1.0,1.5,10,8,2,12,11,1,"November, 2006"
2006-2007,11,2006-11-05,Aston Villa,Blackburn,2,0,H,3,0,3,2,0,2,3,0,9,12,15,12,3,3,November,-0.5000000000000004,0.8660254037844384,1,4,2,1,2,0.8,1.2,12,9,3,10,13,-3,"November, 2006"
2006-2007,11,2006-11-05,Tottenham,Chelsea,2,1,H,3,0,3,2,0,0,5,0,12,2,12,25,10,13,November,-0.5000000000000004,0.8660254037844384,42,14,0,1,4,0.2,1.4,6,10,-4,17,5,12,"November, 2006"
2006-2007,11,2006-11-05,West Ham,Arsenal,1,0,H,3,0,4,0,1,2,3,0,18,5,8,18,13,10,November,-0.5000000000000004,0.8660254037844384,45,0,1,2,2,1.2,1.8,8,14,-6,16,5,11,"November, 2006"
2006-2007,12,2006-11-11,Wigan,Charlton,3,2,H,3,0,1,1,3,0,2,3,11,20,14,8,9,6,November,-0.5000000000000004,0.8660254037844384,46,13,1,0,1,1.5,0.5,13,11,2,7,15,-8,"November, 2006"
2006-2007,12,2006-11-11,Portsmouth,Fulham,1,1,D,1,1,2,2,1,1,1,3,5,9,19,16,4,3,November,-0.5000000000000004,0.8660254037844384,33,19,3,1,1,2.0,1.6,16,9,7,12,15,-3,"November, 2006"
2006-2007,12,2006-11-11,Middlesbrough,West Ham,1,0,H,3,0,2,1,2,4,0,1,16,15,11,11,1,0,November,-0.5000000000000004,0.8660254037844384,29,45,1,1,3,1.0,1.2,9,16,-7,9,14,-5,"November, 2006"
2006-2007,12,2006-11-11,Sheffield United,Bolton,2,2,D,1,1,1,1,3,0,2,3,19,5,9,20,14,11,November,-0.5000000000000004,0.8660254037844384,36,6,0,0,0,0.0,0.0,5,14,-9,10,9,1,"November, 2006"
2006-2007,12,2006-11-11,Everton,Aston Villa,0,1,A,0,3,2,1,2,3,2,0,7,6,17,18,1,1,November,-0.5000000000000004,0.8660254037844384,18,1,3,1,1,2.0,1.4,16,10,6,14,9,5,"November, 2006"
2006-2007,12,2006-11-11,Chelsea,Watford,4,0,H,3,0,0,5,0,1,2,2,2,17,25,9,15,16,November,-0.5000000000000004,0.8660254037844384,14,43,1,0,1,1.0,1.0,18,7,11,9,13,-4,"November, 2006"
2006-2007,12,2006-11-11,Blackburn,Man United,0,1,A,0,3,2,3,0,2,2,1,13,1,12,28,12,16,November,-0.5000000000000004,0.8660254037844384,4,28,3,2,0,1.6,1.0,10,15,-5,26,5,21,"November, 2006"
2006-2007,12,2006-11-11,Man City,Newcastle,0,0,D,1,1,0,1,4,0,2,3,14,19,12,8,5,4,November,-0.5000000000000004,0.8660254037844384,27,30,2,1,2,1.6,1.2,7,14,-7,7,14,-7,"November, 2006"
2006-2007,12,2006-11-12,Arsenal,Liverpool,3,0,H,3,0,2,3,0,2,1,2,6,9,18,17,3,1,November,-0.5000000000000004,0.8660254037844384,0,25,3,0,2,2.0,1.4,16,6,10,14,12,2,"November, 2006"
2006-2007,12,2006-11-12,Reading,Tottenham,3,1,H,3,0,3,1,1,3,2,0,13,11,13,15,2,2,November,-0.5000000000000004,0.8660254037844384,35,42,0,0,0,0.0,0.0,10,17,-7,8,11,-3,"November, 2006"
2006-2007,13,2006-11-18,Sheffield United,Man United,1,2,A,0,3,1,1,3,2,2,1,18,1,10,31,17,21,November,-0.5000000000000004,0.8660254037844384,36,28,0,0,0,0.0,0.0,7,16,-9,27,5,22,"November, 2006"
2006-2007,13,2006-11-18,Portsmouth,Watford,2,1,H,3,0,2,2,1,1,2,2,6,19,20,9,13,11,November,-0.5000000000000004,0.8660254037844384,33,43,0,0,0,0.0,0.0,17,10,7,9,17,-8,"November, 2006"
2006-2007,13,2006-11-18,Middlesbrough,Liverpool,0,0,D,1,1,2,1,2,2,1,2,14,9,14,17,5,3,November,-0.5000000000000004,0.8660254037844384,29,25,1,2,2,0.6,1.0,10,16,-6,14,15,-1,"November, 2006"
2006-2007,13,2006-11-18,Reading,Charlton,2,0,H,3,0,3,1,1,0,2,3,11,20,16,8,9,8,November,-0.5000000000000004,0.8660254037844384,35,13,0,0,0,0.0,0.0,13,18,-5,9,18,-9,"November, 2006"
2006-2007,13,2006-11-18,Everton,Bolton,1,0,H,3,0,2,1,2,0,2,3,7,5,17,21,2,4,November,-0.5000000000000004,0.8660254037844384,18,6,2,0,3,1.4,2.2,16,11,5,12,11,1,"November, 2006"
2006-2007,13,2006-11-18,Chelsea,West Ham,1,0,H,3,0,0,5,0,4,0,1,2,16,28,11,14,17,November,-0.5000000000000004,0.8660254037844384,14,45,3,0,2,2.8,1.4,22,7,15,9,15,-6,"November, 2006"
2006-2007,13,2006-11-18,Arsenal,Newcastle,1,1,D,1,1,2,3,0,0,2,3,3,18,21,9,15,12,November,-0.5000000000000004,0.8660254037844384,0,30,3,1,1,0.8,0.2,19,6,13,7,14,-7,"November, 2006"
2006-2007,13,2006-11-18,Man City,Fulham,3,1,H,3,0,0,1,4,1,1,3,14,10,13,17,4,4,November,-0.5000000000000004,0.8660254037844384,27,19,0,3,2,0.8,1.2,7,14,-7,13,16,-3,"November, 2006"
2006-2007,13,2006-11-19,Blackburn,Tottenham,1,1,D,1,1,2,3,0,3,2,0,15,13,12,15,2,3,November,-0.5000000000000004,0.8660254037844384,4,42,0,2,3,0.4,1.0,10,16,-6,9,14,-5,"November, 2006"
2006-2007,13,2006-11-19,Wigan,Aston Villa,0,0,D,1,1,1,1,3,3,2,0,10,5,17,21,5,4,November,-0.5000000000000004,0.8660254037844384,46,1,2,0,0,2.5,1.0,16,13,3,15,9,6,"November, 2006"
2006-2007,14,2006-11-25,Aston Villa,Middlesbrough,1,1,D,1,1,3,2,0,2,1,2,5,14,22,15,9,7,November,-0.5000000000000004,0.8660254037844384,1,29,3,0,2,2.0,1.4,15,9,6,10,16,-6,"November, 2006"
2006-2007,14,2006-11-25,Bolton,Arsenal,3,1,H,3,0,0,2,3,2,3,0,6,5,21,22,1,1,November,-0.5000000000000004,0.8660254037844384,6,0,2,2,1,1.4,1.0,12,12,0,20,7,13,"November, 2006"
2006-2007,14,2006-11-25,Charlton,Everton,1,1,D,1,1,0,2,3,2,1,2,20,7,8,20,13,12,November,-0.5000000000000004,0.8660254037844384,13,18,3,1,1,1.0,0.6,9,20,-11,17,11,6,"November, 2006"
2006-2007,14,2006-11-25,Fulham,Reading,0,1,A,0,3,1,1,3,3,1,1,11,8,17,19,3,2,November,-0.5000000000000004,0.8660254037844384,19,35,0,0,0,0.0,0.0,14,19,-5,15,18,-3,"November, 2006"
2006-2007,14,2006-11-25,Liverpool,Man City,1,0,H,3,0,2,1,2,0,1,4,10,12,18,16,2,2,November,-0.5000000000000004,0.8660254037844384,25,27,4,0,1,1.2,0.6,14,15,-1,10,15,-5,"November, 2006"
2006-2007,14,2006-11-25,West Ham,Sheffield United,1,0,H,3,0,4,0,1,1,1,3,16,18,11,10,2,1,November,-0.5000000000000004,0.8660254037844384,45,36,0,0,0,0.0,0.0,9,16,-7,8,18,-10,"November, 2006"
2006-2007,14,2006-11-26,Newcastle,Portsmouth,1,0,H,3,0,0,2,3,2,2,1,17,4,10,23,13,13,November,-0.5000000000000004,0.8660254037844384,30,33,1,4,0,1.0,0.6,8,15,-7,19,11,8,"November, 2006"
2006-2007,14,2006-11-26,Man United,Chelsea,1,1,D,1,1,2,2,1,0,5,0,1,2,34,31,1,3,November,-0.5000000000000004,0.8660254037844384,28,14,1,1,3,0.6,1.6,29,6,23,23,7,16,"November, 2006"
2006-2007,14,2006-11-26,Tottenham,Wigan,3,1,H,3,0,3,2,0,1,1,3,12,10,16,18,2,2,November,-0.5000000000000004,0.8660254037844384,42,46,1,1,0,2.0,1.5,10,15,-5,16,13,3,"November, 2006"
2006-2007,15,2006-11-28,Watford,Sheffield United,0,1,A,0,3,1,2,2,1,1,3,19,18,9,10,1,1,November,-0.5000000000000004,0.8660254037844384,43,36,0,0,0,0.0,0.0,10,19,-9,8,19,-11,"November, 2006"
2006-2007,15,2006-11-29,Aston Villa,Man City,1,3,A,0,3,3,2,0,0,1,4,5,14,23,16,9,7,November,-0.5000000000000004,0.8660254037844384,1,27,0,1,4,0.6,1.8,16,10,6,10,16,-6,"November, 2006"
2006-2007,15,2006-11-29,Bolton,Chelsea,0,1,A,0,3,0,2,3,0,5,0,3,2,24,32,1,8,November,-0.5000000000000004,0.8660254037844384,6,14,0,1,4,0.6,2.6,15,13,2,24,8,16,"November, 2006"
2006-2007,15,2006-11-29,Fulham,Arsenal,2,1,H,3,0,1,1,3,2,3,0,13,6,17,22,7,5,November,-0.5000000000000004,0.8660254037844384,19,0,0,0,5,0.2,2.8,14,20,-6,21,10,11,"November, 2006"
2006-2007,15,2006-11-29,Liverpool,Portsmouth,0,0,D,1,1,2,1,2,2,2,1,9,4,21,23,5,2,November,-0.5000000000000004,0.8660254037844384,25,33,4,1,0,2.4,0.6,15,15,0,19,12,7,"November, 2006"
2006-2007,15,2006-11-29,Man United,Everton,3,0,H,3,0,2,2,1,2,1,2,1,9,35,21,8,14,November,-0.5000000000000004,0.8660254037844384,28,18,2,2,1,1.4,1.0,30,7,23,18,12,6,"November, 2006"
2006-2007,16,2006-12-02,Wigan,Liverpool,0,4,A,0,3,1,1,3,2,1,2,13,8,18,22,5,4,December,-2.4492935982947064e-16,1.0,46,25,0,0,2,0.0,2.0,17,16,1,15,15,0,"December, 2006"
2006-2007,16,2006-12-02,Reading,Bolton,1,0,H,3,0,3,1,1,0,2,3,8,6,22,24,2,2,December,-2.4492935982947064e-16,1.0,35,6,0,0,0,0.0,0.0,16,18,-2,15,14,1,"December, 2006"
2006-2007,16,2006-12-02,Portsmouth,Aston Villa,2,2,D,1,1,2,2,1,3,2,0,4,6,24,23,2,1,December,-2.4492935982947064e-16,1.0,33,1,0,1,4,0.6,1.8,19,12,7,17,13,4,"December, 2006"
2006-2007,16,2006-12-02,Sheffield United,Charlton,2,1,H,3,0,1,1,3,0,2,3,18,20,13,9,2,4,December,-2.4492935982947064e-16,1.0,36,13,0,0,0,0.0,0.0,9,19,-10,10,21,-11,"December, 2006"
2006-2007,16,2006-12-02,Blackburn,Fulham,2,0,H,3,0,2,3,0,1,1,3,16,10,13,20,6,7,December,-2.4492935982947064e-16,1.0,4,19,3,0,2,2.0,1.8,11,17,-6,16,21,-5,"December, 2006"
2006-2007,16,2006-12-02,Arsenal,Tottenham,3,0,H,3,0,2,3,0,3,2,0,6,11,22,19,5,3,December,-2.4492935982947064e-16,1.0,0,42,2,3,0,2.0,1.6,22,12,10,13,16,-3,"December, 2006"
2006-2007,16,2006-12-02,Middlesbrough,Man United,1,2,A,0,3,2,1,2,2,2,1,15,1,16,38,14,22,December,-2.4492935982947064e-16,1.0,29,28,2,2,1,1.6,1.2,11,17,-6,33,7,26,"December, 2006"
2006-2007,16,2006-12-03,Everton,West Ham,2,0,H,3,0,2,1,2,4,0,1,9,17,21,14,8,7,December,-2.4492935982947064e-16,1.0,18,45,1,2,2,0.8,1.0,18,15,3,10,16,-6,"December, 2006"
2006-2007,16,2006-12-04,Man City,Watford,0,0,D,1,1,0,1,4,1,2,2,11,19,19,9,8,10,December,-2.4492935982947064e-16,1.0,27,43,0,0,0,0.0,0.0,13,17,-4,10,20,-10,"December, 2006"
2006-2007,16,2006-12-05,Charlton,Blackburn,1,0,H,3,0,0,2,3,2,3,0,20,14,9,16,6,7,December,-2.4492935982947064e-16,1.0,13,4,2,0,3,1.0,1.8,11,23,-12,13,17,-4,"December, 2006"
2006-2007,16,2006-12-05,Tottenham,Middlesbrough,2,1,H,3,0,3,2,0,2,1,2,12,15,19,16,3,3,December,-2.4492935982947064e-16,1.0,42,29,2,1,2,1.4,1.0,13,19,-6,12,19,-7,"December, 2006"
2006-2007,16,2006-12-06,Newcastle,Reading,3,2,H,3,0,0,2,3,3,1,1,18,6,13,25,12,12,December,-2.4492935982947064e-16,1.0,30,35,0,0,0,0.0,0.0,9,15,-6,17,18,-1,"December, 2006"
2006-2007,16,2006-12-06,West Ham,Wigan,0,2,A,0,3,4,0,1,1,1,3,18,13,14,18,5,4,December,-2.4492935982947064e-16,1.0,45,46,1,0,1,1.0,1.5,10,18,-8,17,20,-3,"December, 2006"
2006-2007,17,2006-12-09,Tottenham,Charlton,5,1,H,3,0,3,2,0,0,2,3,11,19,22,12,8,10,December,-2.4492935982947064e-16,1.0,42,13,3,0,2,2.4,2.0,15,20,-5,12,23,-11,"December, 2006"
2006-2007,17,2006-12-09,Watford,Reading,0,0,D,1,1,1,2,2,3,1,1,20,8,10,25,12,15,December,-2.4492935982947064e-16,1.0,43,35,0,0,0,0.0,0.0,10,20,-10,19,21,-2,"December, 2006"
2006-2007,17,2006-12-09,Portsmouth,Everton,2,0,H,3,0,2,2,1,2,1,2,6,8,25,24,2,1,December,-2.4492935982947064e-16,1.0,33,18,1,0,4,0.4,1.0,21,14,7,20,15,5,"December, 2006"
2006-2007,17,2006-12-09,Middlesbrough,Wigan,1,1,D,1,1,2,1,2,1,1,3,16,11,16,21,5,5,December,-2.4492935982947064e-16,1.0,29,46,0,1,1,1.5,2.0,13,21,-8,19,20,-1,"December, 2006"
2006-2007,17,2006-12-09,Liverpool,Fulham,4,0,H,3,0,2,1,2,1,1,3,6,13,25,20,7,5,December,-2.4492935982947064e-16,1.0,25,19,3,1,1,2.4,1.2,19,15,4,16,23,-7,"December, 2006"
2006-2007,17,2006-12-09,Bolton,West Ham,4,0,H,3,0,0,2,3,4,0,1,9,18,24,14,9,10,December,-2.4492935982947064e-16,1.0,6,45,3,1,1,1.8,1.0,15,15,0,10,20,-10,"December, 2006"
2006-2007,17,2006-12-09,Blackburn,Newcastle,1,3,A,0,3,2,3,0,0,2,3,14,15,16,16,1,0,December,-2.4492935982947064e-16,1.0,4,30,1,2,2,0.8,1.8,13,18,-5,12,17,-5,"December, 2006"
2006-2007,17,2006-12-09,Man United,Man City,3,1,H,3,0,2,2,1,0,1,4,1,12,41,20,11,21,December,-2.4492935982947064e-16,1.0,28,27,1,2,2,1.0,1.6,35,8,27,13,17,-4,"December, 2006"
2006-2007,17,2006-12-10,Chelsea,Arsenal,1,1,D,1,1,0,5,0,2,3,0,2,7,35,25,5,10,December,-2.4492935982947064e-16,1.0,14,0,2,2,1,1.2,0.8,25,8,17,25,12,13,"December, 2006"
2006-2007,17,2006-12-11,Sheffield United,Aston Villa,2,2,D,1,1,1,1,3,3,2,0,17,9,16,24,8,8,December,-2.4492935982947064e-16,1.0,36,1,0,0,0,0.0,0.0,11,20,-9,19,15,4,"December, 2006"
2006-2007,17,2006-12-13,Chelsea,Newcastle,1,0,H,3,0,0,5,0,0,2,3,2,14,36,19,12,17,December,-2.4492935982947064e-16,1.0,14,30,2,1,2,1.8,0.8,26,9,17,15,18,-3,"December, 2006"
2006-2007,17,2006-12-13,Wigan,Arsenal,0,1,A,0,3,1,1,3,2,3,0,11,6,22,26,5,4,December,-2.4492935982947064e-16,1.0,46,0,0,0,2,2.0,3.5,20,21,-1,26,13,13,"December, 2006"
2006-2007,18,2006-12-16,Newcastle,Watford,2,1,H,3,0,0,2,3,1,2,2,14,20,19,11,6,8,December,-2.4492935982947064e-16,1.0,30,43,1,1,0,1.0,0.5,15,19,-4,10,20,-10,"December, 2006"
2006-2007,18,2006-12-16,Wigan,Sheffield United,0,1,A,0,3,1,1,3,1,1,3,11,17,22,17,6,5,December,-2.4492935982947064e-16,1.0,46,36,0,0,0,0.0,0.0,20,22,-2,13,22,-9,"December, 2006"
2006-2007,18,2006-12-16,Reading,Blackburn,1,2,A,0,3,3,1,1,2,3,0,7,17,26,16,10,10,December,-2.4492935982947064e-16,1.0,35,4,0,0,0,0.0,0.0,19,21,-2,14,21,-7,"December, 2006"
2006-2007,18,2006-12-16,Aston Villa,Bolton,0,1,A,0,3,3,2,0,0,2,3,8,6,25,27,2,2,December,-2.4492935982947064e-16,1.0,1,6,1,4,0,1.6,1.4,21,17,4,19,15,4,"December, 2006"
2006-2007,18,2006-12-16,Arsenal,Portsmouth,2,2,D,1,1,2,3,0,2,2,1,3,4,29,28,1,1,December,-2.4492935982947064e-16,1.0,0,33,3,2,0,2.0,0.4,27,13,14,23,14,9,"December, 2006"
2006-2007,18,2006-12-16,Charlton,Liverpool,0,3,A,0,3,0,2,3,2,1,2,19,6,12,28,13,16,December,-2.4492935982947064e-16,1.0,13,25,2,1,2,0.8,0.8,13,28,-15,23,15,8,"December, 2006"
2006-2007,18,2006-12-17,Everton,Chelsea,2,3,A,0,3,2,1,2,0,5,0,10,2,24,39,8,15,December,-2.4492935982947064e-16,1.0,18,14,0,2,3,0.2,1.2,20,17,3,27,9,18,"December, 2006"
2006-2007,18,2006-12-17,Man City,Tottenham,1,2,A,0,3,0,1,4,3,2,0,13,9,20,25,4,5,December,-2.4492935982947064e-16,1.0,27,42,0,1,4,0.6,1.6,14,20,-6,20,21,-1,"December, 2006"
2006-2007,18,2006-12-17,West Ham,Man United,1,0,H,3,0,4,0,1,2,2,1,18,1,14,44,17,30,December,-2.4492935982947064e-16,1.0,45,28,0,1,4,1.0,2.4,10,24,-14,38,9,29,"December, 2006"
2006-2007,18,2006-12-18,Fulham,Middlesbrough,2,1,H,3,0,1,1,3,2,1,2,15,17,20,17,2,3,December,-2.4492935982947064e-16,1.0,19,29,1,1,3,1.0,1.6,16,27,-11,14,22,-8,"December, 2006"
2006-2007,19,2006-12-23,Portsmouth,Sheffield United,3,1,H,3,0,2,2,1,1,1,3,6,15,29,20,9,9,December,-2.4492935982947064e-16,1.0,33,36,0,0,0,0.0,0.0,25,16,9,14,22,-8,"December, 2006"
2006-2007,19,2006-12-23,Newcastle,Tottenham,3,1,H,3,0,0,2,3,3,2,0,13,7,22,28,6,6,December,-2.4492935982947064e-16,1.0,30,42,1,0,4,0.6,1.2,17,20,-3,22,22,0,"December, 2006"
2006-2007,19,2006-12-23,Wigan,Chelsea,2,3,A,0,3,1,1,3,0,5,0,13,2,22,42,11,20,December,-2.4492935982947064e-16,1.0,46,14,0,0,2,0.0,1.0,20,23,-3,30,11,19,"December, 2006"
2006-2007,19,2006-12-23,Reading,Everton,0,2,A,0,3,3,1,1,2,1,2,8,11,26,24,3,2,December,-2.4492935982947064e-16,1.0,35,18,0,0,0,0.0,0.0,20,23,-3,22,20,2,"December, 2006"
2006-2007,19,2006-12-23,Middlesbrough,Charlton,2,0,H,3,0,2,1,2,0,2,3,18,19,17,12,1,5,December,-2.4492935982947064e-16,1.0,29,13,1,1,3,1.0,1.8,15,24,-9,13,31,-18,"December, 2006"
2006-2007,19,2006-12-23,Liverpool,Watford,2,0,H,3,0,2,1,2,1,2,2,4,20,31,11,16,20,December,-2.4492935982947064e-16,1.0,25,43,1,0,1,1.5,1.5,26,15,11,11,22,-11,"December, 2006"
2006-2007,19,2006-12-23,Man City,Bolton,0,2,A,0,3,0,1,4,0,2,3,14,5,20,30,9,10,December,-2.4492935982947064e-16,1.0,27,6,2,0,3,0.8,1.0,15,22,-7,20,15,5,"December, 2006"
2006-2007,19,2006-12-23,Fulham,West Ham,0,0,D,1,1,1,1,3,4,0,1,11,18,23,17,7,6,December,-2.4492935982947064e-16,1.0,19,45,0,1,4,0.6,1.4,18,28,-10,11,24,-13,"December, 2006"
2006-2007,19,2006-12-23,Aston Villa,Man United,0,3,A,0,3,3,2,0,2,2,1,9,1,25,44,8,19,December,-2.4492935982947064e-16,1.0,1,28,0,0,5,0.2,1.8,21,18,3,38,10,28,"December, 2006"
2006-2007,19,2006-12-23,Arsenal,Blackburn,6,2,H,3,0,2,3,0,2,3,0,4,16,30,19,12,11,December,-2.4492935982947064e-16,1.0,0,4,4,0,1,1.8,0.2,29,15,14,16,22,-6,"December, 2006"
2006-2007,20,2006-12-26,West Ham,Portsmouth,1,2,A,0,3,4,0,1,2,2,1,18,6,18,32,12,14,December,-2.4492935982947064e-16,1.0,45,33,0,1,2,1.0,2.333333333333333,11,24,-13,28,17,11,"December, 2006"
2006-2007,20,2006-12-26,Watford,Arsenal,1,2,A,0,3,1,2,2,2,3,0,20,5,11,33,15,22,December,-2.4492935982947064e-16,1.0,43,0,0,0,3,0.6666666666666666,2.333333333333333,11,24,-13,35,17,18,"December, 2006"
2006-2007,20,2006-12-26,Tottenham,Aston Villa,2,1,H,3,0,3,2,0,3,2,0,8,10,28,25,2,3,December,-2.4492935982947064e-16,1.0,42,1,1,3,1,1.4,0.8,23,25,-2,21,21,0,"December, 2006"
2006-2007,20,2006-12-26,Sheffield United,Man City,0,1,A,0,3,1,1,3,0,1,4,17,16,20,20,1,0,December,-2.4492935982947064e-16,1.0,36,27,0,1,0,0.0,0.0,15,25,-10,15,24,-9,"December, 2006"
2006-2007,20,2006-12-26,Man United,Wigan,3,1,H,3,0,2,2,1,1,1,3,1,13,47,22,12,25,December,-2.4492935982947064e-16,1.0,28,46,3,0,0,3.0,0.6666666666666666,41,10,31,22,26,-4,"December, 2006"
2006-2007,20,2006-12-26,Everton,Middlesbrough,0,0,D,1,1,2,1,2,2,1,2,8,15,27,20,7,7,December,-2.4492935982947064e-16,1.0,18,29,3,1,1,1.0,0.6,24,20,4,17,24,-7,"December, 2006"
2006-2007,20,2006-12-26,Chelsea,Reading,2,2,D,1,1,0,5,0,3,1,1,2,9,45,26,7,19,December,-2.4492935982947064e-16,1.0,14,35,1,0,0,1.0,0.0,33,13,20,20,25,-5,"December, 2006"
2006-2007,20,2006-12-26,Bolton,Newcastle,2,1,H,3,0,0,2,3,0,2,3,5,11,33,25,6,8,December,-2.4492935982947064e-16,1.0,6,30,3,0,2,1.6,1.4,22,15,7,20,21,-1,"December, 2006"
2006-2007,20,2006-12-26,Blackburn,Liverpool,1,0,H,3,0,2,3,0,2,1,2,17,3,19,34,14,15,December,-2.4492935982947064e-16,1.0,4,25,0,3,2,0.6,1.0,18,28,-10,28,15,13,"December, 2006"
2006-2007,20,2006-12-27,Charlton,Fulham,2,2,D,1,1,0,2,3,1,1,3,19,12,12,24,7,12,December,-2.4492935982947064e-16,1.0,13,19,1,2,2,1.0,1.2,13,33,-20,18,28,-10,"December, 2006"
2006-2007,21,2006-12-30,West Ham,Man City,0,1,A,0,3,4,0,1,0,1,4,18,14,18,23,4,5,December,-2.4492935982947064e-16,1.0,45,27,2,1,2,0.6,0.8,12,26,-14,16,24,-8,"December, 2006"
2006-2007,21,2006-12-30,Tottenham,Liverpool,0,1,A,0,3,3,2,0,2,1,2,8,6,31,34,2,3,December,-2.4492935982947064e-16,1.0,42,25,0,3,2,0.6,1.4,25,26,-1,28,16,12,"December, 2006"
2006-2007,21,2006-12-30,Man United,Reading,3,2,H,3,0,2,2,1,3,1,1,1,9,50,27,8,23,December,-2.4492935982947064e-16,1.0,28,35,0,1,0,1.0,1.0,44,11,33,22,27,-5,"December, 2006"
2006-2007,21,2006-12-30,Everton,Newcastle,3,0,H,3,0,2,1,2,0,2,3,8,12,28,25,4,3,December,-2.4492935982947064e-16,1.0,18,30,2,2,1,1.0,0.8,24,20,4,21,23,-2,"December, 2006"
2006-2007,21,2006-12-30,Sheffield United,Arsenal,1,0,H,3,0,1,1,3,2,3,0,17,4,20,36,13,16,December,-2.4492935982947064e-16,1.0,36,0,0,0,1,0.0,3.0,15,26,-11,37,18,19,"December, 2006"
2006-2007,21,2006-12-30,Charlton,Aston Villa,2,1,H,3,0,0,2,3,3,2,0,19,10,13,25,9,12,December,-2.4492935982947064e-16,1.0,13,1,1,2,2,0.6,0.6,15,35,-20,22,23,-1,"December, 2006"
2006-2007,21,2006-12-30,Chelsea,Fulham,2,2,D,1,1,0,5,0,1,1,3,2,13,46,25,11,21,December,-2.4492935982947064e-16,1.0,14,19,4,0,1,2.4,1.0,35,15,20,20,30,-10,"December, 2006"
2006-2007,21,2006-12-30,Bolton,Portsmouth,3,2,H,3,0,0,2,3,2,2,1,4,5,36,35,1,1,December,-2.4492935982947064e-16,1.0,6,33,2,2,1,0.8,0.6,24,16,8,30,18,12,"December, 2006"
2006-2007,21,2006-12-30,Blackburn,Middlesbrough,2,1,H,3,0,2,3,0,2,1,2,15,16,22,21,1,1,December,-2.4492935982947064e-16,1.0,4,29,3,0,2,1.2,1.4,19,28,-9,17,24,-7,"December, 2006"
2006-2007,22,2007-01-01,Reading,West Ham,6,0,H,3,0,3,1,1,4,0,1,10,18,27,18,8,9,January,0.4999999999999999,0.8660254037844387,35,45,1,0,0,1.0,0.0,24,30,-6,12,27,-15,"January, 2007"
2006-2007,22,2007-01-01,Portsmouth,Tottenham,1,1,D,1,1,2,2,1,3,2,0,6,8,35,31,2,4,January,0.4999999999999999,0.8660254037844387,33,42,1,0,4,0.8,2.0,32,21,11,25,27,-2,"January, 2007"
2006-2007,22,2007-01-01,Newcastle,Man United,2,2,D,1,1,0,2,3,2,2,1,13,1,25,53,12,28,January,0.4999999999999999,0.8660254037844387,30,28,0,0,5,0.4,2.2,21,26,-5,47,13,34,"January, 2007"
2006-2007,22,2007-01-01,Wigan,Blackburn,0,3,A,0,3,1,1,3,2,3,0,17,14,22,25,3,3,January,0.4999999999999999,0.8660254037844387,46,4,0,1,2,0.6666666666666666,2.0,23,29,-6,21,29,-8,"January, 2007"
2006-2007,22,2007-01-01,Man City,Everton,2,1,H,3,0,0,1,4,2,1,2,11,7,26,31,4,5,January,0.4999999999999999,0.8660254037844387,27,18,1,1,3,0.8,1.0,17,24,-7,27,20,7,"January, 2007"
2006-2007,22,2007-01-01,Liverpool,Bolton,3,0,H,3,0,2,1,2,0,2,3,4,3,37,39,1,2,January,0.4999999999999999,0.8660254037844387,25,6,2,1,2,0.8,1.0,29,16,13,27,18,9,"January, 2007"
2006-2007,22,2007-01-01,Fulham,Watford,0,0,D,1,1,1,1,3,1,2,2,11,20,26,11,9,15,January,0.4999999999999999,0.8660254037844387,19,43,0,1,0,3.0,3.0,22,32,-10,12,26,-14,"January, 2007"
2006-2007,22,2007-01-01,Middlesbrough,Sheffield United,3,1,H,3,0,2,1,2,1,1,3,17,15,21,23,2,2,January,0.4999999999999999,0.8660254037844387,29,36,0,0,1,1.0,2.0,18,26,-8,16,26,-10,"January, 2007"
2006-2007,22,2007-01-02,Arsenal,Charlton,4,0,H,3,0,2,3,0,0,2,3,5,19,36,16,14,20,January,0.4999999999999999,0.8660254037844387,0,13,5,0,0,2.6,0.4,37,19,18,17,36,-19,"January, 2007"
2006-2007,22,2007-01-02,Aston Villa,Chelsea,0,0,D,1,1,3,2,0,0,5,0,14,2,25,47,12,22,January,0.4999999999999999,0.8660254037844387,1,14,0,3,2,0.6,1.0,23,25,-2,37,17,20,"January, 2007"
2006-2007,23,2007-01-13,West Ham,Fulham,3,3,D,1,1,4,0,1,1,1,3,18,13,18,27,5,9,January,0.4999999999999999,0.8660254037844387,45,19,3,2,0,1.2,0.6,12,33,-21,22,32,-10,"January, 2007"
2006-2007,23,2007-01-13,Blackburn,Arsenal,0,2,A,0,3,2,3,0,2,3,0,11,4,28,39,7,11,January,0.4999999999999999,0.8660254037844387,4,0,1,0,4,0.6,2.6,24,29,-5,41,19,22,"January, 2007"
2006-2007,23,2007-01-13,Bolton,Man City,0,0,D,1,1,0,2,3,0,1,4,5,10,39,29,5,10,January,0.4999999999999999,0.8660254037844387,6,27,4,0,1,1.2,0.2,27,21,6,19,25,-6,"January, 2007"
2006-2007,23,2007-01-13,Charlton,Middlesbrough,1,3,A,0,3,0,2,3,2,1,2,19,15,16,24,4,8,January,0.4999999999999999,0.8660254037844387,13,29,2,1,2,1.6,1.4,17,40,-23,21,27,-6,"January, 2007"
2006-2007,23,2007-01-13,Chelsea,Wigan,4,0,H,3,0,0,5,0,1,1,3,2,17,48,22,15,26,January,0.4999999999999999,0.8660254037844387,14,46,3,0,0,1.6666666666666667,0.6666666666666666,37,17,20,23,32,-9,"January, 2007"
2006-2007,23,2007-01-13,Man United,Aston Villa,3,1,H,3,0,2,2,1,3,2,0,1,14,54,26,13,28,January,0.4999999999999999,0.8660254037844387,28,1,5,0,0,2.0,0.2,49,15,34,23,25,-2,"January, 2007"
2006-2007,23,2007-01-13,Sheffield United,Portsmouth,1,1,D,1,1,1,1,3,2,2,1,16,6,23,36,10,13,January,0.4999999999999999,0.8660254037844387,36,33,0,0,1,1.0,3.0,17,29,-12,33,22,11,"January, 2007"
2006-2007,23,2007-01-13,Watford,Liverpool,0,3,A,0,3,1,2,2,2,1,2,20,4,12,40,16,28,January,0.4999999999999999,0.8660254037844387,43,25,1,0,2,1.0,1.6666666666666667,12,26,-14,32,16,16,"January, 2007"
2006-2007,23,2007-01-14,Tottenham,Newcastle,2,3,A,0,3,3,2,0,0,2,3,8,15,32,26,7,6,January,0.4999999999999999,0.8660254037844387,42,30,3,0,2,1.2,1.2,26,28,-2,23,28,-5,"January, 2007"
2006-2007,23,2007-01-14,Everton,Reading,1,1,D,1,1,2,1,2,3,1,1,8,9,31,30,1,1,January,0.4999999999999999,0.8660254037844387,18,35,1,0,0,2.0,0.0,28,22,6,30,30,0,"January, 2007"
2006-2007,24,2007-01-20,Aston Villa,Watford,2,0,H,3,0,3,2,0,1,2,2,15,20,26,12,5,14,January,0.4999999999999999,0.8660254037844387,1,43,2,1,0,1.6666666666666667,0.0,24,28,-4,12,29,-17,"January, 2007"
2006-2007,24,2007-01-20,Fulham,Tottenham,1,1,D,1,1,1,1,3,3,2,0,14,8,28,32,6,4,January,0.4999999999999999,0.8660254037844387,19,42,2,1,2,0.6,0.6,25,35,-10,28,31,-3,"January, 2007"
2006-2007,24,2007-01-20,Liverpool,Chelsea,2,0,H,3,0,2,1,2,0,5,0,3,2,43,51,1,8,January,0.4999999999999999,0.8660254037844387,25,14,0,0,5,0.2,1.8,35,16,19,41,17,24,"January, 2007"
2006-2007,24,2007-01-20,Man City,Blackburn,0,3,A,0,3,0,1,4,2,3,0,10,14,30,28,4,2,January,0.4999999999999999,0.8660254037844387,27,4,0,3,2,0.6,1.4,19,25,-6,24,31,-7,"January, 2007"
2006-2007,24,2007-01-20,Middlesbrough,Bolton,5,1,H,3,0,2,1,2,0,2,3,15,5,27,40,10,13,January,0.4999999999999999,0.8660254037844387,29,6,1,4,0,1.2,1.0,24,28,-4,27,21,6,"January, 2007"
2006-2007,24,2007-01-20,Newcastle,West Ham,2,2,D,1,1,0,2,3,4,0,1,14,18,29,19,4,10,January,0.4999999999999999,0.8660254037844387,30,45,3,2,0,2.4,0.8,26,30,-4,15,36,-21,"January, 2007"
2006-2007,24,2007-01-20,Portsmouth,Charlton,0,1,A,0,3,2,2,1,0,2,3,6,19,37,16,13,21,January,0.4999999999999999,0.8660254037844387,33,13,2,0,3,1.6,1.6,34,23,11,18,43,-25,"January, 2007"
2006-2007,24,2007-01-20,Reading,Sheffield United,3,1,H,3,0,3,1,1,1,1,3,9,16,31,24,7,7,January,0.4999999999999999,0.8660254037844387,35,36,1,0,0,2.0,1.0,31,31,0,18,30,-12,"January, 2007"
2006-2007,24,2007-01-21,Arsenal,Man United,2,1,H,3,0,2,3,0,2,2,1,4,1,42,57,3,15,January,0.4999999999999999,0.8660254037844387,0,28,1,1,3,0.6,1.6,43,19,24,52,16,36,"January, 2007"
2006-2007,24,2007-01-21,Wigan,Everton,0,2,A,0,3,1,1,3,2,1,2,17,9,22,32,8,10,January,0.4999999999999999,0.8660254037844387,46,18,1,2,0,1.3333333333333333,1.0,23,36,-13,29,23,6,"January, 2007"
2006-2007,24,2007-01-23,Watford,Blackburn,2,1,H,3,0,1,2,2,2,3,0,20,10,12,31,10,19,January,0.4999999999999999,0.8660254037844387,43,4,0,0,0,0.0,0.0,12,31,-19,27,31,-4,"January, 2007"
2006-2007,25,2007-01-30,West Ham,Liverpool,1,2,A,0,3,4,0,1,2,1,2,18,3,20,46,15,26,January,0.4999999999999999,0.8660254037844387,45,25,0,0,5,0.4,2.2,17,38,-21,37,16,21,"January, 2007"
2006-2007,25,2007-01-30,Sheffield United,Fulham,2,0,H,3,0,1,1,3,1,1,3,16,15,24,29,1,5,January,0.4999999999999999,0.8660254037844387,36,19,0,0,1,0.0,1.0,19,33,-14,26,36,-10,"January, 2007"
2006-2007,25,2007-01-30,Portsmouth,Middlesbrough,0,0,D,1,1,2,2,1,2,1,2,6,11,37,30,5,7,January,0.4999999999999999,0.8660254037844387,33,29,3,2,0,1.8,0.6,34,24,10,29,29,0,"January, 2007"
2006-2007,25,2007-01-30,Reading,Wigan,3,2,H,3,0,3,1,1,1,1,3,8,17,34,22,9,12,January,0.4999999999999999,0.8660254037844387,35,46,0,0,1,0.0,1.0,34,32,2,23,38,-15,"January, 2007"
2006-2007,25,2007-01-31,Bolton,Charlton,1,1,D,1,1,0,2,3,0,2,3,5,19,40,19,14,21,January,0.4999999999999999,0.8660254037844387,6,13,4,0,1,2.2,1.0,28,26,2,19,43,-24,"January, 2007"
2006-2007,25,2007-01-31,Chelsea,Blackburn,3,0,H,3,0,0,5,0,2,3,0,2,11,51,31,9,20,January,0.4999999999999999,0.8660254037844387,14,4,4,0,1,2.2,0.6,41,19,22,28,33,-5,"January, 2007"
2006-2007,25,2007-01-31,Man United,Watford,4,0,H,3,0,2,2,1,1,2,2,1,20,57,15,19,42,January,0.4999999999999999,0.8660254037844387,28,43,3,0,0,3.0,1.3333333333333333,53,18,35,14,32,-18,"January, 2007"
2006-2007,25,2007-01-31,Newcastle,Aston Villa,3,1,H,3,0,0,2,3,3,2,0,12,14,30,29,2,1,January,0.4999999999999999,0.8660254037844387,30,1,1,1,3,1.0,2.2,28,32,-4,26,28,-2,"January, 2007"
2006-2007,26,2007-02-03,Middlesbrough,Arsenal,1,1,D,1,1,2,1,2,2,3,0,14,4,31,45,10,14,February,0.8660254037844386,0.5000000000000001,29,0,1,1,3,1.2,3.0,29,29,0,45,20,25,"February, 2007"
2006-2007,26,2007-02-03,Wigan,Portsmouth,1,0,H,3,0,1,1,3,2,2,1,17,7,22,38,10,16,February,0.8660254037844386,0.5000000000000001,46,33,1,0,2,1.0,1.0,25,41,-16,34,24,10,"February, 2007"
2006-2007,26,2007-02-03,Watford,Bolton,0,1,A,0,3,1,2,2,0,2,3,20,5,15,41,15,26,February,0.8660254037844386,0.5000000000000001,43,6,0,0,1,0.0,1.0,14,36,-22,29,27,2,"February, 2007"
2006-2007,26,2007-02-03,Man City,Reading,0,2,A,0,3,0,1,4,3,1,1,15,7,30,37,8,7,February,0.8660254037844386,0.5000000000000001,27,35,0,0,1,0.0,1.0,19,28,-9,37,34,3,"February, 2007"
2006-2007,26,2007-02-03,Blackburn,Sheffield United,2,1,H,3,0,2,3,0,1,1,3,13,16,31,27,3,4,February,0.8660254037844386,0.5000000000000001,4,36,0,1,0,0.0,0.0,28,36,-8,21,33,-12,"February, 2007"
2006-2007,26,2007-02-03,Fulham,Newcastle,2,1,H,3,0,1,1,3,0,2,3,15,10,29,33,5,4,February,0.8660254037844386,0.5000000000000001,19,30,3,1,1,1.8,1.2,26,38,-12,31,33,-2,"February, 2007"
2006-2007,26,2007-02-03,Charlton,Chelsea,0,1,A,0,3,0,2,3,0,5,0,19,2,20,54,17,34,February,0.8660254037844386,0.5000000000000001,13,14,0,1,4,0.4,2.0,20,44,-24,44,19,25,"February, 2007"
2006-2007,26,2007-02-03,Aston Villa,West Ham,1,0,H,3,0,3,2,0,4,0,1,14,18,29,20,4,9,February,0.8660254037844386,0.5000000000000001,1,45,1,2,2,1.6,2.0,27,31,-4,18,40,-22,"February, 2007"
2006-2007,26,2007-02-03,Liverpool,Everton,0,0,D,1,1,2,1,2,2,1,2,3,8,49,35,5,14,February,0.8660254037844386,0.5000000000000001,25,18,3,0,2,1.6,1.4,39,17,22,31,23,8,"February, 2007"
2006-2007,26,2007-02-04,Tottenham,Man United,0,4,A,0,3,3,2,0,2,2,1,11,1,33,60,10,27,February,0.8660254037844386,0.5000000000000001,42,28,0,2,3,0.4,1.0,29,32,-3,57,18,39,"February, 2007"
2006-2007,27,2007-02-10,West Ham,Watford,0,1,A,0,3,4,0,1,1,2,2,18,20,20,15,2,5,February,0.8660254037844386,0.5000000000000001,45,43,2,1,0,1.3333333333333333,0.6666666666666666,18,41,-23,14,37,-23,"February, 2007"
2006-2007,27,2007-02-10,Sheffield United,Tottenham,2,1,H,3,0,1,1,3,3,2,0,16,11,27,33,5,6,February,0.8660254037844386,0.5000000000000001,36,42,0,0,1,0.0,2.0,22,35,-13,29,36,-7,"February, 2007"
2006-2007,27,2007-02-10,Reading,Aston Villa,2,0,H,3,0,3,1,1,3,2,0,7,13,40,32,6,8,February,0.8660254037844386,0.5000000000000001,35,1,0,0,1,1.0,2.0,39,34,5,28,31,-3,"February, 2007"
2006-2007,27,2007-02-10,Portsmouth,Man City,2,1,H,3,0,2,2,1,0,1,4,8,15,38,30,7,8,February,0.8660254037844386,0.5000000000000001,33,27,1,1,3,0.8,1.6,34,25,9,19,30,-11,"February, 2007"
2006-2007,27,2007-02-10,Newcastle,Liverpool,2,1,H,3,0,0,2,3,2,1,2,10,3,33,50,7,17,February,0.8660254037844386,0.5000000000000001,30,25,1,0,4,0.6,2.0,32,35,-3,39,17,22,"February, 2007"
2006-2007,27,2007-02-10,Everton,Blackburn,1,0,H,3,0,2,1,2,2,3,0,8,9,36,34,1,2,February,0.8660254037844386,0.5000000000000001,18,4,2,2,1,0.8,0.4,31,23,8,30,37,-7,"February, 2007"
2006-2007,27,2007-02-10,Chelsea,Middlesbrough,3,0,H,3,0,0,5,0,2,1,2,2,12,57,32,10,25,February,0.8660254037844386,0.5000000000000001,14,29,3,0,2,1.0,1.0,45,19,26,30,30,0,"February, 2007"
2006-2007,27,2007-02-10,Man United,Charlton,2,0,H,3,0,2,2,1,0,2,3,1,19,63,20,18,43,February,0.8660254037844386,0.5000000000000001,28,13,5,0,0,3.2,0.2,61,18,43,20,45,-25,"February, 2007"
2006-2007,27,2007-02-11,Arsenal,Wigan,2,1,H,3,0,2,3,0,1,1,3,4,17,46,25,13,21,February,0.8660254037844386,0.5000000000000001,0,46,3,0,0,2.6666666666666665,1.3333333333333333,46,21,25,26,41,-15,"February, 2007"
2006-2007,27,2007-02-11,Bolton,Fulham,2,1,H,3,0,0,2,3,1,1,3,5,14,44,32,9,12,February,0.8660254037844386,0.5000000000000001,6,19,2,1,2,1.4,1.4,30,27,3,28,39,-11,"February, 2007"
2006-2007,27,2007-02-21,Everton,Tottenham,1,2,A,0,3,2,1,2,3,2,0,8,11,39,33,3,6,February,0.8660254037844386,0.5000000000000001,18,42,1,0,4,0.8,1.8,32,23,9,30,38,-8,"February, 2007"
2006-2007,27,2007-02-21,Watford,Wigan,1,1,D,1,1,1,2,2,1,1,3,20,17,18,25,3,7,February,0.8660254037844386,0.5000000000000001,43,46,0,1,0,1.0,1.0,15,37,-22,27,43,-16,"February, 2007"
2006-2007,28,2007-02-24,Watford,Everton,0,3,A,0,3,1,2,2,2,1,2,20,8,19,39,12,20,February,0.8660254037844386,0.5000000000000001,43,18,0,0,3,1.3333333333333333,3.0,16,38,-22,33,25,8,"February, 2007"
2006-2007,28,2007-02-24,Liverpool,Sheffield United,4,0,H,3,0,2,1,2,1,1,3,3,15,50,30,12,20,February,0.8660254037844386,0.5000000000000001,25,36,0,1,0,1.0,1.0,40,19,21,24,36,-12,"February, 2007"
2006-2007,28,2007-02-24,Middlesbrough,Reading,2,1,H,3,0,2,1,2,3,1,1,12,6,32,43,6,11,February,0.8660254037844386,0.5000000000000001,29,35,0,0,1,2.0,3.0,30,33,-3,41,34,7,"February, 2007"
2006-2007,28,2007-02-24,Fulham,Man United,1,2,A,0,3,1,1,3,2,2,1,14,1,32,66,13,34,February,0.8660254037844386,0.5000000000000001,19,28,0,1,4,1.2,2.8,29,41,-12,63,18,45,"February, 2007"
2006-2007,28,2007-02-24,Charlton,West Ham,4,0,H,3,0,0,2,3,4,0,1,19,18,20,20,1,0,February,0.8660254037844386,0.5000000000000001,13,45,3,1,1,1.8,1.0,20,47,-27,18,42,-24,"February, 2007"
2006-2007,28,2007-02-25,Blackburn,Portsmouth,3,0,H,3,0,2,3,0,2,2,1,12,8,34,41,4,7,February,0.8660254037844386,0.5000000000000001,4,33,3,1,1,1.2,1.2,30,38,-8,36,26,10,"February, 2007"
2006-2007,28,2007-02-25,Tottenham,Bolton,4,1,H,3,0,3,2,0,0,2,3,11,5,36,47,6,11,February,0.8660254037844386,0.5000000000000001,42,6,1,0,4,0.6,1.6,32,39,-7,32,28,4,"February, 2007"
2006-2007,28,2007-02-25,Wigan,Newcastle,1,0,H,3,0,1,1,3,0,2,3,17,11,26,36,6,10,February,0.8660254037844386,0.5000000000000001,46,30,1,0,2,1.0,1.6666666666666667,28,44,-16,34,36,-2,"February, 2007"
2006-2007,29,2007-03-03,Watford,Charlton,2,2,D,1,1,1,2,2,0,2,3,20,18,19,23,2,4,March,1.0,6.123233995736766e-17,43,13,0,1,0,0.0,0.0,16,41,-25,24,47,-23,"March, 2007"
2006-2007,29,2007-03-03,Sheffield United,Everton,1,1,D,1,1,1,1,3,2,1,2,17,7,30,42,10,12,March,1.0,6.123233995736766e-17,36,18,0,0,1,0.0,2.0,24,40,-16,36,25,11,"March, 2007"
2006-2007,29,2007-03-03,Portsmouth,Chelsea,0,2,A,0,3,2,2,1,0,5,0,8,2,41,60,6,19,March,1.0,6.123233995736766e-17,33,14,0,0,5,0.2,2.2,36,29,7,48,19,29,"March, 2007"
2006-2007,29,2007-03-03,Newcastle,Middlesbrough,0,0,D,1,1,0,2,3,2,1,2,11,12,36,35,1,1,March,1.0,6.123233995736766e-17,30,29,1,3,1,1.2,1.2,34,37,-3,32,34,-2,"March, 2007"
2006-2007,29,2007-03-03,Liverpool,Man United,0,1,A,0,3,2,1,2,2,2,1,3,1,53,69,2,16,March,1.0,6.123233995736766e-17,25,28,0,1,4,0.2,1.2,44,19,25,65,19,46,"March, 2007"
2006-2007,29,2007-03-03,Fulham,Aston Villa,1,1,D,1,1,1,1,3,3,2,0,14,13,32,32,1,0,March,1.0,6.123233995736766e-17,19,1,0,4,1,1.0,1.4,30,43,-13,28,33,-5,"March, 2007"
2006-2007,29,2007-03-03,Arsenal,Reading,2,1,H,3,0,2,3,0,3,1,1,4,6,49,43,2,6,March,1.0,6.123233995736766e-17,0,35,1,0,0,4.0,0.0,48,22,26,42,36,6,"March, 2007"
2006-2007,29,2007-03-03,Man City,Wigan,0,1,A,0,3,0,1,4,1,1,3,15,17,30,29,2,1,March,1.0,6.123233995736766e-17,27,46,0,0,3,1.0,3.0,20,32,-12,29,44,-15,"March, 2007"
2006-2007,29,2007-03-04,Bolton,Blackburn,1,2,A,0,3,0,2,3,2,3,0,5,11,47,37,6,10,March,1.0,6.123233995736766e-17,6,4,2,2,1,0.4,0.2,33,32,1,33,38,-5,"March, 2007"
2006-2007,29,2007-03-04,West Ham,Tottenham,3,4,A,0,3,4,0,1,3,2,0,20,10,20,39,10,19,March,1.0,6.123233995736766e-17,45,42,2,1,2,1.4,1.2,18,46,-28,36,40,-4,"March, 2007"
2006-2007,29,2007-03-14,Aston Villa,Arsenal,0,1,A,0,3,3,2,0,2,3,0,13,4,33,52,9,19,March,1.0,6.123233995736766e-17,1,0,0,2,3,0.6,2.4,29,34,-5,50,23,27,"March, 2007"
2006-2007,29,2007-03-14,Man City,Chelsea,0,1,A,0,3,0,1,4,0,5,0,17,2,30,63,15,33,March,1.0,6.123233995736766e-17,27,14,1,1,3,0.2,1.2,20,33,-13,50,19,31,"March, 2007"
2006-2007,30,2007-03-17,Tottenham,Watford,3,1,H,3,0,3,2,0,1,2,2,9,20,42,20,11,22,March,1.0,6.123233995736766e-17,42,43,1,2,0,1.6666666666666667,0.3333333333333333,40,43,-3,18,43,-25,"March, 2007"
2006-2007,30,2007-03-17,Wigan,Fulham,0,0,D,1,1,1,1,3,1,1,3,16,15,32,33,1,1,March,1.0,6.123233995736766e-17,46,19,2,0,1,0.6666666666666666,0.3333333333333333,30,44,-14,31,44,-13,"March, 2007"
2006-2007,30,2007-03-17,Reading,Portsmouth,0,0,D,1,1,3,1,1,2,2,1,7,9,43,41,2,2,March,1.0,6.123233995736766e-17,35,33,0,0,1,1.0,3.0,43,38,5,36,31,5,"March, 2007"
2006-2007,30,2007-03-17,Middlesbrough,Man City,0,2,A,0,3,2,1,2,0,1,4,12,17,36,30,5,6,March,1.0,6.123233995736766e-17,29,27,2,2,1,1.0,0.8,32,34,-2,20,34,-14,"March, 2007"
2006-2007,30,2007-03-17,Man United,Bolton,4,1,H,3,0,2,2,1,0,2,3,1,5,72,47,4,25,March,1.0,6.123233995736766e-17,28,6,4,1,0,2.8,0.8,66,19,47,34,34,0,"March, 2007"
2006-2007,30,2007-03-17,Chelsea,Sheffield United,3,0,H,3,0,0,5,0,1,1,3,2,16,66,31,14,35,March,1.0,6.123233995736766e-17,14,36,1,0,0,2.0,0.0,51,19,32,25,41,-16,"March, 2007"
2006-2007,30,2007-03-17,Blackburn,West Ham,1,2,A,0,3,2,3,0,4,0,1,10,20,40,20,10,20,March,1.0,6.123233995736766e-17,4,45,1,1,3,1.6,2.2,35,39,-4,21,50,-29,"March, 2007"
2006-2007,30,2007-03-18,Aston Villa,Liverpool,0,0,D,1,1,3,2,0,2,1,2,14,4,33,53,10,20,March,1.0,6.123233995736766e-17,1,25,0,1,4,0.8,2.2,29,35,-6,44,20,24,"March, 2007"
2006-2007,30,2007-03-18,Charlton,Newcastle,2,0,H,3,0,0,2,3,0,2,3,18,11,24,37,7,13,March,1.0,6.123233995736766e-17,13,30,1,4,0,1.0,0.6,26,49,-23,34,37,-3,"March, 2007"
2006-2007,30,2007-03-18,Everton,Arsenal,1,0,H,3,0,2,1,2,2,3,0,8,3,43,55,5,12,March,1.0,6.123233995736766e-17,18,0,1,1,3,0.6,2.8,37,26,11,51,23,28,"March, 2007"
2006-2007,31,2007-03-31,West Ham,Middlesbrough,2,0,H,3,0,4,0,1,2,1,2,19,12,23,36,7,13,March,1.0,6.123233995736766e-17,45,29,2,1,2,1.0,1.2,23,51,-28,32,36,-4,"March, 2007"
2006-2007,31,2007-03-31,Watford,Chelsea,0,1,A,0,3,1,2,2,0,5,0,20,2,20,69,18,49,March,1.0,6.123233995736766e-17,43,14,1,0,2,0.6666666666666666,2.0,19,46,-27,54,19,35,"March, 2007"
2006-2007,31,2007-03-31,Newcastle,Man City,0,1,A,0,3,0,2,3,0,1,4,11,15,37,33,4,4,March,1.0,6.123233995736766e-17,30,27,2,2,1,1.2,1.4,34,39,-5,22,34,-12,"March, 2007"
2006-2007,31,2007-03-31,Man United,Blackburn,4,1,H,3,0,2,2,1,2,3,0,1,10,75,40,9,35,March,1.0,6.123233995736766e-17,28,4,1,2,2,1.2,1.4,70,20,50,36,41,-5,"March, 2007"
2006-2007,31,2007-03-31,Fulham,Portsmouth,1,1,D,1,1,1,1,3,2,2,1,14,9,34,42,5,8,March,1.0,6.123233995736766e-17,19,33,1,1,3,1.6,2.0,31,44,-13,36,31,5,"March, 2007"
2006-2007,31,2007-03-31,Charlton,Wigan,1,0,H,3,0,0,2,3,1,1,3,18,16,27,33,2,6,March,1.0,6.123233995736766e-17,13,46,1,0,2,1.0,2.0,28,49,-21,30,44,-14,"March, 2007"
2006-2007,31,2007-03-31,Bolton,Sheffield United,1,0,H,3,0,0,2,3,1,1,3,5,17,47,31,12,16,March,1.0,6.123233995736766e-17,6,36,0,1,0,2.0,2.0,35,38,-3,25,44,-19,"March, 2007"
2006-2007,31,2007-03-31,Liverpool,Arsenal,4,1,H,3,0,2,1,2,2,3,0,4,3,54,55,1,1,March,1.0,6.123233995736766e-17,25,0,2,0,3,1.0,1.8,44,20,24,51,24,27,"March, 2007"
2006-2007,31,2007-04-01,Tottenham,Reading,1,0,H,3,0,3,2,0,3,1,1,7,8,45,44,1,1,April,0.8660254037844388,-0.4999999999999998,42,35,0,0,1,1.0,3.0,43,44,-1,43,38,5,"April, 2007"
2006-2007,31,2007-04-02,Aston Villa,Everton,1,1,D,1,1,3,2,0,2,1,2,15,7,34,46,8,12,April,0.8660254037844388,-0.4999999999999998,1,18,2,1,2,1.6,1.6,29,35,-6,38,26,12,"April, 2007"
2006-2007,32,2007-04-06,Everton,Fulham,4,1,H,3,0,2,1,2,1,1,3,7,15,47,35,8,12,April,0.8660254037844388,-0.4999999999999998,18,19,2,0,3,0.8,1.0,39,27,12,32,45,-13,"April, 2007"
2006-2007,32,2007-04-06,Man City,Charlton,0,0,D,1,1,0,1,4,0,2,3,13,18,36,30,5,6,April,0.8660254037844388,-0.4999999999999998,27,13,3,1,1,2.8,1.4,23,34,-11,29,49,-20,"April, 2007"
2006-2007,32,2007-04-07,Sheffield United,Newcastle,1,2,A,0,3,1,1,3,0,2,3,18,13,31,37,5,6,April,0.8660254037844388,-0.4999999999999998,36,30,1,0,0,1.0,0.0,25,45,-20,34,40,-6,"April, 2007"
2006-2007,32,2007-04-07,Wigan,Bolton,1,3,A,0,3,1,1,3,0,2,3,16,6,33,50,10,17,April,0.8660254037844388,-0.4999999999999998,46,6,2,1,0,1.3333333333333333,0.6666666666666666,30,45,-15,36,38,-2,"April, 2007"
2006-2007,32,2007-04-07,Portsmouth,Man United,2,1,H,3,0,2,2,1,2,2,1,9,1,43,78,8,35,April,0.8660254037844388,-0.4999999999999998,33,28,1,0,4,0.8,2.2,37,32,5,74,21,53,"April, 2007"
2006-2007,32,2007-04-07,Reading,Liverpool,1,2,A,0,3,3,1,1,2,1,2,9,3,44,57,6,13,April,0.8660254037844388,-0.4999999999999998,35,25,0,0,1,0.0,2.0,43,39,4,48,21,27,"April, 2007"
2006-2007,32,2007-04-07,Chelsea,Tottenham,1,0,H,3,0,0,5,0,3,2,0,2,7,72,48,5,24,April,0.8660254037844388,-0.4999999999999998,14,42,3,1,1,1.4,0.6,55,19,36,44,44,0,"April, 2007"
2006-2007,32,2007-04-07,Middlesbrough,Watford,4,1,H,3,0,2,1,2,1,2,2,14,20,36,20,6,16,April,0.8660254037844388,-0.4999999999999998,29,43,1,1,1,1.3333333333333333,1.3333333333333333,32,38,-6,19,47,-28,"April, 2007"
2006-2007,32,2007-04-07,Blackburn,Aston Villa,1,2,A,0,3,2,3,0,3,2,0,10,14,40,35,4,5,April,0.8660254037844388,-0.4999999999999998,4,1,1,1,3,0.8,1.2,37,45,-8,30,36,-6,"April, 2007"
2006-2007,32,2007-04-07,Arsenal,West Ham,0,1,A,0,3,2,3,0,4,0,1,4,19,55,26,15,29,April,0.8660254037844388,-0.4999999999999998,0,45,1,2,2,1.4,1.4,52,28,24,25,51,-26,"April, 2007"
2006-2007,33,2007-04-09,Aston Villa,Wigan,1,1,D,1,1,3,2,0,1,1,3,13,16,38,33,3,5,April,0.8660254037844388,-0.4999999999999998,1,46,0,1,2,0.6666666666666666,1.6666666666666667,32,37,-5,31,48,-17,"April, 2007"
2006-2007,33,2007-04-09,Bolton,Everton,1,1,D,1,1,0,2,3,2,1,2,5,6,53,50,1,3,April,0.8660254037844388,-0.4999999999999998,6,18,2,0,3,1.8,1.4,39,39,0,43,28,15,"April, 2007"
2006-2007,33,2007-04-09,Charlton,Reading,0,0,D,1,1,0,2,3,3,1,1,17,9,31,44,8,13,April,0.8660254037844388,-0.4999999999999998,13,35,0,0,1,0.0,2.0,29,49,-20,44,41,3,"April, 2007"
2006-2007,33,2007-04-09,Fulham,Man City,1,3,A,0,3,1,1,3,0,1,4,15,14,35,37,1,2,April,0.8660254037844388,-0.4999999999999998,19,27,2,2,1,1.4,1.4,33,49,-16,23,34,-11,"April, 2007"
2006-2007,33,2007-04-09,Newcastle,Arsenal,0,0,D,1,1,0,2,3,2,3,0,10,4,40,55,6,15,April,0.8660254037844388,-0.4999999999999998,30,0,1,1,3,0.4,1.0,36,41,-5,52,29,23,"April, 2007"
2006-2007,33,2007-04-09,Watford,Portsmouth,4,2,H,3,0,1,2,2,2,2,1,20,8,20,46,12,26,April,0.8660254037844388,-0.4999999999999998,43,33,0,0,1,1.0,2.0,20,51,-31,39,33,6,"April, 2007"
2006-2007,34,2007-04-14,Sheffield United,West Ham,3,0,H,3,0,1,1,3,4,0,1,18,19,31,29,1,2,April,0.8660254037844388,-0.4999999999999998,36,45,0,0,1,0.0,1.0,26,47,-21,26,51,-25,"April, 2007"
2006-2007,34,2007-04-14,Reading,Fulham,1,0,H,3,0,3,1,1,1,1,3,9,15,45,35,6,10,April,0.8660254037844388,-0.4999999999999998,35,19,1,0,0,1.0,0.0,44,41,3,34,52,-18,"April, 2007"
2006-2007,34,2007-04-14,Portsmouth,Newcastle,2,1,H,3,0,2,2,1,0,2,3,8,11,46,41,3,5,April,0.8660254037844388,-0.4999999999999998,33,30,0,3,2,0.4,1.0,41,37,4,36,41,-5,"April, 2007"
2006-2007,34,2007-04-14,Man City,Liverpool,0,0,D,1,1,0,1,4,2,1,2,12,3,40,60,9,20,April,0.8660254037844388,-0.4999999999999998,27,25,1,0,4,0.4,1.0,26,35,-9,50,22,28,"April, 2007"
2006-2007,34,2007-04-14,Arsenal,Bolton,2,1,H,3,0,2,3,0,0,2,3,4,5,56,54,1,2,April,0.8660254037844388,-0.4999999999999998,0,6,0,2,3,0.8,1.8,52,29,23,40,40,0,"April, 2007"
2006-2007,34,2007-04-14,Middlesbrough,Aston Villa,1,3,A,0,3,2,1,2,3,2,0,13,14,39,39,1,0,April,0.8660254037844388,-0.4999999999999998,29,1,2,1,2,1.4,1.8,36,39,-3,33,38,-5,"April, 2007"
2006-2007,34,2007-04-15,Everton,Charlton,2,1,H,3,0,2,1,2,0,2,3,6,18,51,32,12,19,April,0.8660254037844388,-0.4999999999999998,18,13,1,2,2,0.8,1.0,44,29,15,29,49,-20,"April, 2007"
2006-2007,34,2007-04-15,Wigan,Tottenham,3,3,D,1,1,1,1,3,3,2,0,16,9,34,48,7,14,April,0.8660254037844388,-0.4999999999999998,46,42,0,1,2,1.3333333333333333,2.333333333333333,32,49,-17,44,45,-1,"April, 2007"
2006-2007,35,2007-04-17,Arsenal,Man City,3,1,H,3,0,2,3,0,0,1,4,4,12,59,41,8,18,April,0.8660254037844388,-0.4999999999999998,0,27,3,1,1,1.2,0.6,54,30,24,26,35,-9,"April, 2007"
2006-2007,35,2007-04-17,Man United,Sheffield United,2,0,H,3,0,2,2,1,1,1,3,1,17,78,34,16,44,April,0.8660254037844388,-0.4999999999999998,28,36,1,0,0,2.0,1.0,75,23,52,29,47,-18,"April, 2007"
2006-2007,35,2007-04-18,Blackburn,Watford,3,1,H,3,0,2,3,0,1,2,2,13,20,40,23,7,17,April,0.8660254037844388,-0.4999999999999998,4,43,0,0,1,1.0,2.0,38,47,-9,24,53,-29,"April, 2007"
2006-2007,35,2007-04-18,Liverpool,Middlesbrough,2,0,H,3,0,2,1,2,2,1,2,4,14,61,39,10,22,April,0.8660254037844388,-0.4999999999999998,25,29,1,3,1,0.6,0.6,50,22,28,37,42,-5,"April, 2007"
2006-2007,35,2007-04-18,West Ham,Chelsea,1,4,A,0,3,4,0,1,0,5,0,19,2,29,75,17,46,April,0.8660254037844388,-0.4999999999999998,45,14,2,0,3,1.2,2.0,26,54,-28,56,19,37,"April, 2007"
2006-2007,36,2007-04-21,Tottenham,Arsenal,2,2,D,1,1,3,2,0,2,3,0,9,4,49,62,5,13,April,0.8660254037844388,-0.4999999999999998,42,0,0,2,3,1.2,2.2,47,48,-1,57,31,26,"April, 2007"
2006-2007,36,2007-04-21,West Ham,Everton,1,0,H,3,0,4,0,1,2,1,2,19,5,29,54,14,25,April,0.8660254037844388,-0.4999999999999998,45,18,1,2,2,0.8,1.2,27,58,-31,46,30,16,"April, 2007"
2006-2007,36,2007-04-21,Watford,Man City,1,1,D,1,1,1,2,2,0,1,4,20,13,23,41,7,18,April,0.8660254037844388,-0.4999999999999998,43,27,0,1,0,0.0,0.0,25,56,-31,27,38,-11,"April, 2007"
2006-2007,36,2007-04-21,Man United,Middlesbrough,1,1,D,1,1,2,2,1,2,1,2,1,14,81,39,13,42,April,0.8660254037844388,-0.4999999999999998,28,29,2,2,1,1.2,1.2,77,23,54,37,44,-7,"April, 2007"
2006-2007,36,2007-04-21,Bolton,Reading,1,3,A,0,3,0,2,3,3,1,1,6,9,54,48,3,6,April,0.8660254037844388,-0.4999999999999998,6,35,0,0,1,0.0,1.0,41,42,-1,45,41,4,"April, 2007"
2006-2007,36,2007-04-21,Fulham,Blackburn,1,1,D,1,1,1,1,3,2,3,0,16,10,35,43,6,8,April,0.8660254037844388,-0.4999999999999998,19,4,2,0,3,1.2,1.6,34,53,-19,41,48,-7,"April, 2007"
2006-2007,36,2007-04-21,Charlton,Sheffield United,1,1,D,1,1,0,2,3,1,1,3,18,17,32,34,1,2,April,0.8660254037844388,-0.4999999999999998,13,36,0,0,1,1.0,2.0,30,51,-21,29,49,-20,"April, 2007"
2006-2007,36,2007-04-21,Liverpool,Wigan,2,0,H,3,0,2,1,2,1,1,3,3,16,64,35,13,29,April,0.8660254037844388,-0.4999999999999998,25,46,3,0,0,2.6666666666666665,0.0,52,22,30,35,52,-17,"April, 2007"
2006-2007,36,2007-04-22,Aston Villa,Portsmouth,0,0,D,1,1,3,2,0,2,2,1,11,9,42,49,2,7,April,0.8660254037844388,-0.4999999999999998,1,33,3,2,0,1.8,0.8,36,39,-3,43,38,5,"April, 2007"
2006-2007,36,2007-04-22,Newcastle,Chelsea,0,0,D,1,1,0,2,3,0,5,0,13,2,41,78,11,37,April,0.8660254037844388,-0.4999999999999998,30,14,1,1,3,0.4,1.8,37,43,-6,60,20,40,"April, 2007"
2006-2007,37,2007-04-28,Wigan,West Ham,0,3,A,0,3,1,1,3,4,0,1,17,19,35,32,2,3,April,0.8660254037844388,-0.4999999999999998,46,45,2,0,1,1.6666666666666667,0.6666666666666666,35,54,-19,28,58,-30,"April, 2007"
2006-2007,37,2007-04-28,Sheffield United,Watford,1,0,H,3,0,1,1,3,1,2,2,17,20,35,24,3,11,April,0.8660254037844388,-0.4999999999999998,36,43,1,0,0,1.0,0.0,30,50,-20,26,57,-31,"April, 2007"
2006-2007,37,2007-04-28,Portsmouth,Liverpool,2,1,H,3,0,2,2,1,2,1,2,9,3,50,67,6,17,April,0.8660254037844388,-0.4999999999999998,33,25,0,2,3,0.6,1.8,43,38,5,54,22,32,"April, 2007"
2006-2007,37,2007-04-28,Middlesbrough,Tottenham,2,3,A,0,3,2,1,2,3,2,0,14,9,40,50,5,10,April,0.8660254037844388,-0.4999999999999998,29,42,1,1,3,1.0,1.8,38,45,-7,49,50,-1,"April, 2007"
2006-2007,37,2007-04-28,Everton,Man United,2,4,A,0,3,2,1,2,2,2,1,6,1,54,82,5,28,April,0.8660254037844388,-0.4999999999999998,18,28,1,2,2,0.4,1.2,46,31,15,78,24,54,"April, 2007"
2006-2007,37,2007-04-28,Chelsea,Bolton,2,2,D,1,1,0,5,0,0,2,3,2,6,79,54,4,25,April,0.8660254037844388,-0.4999999999999998,14,6,4,1,0,2.4,0.6,60,20,40,42,45,-3,"April, 2007"
2006-2007,37,2007-04-28,Blackburn,Charlton,4,1,H,3,0,2,3,0,0,2,3,10,18,44,33,8,11,April,0.8660254037844388,-0.4999999999999998,4,13,3,0,2,1.4,0.6,42,49,-7,31,52,-21,"April, 2007"
2006-2007,37,2007-04-28,Man City,Aston Villa,0,2,A,0,3,0,1,4,3,2,0,13,11,42,43,2,1,April,0.8660254037844388,-0.4999999999999998,27,1,5,0,0,2.2,0.6,28,39,-11,36,39,-3,"April, 2007"
2006-2007,37,2007-04-29,Arsenal,Fulham,3,1,H,3,0,2,3,0,1,1,3,4,16,63,36,12,27,April,0.8660254037844388,-0.4999999999999998,0,19,4,0,1,2.8,0.6,59,33,26,35,54,-19,"April, 2007"
2006-2007,37,2007-04-30,Reading,Newcastle,1,0,H,3,0,3,1,1,0,2,3,9,12,51,42,3,9,April,0.8660254037844388,-0.4999999999999998,35,30,0,0,1,2.0,3.0,48,42,6,37,43,-6,"April, 2007"
2006-2007,38,2007-05-05,Reading,Watford,0,2,A,0,3,3,1,1,1,2,2,7,20,54,24,13,30,May,0.4999999999999999,-0.8660254037844387,35,43,0,1,0,0.0,0.0,49,42,7,26,58,-32,"May, 2007"
2006-2007,38,2007-05-05,Wigan,Middlesbrough,0,1,A,0,3,1,1,3,2,1,2,18,14,35,40,4,5,May,0.4999999999999999,-0.8660254037844387,46,29,1,2,0,1.6666666666666667,1.3333333333333333,35,57,-22,40,48,-8,"May, 2007"
2006-2007,38,2007-05-05,West Ham,Bolton,3,1,H,3,0,4,0,1,0,2,3,18,6,35,55,12,20,May,0.4999999999999999,-0.8660254037844387,45,6,0,1,4,0.6,2.4,31,58,-27,44,47,-3,"May, 2007"
2006-2007,38,2007-05-05,Man City,Man United,0,1,A,0,3,0,1,4,2,2,1,13,1,42,85,12,43,May,0.4999999999999999,-0.8660254037844387,27,28,1,2,2,1.0,1.4,28,41,-13,82,26,56,"May, 2007"
2006-2007,38,2007-05-05,Everton,Portsmouth,3,0,H,3,0,2,1,2,2,2,1,6,8,54,53,2,1,May,0.4999999999999999,-0.8660254037844387,18,33,3,0,2,0.8,0.8,48,35,13,45,39,6,"May, 2007"
2006-2007,38,2007-05-05,Fulham,Liverpool,1,0,H,3,0,1,1,3,2,1,2,16,3,36,67,13,31,May,0.4999999999999999,-0.8660254037844387,19,25,1,0,4,1.2,3.2,36,57,-21,55,24,31,"May, 2007"
2006-2007,38,2007-05-05,Aston Villa,Sheffield United,3,0,H,3,0,3,2,0,1,1,3,11,15,46,38,4,8,May,0.4999999999999999,-0.8660254037844387,1,36,0,1,0,2.0,2.0,38,39,-1,31,50,-19,"May, 2007"
2006-2007,38,2007-05-05,Newcastle,Blackburn,0,2,A,0,3,0,2,3,2,3,0,12,11,42,47,1,5,May,0.4999999999999999,-0.8660254037844387,30,4,3,1,1,2.2,0.8,37,44,-7,46,50,-4,"May, 2007"
2006-2007,38,2007-05-06,Arsenal,Chelsea,1,1,D,1,1,2,3,0,0,5,0,4,2,66,80,2,14,May,0.4999999999999999,-0.8660254037844387,0,14,0,3,2,0.6,1.2,62,34,28,62,22,40,"May, 2007"
2006-2007,38,2007-05-07,Charlton,Tottenham,0,2,A,0,3,0,2,3,3,2,0,19,9,33,53,10,20,May,0.4999999999999999,-0.8660254037844387,13,42,2,0,3,1.8,2.6,32,56,-24,52,52,0,"May, 2007"
2006-2007,38,2007-05-09,Chelsea,Man United,0,0,D,1,1,0,5,0,2,2,1,2,1,81,88,1,7,May,0.4999999999999999,-0.8660254037844387,14,28,3,1,1,1.6,0.6,63,23,40,83,26,57,"May, 2007"
2006-2007,38,2007-05-10,Tottenham,Blackburn,1,1,D,1,1,3,2,0,2,3,0,6,10,56,50,4,6,May,0.4999999999999999,-0.8660254037844387,42,4,2,3,0,1.0,0.6,54,52,2,48,50,-2,"May, 2007"
2006-2007,39,2007-05-13,Blackburn,Reading,3,3,D,1,1,2,3,0,3,1,1,10,8,51,54,2,3,May,0.4999999999999999,-0.8660254037844387,4,35,1,0,0,2.0,1.0,49,51,-2,49,44,5,"May, 2007"
2006-2007,39,2007-05-13,Bolton,Aston Villa,2,2,D,1,1,0,2,3,3,2,0,8,11,55,49,3,6,May,0.4999999999999999,-0.8660254037844387,6,1,1,3,1,1.2,1.2,45,50,-5,41,39,2,"May, 2007"
2006-2007,39,2007-05-13,Chelsea,Everton,1,1,D,1,1,0,5,0,2,1,2,2,5,82,57,3,25,May,0.4999999999999999,-0.8660254037844387,14,18,4,1,0,1.8,0.6,63,23,40,51,35,16,"May, 2007"
2006-2007,39,2007-05-13,Liverpool,Charlton,2,2,D,1,1,2,1,2,0,2,3,3,19,67,33,16,34,May,0.4999999999999999,-0.8660254037844387,25,13,3,1,1,1.4,0.6,55,25,30,32,58,-26,"May, 2007"
2006-2007,39,2007-05-13,Man United,West Ham,0,1,A,0,3,2,2,1,4,0,1,1,17,89,38,16,51,May,0.4999999999999999,-0.8660254037844387,28,45,3,1,1,1.4,0.6,83,26,57,34,59,-25,"May, 2007"
2006-2007,39,2007-05-13,Middlesbrough,Fulham,3,1,H,3,0,2,1,2,1,1,3,12,16,43,39,4,4,May,0.4999999999999999,-0.8660254037844387,29,19,2,1,2,1.4,1.2,41,48,-7,37,57,-20,"May, 2007"
2006-2007,39,2007-05-13,Portsmouth,Arsenal,0,0,D,1,1,2,2,1,2,3,0,9,4,53,67,5,14,May,0.4999999999999999,-0.8660254037844387,33,0,0,2,3,0.6,2.2,45,42,3,63,35,28,"May, 2007"
2006-2007,39,2007-05-13,Sheffield United,Wigan,1,2,A,0,3,1,1,3,1,1,3,17,18,38,35,1,3,May,0.4999999999999999,-0.8660254037844387,36,46,1,0,0,1.0,0.0,31,53,-22,35,58,-23,"May, 2007"
2006-2007,39,2007-05-13,Tottenham,Man City,2,1,H,3,0,3,2,0,0,1,4,6,14,57,42,8,15,May,0.4999999999999999,-0.8660254037844387,42,27,5,0,0,1.8,0.6,55,53,2,28,42,-14,"May, 2007"
2006-2007,39,2007-05-13,Watford,Newcastle,1,1,D,1,1,1,2,2,0,2,3,20,13,27,42,7,15,May,0.4999999999999999,-0.8660254037844387,43,30,0,1,2,0.6666666666666666,1.3333333333333333,28,58,-30,37,46,-9,"May, 2007"
2007-2008,1,2007-08-11,West Ham,Man City,0,2,A,0,3,1,2,2,2,0,3,15,12,0,0,3,0,August,-0.8660254037844384,-0.5000000000000004,45,27,2,0,3,0.6,1.0,0,0,0,0,0,0,"August, 2007"
2007-2008,1,2007-08-11,Middlesbrough,Blackburn,1,2,A,0,3,2,1,2,2,1,2,13,8,0,0,5,0,August,-0.8660254037844384,-0.5000000000000004,29,4,1,0,4,0.8,1.6,0,0,0,0,0,0,"August, 2007"
2007-2008,1,2007-08-11,Sunderland,Tottenham,1,0,H,3,0,1,0,4,1,3,1,14,15,0,0,1,0,August,-0.8660254037844384,-0.5000000000000004,40,42,1,1,3,1.4,2.0,0,0,0,0,0,0,"August, 2007"
2007-2008,1,2007-08-11,Everton,Wigan,2,1,H,3,0,1,2,2,1,3,1,9,18,0,0,9,0,August,-0.8660254037844384,-0.5000000000000004,18,46,1,2,1,1.25,1.0,0,0,0,0,0,0,"August, 2007"
2007-2008,1,2007-08-11,Bolton,Newcastle,1,3,A,0,3,3,2,0,1,2,2,5,13,0,0,8,0,August,-0.8660254037844384,-0.5000000000000004,6,30,3,0,2,1.6,1.4,0,0,0,0,0,0,"August, 2007"
2007-2008,1,2007-08-11,Aston Villa,Liverpool,1,2,A,0,3,2,2,1,4,1,0,2,10,0,0,8,0,August,-0.8660254037844384,-0.5000000000000004,1,25,0,1,4,0.6,2.0,0,0,0,0,0,0,"August, 2007"
2007-2008,1,2007-08-11,Derby,Portsmouth,2,2,D,1,1,0,0,5,0,1,4,7,13,0,0,6,0,August,-0.8660254037844384,-0.5000000000000004,17,33,0,0,0,0.0,0.0,0,0,0,0,0,0,"August, 2007"
2007-2008,1,2007-08-12,Arsenal,Fulham,2,1,H,3,0,4,0,1,4,0,1,9,12,0,0,3,0,August,-0.8660254037844384,-0.5000000000000004,0,19,4,0,1,2.8,0.8,0,0,0,0,0,0,"August, 2007"
2007-2008,1,2007-08-12,Chelsea,Birmingham,3,2,H,3,0,3,2,0,1,2,2,11,10,0,0,1,0,August,-0.8660254037844384,-0.5000000000000004,14,3,2,3,0,0.8,0.2,0,0,0,0,0,0,"August, 2007"
2007-2008,1,2007-08-12,Man United,Reading,0,0,D,1,1,3,1,1,1,1,3,11,12,0,0,1,0,August,-0.8660254037844384,-0.5000000000000004,28,35,1,1,0,2.0,1.5,0,0,0,0,0,0,"August, 2007"
2007-2008,2,2007-08-14,Tottenham,Everton,1,3,A,0,3,1,3,1,1,2,2,18,6,0,3,12,3,August,-0.8660254037844384,-0.5000000000000004,42,18,4,0,1,2.0,1.0,0,1,-1,2,1,1,"August, 2007"
2007-2008,2,2007-08-15,Wigan,Middlesbrough,1,0,H,3,0,1,3,1,2,1,2,17,16,0,0,1,0,August,-0.8660254037844384,-0.5000000000000004,46,29,1,2,1,1.25,1.25,1,2,-1,1,2,-1,"August, 2007"
2007-2008,2,2007-08-15,Reading,Chelsea,1,2,A,0,3,1,1,3,3,2,0,12,5,1,3,7,2,August,-0.8660254037844384,-0.5000000000000004,35,14,0,1,1,1.0,1.5,0,0,0,3,2,1,"August, 2007"
2007-2008,2,2007-08-15,Portsmouth,Man United,1,1,D,1,1,0,1,4,3,1,1,10,11,1,1,1,0,August,-0.8660254037844384,-0.5000000000000004,33,28,1,0,4,0.8,2.4,2,2,0,0,0,0,"August, 2007"
2007-2008,2,2007-08-15,Man City,Derby,1,0,H,3,0,2,0,3,0,0,5,4,10,3,1,6,2,August,-0.8660254037844384,-0.5000000000000004,27,17,0,2,0,0.5,0.5,2,0,2,2,2,0,"August, 2007"
2007-2008,2,2007-08-15,Birmingham,Sunderland,2,2,D,1,1,1,2,2,1,0,4,13,8,0,3,5,3,August,-0.8660254037844384,-0.5000000000000004,3,40,4,0,0,1.25,0.0,2,3,-1,1,0,1,"August, 2007"
2007-2008,2,2007-08-15,Fulham,Bolton,2,1,H,3,0,4,0,1,3,2,0,15,18,0,0,3,0,August,-0.8660254037844384,-0.5000000000000004,19,6,1,1,3,1.2,1.8,1,2,-1,1,3,-2,"August, 2007"
2007-2008,3,2007-08-18,Birmingham,West Ham,0,1,A,0,3,1,2,2,1,2,2,13,18,1,0,5,1,August,-0.8660254037844384,-0.5000000000000004,3,45,1,1,2,1.25,2.0,4,5,-1,0,2,-2,"August, 2007"
2007-2008,3,2007-08-18,Fulham,Middlesbrough,1,2,A,0,3,4,0,1,2,1,2,9,18,3,0,9,3,August,-0.8660254037844384,-0.5000000000000004,19,29,2,1,2,1.4,1.6,3,3,0,1,3,-2,"August, 2007"
2007-2008,3,2007-08-18,Newcastle,Aston Villa,0,0,D,1,1,1,2,2,2,2,1,5,18,3,0,13,3,August,-0.8660254037844384,-0.5000000000000004,30,1,2,1,2,1.2,1.6,3,1,2,1,2,-1,"August, 2007"
2007-2008,3,2007-08-18,Portsmouth,Bolton,3,1,H,3,0,0,1,4,3,2,0,13,19,2,0,6,2,August,-0.8660254037844384,-0.5000000000000004,33,6,0,2,3,0.8,1.4,3,3,0,2,5,-3,"August, 2007"
2007-2008,3,2007-08-18,Reading,Everton,1,0,H,3,0,1,1,3,1,2,2,17,1,1,6,16,5,August,-0.8660254037844384,-0.5000000000000004,35,18,0,1,1,0.5,1.5,1,2,-1,5,2,3,"August, 2007"
2007-2008,3,2007-08-18,Tottenham,Derby,4,0,H,3,0,1,3,1,0,0,5,19,16,0,1,3,1,August,-0.8660254037844384,-0.5000000000000004,42,17,2,1,2,1.6,1.2,1,4,-3,2,3,-1,"August, 2007"
2007-2008,3,2007-08-18,Wigan,Sunderland,3,0,H,3,0,1,3,1,1,0,4,12,6,3,4,6,1,August,-0.8660254037844384,-0.5000000000000004,46,40,2,0,0,1.0,0.0,2,2,0,3,2,1,"August, 2007"
2007-2008,3,2007-08-19,Man City,Man United,1,0,H,3,0,2,0,3,3,1,1,3,16,6,2,13,4,August,-0.8660254037844384,-0.5000000000000004,27,28,1,1,3,1.0,1.6,3,0,3,1,1,0,"August, 2007"
2007-2008,3,2007-08-19,Liverpool,Chelsea,1,1,D,1,1,4,1,0,3,2,0,12,3,3,6,9,3,August,-0.8660254037844384,-0.5000000000000004,25,14,1,0,4,0.6,1.6,2,1,1,5,3,2,"August, 2007"
2007-2008,3,2007-08-19,Blackburn,Arsenal,1,1,D,1,1,2,1,2,4,0,1,11,10,3,3,1,0,August,-0.8660254037844384,-0.5000000000000004,4,0,1,0,4,0.6,2.4,2,1,1,2,1,1,"August, 2007"
2007-2008,4,2007-08-25,Arsenal,Man City,1,0,H,3,0,4,0,1,2,0,3,7,1,4,9,6,5,August,-0.8660254037844384,-0.5000000000000004,0,27,3,1,1,1.6,0.8,3,2,1,4,0,4,"August, 2007"
2007-2008,4,2007-08-25,Aston Villa,Fulham,2,1,H,3,0,2,2,1,4,0,1,17,13,1,3,4,2,August,-0.8660254037844384,-0.5000000000000004,1,19,0,5,0,1.2,1.2,1,2,-1,4,5,-1,"August, 2007"
2007-2008,4,2007-08-25,Bolton,Reading,3,0,H,3,0,3,2,0,1,1,3,20,11,0,4,9,4,August,-0.8660254037844384,-0.5000000000000004,6,35,0,0,2,0.5,2.0,3,8,-5,2,2,0,"August, 2007"
2007-2008,4,2007-08-25,Chelsea,Portsmouth,1,0,H,3,0,3,2,0,0,1,4,2,6,7,5,4,2,August,-0.8660254037844384,-0.5000000000000004,14,33,5,0,0,2.2,0.2,6,4,2,6,4,2,"August, 2007"
2007-2008,4,2007-08-25,Derby,Birmingham,1,2,A,0,3,0,0,5,1,2,2,20,19,1,1,1,0,August,-0.8660254037844384,-0.5000000000000004,17,3,0,0,0,0.0,0.0,2,7,-5,4,6,-2,"August, 2007"
2007-2008,4,2007-08-25,Everton,Blackburn,1,1,D,1,1,1,2,2,2,1,2,5,8,6,4,3,2,August,-0.8660254037844384,-0.5000000000000004,18,4,3,1,1,1.0,0.4,5,3,2,3,2,1,"August, 2007"
2007-2008,4,2007-08-25,Sunderland,Liverpool,0,2,A,0,3,1,0,4,4,1,0,12,9,4,4,3,0,August,-0.8660254037844384,-0.5000000000000004,40,25,1,1,3,0.4,1.0,3,5,-2,3,2,1,"August, 2007"
2007-2008,4,2007-08-25,West Ham,Wigan,1,1,D,1,1,1,2,2,1,3,1,16,6,3,6,10,3,August,-0.8660254037844384,-0.5000000000000004,45,46,2,0,2,1.25,1.25,1,2,-1,5,2,3,"August, 2007"
2007-2008,4,2007-08-26,Middlesbrough,Newcastle,2,2,D,1,1,2,1,2,1,2,2,17,10,3,4,7,1,August,-0.8660254037844384,-0.5000000000000004,29,30,1,3,1,0.8,0.8,3,4,-1,3,1,2,"August, 2007"
2007-2008,4,2007-08-26,Man United,Tottenham,1,0,H,3,0,3,1,1,1,3,1,19,15,2,3,4,1,August,-0.8660254037844384,-0.5000000000000004,28,42,3,2,0,1.6,0.4,1,2,-1,5,4,1,"August, 2007"
2007-2008,5,2007-09-01,Bolton,Everton,1,2,A,0,3,3,2,0,1,2,2,18,5,3,7,13,4,September,-1.0,-1.8369701987210287e-16,6,18,2,1,2,1.6,1.0,6,8,-2,6,4,2,"September, 2007"
2007-2008,5,2007-09-01,Fulham,Tottenham,3,3,D,1,1,4,0,1,1,3,1,18,17,3,3,1,0,September,-1.0,-1.8369701987210287e-16,19,42,1,2,2,0.4,0.8,5,7,-2,5,5,0,"September, 2007"
2007-2008,5,2007-09-01,Liverpool,Derby,6,0,H,3,0,4,1,0,0,0,5,5,20,7,1,15,6,September,-1.0,-1.8369701987210287e-16,25,17,4,1,0,2.0,0.2,5,2,3,3,9,-6,"September, 2007"
2007-2008,5,2007-09-01,Man United,Sunderland,1,0,H,3,0,3,1,1,1,0,4,10,18,5,4,8,1,September,-1.0,-1.8369701987210287e-16,28,40,3,2,0,2.0,0.8,2,2,0,3,7,-4,"September, 2007"
2007-2008,5,2007-09-01,Middlesbrough,Birmingham,2,0,H,3,0,2,1,2,1,2,2,14,13,4,4,1,0,September,-1.0,-1.8369701987210287e-16,29,3,4,0,1,2.2,1.2,5,6,-1,6,7,-1,"September, 2007"
2007-2008,5,2007-09-01,Newcastle,Wigan,1,0,H,3,0,1,2,2,1,3,1,9,6,5,7,3,2,September,-1.0,-1.8369701987210287e-16,30,46,2,0,2,1.25,1.0,5,3,2,6,3,3,"September, 2007"
2007-2008,5,2007-09-01,Reading,West Ham,0,3,A,0,3,1,1,3,1,2,2,17,14,4,4,3,0,September,-1.0,-1.8369701987210287e-16,35,45,2,0,0,3.5,0.0,2,5,-3,2,3,-1,"September, 2007"
2007-2008,5,2007-09-02,Blackburn,Man City,1,0,H,3,0,2,1,2,2,0,3,12,5,5,9,7,4,September,-1.0,-1.8369701987210287e-16,4,27,3,2,0,1.8,0.4,4,3,1,4,1,3,"September, 2007"
2007-2008,5,2007-09-02,Arsenal,Portsmouth,3,1,H,3,0,4,0,1,0,1,4,9,11,7,5,2,2,September,-1.0,-1.8369701987210287e-16,0,33,2,3,0,2.0,0.6,4,2,2,6,5,1,"September, 2007"
2007-2008,5,2007-09-02,Aston Villa,Chelsea,2,0,H,3,0,2,2,1,3,2,0,14,4,4,10,10,6,September,-1.0,-1.8369701987210287e-16,1,14,0,3,2,0.6,1.0,3,3,0,7,4,3,"September, 2007"
2007-2008,6,2007-09-15,Wigan,Fulham,1,1,D,1,1,1,3,1,4,0,1,10,17,7,4,7,3,September,-1.0,-1.8369701987210287e-16,46,19,2,1,1,0.5,0.25,6,4,2,8,10,-2,"September, 2007"
2007-2008,6,2007-09-15,Birmingham,Bolton,1,0,H,3,0,1,2,2,3,2,0,16,19,4,3,3,1,September,-1.0,-1.8369701987210287e-16,3,6,2,1,2,1.0,0.8,6,9,-3,7,10,-3,"September, 2007"
2007-2008,6,2007-09-15,Chelsea,Blackburn,0,0,D,1,1,3,2,0,2,1,2,4,7,10,8,3,2,September,-1.0,-1.8369701987210287e-16,14,4,4,0,1,2.0,0.6,7,6,1,5,3,2,"September, 2007"
2007-2008,6,2007-09-15,Everton,Man United,0,1,A,0,3,1,2,2,3,1,1,4,8,10,8,4,2,September,-1.0,-1.8369701987210287e-16,18,28,1,1,3,0.8,2.0,8,5,3,3,2,1,"September, 2007"
2007-2008,6,2007-09-15,Portsmouth,Liverpool,0,0,D,1,1,0,1,4,4,1,0,14,3,5,10,11,5,September,-1.0,-1.8369701987210287e-16,33,25,1,1,3,0.8,1.8,7,8,-1,11,2,9,"September, 2007"
2007-2008,6,2007-09-15,Sunderland,Reading,2,1,H,3,0,1,0,4,1,1,3,17,18,4,4,1,0,September,-1.0,-1.8369701987210287e-16,40,35,0,0,0,0.0,0.0,3,8,-5,2,8,-6,"September, 2007"
2007-2008,6,2007-09-15,Tottenham,Arsenal,1,3,A,0,3,1,3,1,4,0,1,16,4,4,10,12,6,September,-1.0,-1.8369701987210287e-16,42,0,0,3,2,0.8,1.6,8,8,0,7,3,4,"September, 2007"
2007-2008,6,2007-09-15,West Ham,Middlesbrough,3,0,H,3,0,1,2,2,2,1,2,11,12,7,7,1,0,September,-1.0,-1.8369701987210287e-16,45,29,3,0,2,1.0,0.8,5,3,2,7,6,1,"September, 2007"
2007-2008,6,2007-09-16,Man City,Aston Villa,1,0,H,3,0,2,0,3,2,2,1,8,11,9,7,3,2,September,-1.0,-1.8369701987210287e-16,27,1,4,0,1,1.8,1.0,4,2,2,5,3,2,"September, 2007"
2007-2008,6,2007-09-17,Derby,Newcastle,1,0,H,3,0,0,0,5,1,2,2,20,9,1,8,11,7,September,-1.0,-1.8369701987210287e-16,17,30,1,1,3,1.2,1.4,3,15,-12,6,3,3,"September, 2007"
2007-2008,7,2007-09-22,Arsenal,Derby,5,0,H,3,0,4,0,1,0,0,5,1,19,13,4,18,9,September,-1.0,-1.8369701987210287e-16,0,17,4,1,0,1.4,0.4,10,4,6,4,15,-11,"September, 2007"
2007-2008,7,2007-09-22,Fulham,Man City,3,3,D,1,1,4,0,1,2,0,3,16,2,5,12,14,7,September,-1.0,-1.8369701987210287e-16,19,27,2,1,2,1.4,1.8,9,11,-2,5,2,3,"September, 2007"
2007-2008,7,2007-09-22,Liverpool,Birmingham,0,0,D,1,1,4,1,0,1,2,2,3,12,11,7,9,4,September,-1.0,-1.8369701987210287e-16,25,3,1,2,2,1.2,1.2,11,2,9,7,9,-2,"September, 2007"
2007-2008,7,2007-09-22,Middlesbrough,Sunderland,2,2,D,1,1,2,1,2,1,0,4,13,14,7,7,1,0,September,-1.0,-1.8369701987210287e-16,29,40,4,0,1,2.0,0.6,7,9,-2,5,9,-4,"September, 2007"
2007-2008,7,2007-09-22,Reading,Wigan,2,1,H,3,0,1,1,3,1,3,1,18,9,4,8,9,4,September,-1.0,-1.8369701987210287e-16,35,46,1,0,1,1.5,1.5,3,10,-7,7,5,2,"September, 2007"
2007-2008,7,2007-09-23,Man United,Chelsea,2,0,H,3,0,3,1,1,3,2,0,4,5,11,11,1,0,September,-1.0,-1.8369701987210287e-16,28,14,1,2,2,0.6,1.4,4,2,2,7,6,1,"September, 2007"
2007-2008,7,2007-09-23,Bolton,Tottenham,1,1,D,1,1,3,2,0,1,3,1,20,18,3,4,2,1,September,-1.0,-1.8369701987210287e-16,6,42,3,0,2,1.4,1.2,7,11,-4,9,11,-2,"September, 2007"
2007-2008,7,2007-09-23,Newcastle,West Ham,3,1,H,3,0,1,2,2,1,2,2,11,6,8,10,5,2,September,-1.0,-1.8369701987210287e-16,30,45,2,3,0,2.0,1.2,6,4,2,8,3,5,"September, 2007"
2007-2008,7,2007-09-23,Aston Villa,Everton,2,0,H,3,0,2,2,1,1,2,2,14,7,7,10,7,3,September,-1.0,-1.8369701987210287e-16,1,18,2,1,2,1.6,1.6,5,4,1,8,6,2,"September, 2007"
2007-2008,7,2007-09-23,Blackburn,Portsmouth,0,1,A,0,3,2,1,2,0,1,4,9,16,9,6,7,3,September,-1.0,-1.8369701987210287e-16,4,33,3,1,1,1.6,1.2,5,3,2,7,8,-1,"September, 2007"
2007-2008,8,2007-09-29,West Ham,Arsenal,0,1,A,0,3,1,2,2,4,0,1,9,2,10,16,7,6,September,-1.0,-1.8369701987210287e-16,45,0,3,1,1,1.2,1.0,9,6,3,15,4,11,"September, 2007"
2007-2008,8,2007-09-29,Sunderland,Blackburn,1,2,A,0,3,1,0,4,2,1,2,15,11,8,9,4,1,September,-1.0,-1.8369701987210287e-16,40,4,1,2,2,0.6,0.6,7,11,-4,5,4,1,"September, 2007"
2007-2008,8,2007-09-29,Wigan,Liverpool,0,1,A,0,3,1,3,1,4,1,0,12,4,8,12,8,4,September,-1.0,-1.8369701987210287e-16,46,25,0,0,4,0.0,2.5,8,7,1,11,2,9,"September, 2007"
2007-2008,8,2007-09-29,Portsmouth,Reading,7,4,H,3,0,0,1,4,1,1,3,11,17,9,7,6,2,September,-1.0,-1.8369701987210287e-16,33,35,1,1,0,1.5,0.5,8,8,0,5,11,-6,"September, 2007"
2007-2008,8,2007-09-29,Birmingham,Man United,0,1,A,0,3,1,2,2,3,1,1,14,2,8,14,12,6,September,-1.0,-1.8369701987210287e-16,3,28,0,2,3,0.6,1.8,7,9,-2,6,2,4,"September, 2007"
2007-2008,8,2007-09-29,Derby,Bolton,1,1,D,1,1,0,0,5,3,2,0,20,19,4,4,1,0,September,-1.0,-1.8369701987210287e-16,17,6,3,1,0,2.75,1.0,4,20,-16,8,12,-4,"September, 2007"
2007-2008,8,2007-09-29,Chelsea,Fulham,0,0,D,1,1,3,2,0,4,0,1,6,17,11,6,11,5,September,-1.0,-1.8369701987210287e-16,14,19,3,1,1,2.0,1.2,7,8,-1,12,14,-2,"September, 2007"
2007-2008,8,2007-09-29,Man City,Newcastle,3,1,H,3,0,2,0,3,1,2,2,3,6,13,11,3,2,September,-1.0,-1.8369701987210287e-16,27,30,2,2,1,1.0,0.4,8,5,3,9,5,4,"September, 2007"
2007-2008,8,2007-09-30,Everton,Middlesbrough,2,0,H,3,0,1,2,2,2,1,2,11,13,10,8,2,2,September,-1.0,-1.8369701987210287e-16,18,29,2,2,1,0.8,0.6,8,8,0,9,11,-2,"September, 2007"
2007-2008,8,2007-10-01,Tottenham,Aston Villa,4,4,D,1,1,1,3,1,2,2,1,18,10,5,10,8,5,October,-0.8660254037844386,0.5,42,1,2,3,0,1.8,0.8,10,12,-2,7,4,3,"October, 2007"
2007-2008,9,2007-10-06,Aston Villa,West Ham,1,0,H,3,0,2,2,1,1,2,2,9,11,11,10,2,1,October,-0.8660254037844386,0.5,1,45,1,2,2,1.0,1.8,11,8,3,9,7,2,"October, 2007"
2007-2008,9,2007-10-06,Man United,Wigan,4,0,H,3,0,3,1,1,1,3,1,2,12,17,8,10,9,October,-0.8660254037844386,0.5,28,46,4,0,0,3.0,0.75,7,2,5,8,8,0,"October, 2007"
2007-2008,9,2007-10-07,Reading,Derby,1,0,H,3,0,1,1,3,0,0,5,18,20,7,5,2,2,October,-0.8660254037844386,0.5,35,17,0,0,0,0.0,0.0,9,18,-9,5,21,-16,"October, 2007"
2007-2008,9,2007-10-07,Newcastle,Everton,3,2,H,3,0,1,2,2,1,2,2,10,9,11,13,1,2,October,-0.8660254037844386,0.5,30,18,1,1,3,0.6,1.4,10,8,2,10,8,2,"October, 2007"
2007-2008,9,2007-10-07,Man City,Middlesbrough,3,1,H,3,0,2,0,3,2,1,2,4,12,16,8,8,8,October,-0.8660254037844386,0.5,27,29,2,2,1,0.8,0.4,11,6,5,9,13,-4,"October, 2007"
2007-2008,9,2007-10-07,Liverpool,Tottenham,2,2,D,1,1,4,1,0,1,3,1,4,18,15,6,14,9,October,-0.8660254037844386,0.5,25,42,3,2,0,1.4,0.4,12,2,10,14,16,-2,"October, 2007"
2007-2008,9,2007-10-07,Bolton,Chelsea,0,1,A,0,3,3,2,0,3,2,0,19,9,5,12,10,7,October,-0.8660254037844386,0.5,6,14,0,1,4,0.6,2.4,9,13,-4,7,8,-1,"October, 2007"
2007-2008,9,2007-10-07,Blackburn,Birmingham,2,1,H,3,0,2,1,2,1,2,2,8,12,12,8,4,4,October,-0.8660254037844386,0.5,4,3,1,2,2,1.6,1.6,7,5,2,7,10,-3,"October, 2007"
2007-2008,9,2007-10-07,Arsenal,Sunderland,3,2,H,3,0,4,0,1,1,0,4,2,15,19,8,13,11,October,-0.8660254037844386,0.5,0,40,5,0,0,3.2,0.4,16,4,12,8,13,-5,"October, 2007"
2007-2008,9,2007-10-07,Fulham,Portsmouth,0,2,A,0,3,4,0,1,0,1,4,16,9,7,12,7,5,October,-0.8660254037844386,0.5,19,33,1,2,2,1.2,1.4,12,14,-2,15,12,3,"October, 2007"
2007-2008,10,2007-10-20,Man City,Birmingham,1,0,H,3,0,2,0,3,1,2,2,4,14,19,8,10,11,October,-0.8660254037844386,0.5,27,3,3,1,1,1.8,0.6,14,7,7,8,12,-4,"October, 2007"
2007-2008,10,2007-10-20,Wigan,Portsmouth,0,2,A,0,3,1,3,1,0,1,4,14,7,8,15,7,7,October,-0.8660254037844386,0.5,46,33,2,0,2,1.0,0.75,8,12,-4,17,12,5,"October, 2007"
2007-2008,10,2007-10-20,Middlesbrough,Chelsea,0,2,A,0,3,2,1,2,3,2,0,16,7,8,15,9,7,October,-0.8660254037844386,0.5,29,14,2,0,3,1.0,1.4,10,16,-6,8,8,0,"October, 2007"
2007-2008,10,2007-10-20,Fulham,Derby,0,0,D,1,1,4,0,1,0,0,5,18,20,7,5,2,2,October,-0.8660254037844386,0.5,19,17,1,1,0,0.5,0.0,12,16,-4,5,22,-17,"October, 2007"
2007-2008,10,2007-10-20,Everton,Liverpool,1,2,A,0,3,1,2,2,4,1,0,10,5,13,16,5,3,October,-0.8660254037844386,0.5,18,25,1,1,3,1.2,1.6,12,11,1,14,4,10,"October, 2007"
2007-2008,10,2007-10-20,Blackburn,Reading,4,2,H,3,0,2,1,2,1,1,3,6,12,15,10,6,5,October,-0.8660254037844386,0.5,4,35,1,1,0,2.5,2.0,9,6,3,10,18,-8,"October, 2007"
2007-2008,10,2007-10-20,Aston Villa,Man United,1,4,A,0,3,2,2,1,3,1,1,8,2,14,20,6,6,October,-0.8660254037844386,0.5,1,28,0,0,5,0.4,2.4,12,8,4,11,2,9,"October, 2007"
2007-2008,10,2007-10-20,Arsenal,Bolton,2,0,H,3,0,4,0,1,3,2,0,1,19,22,5,18,17,October,-0.8660254037844386,0.5,0,6,1,1,3,0.8,1.6,19,6,13,9,14,-5,"October, 2007"
2007-2008,10,2007-10-21,West Ham,Sunderland,3,1,H,3,0,1,2,2,1,0,4,11,15,10,8,4,2,October,-0.8660254037844386,0.5,45,40,4,1,0,1.8,0.2,9,8,1,10,16,-6,"October, 2007"
2007-2008,10,2007-10-22,Newcastle,Tottenham,3,1,H,3,0,1,2,2,1,3,1,8,18,14,7,10,7,October,-0.8660254037844386,0.5,30,42,3,0,2,1.8,1.4,13,10,3,16,18,-2,"October, 2007"
2007-2008,11,2007-10-27,Sunderland,Fulham,1,1,D,1,1,1,0,4,4,0,1,16,14,8,8,2,0,October,-0.8660254037844386,0.5,40,19,1,1,3,0.8,1.6,11,19,-8,12,16,-4,"October, 2007"
2007-2008,11,2007-10-27,Reading,Newcastle,2,1,H,3,0,1,1,3,1,2,2,13,8,10,17,5,7,October,-0.8660254037844386,0.5,35,30,1,0,1,1.5,1.5,12,22,-10,16,11,5,"October, 2007"
2007-2008,11,2007-10-27,Portsmouth,West Ham,0,0,D,1,1,0,1,4,1,2,2,6,10,18,13,4,5,October,-0.8660254037844386,0.5,33,45,3,1,0,2.25,1.0,19,12,7,12,9,3,"October, 2007"
2007-2008,11,2007-10-27,Chelsea,Man City,6,0,H,3,0,3,2,0,2,0,3,7,3,18,22,4,4,October,-0.8660254037844386,0.5,14,27,4,1,0,1.4,0.0,10,8,2,15,7,8,"October, 2007"
2007-2008,11,2007-10-27,Birmingham,Wigan,3,2,H,3,0,1,2,2,1,3,1,14,15,8,8,1,0,October,-0.8660254037844386,0.5,3,46,1,1,0,1.5,0.5,8,13,-5,8,14,-6,"October, 2007"
2007-2008,11,2007-10-27,Man United,Middlesbrough,4,1,H,3,0,3,1,1,2,1,2,2,17,23,8,15,15,October,-0.8660254037844386,0.5,28,29,2,2,1,1.2,1.2,15,3,12,10,18,-8,"October, 2007"
2007-2008,11,2007-10-28,Bolton,Aston Villa,1,1,D,1,1,3,2,0,2,2,1,20,10,5,14,10,9,October,-0.8660254037844386,0.5,6,1,1,4,0,1.4,1.2,9,16,-7,13,12,1,"October, 2007"
2007-2008,11,2007-10-28,Derby,Everton,0,2,A,0,3,0,0,5,1,2,2,20,11,6,13,9,7,October,-0.8660254037844386,0.5,17,18,1,1,3,1.4,1.8,5,22,-17,13,13,0,"October, 2007"
2007-2008,11,2007-10-28,Liverpool,Arsenal,1,1,D,1,1,4,1,0,4,0,1,5,2,19,25,3,6,October,-0.8660254037844386,0.5,25,0,2,0,3,1.4,1.8,16,5,11,21,6,15,"October, 2007"
2007-2008,11,2007-10-28,Tottenham,Blackburn,1,2,A,0,3,1,3,1,2,1,2,18,7,7,18,11,11,October,-0.8660254037844386,0.5,42,4,1,4,0,1.0,0.8,17,21,-4,13,8,5,"October, 2007"
2007-2008,12,2007-11-03,Middlesbrough,Tottenham,1,1,D,1,1,2,1,2,1,3,1,17,18,8,7,1,1,November,-0.5000000000000004,0.8660254037844384,29,42,1,1,3,1.4,2.0,11,22,-11,18,23,-5,"November, 2007"
2007-2008,12,2007-11-03,Newcastle,Portsmouth,1,4,A,0,3,1,2,2,0,1,4,10,7,17,19,3,2,November,-0.5000000000000004,0.8660254037844384,30,33,2,2,1,1.0,0.6,17,13,4,19,12,7,"November, 2007"
2007-2008,12,2007-11-03,Fulham,Reading,3,1,H,3,0,4,0,1,1,1,3,14,12,9,13,2,4,November,-0.5000000000000004,0.8660254037844384,19,35,0,0,2,0.0,1.0,13,17,-4,14,23,-9,"November, 2007"
2007-2008,12,2007-11-03,Wigan,Chelsea,0,2,A,0,3,1,3,1,3,2,0,18,7,8,21,11,13,November,-0.5000000000000004,0.8660254037844384,46,14,0,0,4,0.5,2.25,10,17,-7,16,8,8,"November, 2007"
2007-2008,12,2007-11-03,Blackburn,Liverpool,0,0,D,1,1,2,1,2,4,1,0,5,6,21,20,1,1,November,-0.5000000000000004,0.8660254037844384,4,25,1,2,2,0.4,0.6,15,9,6,17,6,11,"November, 2007"
2007-2008,12,2007-11-03,Aston Villa,Derby,2,0,H,3,0,2,2,1,0,0,5,10,20,15,6,10,9,November,-0.5000000000000004,0.8660254037844384,1,17,3,0,2,1.8,1.2,14,13,1,5,24,-19,"November, 2007"
2007-2008,12,2007-11-03,Arsenal,Man United,2,2,D,1,1,4,0,1,3,1,1,1,2,26,26,1,0,November,-0.5000000000000004,0.8660254037844384,0,28,2,1,2,1.0,1.4,22,7,15,19,4,15,"November, 2007"
2007-2008,12,2007-11-03,Everton,Birmingham,3,1,H,3,0,1,2,2,1,2,2,10,13,16,11,3,5,November,-0.5000000000000004,0.8660254037844384,18,3,2,2,1,0.6,0.8,15,13,2,11,15,-4,"November, 2007"
2007-2008,12,2007-11-04,West Ham,Bolton,1,1,D,1,1,1,2,2,3,2,0,11,19,14,6,8,8,November,-0.5000000000000004,0.8660254037844384,45,6,1,0,4,1.0,2.4,12,9,3,10,17,-7,"November, 2007"
2007-2008,12,2007-11-05,Man City,Sunderland,1,0,H,3,0,2,0,3,1,0,4,6,15,22,9,9,13,November,-0.5000000000000004,0.8660254037844384,27,40,4,0,1,2.0,0.6,15,13,2,12,20,-8,"November, 2007"
2007-2008,13,2007-11-10,Derby,West Ham,0,5,A,0,3,0,0,5,1,2,2,20,11,6,15,9,9,November,-0.5000000000000004,0.8660254037844384,17,45,0,2,3,0.4,1.8,5,26,-21,13,10,3,"November, 2007"
2007-2008,13,2007-11-10,Liverpool,Fulham,2,0,H,3,0,4,1,0,4,0,1,7,13,21,12,6,9,November,-0.5000000000000004,0.8660254037844384,25,19,3,0,2,2.4,1.0,17,6,11,16,18,-2,"November, 2007"
2007-2008,13,2007-11-10,Sunderland,Newcastle,1,1,D,1,1,1,0,4,1,2,2,15,11,9,17,4,8,November,-0.5000000000000004,0.8660254037844384,40,30,0,0,5,0.6,2.2,12,21,-9,18,17,1,"November, 2007"
2007-2008,13,2007-11-11,Tottenham,Wigan,4,0,H,3,0,1,3,1,1,3,1,17,19,8,8,2,0,November,-0.5000000000000004,0.8660254037844384,42,46,2,2,0,2.5,1.75,19,24,-5,10,19,-9,"November, 2007"
2007-2008,13,2007-11-11,Portsmouth,Man City,0,0,D,1,1,0,1,4,2,0,3,6,4,22,25,2,3,November,-0.5000000000000004,0.8660254037844384,33,27,2,1,2,1.0,1.2,23,13,10,16,13,3,"November, 2007"
2007-2008,13,2007-11-11,Man United,Blackburn,2,0,H,3,0,3,1,1,2,1,2,2,7,27,22,5,5,November,-0.5000000000000004,0.8660254037844384,28,4,2,1,2,1.8,1.4,21,6,15,15,9,6,"November, 2007"
2007-2008,13,2007-11-11,Birmingham,Aston Villa,1,2,A,0,3,1,2,2,2,2,1,14,10,11,18,4,7,November,-0.5000000000000004,0.8660254037844384,3,1,2,1,2,1.4,1.4,12,18,-6,16,13,3,"November, 2007"
2007-2008,13,2007-11-11,Bolton,Middlesbrough,0,0,D,1,1,3,2,0,2,1,2,19,16,7,9,3,2,November,-0.5000000000000004,0.8660254037844384,6,29,0,3,2,1.0,2.0,11,18,-7,12,23,-11,"November, 2007"
2007-2008,13,2007-11-11,Chelsea,Everton,1,1,D,1,1,3,2,0,1,2,2,5,9,24,19,4,5,November,-0.5000000000000004,0.8660254037844384,14,18,3,2,0,1.8,0.8,18,8,10,18,14,4,"November, 2007"
2007-2008,13,2007-11-12,Reading,Arsenal,1,3,A,0,3,1,1,3,4,0,1,12,2,13,27,10,14,November,-0.5000000000000004,0.8660254037844384,35,0,0,0,2,0.5,3.0,15,26,-11,24,9,15,"November, 2007"
2007-2008,14,2007-11-24,Man City,Reading,2,1,H,3,0,2,0,3,1,1,3,5,12,26,13,7,13,November,-0.5000000000000004,0.8660254037844384,27,35,0,0,2,0.0,1.5,16,13,3,16,29,-13,"November, 2007"
2007-2008,14,2007-11-24,Newcastle,Liverpool,0,3,A,0,3,1,2,2,4,1,0,11,6,18,24,5,6,November,-0.5000000000000004,0.8660254037844384,30,25,2,0,3,0.8,1.6,19,18,1,19,6,13,"November, 2007"
2007-2008,14,2007-11-24,Everton,Sunderland,7,1,H,3,0,1,2,2,1,0,4,9,17,20,10,8,10,November,-0.5000000000000004,0.8660254037844384,18,40,4,1,0,1.4,0.6,19,15,4,13,22,-9,"November, 2007"
2007-2008,14,2007-11-24,Middlesbrough,Aston Villa,0,3,A,0,3,2,1,2,2,2,1,17,9,10,21,8,11,November,-0.5000000000000004,0.8660254037844384,29,1,1,1,3,1.0,2.4,12,23,-11,18,14,4,"November, 2007"
2007-2008,14,2007-11-24,Bolton,Man United,1,0,H,3,0,3,2,0,3,1,1,18,2,8,30,16,22,November,-0.5000000000000004,0.8660254037844384,6,28,0,0,5,0.6,3.2,11,18,-7,23,6,17,"November, 2007"
2007-2008,14,2007-11-24,Birmingham,Portsmouth,0,2,A,0,3,1,2,2,0,1,4,15,6,11,23,9,12,November,-0.5000000000000004,0.8660254037844384,3,33,1,3,1,1.6,1.0,13,20,-7,23,13,10,"November, 2007"
2007-2008,14,2007-11-24,Arsenal,Wigan,2,0,H,3,0,4,0,1,1,3,1,1,19,30,8,18,22,November,-0.5000000000000004,0.8660254037844384,0,46,4,0,0,2.5,1.25,27,10,17,10,23,-13,"November, 2007"
2007-2008,14,2007-11-24,Derby,Chelsea,0,2,A,0,3,0,0,5,3,2,0,20,5,6,25,15,19,November,-0.5000000000000004,0.8660254037844384,17,14,0,1,4,0.6,3.0,5,31,-26,19,9,10,"November, 2007"
2007-2008,14,2007-11-25,Fulham,Blackburn,2,2,D,1,1,4,0,1,2,1,2,13,9,12,22,4,10,November,-0.5000000000000004,0.8660254037844384,19,4,2,1,2,1.4,1.4,16,20,-4,15,11,4,"November, 2007"
2007-2008,14,2007-11-25,West Ham,Tottenham,1,1,D,1,1,1,2,2,1,3,1,10,14,18,11,4,7,November,-0.5000000000000004,0.8660254037844384,45,42,2,1,2,1.6,1.4,18,10,8,23,24,-1,"November, 2007"
2007-2008,14,2007-11-28,Blackburn,Aston Villa,0,4,A,0,3,2,1,2,2,2,1,9,7,23,24,2,1,November,-0.5000000000000004,0.8660254037844384,4,1,1,0,4,0.6,1.2,17,13,4,21,14,7,"November, 2007"
2007-2008,15,2007-12-01,Wigan,Man City,1,1,D,1,1,1,3,1,2,0,3,19,4,8,29,15,21,December,-2.4492935982947064e-16,1.0,46,27,4,0,0,2.5,0.75,10,25,-15,18,14,4,"December, 2007"
2007-2008,15,2007-12-01,Reading,Middlesbrough,1,1,D,1,1,1,1,3,2,1,2,13,17,13,10,4,3,December,-2.4492935982947064e-16,1.0,35,29,1,0,1,2.0,2.0,17,31,-14,12,26,-14,"December, 2007"
2007-2008,15,2007-12-01,Portsmouth,Everton,0,0,D,1,1,0,1,4,1,2,2,7,9,26,23,2,3,December,-2.4492935982947064e-16,1.0,33,18,2,0,3,0.8,1.2,25,13,12,26,16,10,"December, 2007"
2007-2008,15,2007-12-01,Sunderland,Derby,1,0,H,3,0,1,0,4,0,0,5,18,20,10,6,2,4,December,-2.4492935982947064e-16,1.0,40,17,2,2,1,1.0,0.8,14,29,-15,5,33,-28,"December, 2007"
2007-2008,15,2007-12-01,Blackburn,Newcastle,3,1,H,3,0,2,1,2,1,2,2,9,11,23,18,2,5,December,-2.4492935982947064e-16,1.0,4,30,2,1,2,1.2,1.6,17,17,0,19,21,-2,"December, 2007"
2007-2008,15,2007-12-01,Aston Villa,Arsenal,1,2,A,0,3,2,2,1,4,0,1,6,1,27,33,5,6,December,-2.4492935982947064e-16,1.0,1,0,0,2,3,0.4,2.0,25,14,11,29,10,19,"December, 2007"
2007-2008,15,2007-12-01,Chelsea,West Ham,1,0,H,3,0,3,2,0,1,2,2,4,10,28,19,6,9,December,-2.4492935982947064e-16,1.0,14,45,4,0,1,2.4,0.8,21,9,12,19,11,8,"December, 2007"
2007-2008,15,2007-12-02,Liverpool,Bolton,4,0,H,3,0,4,1,0,3,2,0,5,16,27,11,11,16,December,-2.4492935982947064e-16,1.0,25,6,3,1,1,1.4,0.8,22,6,16,12,18,-6,"December, 2007"
2007-2008,15,2007-12-02,Tottenham,Birmingham,2,3,A,0,3,1,3,1,1,2,2,15,16,12,11,1,1,December,-2.4492935982947064e-16,1.0,42,3,4,1,0,2.0,0.4,24,25,-1,13,22,-9,"December, 2007"
2007-2008,15,2007-12-03,Man United,Fulham,2,0,H,3,0,3,1,1,4,0,1,4,14,30,13,10,17,December,-2.4492935982947064e-16,1.0,28,19,5,0,0,3.0,1.2,23,7,16,18,22,-4,"December, 2007"
2007-2008,15,2007-12-05,Newcastle,Arsenal,1,1,D,1,1,1,2,2,4,0,1,11,1,18,36,10,18,December,-2.4492935982947064e-16,1.0,30,0,1,2,2,0.4,0.8,20,24,-4,31,11,20,"December, 2007"
2007-2008,16,2007-12-08,Aston Villa,Portsmouth,1,3,A,0,3,2,2,1,0,1,4,7,6,27,27,1,0,December,-2.4492935982947064e-16,1.0,1,33,2,3,0,1.2,0.8,26,16,10,25,13,12,"December, 2007"
2007-2008,16,2007-12-08,Chelsea,Sunderland,2,0,H,3,0,3,2,0,1,0,4,3,15,31,13,12,18,December,-2.4492935982947064e-16,1.0,14,40,5,0,0,2.6,0.4,22,9,13,15,29,-14,"December, 2007"
2007-2008,16,2007-12-08,Everton,Fulham,3,0,H,3,0,1,2,2,4,0,1,9,14,24,13,5,11,December,-2.4492935982947064e-16,1.0,18,19,2,0,3,1.4,1.2,26,16,10,18,24,-6,"December, 2007"
2007-2008,16,2007-12-08,Man United,Derby,4,1,H,3,0,3,1,1,0,0,5,3,20,33,6,17,27,December,-2.4492935982947064e-16,1.0,28,17,3,1,1,2.6,0.8,25,7,18,5,34,-29,"December, 2007"
2007-2008,16,2007-12-08,Newcastle,Birmingham,2,1,H,3,0,1,2,2,1,2,2,11,12,19,14,1,5,December,-2.4492935982947064e-16,1.0,30,3,2,3,0,1.2,0.8,21,25,-4,16,24,-8,"December, 2007"
2007-2008,16,2007-12-08,Reading,Liverpool,3,1,H,3,0,1,1,3,4,1,0,13,4,14,30,9,16,December,-2.4492935982947064e-16,1.0,35,25,0,0,2,0.5,2.0,18,32,-14,26,6,20,"December, 2007"
2007-2008,16,2007-12-09,Tottenham,Man City,2,1,H,3,0,1,3,1,2,0,3,18,6,12,30,12,18,December,-2.4492935982947064e-16,1.0,42,27,5,0,0,2.0,0.8,26,28,-2,19,15,4,"December, 2007"
2007-2008,16,2007-12-09,Middlesbrough,Arsenal,2,1,H,3,0,2,1,2,4,0,1,18,1,11,37,17,26,December,-2.4492935982947064e-16,1.0,29,0,1,2,2,0.8,2.2,13,27,-14,32,12,20,"December, 2007"
2007-2008,16,2007-12-09,Bolton,Wigan,4,1,H,3,0,3,2,0,1,3,1,17,19,11,9,2,2,December,-2.4492935982947064e-16,1.0,6,46,1,1,2,1.25,1.25,12,22,-10,11,26,-15,"December, 2007"
2007-2008,16,2007-12-09,Blackburn,West Ham,0,1,A,0,3,2,1,2,1,2,2,9,11,26,19,2,7,December,-2.4492935982947064e-16,1.0,4,45,1,0,4,1.4,2.2,20,18,2,19,12,7,"December, 2007"
2007-2008,17,2007-12-15,Birmingham,Reading,1,1,D,1,1,1,2,2,1,1,3,15,12,14,17,3,3,December,-2.4492935982947064e-16,1.0,3,35,0,0,0,0.0,0.0,17,26,-9,21,33,-12,"December, 2007"
2007-2008,17,2007-12-15,Derby,Middlesbrough,0,1,A,0,3,0,0,5,2,1,2,20,16,6,14,4,8,December,-2.4492935982947064e-16,1.0,17,29,1,1,3,1.6,2.8,6,38,-32,15,28,-13,"December, 2007"
2007-2008,17,2007-12-15,Fulham,Newcastle,0,1,A,0,3,4,0,1,1,2,2,17,11,13,22,6,9,December,-2.4492935982947064e-16,1.0,19,30,3,1,1,1.4,1.2,18,27,-9,23,26,-3,"December, 2007"
2007-2008,17,2007-12-15,Man City,Bolton,4,2,H,3,0,2,0,3,3,2,0,6,16,30,14,10,16,December,-2.4492935982947064e-16,1.0,27,6,0,1,4,0.0,1.2,20,17,3,16,23,-7,"December, 2007"
2007-2008,17,2007-12-15,Portsmouth,Tottenham,0,1,A,0,3,0,1,4,1,3,1,6,14,30,15,8,15,December,-2.4492935982947064e-16,1.0,33,42,0,1,4,0.8,2.2,28,14,14,28,29,-1,"December, 2007"
2007-2008,17,2007-12-15,Sunderland,Aston Villa,1,1,D,1,1,1,0,4,2,2,1,18,8,13,27,10,14,December,-2.4492935982947064e-16,1.0,40,1,1,1,3,0.8,1.4,15,31,-16,27,19,8,"December, 2007"
2007-2008,17,2007-12-15,West Ham,Everton,0,2,A,0,3,1,2,2,1,2,2,11,8,22,27,3,5,December,-2.4492935982947064e-16,1.0,45,18,2,2,1,1.0,1.0,20,12,8,29,16,13,"December, 2007"
2007-2008,17,2007-12-15,Wigan,Blackburn,5,3,H,3,0,1,3,1,2,1,2,19,9,9,26,10,17,December,-2.4492935982947064e-16,1.0,46,4,0,1,3,0.5,2.25,12,30,-18,20,19,1,"December, 2007"
2007-2008,17,2007-12-16,Arsenal,Chelsea,1,0,H,3,0,4,0,1,3,2,0,1,3,37,34,2,3,December,-2.4492935982947064e-16,1.0,0,14,0,3,2,0.4,1.0,33,14,19,24,9,15,"December, 2007"
2007-2008,17,2007-12-16,Liverpool,Man United,0,1,A,0,3,4,1,0,3,1,1,5,2,30,36,3,6,December,-2.4492935982947064e-16,1.0,25,28,0,1,4,0.0,1.0,27,9,18,29,8,21,"December, 2007"
2007-2008,18,2007-12-22,Reading,Sunderland,2,1,H,3,0,1,1,3,1,0,4,13,18,18,14,5,4,December,-2.4492935982947064e-16,1.0,35,40,0,0,1,1.0,2.0,22,34,-12,16,32,-16,"December, 2007"
2007-2008,18,2007-12-22,Middlesbrough,West Ham,1,2,A,0,3,2,1,2,1,2,2,15,11,17,22,4,5,December,-2.4492935982947064e-16,1.0,29,45,2,0,3,0.8,1.4,16,28,-12,20,14,6,"December, 2007"
2007-2008,18,2007-12-22,Liverpool,Portsmouth,4,1,H,3,0,4,1,0,0,1,4,5,7,30,30,2,0,December,-2.4492935982947064e-16,1.0,25,33,2,2,1,1.4,0.6,27,10,17,28,15,13,"December, 2007"
2007-2008,18,2007-12-22,Aston Villa,Man City,1,1,D,1,1,2,2,1,2,0,3,8,4,28,33,4,5,December,-2.4492935982947064e-16,1.0,1,27,1,0,4,0.8,1.6,28,20,8,24,19,5,"December, 2007"
2007-2008,18,2007-12-22,Bolton,Birmingham,3,0,H,3,0,3,2,0,1,2,2,16,15,14,15,1,1,December,-2.4492935982947064e-16,1.0,6,3,2,1,2,0.8,0.8,18,27,-9,18,27,-9,"December, 2007"
2007-2008,18,2007-12-22,Arsenal,Tottenham,2,1,H,3,0,4,0,1,1,3,1,1,12,40,18,11,22,December,-2.4492935982947064e-16,1.0,0,42,2,3,0,2.0,1.0,34,14,20,29,29,0,"December, 2007"
2007-2008,18,2007-12-22,Fulham,Wigan,1,1,D,1,1,4,0,1,1,3,1,18,19,13,12,1,1,December,-2.4492935982947064e-16,1.0,19,46,1,2,2,0.4,0.6,18,28,-10,17,33,-16,"December, 2007"
2007-2008,18,2007-12-23,Blackburn,Chelsea,0,1,A,0,3,2,1,2,3,2,0,9,3,26,34,6,8,December,-2.4492935982947064e-16,1.0,4,14,1,1,3,0.6,1.8,23,24,-1,24,10,14,"December, 2007"
2007-2008,18,2007-12-23,Man United,Everton,2,1,H,3,0,3,1,1,1,2,2,2,6,39,30,4,9,December,-2.4492935982947064e-16,1.0,28,18,4,1,0,2.2,0.6,30,8,22,31,16,15,"December, 2007"
2007-2008,18,2007-12-23,Newcastle,Derby,2,2,D,1,1,1,2,2,0,0,5,11,20,25,6,9,19,December,-2.4492935982947064e-16,1.0,30,17,3,0,2,1.4,1.4,24,26,-2,6,39,-33,"December, 2007"
2007-2008,19,2007-12-26,Tottenham,Fulham,5,1,H,3,0,1,3,1,4,0,1,13,17,18,14,4,4,December,-2.4492935982947064e-16,1.0,42,19,1,3,1,1.0,1.0,30,31,-1,19,29,-10,"December, 2007"
2007-2008,19,2007-12-26,Wigan,Newcastle,1,0,H,3,0,1,3,1,1,2,2,19,10,13,26,9,13,December,-2.4492935982947064e-16,1.0,46,30,2,0,3,0.8,1.2,18,34,-16,26,28,-2,"December, 2007"
2007-2008,19,2007-12-26,West Ham,Reading,1,1,D,1,1,1,2,2,1,1,3,11,13,25,21,2,4,December,-2.4492935982947064e-16,1.0,45,35,1,0,2,1.0,2.333333333333333,22,15,7,24,35,-11,"December, 2007"
2007-2008,19,2007-12-26,Sunderland,Man United,0,4,A,0,3,1,0,4,3,1,1,18,2,14,42,16,28,December,-2.4492935982947064e-16,1.0,40,28,0,2,3,0.6,1.4,17,34,-17,32,9,23,"December, 2007"
2007-2008,19,2007-12-26,Birmingham,Middlesbrough,3,0,H,3,0,1,2,2,2,1,2,16,15,15,17,1,2,December,-2.4492935982947064e-16,1.0,3,29,1,0,4,0.6,1.6,18,30,-12,17,30,-13,"December, 2007"
2007-2008,19,2007-12-26,Everton,Bolton,2,0,H,3,0,1,2,2,3,2,0,6,15,30,17,9,13,December,-2.4492935982947064e-16,1.0,18,6,3,1,1,1.0,1.2,32,18,14,21,27,-6,"December, 2007"
2007-2008,19,2007-12-26,Derby,Liverpool,1,2,A,0,3,0,0,5,4,1,0,20,5,7,33,15,26,December,-2.4492935982947064e-16,1.0,17,25,0,1,4,0.2,2.8,8,41,-33,31,11,20,"December, 2007"
2007-2008,19,2007-12-26,Chelsea,Aston Villa,4,4,D,1,1,3,2,0,2,2,1,3,8,37,29,5,8,December,-2.4492935982947064e-16,1.0,14,1,1,3,1,0.8,1.0,25,10,15,29,21,8,"December, 2007"
2007-2008,19,2007-12-26,Portsmouth,Arsenal,0,0,D,1,1,0,1,4,4,0,1,7,1,30,43,6,13,December,-2.4492935982947064e-16,1.0,33,0,0,3,2,0.8,2.0,29,19,10,36,15,21,"December, 2007"
2007-2008,19,2007-12-27,Man City,Blackburn,2,2,D,1,1,2,0,3,2,1,2,5,10,34,26,5,8,December,-2.4492935982947064e-16,1.0,27,4,0,1,4,0.4,2.0,25,20,5,23,25,-2,"December, 2007"
2007-2008,20,2007-12-29,Wigan,Aston Villa,1,2,A,0,3,1,3,1,2,2,1,18,8,16,30,10,14,December,-2.4492935982947064e-16,1.0,46,1,2,2,0,1.5,0.75,19,34,-15,33,25,8,"December, 2007"
2007-2008,20,2007-12-29,West Ham,Man United,2,1,H,3,0,1,2,2,3,1,1,10,2,26,45,8,19,December,-2.4492935982947064e-16,1.0,45,28,2,0,3,0.6,1.2,23,16,7,36,9,27,"December, 2007"
2007-2008,20,2007-12-29,Tottenham,Reading,6,4,H,3,0,1,3,1,1,1,3,13,12,21,22,1,1,December,-2.4492935982947064e-16,1.0,42,35,1,0,1,1.0,1.5,35,32,3,25,36,-11,"December, 2007"
2007-2008,20,2007-12-29,Sunderland,Bolton,3,1,H,3,0,1,0,4,3,2,0,19,16,14,17,3,3,December,-2.4492935982947064e-16,1.0,40,6,1,2,2,0.4,1.0,17,38,-21,21,29,-8,"December, 2007"
2007-2008,20,2007-12-29,Portsmouth,Middlesbrough,0,1,A,0,3,0,1,4,2,1,2,7,16,31,17,9,14,December,-2.4492935982947064e-16,1.0,33,29,3,2,0,1.6,0.4,29,19,10,17,33,-16,"December, 2007"
2007-2008,20,2007-12-29,Chelsea,Newcastle,2,1,H,3,0,3,2,0,1,2,2,3,11,38,26,8,12,December,-2.4492935982947064e-16,1.0,14,30,2,2,1,1.0,0.4,29,14,15,26,29,-3,"December, 2007"
2007-2008,20,2007-12-29,Birmingham,Fulham,1,1,D,1,1,1,2,2,4,0,1,14,18,18,14,4,4,December,-2.4492935982947064e-16,1.0,3,19,2,2,1,1.0,0.8,21,30,-9,20,34,-14,"December, 2007"
2007-2008,20,2007-12-29,Everton,Arsenal,1,4,A,0,3,1,2,2,4,0,1,6,2,33,44,4,11,December,-2.4492935982947064e-16,1.0,18,0,2,1,2,0.6,2.0,34,18,16,36,15,21,"December, 2007"
2007-2008,20,2007-12-30,Derby,Blackburn,1,2,A,0,3,0,0,5,2,1,2,20,10,7,27,10,20,December,-2.4492935982947064e-16,1.0,17,4,4,1,0,1.4,0.4,9,43,-34,25,27,-2,"December, 2007"
2007-2008,20,2007-12-30,Man City,Liverpool,0,0,D,1,1,2,0,3,4,1,0,5,4,35,36,1,1,December,-2.4492935982947064e-16,1.0,27,25,1,1,3,0.2,0.6,27,22,5,33,12,21,"December, 2007"
2007-2008,21,2008-01-01,Middlesbrough,Everton,0,2,A,0,3,2,1,2,1,2,2,14,7,20,33,7,13,January,0.4999999999999999,0.8660254037844387,29,18,1,1,3,0.4,1.0,18,33,-15,35,22,13,"January, 2008"
2007-2008,21,2008-01-01,Reading,Portsmouth,0,2,A,0,3,1,1,3,0,1,4,13,8,22,31,5,9,January,0.4999999999999999,0.8660254037844387,35,33,0,1,2,1.6666666666666667,3.333333333333333,29,42,-13,29,20,9,"January, 2008"
2007-2008,21,2008-01-01,Man United,Birmingham,1,0,H,3,0,3,1,1,1,2,2,2,15,45,19,13,26,January,0.4999999999999999,0.8660254037844387,28,3,3,2,0,1.6,0.4,37,11,26,22,31,-9,"January, 2008"
2007-2008,21,2008-01-01,Arsenal,West Ham,2,0,H,3,0,4,0,1,1,2,2,1,10,47,29,9,18,January,0.4999999999999999,0.8660254037844387,0,45,1,1,3,0.6,1.0,40,16,24,25,17,8,"January, 2008"
2007-2008,21,2008-01-01,Aston Villa,Tottenham,2,1,H,3,0,2,2,1,1,3,1,7,12,33,24,5,9,January,0.4999999999999999,0.8660254037844387,1,42,0,4,1,1.4,1.6,35,26,9,41,36,5,"January, 2008"
2007-2008,21,2008-01-01,Fulham,Chelsea,1,2,A,0,3,4,0,1,3,2,0,19,3,15,41,16,26,January,0.4999999999999999,0.8660254037844387,19,14,1,2,2,1.0,1.4,21,35,-14,31,15,16,"January, 2008"
2007-2008,21,2008-01-02,Blackburn,Sunderland,1,0,H,3,0,2,1,2,1,0,4,9,17,30,17,8,13,January,0.4999999999999999,0.8660254037844387,4,40,3,2,0,1.0,0.2,27,28,-1,20,39,-19,"January, 2008"
2007-2008,21,2008-01-02,Bolton,Derby,1,0,H,3,0,3,2,0,0,0,5,16,20,17,7,4,10,January,0.4999999999999999,0.8660254037844387,6,17,0,2,3,1.0,2.4,22,32,-10,10,45,-35,"January, 2008"
2007-2008,21,2008-01-02,Liverpool,Wigan,1,1,D,1,1,4,1,0,1,3,1,4,18,37,16,14,21,January,0.4999999999999999,0.8660254037844387,25,46,5,0,0,2.2,0.0,33,12,21,20,36,-16,"January, 2008"
2007-2008,21,2008-01-02,Newcastle,Man City,0,2,A,0,3,1,2,2,2,0,3,11,7,26,36,4,10,January,0.4999999999999999,0.8660254037844387,30,27,1,1,3,0.4,1.4,27,31,-4,27,22,5,"January, 2008"
2007-2008,22,2008-01-12,West Ham,Fulham,2,1,H,3,0,1,2,2,4,0,1,10,19,29,15,9,14,January,0.4999999999999999,0.8660254037844387,45,19,2,3,0,1.6,1.2,25,19,6,22,37,-15,"January, 2008"
2007-2008,22,2008-01-12,Middlesbrough,Liverpool,1,1,D,1,1,2,1,2,4,1,0,17,7,20,38,10,18,January,0.4999999999999999,0.8660254037844387,29,25,0,3,2,0.2,1.0,18,35,-17,34,13,21,"January, 2008"
2007-2008,22,2008-01-12,Man United,Newcastle,6,0,H,3,0,3,1,1,1,2,2,2,11,48,26,9,22,January,0.4999999999999999,0.8660254037844387,28,30,4,1,0,2.0,0.6,38,11,27,27,33,-6,"January, 2008"
2007-2008,22,2008-01-12,Everton,Man City,1,0,H,3,0,1,2,2,2,0,3,7,5,36,39,2,3,January,0.4999999999999999,0.8660254037844387,18,27,2,1,2,1.0,1.2,37,22,15,29,22,7,"January, 2008"
2007-2008,22,2008-01-12,Chelsea,Tottenham,2,0,H,3,0,3,2,0,1,3,1,3,12,44,24,9,20,January,0.4999999999999999,0.8660254037844387,14,42,4,0,1,1.6,0.6,33,16,17,42,38,4,"January, 2008"
2007-2008,22,2008-01-12,Aston Villa,Reading,3,1,H,3,0,2,2,1,1,1,3,7,13,36,22,6,14,January,0.4999999999999999,0.8660254037844387,1,35,1,0,1,1.0,1.5,37,27,10,29,44,-15,"January, 2008"
2007-2008,22,2008-01-12,Arsenal,Birmingham,1,1,D,1,1,4,0,1,1,2,2,1,16,50,19,15,31,January,0.4999999999999999,0.8660254037844387,0,3,3,1,1,1.4,0.4,42,16,26,22,32,-10,"January, 2008"
2007-2008,22,2008-01-12,Derby,Wigan,0,1,A,0,3,0,0,5,1,3,1,20,17,7,17,3,10,January,0.4999999999999999,0.8660254037844387,17,46,0,0,0,0.0,0.0,10,46,-36,21,37,-16,"January, 2008"
2007-2008,22,2008-01-13,Bolton,Blackburn,1,2,A,0,3,3,2,0,2,1,2,15,9,20,33,6,13,January,0.4999999999999999,0.8660254037844387,6,4,2,2,1,0.6,0.4,23,32,-9,28,28,0,"January, 2008"
2007-2008,22,2008-01-13,Sunderland,Portsmouth,2,0,H,3,0,1,0,4,0,1,4,18,9,17,34,9,17,January,0.4999999999999999,0.8660254037844387,40,33,0,0,2,1.0,3.0,20,40,-20,31,20,11,"January, 2008"
2007-2008,23,2008-01-19,Tottenham,Sunderland,2,0,H,3,0,1,3,1,1,0,4,12,18,24,20,6,4,January,0.4999999999999999,0.8660254037844387,42,40,2,1,2,1.6,1.4,42,40,2,22,40,-18,"January, 2008"
2007-2008,23,2008-01-19,Reading,Man United,0,2,A,0,3,1,1,3,3,1,1,13,2,22,51,11,29,January,0.4999999999999999,0.8660254037844387,35,28,0,2,1,1.0,1.3333333333333333,30,47,-17,44,11,33,"January, 2008"
2007-2008,23,2008-01-19,Portsmouth,Derby,3,1,H,3,0,0,1,4,0,0,5,9,20,34,7,11,27,January,0.4999999999999999,0.8660254037844387,33,17,0,1,0,2.0,2.0,31,22,9,10,47,-37,"January, 2008"
2007-2008,23,2008-01-19,Newcastle,Bolton,0,0,D,1,1,1,2,2,3,2,0,11,15,26,20,4,6,January,0.4999999999999999,0.8660254037844387,30,6,2,0,3,1.6,1.6,27,39,-12,24,34,-10,"January, 2008"
2007-2008,23,2008-01-19,Blackburn,Middlesbrough,1,1,D,1,1,2,1,2,2,1,2,8,14,36,21,6,15,January,0.4999999999999999,0.8660254037844387,4,29,5,0,0,2.0,0.8,30,29,1,19,36,-17,"January, 2008"
2007-2008,23,2008-01-19,Birmingham,Chelsea,0,1,A,0,3,1,2,2,3,2,0,16,3,20,47,13,27,January,0.4999999999999999,0.8660254037844387,3,14,0,2,3,0.6,1.4,23,33,-10,35,16,19,"January, 2008"
2007-2008,23,2008-01-19,Fulham,Arsenal,0,3,A,0,3,4,0,1,4,0,1,19,2,15,51,17,36,January,0.4999999999999999,0.8660254037844387,19,0,1,0,4,1.0,2.8,23,39,-16,43,17,26,"January, 2008"
2007-2008,23,2008-01-20,Man City,West Ham,1,1,D,1,1,2,0,3,1,2,2,7,10,39,32,3,7,January,0.4999999999999999,0.8660254037844387,27,45,4,0,1,1.4,0.4,29,23,6,27,20,7,"January, 2008"
2007-2008,23,2008-01-20,Wigan,Everton,1,2,A,0,3,1,3,1,1,2,2,17,6,20,39,11,19,January,0.4999999999999999,0.8660254037844387,46,18,1,2,2,1.0,1.4,22,37,-15,38,22,16,"January, 2008"
2007-2008,23,2008-01-21,Liverpool,Aston Villa,2,2,D,1,1,4,1,0,2,2,1,6,7,39,39,1,0,January,0.4999999999999999,0.8660254037844387,25,1,4,1,0,2.0,0.6,35,14,21,40,28,12,"January, 2008"
2007-2008,23,2008-01-26,Aston Villa,Blackburn,1,1,D,1,1,2,2,1,2,1,2,6,9,40,37,3,3,January,0.4999999999999999,0.8660254037844387,1,4,4,0,1,1.8,0.6,42,30,12,31,30,1,"January, 2008"
2007-2008,24,2008-01-29,Sunderland,Birmingham,2,0,H,3,0,1,0,4,1,2,2,18,16,20,20,2,0,January,0.4999999999999999,0.8660254037844387,40,3,0,1,4,0.4,1.4,22,42,-20,23,34,-11,"January, 2008"
2007-2008,24,2008-01-29,Middlesbrough,Wigan,1,0,H,3,0,2,1,2,1,3,1,14,17,22,20,3,2,January,0.4999999999999999,0.8660254037844387,29,46,1,2,2,1.0,1.2,20,37,-17,23,39,-16,"January, 2008"
2007-2008,24,2008-01-29,Arsenal,Newcastle,3,0,H,3,0,4,0,1,1,2,2,2,12,54,27,10,27,January,0.4999999999999999,0.8660254037844387,0,30,1,3,1,0.8,0.6,46,17,29,27,39,-12,"January, 2008"
2007-2008,24,2008-01-29,Bolton,Fulham,0,0,D,1,1,3,2,0,4,0,1,15,19,21,15,4,6,January,0.4999999999999999,0.8660254037844387,6,19,2,1,2,1.4,1.4,24,34,-10,23,42,-19,"January, 2008"
2007-2008,24,2008-01-30,Chelsea,Reading,1,0,H,3,0,3,2,0,1,1,3,3,16,50,22,13,28,January,0.4999999999999999,0.8660254037844387,14,35,2,1,0,1.6666666666666667,1.0,36,16,20,30,49,-19,"January, 2008"
2007-2008,24,2008-01-30,Derby,Man City,1,1,D,1,1,0,0,5,2,0,3,20,7,7,40,13,33,January,0.4999999999999999,0.8660254037844387,17,27,0,2,1,0.3333333333333333,0.6666666666666666,11,50,-39,30,24,6,"January, 2008"
2007-2008,24,2008-01-30,Everton,Tottenham,0,0,D,1,1,1,2,2,1,3,1,4,11,42,27,7,15,January,0.4999999999999999,0.8660254037844387,18,42,2,0,3,1.2,1.2,40,23,17,44,40,4,"January, 2008"
2007-2008,24,2008-01-30,Man United,Portsmouth,2,0,H,3,0,3,1,1,0,1,4,2,9,54,37,7,17,January,0.4999999999999999,0.8660254037844387,28,33,3,1,1,2.2,0.8,46,11,35,34,23,11,"January, 2008"
2007-2008,24,2008-01-30,West Ham,Liverpool,1,0,H,3,0,1,2,2,4,1,0,10,7,33,40,3,7,January,0.4999999999999999,0.8660254037844387,45,25,0,0,5,0.6,2.2,28,21,7,37,16,21,"January, 2008"
2007-2008,25,2008-02-02,Reading,Bolton,0,2,A,0,3,1,1,3,3,2,0,16,15,22,22,1,0,February,0.8660254037844386,0.5000000000000001,35,6,2,0,1,1.3333333333333333,1.3333333333333333,30,50,-20,24,34,-10,"February, 2008"
2007-2008,25,2008-02-02,Tottenham,Man United,1,1,D,1,1,1,3,1,3,1,1,11,2,28,57,9,29,February,0.8660254037844386,0.5000000000000001,42,28,0,1,4,0.4,1.8,44,40,4,48,11,37,"February, 2008"
2007-2008,25,2008-02-02,Portsmouth,Chelsea,1,1,D,1,1,0,1,4,3,2,0,9,3,37,53,6,16,February,0.8660254037844386,0.5000000000000001,33,14,0,0,5,0.2,1.8,34,25,9,37,16,21,"February, 2008"
2007-2008,25,2008-02-02,Wigan,West Ham,1,0,H,3,0,1,3,1,1,2,2,18,10,20,36,8,16,February,0.8660254037844386,0.5000000000000001,46,45,2,1,2,1.2,1.2,23,40,-17,29,21,8,"February, 2008"
2007-2008,25,2008-02-02,Liverpool,Sunderland,3,0,H,3,0,4,1,0,1,0,4,7,14,40,23,7,17,February,0.8660254037844386,0.5000000000000001,25,40,3,1,1,1.2,0.4,37,17,20,24,42,-18,"February, 2008"
2007-2008,25,2008-02-02,Blackburn,Everton,0,0,D,1,1,2,1,2,1,2,2,8,4,38,43,4,5,February,0.8660254037844386,0.5000000000000001,4,18,0,2,3,0.4,1.2,32,31,1,40,23,17,"February, 2008"
2007-2008,25,2008-02-02,Birmingham,Derby,1,1,D,1,1,1,2,2,0,0,5,17,20,20,8,3,12,February,0.8660254037844386,0.5000000000000001,3,17,1,0,0,2.0,1.0,23,36,-13,12,51,-39,"February, 2008"
2007-2008,25,2008-02-02,Man City,Arsenal,1,3,A,0,3,2,0,3,4,0,1,7,2,41,57,5,16,February,0.8660254037844386,0.5000000000000001,27,0,1,0,4,0.6,1.6,31,25,6,49,17,32,"February, 2008"
2007-2008,25,2008-02-03,Fulham,Aston Villa,2,1,H,3,0,4,0,1,2,2,1,19,6,16,41,13,25,February,0.8660254037844386,0.5000000000000001,19,1,0,4,1,1.2,1.4,23,42,-19,43,31,12,"February, 2008"
2007-2008,25,2008-02-03,Newcastle,Middlesbrough,1,1,D,1,1,1,2,2,2,1,2,12,14,27,25,2,2,February,0.8660254037844386,0.5000000000000001,30,29,1,3,1,1.2,1.2,27,42,-15,21,37,-16,"February, 2008"
2007-2008,26,2008-02-09,West Ham,Birmingham,1,1,D,1,1,1,2,2,1,2,2,10,18,36,21,8,15,February,0.8660254037844386,0.5000000000000001,45,3,3,1,1,1.8,1.0,29,22,7,24,37,-13,"February, 2008"
2007-2008,26,2008-02-09,Sunderland,Wigan,2,0,H,3,0,1,0,4,1,3,1,16,15,23,23,1,0,February,0.8660254037844386,0.5000000000000001,40,46,0,0,3,0.0,1.6666666666666667,24,45,-21,24,40,-16,"February, 2008"
2007-2008,26,2008-02-09,Middlesbrough,Fulham,1,0,H,3,0,2,1,2,4,0,1,13,19,26,19,6,7,February,0.8660254037844386,0.5000000000000001,29,19,3,0,2,1.8,1.4,22,38,-16,25,43,-18,"February, 2008"
2007-2008,26,2008-02-09,Derby,Tottenham,0,3,A,0,3,0,0,5,1,3,1,20,11,9,29,9,20,February,0.8660254037844386,0.5000000000000001,17,42,2,0,3,1.0,2.2,13,52,-39,45,41,4,"February, 2008"
2007-2008,26,2008-02-09,Bolton,Portsmouth,0,1,A,0,3,3,2,0,0,1,4,14,9,25,38,5,13,February,0.8660254037844386,0.5000000000000001,6,33,3,1,1,1.4,1.2,26,34,-8,35,26,9,"February, 2008"
2007-2008,26,2008-02-09,Aston Villa,Newcastle,4,1,H,3,0,2,2,1,1,2,2,6,12,41,28,6,13,February,0.8660254037844386,0.5000000000000001,1,30,1,2,2,1.0,1.2,44,33,11,28,43,-15,"February, 2008"
2007-2008,26,2008-02-09,Everton,Reading,1,0,H,3,0,1,2,2,1,1,3,4,17,44,22,13,22,February,0.8660254037844386,0.5000000000000001,18,35,1,1,1,1.0,0.6666666666666666,40,23,17,30,52,-22,"February, 2008"
2007-2008,26,2008-02-10,Chelsea,Liverpool,0,0,D,1,1,3,2,0,4,1,0,3,6,54,43,3,11,February,0.8660254037844386,0.5000000000000001,14,25,3,1,1,1.6,0.8,38,17,21,40,17,23,"February, 2008"
2007-2008,26,2008-02-10,Man United,Man City,1,2,A,0,3,3,1,1,2,0,3,2,8,58,41,6,17,February,0.8660254037844386,0.5000000000000001,28,27,2,1,2,1.2,1.2,49,12,37,32,28,4,"February, 2008"
2007-2008,26,2008-02-11,Arsenal,Blackburn,2,0,H,3,0,4,0,1,2,1,2,1,9,60,39,8,21,February,0.8660254037844386,0.5000000000000001,0,4,3,1,1,2.4,0.8,52,18,34,32,31,1,"February, 2008"
2007-2008,27,2008-02-23,Portsmouth,Sunderland,1,0,H,3,0,0,1,4,1,0,4,8,14,41,26,6,15,February,0.8660254037844386,0.5000000000000001,33,40,2,0,1,2.0,1.3333333333333333,36,26,10,26,45,-19,"February, 2008"
2007-2008,27,2008-02-23,Newcastle,Man United,1,5,A,0,3,1,2,2,3,1,1,13,2,28,58,11,30,February,0.8660254037844386,0.5000000000000001,30,28,0,1,4,0.4,2.8,29,47,-18,50,14,36,"February, 2008"
2007-2008,27,2008-02-23,Wigan,Derby,2,0,H,3,0,1,3,1,0,0,5,17,20,23,9,3,14,February,0.8660254037844386,0.5000000000000001,46,17,1,0,0,1.0,0.0,24,42,-18,13,55,-42,"February, 2008"
2007-2008,27,2008-02-23,Fulham,West Ham,0,1,A,0,3,4,0,1,1,2,2,19,10,19,37,9,18,February,0.8660254037844386,0.5000000000000001,19,45,0,2,3,1.2,1.8,25,44,-19,30,23,7,"February, 2008"
2007-2008,27,2008-02-23,Birmingham,Arsenal,2,2,D,1,1,1,2,2,4,0,1,17,1,22,63,16,41,February,0.8660254037844386,0.5000000000000001,3,0,1,1,3,0.6,1.6,25,38,-13,54,18,36,"February, 2008"
2007-2008,27,2008-02-23,Liverpool,Middlesbrough,3,2,H,3,0,4,1,0,2,1,2,5,12,44,29,7,15,February,0.8660254037844386,0.5000000000000001,25,29,2,3,0,1.0,0.2,40,17,23,23,38,-15,"February, 2008"
2007-2008,27,2008-02-24,Blackburn,Bolton,4,1,H,3,0,2,1,2,3,2,0,10,16,39,25,6,14,February,0.8660254037844386,0.5000000000000001,4,6,2,2,1,0.8,0.6,32,33,-1,26,35,-9,"February, 2008"
2007-2008,27,2008-02-24,Reading,Aston Villa,1,2,A,0,3,1,1,3,2,2,1,18,6,22,44,12,22,February,0.8660254037844386,0.5000000000000001,35,1,1,0,2,1.3333333333333333,1.6666666666666667,30,53,-23,48,34,14,"February, 2008"
2007-2008,27,2008-02-25,Man City,Everton,0,2,A,0,3,2,0,3,1,2,2,8,5,44,47,3,3,February,0.8660254037844386,0.5000000000000001,27,18,2,1,2,1.0,0.8,34,29,5,41,23,18,"February, 2008"
2007-2008,28,2008-03-01,West Ham,Chelsea,0,4,A,0,3,1,2,2,3,2,0,10,3,40,55,7,15,March,1.0,6.123233995736766e-17,45,14,0,0,5,0.6,2.6,31,23,8,38,17,21,"March, 2008"
2007-2008,28,2008-03-01,Newcastle,Blackburn,0,1,A,0,3,1,2,2,2,1,2,13,9,28,42,4,14,March,1.0,6.123233995736766e-17,30,4,2,0,3,1.4,1.4,30,52,-22,36,34,2,"March, 2008"
2007-2008,28,2008-03-01,Man City,Wigan,0,0,D,1,1,2,0,3,1,3,1,8,16,44,26,8,18,March,1.0,6.123233995736766e-17,27,46,0,1,4,0.8,2.2,34,31,3,26,42,-16,"March, 2008"
2007-2008,28,2008-03-01,Middlesbrough,Reading,0,1,A,0,3,2,1,2,1,1,3,12,18,29,22,6,7,March,1.0,6.123233995736766e-17,29,35,1,1,1,1.6666666666666667,1.6666666666666667,25,41,-16,31,55,-24,"March, 2008"
2007-2008,28,2008-03-01,Derby,Sunderland,0,0,D,1,1,0,0,5,1,0,4,20,16,9,26,4,17,March,1.0,6.123233995736766e-17,17,40,1,1,3,0.6,1.0,13,57,-44,26,46,-20,"March, 2008"
2007-2008,28,2008-03-01,Birmingham,Tottenham,4,1,H,3,0,1,2,2,1,3,1,17,11,23,32,6,9,March,1.0,6.123233995736766e-17,3,42,1,1,3,0.8,1.6,27,40,-13,48,41,7,"March, 2008"
2007-2008,28,2008-03-01,Arsenal,Aston Villa,1,1,D,1,1,4,0,1,2,2,1,1,6,64,47,5,17,March,1.0,6.123233995736766e-17,0,1,3,2,0,1.8,0.4,56,20,36,50,35,15,"March, 2008"
2007-2008,28,2008-03-01,Fulham,Man United,0,3,A,0,3,4,0,1,3,1,1,19,2,19,61,17,42,March,1.0,6.123233995736766e-17,19,28,0,0,5,1.2,3.2,25,45,-20,55,15,40,"March, 2008"
2007-2008,28,2008-03-02,Bolton,Liverpool,1,3,A,0,3,3,2,0,4,1,0,17,6,25,47,11,22,March,1.0,6.123233995736766e-17,6,25,1,1,3,0.8,2.0,27,39,-12,43,19,24,"March, 2008"
2007-2008,28,2008-03-02,Everton,Portsmouth,3,1,H,3,0,1,2,2,0,1,4,5,9,50,44,4,6,March,1.0,6.123233995736766e-17,18,33,2,1,2,0.8,0.6,43,23,20,37,26,11,"March, 2008"
2007-2008,28,2008-03-05,Liverpool,West Ham,4,0,H,3,0,4,1,0,1,2,2,5,10,50,40,5,10,March,1.0,6.123233995736766e-17,25,45,4,0,1,1.6,0.8,46,20,26,31,27,4,"March, 2008"
2007-2008,29,2008-03-08,Blackburn,Fulham,1,1,D,1,1,2,1,2,4,0,1,7,19,45,19,12,26,March,1.0,6.123233995736766e-17,4,19,2,2,1,1.6,1.2,37,34,3,25,48,-23,"March, 2008"
2007-2008,29,2008-03-08,Liverpool,Newcastle,3,0,H,3,0,4,1,0,1,2,2,4,13,53,28,9,25,March,1.0,6.123233995736766e-17,25,30,4,0,1,2.2,0.6,50,20,30,30,53,-23,"March, 2008"
2007-2008,29,2008-03-08,Reading,Man City,2,0,H,3,0,1,1,3,2,0,3,18,8,25,45,10,20,March,1.0,6.123233995736766e-17,35,27,2,0,1,1.3333333333333333,0.6666666666666666,32,55,-23,34,31,3,"March, 2008"
2007-2008,29,2008-03-09,Wigan,Arsenal,0,0,D,1,1,1,3,1,4,0,1,15,1,27,65,14,38,March,1.0,6.123233995736766e-17,46,0,0,0,5,1.0,2.4,26,42,-16,57,21,36,"March, 2008"
2007-2008,29,2008-03-09,Sunderland,Everton,0,1,A,0,3,1,0,4,1,2,2,16,5,27,53,11,26,March,1.0,6.123233995736766e-17,40,18,0,1,4,0.8,2.6,26,46,-20,46,24,22,"March, 2008"
2007-2008,29,2008-03-09,Tottenham,West Ham,4,0,H,3,0,1,3,1,1,2,2,11,10,32,40,1,8,March,1.0,6.123233995736766e-17,42,45,2,2,1,1.6,1.4,49,45,4,31,31,0,"March, 2008"
2007-2008,29,2008-03-12,Chelsea,Derby,6,1,H,3,0,3,2,0,0,0,5,3,20,58,10,17,48,March,1.0,6.123233995736766e-17,14,17,4,1,0,2.6,0.6,42,17,25,13,57,-44,"March, 2008"
2007-2008,29,2008-03-12,Portsmouth,Birmingham,4,2,H,3,0,0,1,4,1,2,2,9,17,44,26,8,18,March,1.0,6.123233995736766e-17,33,3,1,3,1,0.8,1.4,38,29,9,31,41,-10,"March, 2008"
2007-2008,29,2008-03-12,Aston Villa,Middlesbrough,1,1,D,1,1,2,2,1,2,1,2,6,12,48,29,6,19,March,1.0,6.123233995736766e-17,1,29,3,1,1,2.6,1.0,51,36,15,25,42,-17,"March, 2008"
2007-2008,30,2008-03-15,Arsenal,Middlesbrough,1,1,D,1,1,4,0,1,2,1,2,1,12,66,30,11,36,March,1.0,6.123233995736766e-17,0,29,1,2,2,2.2,1.2,57,21,36,26,43,-17,"March, 2008"
2007-2008,30,2008-03-15,Derby,Man United,0,1,A,0,3,0,0,5,3,1,1,20,2,10,64,18,54,March,1.0,6.123233995736766e-17,17,28,1,1,3,0.8,2.8,14,63,-49,58,15,43,"March, 2008"
2007-2008,30,2008-03-15,Liverpool,Reading,2,1,H,3,0,4,1,0,1,1,3,4,14,56,28,10,28,March,1.0,6.123233995736766e-17,25,35,2,0,1,1.6666666666666667,1.3333333333333333,53,20,33,34,55,-21,"March, 2008"
2007-2008,30,2008-03-15,Portsmouth,Aston Villa,2,0,H,3,0,0,1,4,2,2,1,7,6,47,49,1,2,March,1.0,6.123233995736766e-17,33,1,1,3,1,1.2,1.0,42,31,11,52,37,15,"March, 2008"
2007-2008,30,2008-03-15,Sunderland,Chelsea,0,1,A,0,3,1,0,4,3,2,0,16,3,27,61,13,34,March,1.0,6.123233995736766e-17,40,14,0,0,5,0.4,2.2,26,47,-21,48,18,30,"March, 2008"
2007-2008,30,2008-03-15,West Ham,Blackburn,2,1,H,3,0,1,2,2,2,1,2,10,8,40,46,2,6,March,1.0,6.123233995736766e-17,45,4,4,0,1,2.0,1.2,31,35,-4,38,35,3,"March, 2008"
2007-2008,30,2008-03-16,Fulham,Everton,1,0,H,3,0,4,0,1,1,2,2,19,5,20,56,14,36,March,1.0,6.123233995736766e-17,19,18,2,0,3,0.8,2.0,26,49,-23,47,24,23,"March, 2008"
2007-2008,30,2008-03-16,Man City,Tottenham,2,1,H,3,0,2,0,3,1,3,1,9,11,45,35,2,10,March,1.0,6.123233995736766e-17,27,42,0,0,5,0.8,2.0,34,33,1,53,45,8,"March, 2008"
2007-2008,30,2008-03-16,Wigan,Bolton,1,0,H,3,0,1,3,1,3,2,0,13,18,28,25,5,3,March,1.0,6.123233995736766e-17,46,6,2,1,2,1.2,1.8,26,42,-16,28,42,-14,"March, 2008"
2007-2008,30,2008-03-17,Birmingham,Newcastle,1,1,D,1,1,1,2,2,1,2,2,17,15,26,28,2,2,March,1.0,6.123233995736766e-17,3,30,0,2,3,0.8,1.4,33,45,-12,30,56,-26,"March, 2008"
2007-2008,30,2008-03-19,Man United,Bolton,2,0,H,3,0,3,1,1,3,2,0,1,18,67,25,17,42,March,1.0,6.123233995736766e-17,28,6,4,0,1,2.8,0.8,59,15,44,28,43,-15,"March, 2008"
2007-2008,30,2008-03-19,Tottenham,Chelsea,4,4,D,1,1,1,3,1,3,2,0,11,3,35,64,8,29,March,1.0,6.123233995736766e-17,42,14,1,0,4,0.6,1.6,54,47,7,49,18,31,"March, 2008"
2007-2008,31,2008-03-22,Aston Villa,Sunderland,0,1,A,0,3,2,2,1,1,0,4,7,17,49,27,10,22,March,1.0,6.123233995736766e-17,1,40,3,1,1,1.4,0.8,52,39,13,26,48,-22,"March, 2008"
2007-2008,31,2008-03-22,Blackburn,Wigan,3,1,H,3,0,2,1,2,1,3,1,9,12,46,31,3,15,March,1.0,6.123233995736766e-17,4,46,3,1,1,2.4,1.4,39,37,2,27,42,-15,"March, 2008"
2007-2008,31,2008-03-22,Bolton,Man City,0,0,D,1,1,3,2,0,2,0,3,18,9,25,48,9,23,March,1.0,6.123233995736766e-17,6,27,3,1,1,1.4,0.8,28,45,-17,36,34,2,"March, 2008"
2007-2008,31,2008-03-22,Everton,West Ham,1,1,D,1,1,1,2,2,1,2,2,5,10,56,43,5,13,March,1.0,6.123233995736766e-17,18,45,2,1,2,1.4,1.0,47,25,22,33,36,-3,"March, 2008"
2007-2008,31,2008-03-22,Middlesbrough,Derby,1,0,H,3,0,2,1,2,0,0,5,13,20,31,10,7,21,March,1.0,6.123233995736766e-17,29,17,4,1,0,2.8,0.8,27,44,-17,14,64,-50,"March, 2008"
2007-2008,31,2008-03-22,Newcastle,Fulham,2,0,H,3,0,1,2,2,4,0,1,15,19,29,23,4,6,March,1.0,6.123233995736766e-17,30,19,1,1,3,0.8,1.2,31,57,-26,27,49,-22,"March, 2008"
2007-2008,31,2008-03-22,Reading,Birmingham,2,1,H,3,0,1,1,3,1,2,2,16,17,28,27,1,1,March,1.0,6.123233995736766e-17,35,3,0,1,0,1.0,1.0,35,57,-22,34,46,-12,"March, 2008"
2007-2008,31,2008-03-22,Tottenham,Portsmouth,2,0,H,3,0,1,3,1,0,1,4,11,6,36,50,5,14,March,1.0,6.123233995736766e-17,42,33,4,1,0,1.8,0.6,58,51,7,44,31,13,"March, 2008"
2007-2008,31,2008-03-23,Man United,Liverpool,3,0,H,3,0,3,1,1,4,1,0,1,4,70,59,3,11,March,1.0,6.123233995736766e-17,28,25,4,1,0,1.0,0.0,61,15,46,55,21,34,"March, 2008"
2007-2008,31,2008-03-23,Chelsea,Arsenal,2,1,H,3,0,3,2,0,4,0,1,3,2,65,67,1,2,March,1.0,6.123233995736766e-17,14,0,2,2,1,1.0,0.6,53,22,31,58,22,36,"March, 2008"
2007-2008,32,2008-03-29,Birmingham,Man City,3,1,H,3,0,1,2,2,2,0,3,17,9,27,49,8,22,March,1.0,6.123233995736766e-17,3,27,1,0,4,0.6,2.0,35,48,-13,36,34,2,"March, 2008"
2007-2008,32,2008-03-29,Bolton,Arsenal,2,3,A,0,3,3,2,0,4,0,1,18,3,26,67,15,41,March,1.0,6.123233995736766e-17,6,0,2,1,2,1.4,1.2,28,45,-17,59,24,35,"March, 2008"
2007-2008,32,2008-03-29,Derby,Fulham,2,2,D,1,1,0,0,5,4,0,1,20,19,10,23,1,13,March,1.0,6.123233995736766e-17,17,19,0,2,1,0.0,0.3333333333333333,14,65,-51,27,51,-24,"March, 2008"
2007-2008,32,2008-03-29,Man United,Aston Villa,4,0,H,3,0,3,1,1,2,2,1,1,7,73,49,6,24,March,1.0,6.123233995736766e-17,28,1,5,0,0,2.6,0.4,64,15,49,52,40,12,"March, 2008"
2007-2008,32,2008-03-29,Portsmouth,Wigan,2,0,H,3,0,0,1,4,1,3,1,6,14,50,31,8,19,March,1.0,6.123233995736766e-17,33,46,3,0,2,1.0,0.8,44,33,11,28,45,-17,"March, 2008"
2007-2008,32,2008-03-29,Reading,Blackburn,0,0,D,1,1,1,1,3,2,1,2,15,8,31,49,7,18,March,1.0,6.123233995736766e-17,35,4,0,1,2,2.0,3.0,37,58,-21,42,38,4,"March, 2008"
2007-2008,32,2008-03-29,Sunderland,West Ham,2,1,H,3,0,1,0,4,1,2,2,17,10,30,44,7,14,March,1.0,6.123233995736766e-17,40,45,0,1,4,0.4,1.8,27,48,-21,34,37,-3,"March, 2008"
2007-2008,32,2008-03-30,Liverpool,Everton,1,0,H,3,0,4,1,0,1,2,2,4,5,59,57,1,2,March,1.0,6.123233995736766e-17,25,18,3,1,1,1.6,1.2,55,24,31,48,26,22,"March, 2008"
2007-2008,32,2008-03-30,Tottenham,Newcastle,1,4,A,0,3,1,3,1,1,2,2,11,15,39,32,4,7,March,1.0,6.123233995736766e-17,42,30,1,0,4,1.4,2.4,60,51,9,33,57,-24,"March, 2008"
2007-2008,32,2008-03-30,Chelsea,Middlesbrough,1,0,H,3,0,3,2,0,2,1,2,3,12,68,34,9,34,March,1.0,6.123233995736766e-17,14,29,3,0,2,1.4,1.0,55,23,32,28,44,-16,"March, 2008"
2007-2008,33,2008-04-05,Arsenal,Liverpool,1,1,D,1,1,4,0,1,4,1,0,3,4,70,62,1,8,April,0.8660254037844388,-0.4999999999999998,0,25,2,1,2,1.4,1.4,62,26,36,56,24,32,"April, 2008"
2007-2008,33,2008-04-05,Aston Villa,Bolton,4,0,H,3,0,2,2,1,3,2,0,8,18,49,26,10,23,April,0.8660254037844388,-0.4999999999999998,1,6,0,4,1,1.2,1.4,52,44,8,30,48,-18,"April, 2008"
2007-2008,33,2008-04-05,Blackburn,Tottenham,1,1,D,1,1,2,1,2,1,3,1,8,11,50,39,3,11,April,0.8660254037844388,-0.4999999999999998,4,42,1,3,1,1.2,1.2,42,38,4,61,55,6,"April, 2008"
2007-2008,33,2008-04-05,Fulham,Sunderland,1,3,A,0,3,4,0,1,1,0,4,19,14,24,33,5,9,April,0.8660254037844388,-0.4999999999999998,19,40,3,1,1,1.6,0.8,29,53,-24,29,49,-20,"April, 2008"
2007-2008,33,2008-04-05,Man City,Chelsea,0,2,A,0,3,2,0,3,3,2,0,9,3,49,71,6,22,April,0.8660254037844388,-0.4999999999999998,27,14,0,0,5,0.0,2.6,37,37,0,56,23,33,"April, 2008"
2007-2008,33,2008-04-05,Newcastle,Reading,3,0,H,3,0,1,2,2,1,1,3,13,15,35,32,2,3,April,0.8660254037844388,-0.4999999999999998,30,35,1,0,2,1.3333333333333333,1.6666666666666667,37,58,-21,37,58,-21,"April, 2008"
2007-2008,33,2008-04-05,Wigan,Birmingham,2,0,H,3,0,1,3,1,1,2,2,16,17,31,30,1,1,April,0.8660254037844388,-0.4999999999999998,46,3,0,1,2,1.0,2.0,28,47,-19,38,49,-11,"April, 2008"
2007-2008,33,2008-04-06,Middlesbrough,Man United,2,2,D,1,1,2,1,2,3,1,1,15,1,34,76,14,42,April,0.8660254037844388,-0.4999999999999998,29,28,1,2,2,1.4,1.6,28,45,-17,68,15,53,"April, 2008"
2007-2008,33,2008-04-06,Everton,Derby,1,0,H,3,0,1,2,2,0,0,5,5,20,57,11,15,46,April,0.8660254037844388,-0.4999999999999998,18,17,3,1,1,1.8,1.2,48,27,21,16,67,-51,"April, 2008"
2007-2008,33,2008-04-08,West Ham,Portsmouth,0,1,A,0,3,1,2,2,0,1,4,10,6,44,53,4,9,April,0.8660254037844388,-0.4999999999999998,45,33,0,2,3,0.8,1.8,35,39,-4,46,33,13,"April, 2008"
2007-2008,34,2008-04-12,Tottenham,Middlesbrough,1,1,D,1,1,1,3,1,2,1,2,11,14,40,35,3,5,April,0.8660254037844388,-0.4999999999999998,42,29,3,2,0,2.2,1.4,62,56,6,30,47,-17,"April, 2008"
2007-2008,34,2008-04-12,Sunderland,Man City,1,2,A,0,3,1,0,4,2,0,3,13,9,36,49,4,13,April,0.8660254037844388,-0.4999999999999998,40,27,0,0,5,0.4,2.2,32,50,-18,37,39,-2,"April, 2008"
2007-2008,34,2008-04-12,Reading,Fulham,0,2,A,0,3,1,1,3,4,0,1,16,19,32,24,3,8,April,0.8660254037844388,-0.4999999999999998,35,19,2,0,1,1.0,1.0,37,61,-24,30,56,-26,"April, 2008"
2007-2008,34,2008-04-12,Bolton,West Ham,1,0,H,3,0,3,2,0,1,2,2,18,10,26,44,8,18,April,0.8660254037844388,-0.4999999999999998,6,45,3,1,1,2.4,1.2,30,52,-22,35,40,-5,"April, 2008"
2007-2008,34,2008-04-12,Derby,Aston Villa,0,6,A,0,3,0,0,5,2,2,1,20,7,11,52,13,41,April,0.8660254037844388,-0.4999999999999998,17,1,2,0,3,1.2,1.8,16,68,-52,56,44,12,"April, 2008"
2007-2008,34,2008-04-12,Birmingham,Everton,1,1,D,1,1,1,2,2,1,2,2,17,5,30,60,12,30,April,0.8660254037844388,-0.4999999999999998,3,18,0,2,3,0.4,1.2,38,51,-13,49,27,22,"April, 2008"
2007-2008,34,2008-04-12,Portsmouth,Newcastle,0,0,D,1,1,0,1,4,1,2,2,6,12,56,38,6,18,April,0.8660254037844388,-0.4999999999999998,33,30,2,1,2,1.2,1.0,47,33,14,40,58,-18,"April, 2008"
2007-2008,34,2008-04-13,Liverpool,Blackburn,3,1,H,3,0,4,1,0,2,1,2,4,9,63,51,5,12,April,0.8660254037844388,-0.4999999999999998,25,4,2,2,1,0.6,0.4,57,25,32,43,39,4,"April, 2008"
2007-2008,34,2008-04-13,Man United,Arsenal,2,1,H,3,0,3,1,1,4,0,1,1,3,77,71,2,6,April,0.8660254037844388,-0.4999999999999998,28,0,1,2,2,1.0,1.0,70,17,53,63,27,36,"April, 2008"
2007-2008,34,2008-04-14,Chelsea,Wigan,1,1,D,1,1,3,2,0,1,3,1,2,15,74,34,13,40,April,0.8660254037844388,-0.4999999999999998,14,46,5,0,0,2.2,0.4,58,23,35,30,47,-17,"April, 2008"
2007-2008,34,2008-04-17,Everton,Chelsea,0,1,A,0,3,1,2,2,3,2,0,5,2,61,75,3,14,April,0.8660254037844388,-0.4999999999999998,18,14,0,3,2,1.0,1.8,50,28,22,59,24,35,"April, 2008"
2007-2008,35,2008-04-19,Wigan,Tottenham,1,1,D,1,1,1,3,1,1,3,1,15,11,35,41,4,6,April,0.8660254037844388,-0.4999999999999998,46,42,0,2,3,1.4,2.8,31,48,-17,63,57,6,"April, 2008"
2007-2008,35,2008-04-19,West Ham,Derby,2,1,H,3,0,1,2,2,0,0,5,10,20,44,11,10,33,April,0.8660254037844388,-0.4999999999999998,45,17,3,2,0,2.4,0.2,35,41,-6,16,74,-58,"April, 2008"
2007-2008,35,2008-04-19,Middlesbrough,Bolton,0,1,A,0,3,2,1,2,3,2,0,13,18,36,29,5,7,April,0.8660254037844388,-0.4999999999999998,29,6,2,3,0,2.0,1.0,31,48,-17,31,52,-21,"April, 2008"
2007-2008,35,2008-04-19,Fulham,Liverpool,0,2,A,0,3,4,0,1,4,1,0,19,4,27,66,15,39,April,0.8660254037844388,-0.4999999999999998,19,25,2,0,3,0.8,2.2,32,56,-24,60,26,34,"April, 2008"
2007-2008,35,2008-04-19,Blackburn,Man United,1,1,D,1,1,2,1,2,3,1,1,9,1,51,80,8,29,April,0.8660254037844388,-0.4999999999999998,4,28,2,0,3,1.4,2.2,44,42,2,72,18,54,"April, 2008"
2007-2008,35,2008-04-19,Arsenal,Reading,2,0,H,3,0,4,0,1,1,1,3,3,16,71,32,13,39,April,0.8660254037844388,-0.4999999999999998,0,35,3,0,0,3.0,0.6666666666666666,64,29,35,37,63,-26,"April, 2008"
2007-2008,35,2008-04-20,Aston Villa,Birmingham,5,1,H,3,0,2,2,1,1,2,2,7,18,55,31,11,24,April,0.8660254037844388,-0.4999999999999998,1,3,3,0,2,1.4,1.2,62,44,18,39,52,-13,"April, 2008"
2007-2008,35,2008-04-20,Man City,Portsmouth,3,1,H,3,0,2,0,3,0,1,4,9,7,52,57,2,5,April,0.8660254037844388,-0.4999999999999998,27,33,1,2,2,0.8,1.0,39,40,-1,47,33,14,"April, 2008"
2007-2008,35,2008-04-20,Newcastle,Sunderland,2,0,H,3,0,1,2,2,1,0,4,12,15,39,36,3,3,April,0.8660254037844388,-0.4999999999999998,30,40,4,1,0,2.2,0.8,40,58,-18,33,52,-19,"April, 2008"
2007-2008,36,2008-04-26,Wigan,Reading,0,0,D,1,1,1,3,1,1,1,3,14,18,36,32,4,4,April,0.8660254037844388,-0.4999999999999998,46,35,1,0,2,1.3333333333333333,1.6666666666666667,32,49,-17,37,65,-28,"April, 2008"
2007-2008,36,2008-04-26,West Ham,Newcastle,2,2,D,1,1,1,2,2,1,2,2,10,12,47,42,2,5,April,0.8660254037844388,-0.4999999999999998,45,30,0,2,3,1.0,2.2,37,42,-5,42,58,-16,"April, 2008"
2007-2008,36,2008-04-26,Tottenham,Bolton,1,1,D,1,1,1,3,1,3,2,0,11,17,42,32,6,10,April,0.8660254037844388,-0.4999999999999998,42,6,2,1,2,1.2,1.0,64,58,6,32,52,-20,"April, 2008"
2007-2008,36,2008-04-26,Sunderland,Middlesbrough,3,2,H,3,0,1,0,4,2,1,2,15,14,36,36,1,0,April,0.8660254037844388,-0.4999999999999998,40,29,1,1,3,1.0,2.2,33,54,-21,31,49,-18,"April, 2008"
2007-2008,36,2008-04-26,Man City,Fulham,2,3,A,0,3,2,0,3,4,0,1,8,19,55,27,11,28,April,0.8660254037844388,-0.4999999999999998,27,19,2,1,2,2.2,1.8,42,41,1,32,58,-26,"April, 2008"
2007-2008,36,2008-04-26,Chelsea,Man United,2,1,H,3,0,3,2,0,3,1,1,2,1,78,81,1,3,April,0.8660254037844388,-0.4999999999999998,14,28,1,2,2,0.8,0.8,60,24,36,73,19,54,"April, 2008"
2007-2008,36,2008-04-26,Birmingham,Liverpool,2,2,D,1,1,1,2,2,4,1,0,18,4,31,69,14,38,April,0.8660254037844388,-0.4999999999999998,3,25,2,3,0,1.2,0.6,40,57,-17,62,26,36,"April, 2008"
2007-2008,36,2008-04-27,Everton,Aston Villa,2,2,D,1,1,1,2,2,2,2,1,5,6,61,58,1,3,April,0.8660254037844388,-0.4999999999999998,18,1,1,1,3,1.0,1.8,50,29,21,67,45,22,"April, 2008"
2007-2008,36,2008-04-27,Portsmouth,Blackburn,0,1,A,0,3,0,1,4,2,1,2,7,9,57,52,2,5,April,0.8660254037844388,-0.4999999999999998,33,4,2,1,2,1.4,1.4,48,36,12,45,43,2,"April, 2008"
2007-2008,36,2008-04-28,Derby,Arsenal,2,6,A,0,3,0,0,5,4,0,1,20,3,11,74,17,63,April,0.8660254037844388,-0.4999999999999998,17,0,0,1,4,0.2,2.0,17,76,-59,66,29,37,"April, 2008"
2007-2008,37,2008-05-03,Reading,Tottenham,0,1,A,0,3,1,1,3,1,3,1,18,11,33,43,7,10,May,0.4999999999999999,-0.8660254037844387,35,42,1,0,2,2.333333333333333,2.6666666666666665,37,65,-28,65,59,6,"May, 2008"
2007-2008,37,2008-05-03,Middlesbrough,Portsmouth,2,0,H,3,0,2,1,2,0,1,4,16,8,36,57,8,21,May,0.4999999999999999,-0.8660254037844387,29,33,1,2,2,0.4,1.2,33,52,-19,48,37,11,"May, 2008"
2007-2008,37,2008-05-03,Man United,West Ham,4,1,H,3,0,3,1,1,1,2,2,1,10,81,48,9,33,May,0.4999999999999999,-0.8660254037844387,28,45,2,0,3,0.8,1.0,74,21,53,39,44,-5,"May, 2008"
2007-2008,37,2008-05-03,Fulham,Birmingham,2,0,H,3,0,4,0,1,1,2,2,19,18,30,32,1,2,May,0.4999999999999999,-0.8660254037844387,19,3,1,2,2,1.0,1.2,35,60,-25,42,59,-17,"May, 2008"
2007-2008,37,2008-05-03,Bolton,Sunderland,2,0,H,3,0,3,2,0,1,0,4,16,14,33,39,2,6,May,0.4999999999999999,-0.8660254037844387,6,40,2,2,1,1.2,0.8,33,53,-20,36,56,-20,"May, 2008"
2007-2008,37,2008-05-03,Blackburn,Derby,3,1,H,3,0,2,1,2,0,0,5,8,20,55,11,12,44,May,0.4999999999999999,-0.8660254037844387,4,17,1,1,3,0.6,1.0,46,43,3,19,82,-63,"May, 2008"
2007-2008,37,2008-05-03,Aston Villa,Wigan,0,2,A,0,3,2,2,1,1,3,1,6,14,59,37,8,22,May,0.4999999999999999,-0.8660254037844387,1,46,1,2,2,1.0,1.4,69,47,22,32,49,-17,"May, 2008"
2007-2008,37,2008-05-04,Arsenal,Everton,1,0,H,3,0,4,0,1,1,2,2,3,5,77,62,2,15,May,0.4999999999999999,-0.8660254037844387,0,18,2,1,2,1.4,0.8,72,31,41,52,31,21,"May, 2008"
2007-2008,37,2008-05-04,Liverpool,Man City,1,0,H,3,0,4,1,0,2,0,3,4,9,70,55,5,15,May,0.4999999999999999,-0.8660254037844387,25,27,3,2,0,0.6,0.0,64,28,36,44,44,0,"May, 2008"
2007-2008,37,2008-05-05,Newcastle,Chelsea,0,2,A,0,3,1,2,2,3,2,0,12,2,43,81,10,38,May,0.4999999999999999,-0.8660254037844387,30,14,1,1,3,0.4,1.2,44,60,-16,62,25,37,"May, 2008"
2007-2008,38,2008-05-11,West Ham,Aston Villa,2,2,D,1,1,1,2,2,2,2,1,10,6,48,59,4,11,May,0.4999999999999999,-0.8660254037844387,45,1,2,1,2,1.4,0.8,40,48,-8,69,49,20,"May, 2008"
2007-2008,38,2008-05-11,Wigan,Man United,0,2,A,0,3,1,3,1,3,1,1,14,2,40,84,12,44,May,0.4999999999999999,-0.8660254037844387,46,28,0,0,5,0.6,3.2,34,49,-15,78,22,56,"May, 2008"
2007-2008,38,2008-05-11,Sunderland,Arsenal,0,1,A,0,3,1,0,4,4,0,1,15,3,39,80,12,41,May,0.4999999999999999,-0.8660254037844387,40,0,0,0,5,0.8,3.2,36,58,-22,73,31,42,"May, 2008"
2007-2008,38,2008-05-11,Portsmouth,Fulham,0,1,A,0,3,0,1,4,4,0,1,8,19,57,33,11,24,May,0.4999999999999999,-0.8660254037844387,33,19,3,2,0,1.6,0.6,48,39,9,37,60,-23,"May, 2008"
2007-2008,38,2008-05-11,Tottenham,Liverpool,0,2,A,0,3,1,3,1,4,1,0,11,4,46,73,7,27,May,0.4999999999999999,-0.8660254037844387,42,25,0,2,3,0.4,1.4,66,59,7,65,28,37,"May, 2008"
2007-2008,38,2008-05-11,Everton,Newcastle,3,1,H,3,0,1,2,2,1,2,2,5,12,62,43,7,19,May,0.4999999999999999,-0.8660254037844387,18,30,2,1,2,1.4,1.2,52,32,20,44,62,-18,"May, 2008"
2007-2008,38,2008-05-11,Birmingham,Blackburn,4,1,H,3,0,1,2,2,2,1,2,19,7,32,58,12,26,May,0.4999999999999999,-0.8660254037844387,3,4,2,1,2,1.6,1.8,42,61,-19,49,44,5,"May, 2008"
2007-2008,38,2008-05-11,Middlesbrough,Man City,8,1,H,3,0,2,1,2,2,0,3,14,9,39,55,5,16,May,0.4999999999999999,-0.8660254037844387,29,27,1,1,3,0.4,1.2,35,52,-17,44,45,-1,"May, 2008"
2007-2008,38,2008-05-11,Derby,Reading,0,4,A,0,3,0,0,5,1,1,3,20,19,11,33,1,22,May,0.4999999999999999,-0.8660254037844387,17,35,0,0,1,0.0,1.0,20,85,-65,37,66,-29,"May, 2008"
2007-2008,38,2008-05-11,Chelsea,Bolton,1,1,D,1,1,3,2,0,3,2,0,2,16,84,36,14,48,May,0.4999999999999999,-0.8660254037844387,14,6,4,1,0,2.2,0.6,64,25,39,35,53,-18,"May, 2008"
2008-2009,1,2008-08-16,Sunderland,Liverpool,0,1,A,0,3,0,1,4,5,0,0,13,8,0,0,5,0,August,-0.8660254037844384,-0.5000000000000004,40,25,1,0,4,0.4,1.8,0,0,0,0,0,0,"August, 2008"
2008-2009,1,2008-08-16,Middlesbrough,Tottenham,2,1,H,3,0,0,1,4,2,1,2,10,14,0,0,4,0,August,-0.8660254037844384,-0.5000000000000004,29,42,0,3,2,1.6,2.0,0,0,0,0,0,0,"August, 2008"
2008-2009,1,2008-08-16,Hull,Fulham,2,1,H,3,0,0,1,4,3,0,2,7,6,0,0,1,0,August,-0.8660254037844384,-0.5000000000000004,21,19,0,0,0,0.0,0.0,0,0,0,0,0,0,"August, 2008"
2008-2009,1,2008-08-16,West Ham,Wigan,2,1,H,3,0,2,0,3,1,1,3,13,14,0,0,1,0,August,-0.8660254037844384,-0.5000000000000004,45,46,2,1,2,1.2,1.0,0,0,0,0,0,0,"August, 2008"
2008-2009,1,2008-08-16,Bolton,Stoke,3,1,H,3,0,0,4,1,2,0,3,4,15,0,0,11,0,August,-0.8660254037844384,-0.5000000000000004,6,39,0,0,0,0.0,0.0,0,0,0,0,0,0,"August, 2008"
2008-2009,1,2008-08-16,Arsenal,West Brom,1,0,H,3,0,3,1,1,2,1,2,1,18,0,0,17,0,August,-0.8660254037844384,-0.5000000000000004,0,44,3,1,1,1.8,1.0,0,0,0,0,0,0,"August, 2008"
2008-2009,1,2008-08-16,Everton,Blackburn,2,3,A,0,3,3,1,1,2,1,2,6,4,0,0,2,0,August,-0.8660254037844384,-0.5000000000000004,18,4,2,3,0,0.8,0.4,0,0,0,0,0,0,"August, 2008"
2008-2009,1,2008-08-17,Chelsea,Portsmouth,4,0,H,3,0,5,0,0,1,1,3,9,12,0,0,3,0,August,-0.8660254037844384,-0.5000000000000004,14,33,4,1,0,1.6,0.4,0,0,0,0,0,0,"August, 2008"
2008-2009,1,2008-08-17,Man United,Newcastle,1,1,D,1,1,4,1,0,1,1,3,10,11,0,0,1,0,August,-0.8660254037844384,-0.5000000000000004,28,30,4,1,0,3.4,0.6,0,0,0,0,0,0,"August, 2008"
2008-2009,1,2008-08-17,Aston Villa,Man City,4,2,H,3,0,2,2,1,3,0,2,8,10,0,0,2,0,August,-0.8660254037844384,-0.5000000000000004,1,27,1,1,3,0.8,1.2,0,0,0,0,0,0,"August, 2008"
2008-2009,2,2008-08-23,West Brom,Everton,1,2,A,0,3,2,1,2,3,1,1,17,15,0,0,2,0,August,-0.8660254037844384,-0.5000000000000004,44,18,2,1,2,1.8,1.2,0,1,-1,2,3,-1,"August, 2008"
2008-2009,2,2008-08-23,Blackburn,Hull,1,1,D,1,1,2,1,2,0,1,4,4,5,3,3,1,0,August,-0.8660254037844384,-0.5000000000000004,4,21,0,0,0,0.0,0.0,3,2,1,2,1,1,"August, 2008"
2008-2009,2,2008-08-23,Fulham,Arsenal,1,0,H,3,0,3,0,2,3,1,1,13,8,0,3,5,3,August,-0.8660254037844384,-0.5000000000000004,19,0,1,0,4,0.8,2.6,1,2,-1,1,0,1,"August, 2008"
2008-2009,2,2008-08-23,Liverpool,Middlesbrough,2,1,H,3,0,5,0,0,0,1,4,8,6,3,3,2,0,August,-0.8660254037844384,-0.5000000000000004,25,29,3,2,0,1.6,0.6,1,0,1,2,1,1,"August, 2008"
2008-2009,2,2008-08-23,Newcastle,Bolton,1,0,H,3,0,1,1,3,0,4,1,12,6,1,3,6,2,August,-0.8660254037844384,-0.5000000000000004,30,6,2,1,2,1.6,1.2,1,1,0,3,1,2,"August, 2008"
2008-2009,2,2008-08-23,Stoke,Aston Villa,3,2,H,3,0,2,0,3,2,2,1,19,6,0,3,13,3,August,-0.8660254037844384,-0.5000000000000004,39,1,0,0,0,0.0,0.0,1,3,-2,4,2,2,"August, 2008"
2008-2009,2,2008-08-23,Tottenham,Sunderland,1,2,A,0,3,2,1,2,0,1,4,15,17,0,0,2,0,August,-0.8660254037844384,-0.5000000000000004,42,40,3,1,1,2.0,1.0,1,2,-1,0,1,-1,"August, 2008"
2008-2009,2,2008-08-24,Wigan,Chelsea,0,1,A,0,3,1,1,3,5,0,0,17,5,0,3,12,3,August,-0.8660254037844384,-0.5000000000000004,46,14,0,1,4,0.6,2.2,1,2,-1,4,0,4,"August, 2008"
2008-2009,2,2008-08-24,Man City,West Ham,3,0,H,3,0,3,0,2,2,0,3,17,8,0,3,9,3,August,-0.8660254037844384,-0.5000000000000004,27,45,3,1,1,1.2,0.4,2,4,-2,2,1,1,"August, 2008"
2008-2009,2,2008-08-25,Portsmouth,Man United,0,1,A,0,3,1,1,3,4,1,0,20,16,0,1,4,1,August,-0.8660254037844384,-0.5000000000000004,33,28,1,1,3,0.8,2.0,0,4,-4,1,1,0,"August, 2008"
2008-2009,3,2008-08-30,Arsenal,Newcastle,3,0,H,3,0,3,1,1,1,1,3,14,6,3,4,8,1,August,-0.8660254037844384,-0.5000000000000004,0,30,1,3,1,1.0,0.6,1,1,0,2,1,1,"August, 2008"
2008-2009,3,2008-08-30,Bolton,West Brom,0,0,D,1,1,0,4,1,2,1,2,10,18,3,0,8,3,August,-0.8660254037844384,-0.5000000000000004,6,44,1,3,1,1.0,0.8,3,2,1,1,3,-2,"August, 2008"
2008-2009,3,2008-08-30,Everton,Portsmouth,0,3,A,0,3,3,1,1,1,1,3,11,20,3,0,9,3,August,-0.8660254037844384,-0.5000000000000004,18,33,3,1,1,1.4,0.6,4,4,0,0,5,-5,"August, 2008"
2008-2009,3,2008-08-30,Hull,Wigan,0,5,A,0,3,0,1,4,1,1,3,6,20,4,0,14,4,August,-0.8660254037844384,-0.5000000000000004,21,46,0,0,0,0.0,0.0,3,2,1,1,3,-2,"August, 2008"
2008-2009,3,2008-08-30,Middlesbrough,Stoke,2,1,H,3,0,0,1,4,2,0,3,12,15,3,3,3,0,August,-0.8660254037844384,-0.5000000000000004,29,39,0,0,0,0.0,0.0,3,3,0,4,5,-1,"August, 2008"
2008-2009,3,2008-08-30,West Ham,Blackburn,4,1,H,3,0,2,0,3,2,1,2,17,5,3,4,12,1,August,-0.8660254037844384,-0.5000000000000004,45,4,4,0,1,1.8,1.2,2,4,-2,4,3,1,"August, 2008"
2008-2009,3,2008-08-31,Aston Villa,Liverpool,0,0,D,1,1,2,2,1,5,0,0,12,3,3,6,9,3,August,-0.8660254037844384,-0.5000000000000004,1,25,0,2,3,1.0,2.0,6,5,1,3,1,2,"August, 2008"
2008-2009,3,2008-08-31,Chelsea,Tottenham,1,1,D,1,1,5,0,0,2,1,2,2,20,6,0,18,6,August,-0.8660254037844384,-0.5000000000000004,14,42,3,1,1,2.0,1.4,5,0,5,2,4,-2,"August, 2008"
2008-2009,3,2008-08-31,Sunderland,Man City,0,3,A,0,3,0,1,4,3,0,2,15,13,3,3,2,0,August,-0.8660254037844384,-0.5000000000000004,40,27,0,0,5,0.6,2.0,2,2,0,5,4,1,"August, 2008"
2008-2009,4,2008-09-13,Wigan,Sunderland,1,1,D,1,1,1,1,3,0,1,4,16,19,3,3,3,0,September,-1.0,-1.8369701987210287e-16,46,40,3,0,1,1.25,0.5,6,3,3,2,5,-3,"September, 2008"
2008-2009,4,2008-09-13,West Brom,West Ham,3,2,H,3,0,2,1,2,2,0,3,20,6,1,6,14,5,September,-1.0,-1.8369701987210287e-16,44,45,1,0,3,0.5,1.0,1,3,-2,6,5,1,"September, 2008"
2008-2009,4,2008-09-13,Portsmouth,Middlesbrough,2,1,H,3,0,1,1,3,0,1,4,16,7,3,6,9,3,September,-1.0,-1.8369701987210287e-16,33,29,2,1,2,1.0,0.6,3,5,-2,5,4,1,"September, 2008"
2008-2009,4,2008-09-13,Newcastle,Hull,1,2,A,0,3,1,1,3,0,1,4,11,12,4,4,1,0,September,-1.0,-1.8369701987210287e-16,30,21,0,0,0,0.0,0.0,2,4,-2,3,7,-4,"September, 2008"
2008-2009,4,2008-09-13,Blackburn,Arsenal,0,4,A,0,3,2,1,2,3,1,1,10,4,4,6,6,2,September,-1.0,-1.8369701987210287e-16,4,0,1,1,3,0.8,2.2,5,7,-2,4,1,3,"September, 2008"
2008-2009,4,2008-09-13,Liverpool,Man United,2,1,H,3,0,5,0,0,4,1,0,3,9,7,4,6,3,September,-1.0,-1.8369701987210287e-16,25,28,0,0,5,0.0,1.6,3,1,2,2,1,1,"September, 2008"
2008-2009,4,2008-09-13,Fulham,Bolton,2,1,H,3,0,3,0,2,0,4,1,14,8,3,4,6,1,September,-1.0,-1.8369701987210287e-16,19,6,1,2,2,1.0,1.2,2,2,0,3,2,1,"September, 2008"
2008-2009,4,2008-09-13,Man City,Chelsea,1,3,A,0,3,3,0,2,5,0,0,4,3,6,7,1,1,September,-1.0,-1.8369701987210287e-16,27,14,0,0,5,0.0,2.8,8,4,4,6,1,5,"September, 2008"
2008-2009,4,2008-09-14,Stoke,Everton,2,3,A,0,3,2,0,3,3,1,1,18,19,3,3,1,0,September,-1.0,-1.8369701987210287e-16,39,18,0,0,0,0.0,0.0,5,7,-2,4,7,-3,"September, 2008"
2008-2009,4,2008-09-15,Tottenham,Aston Villa,1,2,A,0,3,2,1,2,2,2,1,20,12,1,4,8,3,September,-1.0,-1.8369701987210287e-16,42,1,1,3,1,1.6,1.6,3,5,-2,6,5,1,"September, 2008"
2008-2009,5,2008-09-20,Sunderland,Middlesbrough,2,0,H,3,0,0,1,4,0,1,4,19,9,4,6,10,2,September,-1.0,-1.8369701987210287e-16,40,29,2,1,2,1.6,2.0,3,6,-3,6,6,0,"September, 2008"
2008-2009,5,2008-09-20,Liverpool,Stoke,0,0,D,1,1,5,0,0,2,0,3,3,19,10,3,16,7,September,-1.0,-1.8369701987210287e-16,25,39,0,0,0,0.0,0.0,5,2,3,7,10,-3,"September, 2008"
2008-2009,5,2008-09-20,West Ham,Newcastle,3,1,H,3,0,2,0,3,1,1,3,9,19,6,4,10,2,September,-1.0,-1.8369701987210287e-16,45,30,0,2,3,1.4,2.6,8,8,0,3,6,-3,"September, 2008"
2008-2009,5,2008-09-20,Blackburn,Fulham,1,0,H,3,0,2,1,2,3,0,2,18,7,4,6,11,2,September,-1.0,-1.8369701987210287e-16,4,19,1,3,1,1.4,1.2,5,11,-6,4,3,1,"September, 2008"
2008-2009,5,2008-09-20,Bolton,Arsenal,1,3,A,0,3,0,4,1,3,1,1,14,3,4,9,11,5,September,-1.0,-1.8369701987210287e-16,6,0,1,1,3,1.4,1.8,4,4,0,8,1,7,"September, 2008"
2008-2009,5,2008-09-21,Chelsea,Man United,1,1,D,1,1,5,0,0,4,1,0,3,15,10,4,12,6,September,-1.0,-1.8369701987210287e-16,14,28,2,2,1,1.2,0.8,9,2,7,3,3,0,"September, 2008"
2008-2009,5,2008-09-21,Hull,Everton,2,2,D,1,1,0,1,4,3,1,1,7,12,7,6,5,1,September,-1.0,-1.8369701987210287e-16,21,18,0,0,0,0.0,0.0,5,8,-3,7,9,-2,"September, 2008"
2008-2009,5,2008-09-21,Man City,Portsmouth,6,0,H,3,0,3,0,2,1,1,3,10,12,6,6,2,0,September,-1.0,-1.8369701987210287e-16,27,33,1,2,2,1.0,1.0,9,7,2,5,6,-1,"September, 2008"
2008-2009,5,2008-09-21,Tottenham,Wigan,0,0,D,1,1,2,1,2,1,1,3,20,15,1,4,5,3,September,-1.0,-1.8369701987210287e-16,42,46,2,3,0,2.6,1.4,4,7,-3,7,4,3,"September, 2008"
2008-2009,5,2008-09-21,West Brom,Aston Villa,1,2,A,0,3,2,1,2,2,2,1,16,7,4,7,9,3,September,-1.0,-1.8369701987210287e-16,44,1,0,3,2,0.8,1.2,4,5,-1,8,6,2,"September, 2008"
2008-2009,6,2008-09-27,Stoke,Chelsea,0,2,A,0,3,2,0,3,5,0,0,17,5,4,11,12,7,September,-1.0,-1.8369701987210287e-16,39,14,0,0,0,0.0,0.0,7,10,-3,10,3,7,"September, 2008"
2008-2009,6,2008-09-27,Newcastle,Blackburn,1,2,A,0,3,1,1,3,2,1,2,19,12,4,7,7,3,September,-1.0,-1.8369701987210287e-16,30,4,1,0,4,0.8,1.6,4,9,-5,6,11,-5,"September, 2008"
2008-2009,6,2008-09-27,Middlesbrough,West Brom,0,1,A,0,3,0,1,4,2,1,2,13,16,6,4,3,2,September,-1.0,-1.8369701987210287e-16,29,44,4,1,0,2.6,0.6,6,8,-2,5,7,-2,"September, 2008"
2008-2009,6,2008-09-27,Man United,Bolton,2,0,H,3,0,4,1,0,0,4,1,15,16,5,4,1,1,September,-1.0,-1.8369701987210287e-16,28,6,4,0,1,2.4,0.6,4,4,0,5,7,-2,"September, 2008"
2008-2009,6,2008-09-27,Everton,Liverpool,0,2,A,0,3,3,1,1,5,0,0,8,4,7,11,4,4,September,-1.0,-1.8369701987210287e-16,18,25,1,1,3,1.0,1.2,9,11,-2,5,2,3,"September, 2008"
2008-2009,6,2008-09-27,Aston Villa,Sunderland,2,1,H,3,0,2,2,1,0,1,4,5,8,10,7,3,3,September,-1.0,-1.8369701987210287e-16,1,40,3,1,1,1.4,0.8,10,7,3,5,6,-1,"September, 2008"
2008-2009,6,2008-09-27,Arsenal,Hull,1,2,A,0,3,3,1,1,0,1,4,1,7,12,8,6,4,September,-1.0,-1.8369701987210287e-16,0,21,0,0,0,0.0,0.0,11,2,9,7,10,-3,"September, 2008"
2008-2009,6,2008-09-27,Fulham,West Ham,1,2,A,0,3,3,0,2,2,0,3,11,7,6,9,4,3,September,-1.0,-1.8369701987210287e-16,19,45,0,2,3,1.0,1.6,4,4,0,11,9,2,"September, 2008"
2008-2009,6,2008-09-28,Portsmouth,Tottenham,2,0,H,3,0,1,1,3,2,1,2,15,20,6,2,5,4,September,-1.0,-1.8369701987210287e-16,33,42,0,1,4,0.6,1.8,5,12,-7,4,7,-3,"September, 2008"
2008-2009,6,2008-09-28,Wigan,Man City,2,1,H,3,0,1,1,3,3,0,2,16,8,5,9,8,4,September,-1.0,-1.8369701987210287e-16,46,27,3,2,0,1.4,0.2,7,4,3,15,7,8,"September, 2008"
2008-2009,7,2008-10-04,Blackburn,Man United,0,2,A,0,3,2,1,2,4,1,0,7,11,10,8,4,2,October,-0.8660254037844386,0.5,4,28,1,1,3,1.2,2.2,8,12,-4,6,4,2,"October, 2008"
2008-2009,7,2008-10-04,Sunderland,Arsenal,1,1,D,1,1,0,1,4,3,1,1,13,4,7,12,9,5,October,-0.8660254037844386,0.5,40,0,0,0,5,0.6,2.8,6,8,-2,12,4,8,"October, 2008"
2008-2009,7,2008-10-04,West Brom,Fulham,1,0,H,3,0,2,1,2,3,0,2,13,15,7,6,2,1,October,-0.8660254037844386,0.5,44,19,0,2,3,0.4,2.2,6,7,-1,5,6,-1,"October, 2008"
2008-2009,7,2008-10-04,Wigan,Middlesbrough,0,1,A,0,3,1,1,3,0,1,4,12,16,8,6,4,2,October,-0.8660254037844386,0.5,46,29,2,1,2,1.0,1.0,9,5,4,6,9,-3,"October, 2008"
2008-2009,7,2008-10-05,Tottenham,Hull,0,1,A,0,3,2,1,2,0,1,4,20,8,2,11,12,9,October,-0.8660254037844386,0.5,42,21,0,0,0,0.0,0.0,4,9,-5,9,11,-2,"October, 2008"
2008-2009,7,2008-10-05,West Ham,Bolton,1,3,A,0,3,2,0,3,0,4,1,6,18,12,4,12,8,October,-0.8660254037844386,0.5,45,6,1,1,3,1.0,2.2,13,10,3,5,9,-4,"October, 2008"
2008-2009,7,2008-10-05,Portsmouth,Stoke,2,1,H,3,0,1,1,3,2,0,3,12,19,9,4,7,5,October,-0.8660254037844386,0.5,33,39,0,0,0,0.0,0.0,7,12,-5,7,12,-5,"October, 2008"
2008-2009,7,2008-10-05,Chelsea,Aston Villa,2,0,H,3,0,5,0,0,2,2,1,1,4,14,13,3,1,October,-0.8660254037844386,0.5,14,1,0,4,1,1.2,1.6,12,3,9,12,8,4,"October, 2008"
2008-2009,7,2008-10-05,Everton,Newcastle,2,2,D,1,1,3,1,1,1,1,3,15,19,7,4,4,3,October,-0.8660254037844386,0.5,18,30,2,1,2,1.8,1.4,9,13,-4,5,11,-6,"October, 2008"
2008-2009,7,2008-10-05,Man City,Liverpool,2,3,A,0,3,3,0,2,5,0,0,10,2,9,14,8,5,October,-0.8660254037844386,0.5,27,25,0,2,3,0.0,0.6,16,9,7,7,2,5,"October, 2008"
2008-2009,8,2008-10-18,Man United,West Brom,4,0,H,3,0,4,1,0,2,1,2,8,10,11,10,2,1,October,-0.8660254037844386,0.5,28,44,4,1,0,2.4,0.6,8,4,4,7,7,0,"October, 2008"
2008-2009,8,2008-10-18,Liverpool,Wigan,3,2,H,3,0,5,0,0,1,1,3,2,14,17,8,12,9,October,-0.8660254037844386,0.5,25,46,4,1,0,1.8,0.2,10,4,6,9,6,3,"October, 2008"
2008-2009,8,2008-10-18,Fulham,Sunderland,0,0,D,1,1,3,0,2,0,1,4,17,15,6,8,2,2,October,-0.8660254037844386,0.5,19,40,2,1,2,1.2,1.4,5,7,-2,7,9,-2,"October, 2008"
2008-2009,8,2008-10-18,Middlesbrough,Chelsea,0,5,A,0,3,0,1,4,5,0,0,12,2,9,17,10,8,October,-0.8660254037844386,0.5,29,14,2,0,3,1.0,1.4,7,9,-2,14,3,11,"October, 2008"
2008-2009,8,2008-10-18,Aston Villa,Portsmouth,0,0,D,1,1,2,2,1,1,1,3,5,7,13,12,2,1,October,-0.8660254037844386,0.5,1,33,1,2,2,0.8,1.4,12,10,2,9,13,-4,"October, 2008"
2008-2009,8,2008-10-18,Arsenal,Everton,3,1,H,3,0,3,1,1,3,1,1,4,15,13,8,11,5,October,-0.8660254037844386,0.5,0,18,2,1,2,1.2,0.8,13,5,8,11,15,-4,"October, 2008"
2008-2009,8,2008-10-18,Bolton,Blackburn,0,0,D,1,1,0,4,1,2,1,2,16,10,7,10,6,3,October,-0.8660254037844386,0.5,6,4,1,1,3,0.8,1.6,8,10,-2,8,14,-6,"October, 2008"
2008-2009,8,2008-10-19,Hull,West Ham,1,0,H,3,0,0,1,4,2,0,3,6,8,14,12,2,2,October,-0.8660254037844386,0.5,21,45,0,0,0,0.0,0.0,10,11,-1,14,13,1,"October, 2008"
2008-2009,8,2008-10-19,Stoke,Tottenham,2,1,H,3,0,2,0,3,2,1,2,19,20,4,2,1,2,October,-0.8660254037844386,0.5,39,42,0,0,0,0.0,0.0,8,14,-6,4,10,-6,"October, 2008"
2008-2009,8,2008-10-20,Newcastle,Man City,2,2,D,1,1,1,1,3,3,0,2,19,11,5,9,8,4,October,-0.8660254037844386,0.5,30,27,0,1,4,0.2,1.8,7,13,-6,18,12,6,"October, 2008"
2008-2009,9,2008-10-25,Blackburn,Middlesbrough,1,1,D,1,1,2,1,2,0,1,4,9,13,11,9,4,2,October,-0.8660254037844386,0.5,4,29,4,1,0,1.8,1.0,8,14,-6,7,14,-7,"October, 2008"
2008-2009,9,2008-10-25,Everton,Man United,1,1,D,1,1,3,1,1,4,1,0,16,5,8,14,11,6,October,-0.8660254037844386,0.5,18,28,0,1,4,0.8,2.2,12,18,-6,12,4,8,"October, 2008"
2008-2009,9,2008-10-25,Sunderland,Newcastle,2,1,H,3,0,0,1,4,1,1,3,13,19,9,6,6,3,October,-0.8660254037844386,0.5,40,30,0,1,4,0.8,2.2,7,9,-2,9,15,-6,"October, 2008"
2008-2009,9,2008-10-25,West Brom,Hull,0,3,A,0,3,2,1,2,0,1,4,12,3,10,17,9,7,October,-0.8660254037844386,0.5,44,21,0,0,0,0.0,0.0,7,11,-4,11,11,0,"October, 2008"
2008-2009,9,2008-10-26,Wigan,Aston Villa,0,4,A,0,3,1,1,3,2,2,1,15,6,8,14,9,6,October,-0.8660254037844386,0.5,46,1,2,2,1,1.4,1.0,11,9,2,12,10,2,"October, 2008"
2008-2009,9,2008-10-26,West Ham,Arsenal,0,2,A,0,3,2,0,3,3,1,1,9,4,12,16,5,4,October,-0.8660254037844386,0.5,45,0,3,0,2,1.0,1.0,14,14,0,16,6,10,"October, 2008"
2008-2009,9,2008-10-26,Tottenham,Bolton,2,0,H,3,0,2,1,2,0,4,1,20,16,2,8,4,6,October,-0.8660254037844386,0.5,42,6,2,2,1,1.4,1.0,5,12,-7,8,10,-2,"October, 2008"
2008-2009,9,2008-10-26,Portsmouth,Fulham,1,1,D,1,1,1,1,3,3,0,2,8,17,13,7,9,6,October,-0.8660254037844386,0.5,33,19,2,2,1,1.4,0.8,9,13,-4,5,7,-2,"October, 2008"
2008-2009,9,2008-10-26,Man City,Stoke,3,0,H,3,0,3,0,2,2,0,3,11,18,10,7,7,3,October,-0.8660254037844386,0.5,27,39,0,0,0,0.0,0.0,20,14,6,10,15,-5,"October, 2008"
2008-2009,9,2008-10-26,Chelsea,Liverpool,0,1,A,0,3,5,0,0,5,0,0,1,2,20,20,1,0,October,-0.8660254037844386,0.5,14,25,2,2,1,0.8,0.6,19,3,16,13,6,7,"October, 2008"
2008-2009,10,2008-10-28,Newcastle,West Brom,2,1,H,3,0,1,1,3,2,1,2,19,13,6,10,6,4,October,-0.8660254037844386,0.5,30,44,3,2,0,2.2,0.6,10,17,-7,7,14,-7,"October, 2008"
2008-2009,10,2008-10-29,Stoke,Sunderland,1,0,H,3,0,2,0,3,0,1,4,19,10,7,12,9,5,October,-0.8660254037844386,0.5,39,40,0,0,0,0.0,0.0,10,18,-8,9,10,-1,"October, 2008"
2008-2009,10,2008-10-29,Middlesbrough,Man City,2,0,H,3,0,0,1,4,3,0,2,14,8,10,13,6,3,October,-0.8660254037844386,0.5,29,27,2,0,3,2.0,1.4,8,15,-7,23,14,9,"October, 2008"
2008-2009,10,2008-10-29,Liverpool,Portsmouth,1,0,H,3,0,5,0,0,1,1,3,2,7,23,14,5,9,October,-0.8660254037844386,0.5,25,33,2,2,1,1.6,0.8,14,6,8,10,14,-4,"October, 2008"
2008-2009,10,2008-10-29,Hull,Chelsea,0,3,A,0,3,0,1,4,5,0,0,5,2,20,20,3,0,October,-0.8660254037844386,0.5,21,14,0,0,0,0.0,0.0,14,11,3,19,4,15,"October, 2008"
2008-2009,10,2008-10-29,Man United,West Ham,2,0,H,3,0,4,1,0,2,0,3,6,10,15,12,4,3,October,-0.8660254037844386,0.5,28,45,2,0,3,1.2,1.0,13,5,8,14,16,-2,"October, 2008"
2008-2009,10,2008-10-29,Bolton,Everton,0,1,A,0,3,0,4,1,3,1,1,18,14,8,9,4,1,October,-0.8660254037844386,0.5,6,18,1,1,3,1.2,1.2,8,12,-4,13,19,-6,"October, 2008"
2008-2009,10,2008-10-29,Aston Villa,Blackburn,3,2,H,3,0,2,2,1,2,1,2,5,11,17,12,6,5,October,-0.8660254037844386,0.5,1,4,3,1,1,1.8,0.8,16,10,6,9,15,-6,"October, 2008"
2008-2009,10,2008-10-29,Arsenal,Tottenham,4,4,D,1,1,3,1,1,2,1,2,4,20,19,5,16,14,October,-0.8660254037844386,0.5,0,42,3,2,0,2.2,1.0,18,6,12,7,12,-5,"October, 2008"
2008-2009,10,2008-10-29,Fulham,Wigan,2,0,H,3,0,3,0,2,1,1,3,17,16,8,8,1,0,October,-0.8660254037844386,0.5,19,46,1,3,1,0.6,0.6,6,8,-2,11,13,-2,"October, 2008"
2008-2009,11,2008-11-01,West Brom,Blackburn,2,2,D,1,1,2,1,2,2,1,2,17,13,10,12,4,2,November,-0.5000000000000004,0.8660254037844384,44,4,1,3,1,1.0,1.0,8,16,-8,11,18,-7,"November, 2008"
2008-2009,11,2008-11-01,Chelsea,Sunderland,5,0,H,3,0,5,0,0,0,1,4,2,10,23,12,8,11,November,-0.5000000000000004,0.8660254037844384,14,40,5,0,0,1.8,0.4,22,4,18,9,11,-2,"November, 2008"
2008-2009,11,2008-11-01,Everton,Fulham,1,0,H,3,0,3,1,1,3,0,2,11,14,12,11,3,1,November,-0.5000000000000004,0.8660254037844384,18,19,3,0,2,2.0,0.8,14,19,-5,8,8,0,"November, 2008"
2008-2009,11,2008-11-01,Man United,Hull,4,3,H,3,0,4,1,0,0,1,4,6,5,18,20,1,2,November,-0.5000000000000004,0.8660254037844384,28,21,0,0,0,0.0,0.0,15,5,10,14,14,0,"November, 2008"
2008-2009,11,2008-11-01,Middlesbrough,West Ham,1,1,D,1,1,0,1,4,2,0,3,10,11,13,12,1,1,November,-0.5000000000000004,0.8660254037844384,29,45,2,0,3,0.8,1.4,10,15,-5,14,18,-4,"November, 2008"
2008-2009,11,2008-11-01,Portsmouth,Wigan,1,2,A,0,3,1,1,3,1,1,3,9,18,14,8,9,6,November,-0.5000000000000004,0.8660254037844384,33,46,4,0,1,1.4,0.4,10,15,-5,11,15,-4,"November, 2008"
2008-2009,11,2008-11-01,Stoke,Arsenal,2,1,H,3,0,2,0,3,3,1,1,16,4,10,20,12,10,November,-0.5000000000000004,0.8660254037844384,39,0,0,0,0,0.0,0.0,11,18,-7,22,10,12,"November, 2008"
2008-2009,11,2008-11-01,Tottenham,Liverpool,2,1,H,3,0,2,1,2,5,0,0,20,2,6,26,18,20,November,-0.5000000000000004,0.8660254037844384,42,25,0,1,4,0.4,1.8,11,16,-5,15,6,9,"November, 2008"
2008-2009,11,2008-11-02,Bolton,Man City,2,0,H,3,0,0,4,1,3,0,2,20,10,8,13,10,5,November,-0.5000000000000004,0.8660254037844384,6,27,2,2,1,1.2,0.8,8,13,-5,23,16,7,"November, 2008"
2008-2009,11,2008-11-03,Newcastle,Aston Villa,2,0,H,3,0,1,1,3,2,2,1,20,5,9,20,15,11,November,-0.5000000000000004,0.8660254037844384,30,1,2,1,2,1.2,1.6,12,18,-6,19,12,7,"November, 2008"
2008-2009,12,2008-11-08,Arsenal,Man United,2,1,H,3,0,3,1,1,4,1,0,4,3,20,21,1,1,November,-0.5000000000000004,0.8660254037844384,0,28,2,1,2,1.2,1.4,23,12,11,19,8,11,"November, 2008"
2008-2009,12,2008-11-08,Hull,Bolton,0,1,A,0,3,0,1,4,0,4,1,6,18,20,11,12,9,November,-0.5000000000000004,0.8660254037844384,21,6,0,0,0,0.0,0.0,17,18,-1,10,13,-3,"November, 2008"
2008-2009,12,2008-11-08,Liverpool,West Brom,3,0,H,3,0,5,0,0,2,1,2,2,19,26,11,17,15,November,-0.5000000000000004,0.8660254037844384,25,44,5,0,0,3.4,0.0,16,8,8,10,18,-8,"November, 2008"
2008-2009,12,2008-11-08,Sunderland,Portsmouth,1,2,A,0,3,0,1,4,1,1,3,16,10,12,14,6,2,November,-0.5000000000000004,0.8660254037844384,40,33,1,0,3,1.0,1.75,9,16,-7,11,17,-6,"November, 2008"
2008-2009,12,2008-11-08,West Ham,Everton,1,3,A,0,3,2,0,3,3,1,1,12,8,13,15,4,2,November,-0.5000000000000004,0.8660254037844384,45,18,1,2,2,0.8,1.4,15,19,-4,15,19,-4,"November, 2008"
2008-2009,12,2008-11-08,Wigan,Stoke,0,0,D,1,1,1,1,3,2,0,3,18,13,11,13,5,2,November,-0.5000000000000004,0.8660254037844384,46,39,0,0,0,0.0,0.0,13,16,-3,13,19,-6,"November, 2008"
2008-2009,12,2008-11-09,Fulham,Newcastle,2,1,H,3,0,3,0,2,1,1,3,18,16,11,12,2,1,November,-0.5000000000000004,0.8660254037844384,19,30,3,0,2,1.0,1.0,8,9,-1,14,18,-4,"November, 2008"
2008-2009,12,2008-11-09,Man City,Tottenham,1,2,A,0,3,3,0,2,2,1,2,13,20,13,9,7,4,November,-0.5000000000000004,0.8660254037844384,27,42,1,0,4,1.2,1.8,23,18,5,13,17,-4,"November, 2008"
2008-2009,12,2008-11-09,Aston Villa,Middlesbrough,1,2,A,0,3,2,2,1,0,1,4,5,10,20,14,5,6,November,-0.5000000000000004,0.8660254037844384,1,29,3,2,0,2.4,0.6,19,14,5,11,16,-5,"November, 2008"
2008-2009,12,2008-11-09,Blackburn,Chelsea,0,2,A,0,3,2,1,2,5,0,0,14,2,13,26,12,13,November,-0.5000000000000004,0.8660254037844384,4,14,1,1,3,0.2,1.2,13,20,-7,27,4,23,"November, 2008"
2008-2009,13,2008-11-15,Arsenal,Aston Villa,0,2,A,0,3,3,1,1,2,2,1,3,5,23,20,2,3,November,-0.5000000000000004,0.8660254037844384,0,1,3,2,0,2.0,0.6,25,13,12,20,16,4,"November, 2008"
2008-2009,13,2008-11-15,Blackburn,Sunderland,1,2,A,0,3,2,1,2,0,1,4,15,19,13,12,4,1,November,-0.5000000000000004,0.8660254037844384,4,40,4,1,0,1.2,0.2,13,22,-9,10,18,-8,"November, 2008"
2008-2009,13,2008-11-15,Bolton,Liverpool,0,2,A,0,3,0,4,1,5,0,0,12,2,14,29,10,15,November,-0.5000000000000004,0.8660254037844384,6,25,1,0,4,0.6,2.2,11,13,-2,19,8,11,"November, 2008"
2008-2009,13,2008-11-15,Fulham,Tottenham,2,1,H,3,0,3,0,2,2,1,2,11,17,14,12,6,2,November,-0.5000000000000004,0.8660254037844384,19,42,1,3,1,1.2,1.8,10,10,0,15,18,-3,"November, 2008"
2008-2009,13,2008-11-15,Man United,Stoke,5,0,H,3,0,4,1,0,2,0,3,5,13,21,14,8,7,November,-0.5000000000000004,0.8660254037844384,28,39,0,0,0,0.0,0.0,20,10,10,13,19,-6,"November, 2008"
2008-2009,13,2008-11-15,Newcastle,Wigan,2,2,D,1,1,1,1,3,1,1,3,19,17,12,12,2,0,November,-0.5000000000000004,0.8660254037844384,30,46,3,0,2,1.2,0.8,15,20,-5,13,16,-3,"November, 2008"
2008-2009,13,2008-11-15,West Brom,Chelsea,0,3,A,0,3,2,1,2,5,0,0,20,2,11,29,18,18,November,-0.5000000000000004,0.8660254037844384,44,14,0,0,5,0.4,2.6,10,21,-11,29,4,25,"November, 2008"
2008-2009,13,2008-11-15,West Ham,Portsmouth,0,0,D,1,1,2,0,3,1,1,3,17,10,13,17,7,4,November,-0.5000000000000004,0.8660254037844384,45,33,0,1,4,0.6,1.8,16,22,-6,13,18,-5,"November, 2008"
2008-2009,13,2008-11-16,Everton,Middlesbrough,1,1,D,1,1,3,1,1,0,1,4,7,10,18,17,3,1,November,-0.5000000000000004,0.8660254037844384,18,29,3,1,1,1.2,0.4,18,20,-2,13,17,-4,"November, 2008"
2008-2009,13,2008-11-16,Hull,Man City,2,2,D,1,1,0,1,4,3,0,2,6,15,20,13,9,7,November,-0.5000000000000004,0.8660254037844384,21,27,0,0,0,0.0,0.0,17,19,-2,24,20,4,"November, 2008"
2008-2009,14,2008-11-22,Portsmouth,Hull,2,2,D,1,1,1,1,3,0,1,4,9,6,18,21,3,3,November,-0.5000000000000004,0.8660254037844384,33,21,0,0,0,0.0,0.0,13,18,-5,19,21,-2,"November, 2008"
2008-2009,14,2008-11-22,Stoke,West Brom,1,0,H,3,0,2,0,3,2,1,2,16,20,14,11,4,3,November,-0.5000000000000004,0.8660254037844384,39,44,0,0,0,0.0,0.0,13,24,-11,10,24,-14,"November, 2008"
2008-2009,14,2008-11-22,Middlesbrough,Bolton,1,3,A,0,3,0,1,4,0,4,1,9,13,18,14,4,4,November,-0.5000000000000004,0.8660254037844384,29,6,1,3,1,1.2,0.6,14,18,-4,11,15,-4,"November, 2008"
2008-2009,14,2008-11-22,Aston Villa,Man United,0,0,D,1,1,2,2,1,4,1,0,5,3,23,24,2,1,November,-0.5000000000000004,0.8660254037844384,1,28,0,0,5,0.4,3.2,22,16,6,25,10,15,"November, 2008"
2008-2009,14,2008-11-22,Liverpool,Fulham,0,0,D,1,1,5,0,0,3,0,2,2,10,32,17,8,15,November,-0.5000000000000004,0.8660254037844384,25,19,4,0,1,2.6,0.4,21,8,13,12,11,1,"November, 2008"
2008-2009,14,2008-11-22,Man City,Arsenal,3,0,H,3,0,3,0,2,3,1,1,12,5,14,23,7,9,November,-0.5000000000000004,0.8660254037844384,27,0,1,0,4,0.8,2.0,26,22,4,25,15,10,"November, 2008"
2008-2009,14,2008-11-22,Chelsea,Newcastle,0,0,D,1,1,5,0,0,1,1,3,1,17,32,13,16,19,November,-0.5000000000000004,0.8660254037844384,14,30,3,1,1,1.0,0.4,32,4,28,17,22,-5,"November, 2008"
2008-2009,14,2008-11-23,Sunderland,West Ham,0,1,A,0,3,0,1,4,2,0,3,14,16,15,14,2,1,November,-0.5000000000000004,0.8660254037844384,40,45,1,1,3,0.8,1.8,12,19,-7,16,22,-6,"November, 2008"
2008-2009,14,2008-11-23,Tottenham,Blackburn,1,0,H,3,0,2,1,2,2,1,2,19,18,12,13,1,1,November,-0.5000000000000004,0.8660254037844384,42,4,1,3,1,1.4,1.4,16,20,-4,14,24,-10,"November, 2008"
2008-2009,14,2008-11-24,Wigan,Everton,1,0,H,3,0,1,1,3,3,1,1,18,7,13,19,11,6,November,-0.5000000000000004,0.8660254037844384,46,18,0,2,3,1.0,1.8,15,18,-3,19,21,-2,"November, 2008"
2008-2009,15,2008-11-29,Wigan,West Brom,2,1,H,3,0,1,1,3,2,1,2,15,20,16,11,5,5,November,-0.5000000000000004,0.8660254037844384,46,44,1,0,1,1.0,1.0,16,18,-2,10,25,-15,"November, 2008"
2008-2009,15,2008-11-29,Aston Villa,Fulham,0,0,D,1,1,2,2,1,3,0,2,4,9,24,18,5,6,November,-0.5000000000000004,0.8660254037844384,1,19,1,3,1,1.0,1.0,22,16,6,12,11,1,"November, 2008"
2008-2009,15,2008-11-29,Middlesbrough,Newcastle,0,0,D,1,1,0,1,4,1,1,3,10,18,18,14,8,4,November,-0.5000000000000004,0.8660254037844384,29,30,1,3,1,1.0,1.0,15,21,-6,17,22,-5,"November, 2008"
2008-2009,15,2008-11-29,Stoke,Hull,1,1,D,1,1,2,0,3,0,1,4,14,6,17,22,8,5,November,-0.5000000000000004,0.8660254037844384,39,21,0,0,0,0.0,0.0,14,24,-10,21,23,-2,"November, 2008"
2008-2009,15,2008-11-29,Sunderland,Bolton,1,4,A,0,3,0,1,4,0,4,1,18,13,15,17,5,2,November,-0.5000000000000004,0.8660254037844384,40,6,1,1,3,0.6,1.4,12,20,-8,14,16,-2,"November, 2008"
2008-2009,15,2008-11-30,Chelsea,Arsenal,1,2,A,0,3,5,0,0,3,1,1,1,5,33,23,4,10,November,-0.5000000000000004,0.8660254037844384,14,0,2,2,1,1.2,0.8,32,4,28,25,18,7,"November, 2008"
2008-2009,15,2008-11-30,Man City,Man United,0,1,A,0,3,3,0,2,4,1,0,14,4,17,25,10,8,November,-0.5000000000000004,0.8660254037844384,27,28,3,0,2,1.4,1.2,29,22,7,25,10,15,"November, 2008"
2008-2009,15,2008-11-30,Portsmouth,Blackburn,3,2,H,3,0,1,1,3,2,1,2,11,19,19,13,8,6,November,-0.5000000000000004,0.8660254037844384,33,4,2,1,2,1.2,1.2,15,20,-5,14,25,-11,"November, 2008"
2008-2009,15,2008-11-30,Tottenham,Everton,0,1,A,0,3,2,1,2,3,1,1,16,11,15,19,5,4,November,-0.5000000000000004,0.8660254037844384,42,18,2,1,2,0.8,1.2,17,20,-3,19,22,-3,"November, 2008"
2008-2009,15,2008-12-01,Liverpool,West Ham,0,0,D,1,1,5,0,0,2,0,3,2,15,33,17,13,16,December,-2.4492935982947064e-16,1.0,25,45,4,0,1,2.0,0.8,21,8,13,17,22,-5,"December, 2008"
2008-2009,16,2008-12-06,Man United,Sunderland,1,0,H,3,0,4,1,0,0,1,4,4,18,28,15,14,13,December,-2.4492935982947064e-16,1.0,28,40,4,1,0,2.0,0.4,26,10,16,13,24,-11,"December, 2008"
2008-2009,16,2008-12-06,Newcastle,Stoke,2,2,D,1,1,1,1,3,2,0,3,17,15,15,18,2,3,December,-2.4492935982947064e-16,1.0,30,39,0,0,0,0.0,0.0,17,22,-5,15,25,-10,"December, 2008"
2008-2009,16,2008-12-06,Fulham,Man City,1,1,D,1,1,3,0,2,3,0,2,10,15,19,17,5,2,December,-2.4492935982947064e-16,1.0,19,27,2,1,2,2.0,2.4,12,11,1,29,23,6,"December, 2008"
2008-2009,16,2008-12-06,Hull,Middlesbrough,2,1,H,3,0,0,1,4,0,1,4,6,12,23,19,6,4,December,-2.4492935982947064e-16,1.0,21,29,0,0,0,0.0,0.0,22,24,-2,15,21,-6,"December, 2008"
2008-2009,16,2008-12-06,Blackburn,Liverpool,1,3,A,0,3,2,1,2,5,0,0,19,1,13,34,18,21,December,-2.4492935982947064e-16,1.0,4,25,1,2,2,0.6,1.0,16,28,-12,21,8,13,"December, 2008"
2008-2009,16,2008-12-06,Arsenal,Wigan,1,0,H,3,0,3,1,1,1,1,3,4,11,26,19,7,7,December,-2.4492935982947064e-16,1.0,0,46,4,1,0,1.8,0.6,27,19,8,18,19,-1,"December, 2008"
2008-2009,16,2008-12-06,Bolton,Chelsea,0,2,A,0,3,0,4,1,5,0,0,9,2,20,33,7,13,December,-2.4492935982947064e-16,1.0,6,14,0,2,3,0.6,1.4,18,17,1,33,6,27,"December, 2008"
2008-2009,16,2008-12-07,Everton,Aston Villa,2,3,A,0,3,3,1,1,2,2,1,7,6,22,25,1,3,December,-2.4492935982947064e-16,1.0,18,1,1,2,2,1.4,1.4,20,22,-2,22,16,6,"December, 2008"
2008-2009,16,2008-12-07,West Brom,Portsmouth,1,1,D,1,1,2,1,2,1,1,3,20,8,11,22,12,11,December,-2.4492935982947064e-16,1.0,44,33,2,0,2,1.5,1.25,11,27,-16,18,22,-4,"December, 2008"
2008-2009,16,2008-12-08,West Ham,Tottenham,0,2,A,0,3,2,0,3,2,1,2,15,17,18,15,2,3,December,-2.4492935982947064e-16,1.0,45,42,1,1,3,1.2,2.2,17,22,-5,17,21,-4,"December, 2008"
2008-2009,17,2008-12-13,Stoke,Fulham,0,0,D,1,1,2,0,3,3,0,2,13,9,19,20,4,1,December,-2.4492935982947064e-16,1.0,39,19,0,0,0,0.0,0.0,17,27,-10,13,12,1,"December, 2008"
2008-2009,17,2008-12-13,Wigan,Blackburn,3,0,H,3,0,1,1,3,2,1,2,14,19,19,13,5,6,December,-2.4492935982947064e-16,1.0,46,4,1,1,3,1.6,2.4,18,20,-2,17,31,-14,"December, 2008"
2008-2009,17,2008-12-13,Tottenham,Man United,0,0,D,1,1,2,1,2,4,1,0,15,3,18,31,12,13,December,-2.4492935982947064e-16,1.0,42,28,0,1,4,0.4,1.8,19,21,-2,27,10,17,"December, 2008"
2008-2009,17,2008-12-13,Sunderland,West Brom,4,0,H,3,0,0,1,4,2,1,2,18,20,15,12,2,3,December,-2.4492935982947064e-16,1.0,40,44,1,2,1,1.25,1.25,13,25,-12,12,28,-16,"December, 2008"
2008-2009,17,2008-12-13,Man City,Everton,0,1,A,0,3,3,0,2,3,1,1,14,8,18,22,6,4,December,-2.4492935982947064e-16,1.0,27,18,1,1,3,0.6,1.2,30,24,6,22,25,-3,"December, 2008"
2008-2009,17,2008-12-13,Liverpool,Hull,2,2,D,1,1,5,0,0,0,1,4,1,6,37,26,5,11,December,-2.4492935982947064e-16,1.0,25,21,0,0,0,0.0,0.0,24,9,15,24,25,-1,"December, 2008"
2008-2009,17,2008-12-13,Aston Villa,Bolton,4,2,H,3,0,2,2,1,0,4,1,5,10,28,20,5,8,December,-2.4492935982947064e-16,1.0,1,6,1,3,1,1.6,1.0,25,18,7,18,19,-1,"December, 2008"
2008-2009,17,2008-12-13,Middlesbrough,Arsenal,1,1,D,1,1,0,1,4,3,1,1,12,5,19,29,7,10,December,-2.4492935982947064e-16,1.0,29,0,1,3,1,1.0,2.2,16,23,-7,28,19,9,"December, 2008"
2008-2009,17,2008-12-14,Chelsea,West Ham,1,1,D,1,1,5,0,0,2,0,3,2,16,36,18,14,18,December,-2.4492935982947064e-16,1.0,14,45,5,0,0,2.8,0.4,35,6,29,17,24,-7,"December, 2008"
2008-2009,17,2008-12-14,Portsmouth,Newcastle,0,3,A,0,3,1,1,3,1,1,3,8,18,23,16,10,7,December,-2.4492935982947064e-16,1.0,33,30,2,1,2,1.2,1.0,19,23,-4,19,24,-5,"December, 2008"
2008-2009,18,2008-12-20,Hull,Sunderland,1,4,A,0,3,0,1,4,0,1,4,6,18,27,18,12,9,December,-2.4492935982947064e-16,1.0,21,40,0,0,0,0.0,0.0,26,27,-1,17,25,-8,"December, 2008"
2008-2009,18,2008-12-20,Fulham,Middlesbrough,3,0,H,3,0,3,0,2,0,1,4,11,12,21,20,1,1,December,-2.4492935982947064e-16,1.0,19,29,2,0,3,1.0,1.4,13,12,1,17,24,-7,"December, 2008"
2008-2009,18,2008-12-20,West Ham,Aston Villa,0,1,A,0,3,2,0,3,2,2,1,17,4,19,31,13,12,December,-2.4492935982947064e-16,1.0,45,1,1,2,2,1.0,1.2,18,25,-7,29,20,9,"December, 2008"
2008-2009,18,2008-12-20,Blackburn,Stoke,3,0,H,3,0,2,1,2,2,0,3,19,13,13,20,6,7,December,-2.4492935982947064e-16,1.0,4,39,0,0,0,0.0,0.0,17,34,-17,17,27,-10,"December, 2008"
2008-2009,18,2008-12-20,Bolton,Portsmouth,2,1,H,3,0,0,4,1,1,1,3,11,8,20,23,3,3,December,-2.4492935982947064e-16,1.0,6,33,2,1,2,1.2,1.4,20,23,-3,19,26,-7,"December, 2008"
2008-2009,18,2008-12-21,West Brom,Man City,2,1,H,3,0,2,1,2,3,0,2,20,18,12,18,2,6,December,-2.4492935982947064e-16,1.0,44,27,3,2,0,1.4,0.4,12,32,-20,30,25,5,"December, 2008"
2008-2009,18,2008-12-21,Newcastle,Tottenham,2,1,H,3,0,1,1,3,2,1,2,15,16,19,19,1,0,December,-2.4492935982947064e-16,1.0,30,42,5,0,0,3.2,1.2,22,24,-2,19,21,-2,"December, 2008"
2008-2009,18,2008-12-21,Arsenal,Liverpool,1,1,D,1,1,3,1,1,5,0,0,5,1,30,38,4,8,December,-2.4492935982947064e-16,1.0,0,25,2,2,1,1.6,1.4,29,20,9,26,11,15,"December, 2008"
2008-2009,18,2008-12-22,Everton,Chelsea,0,0,D,1,1,3,1,1,5,0,0,7,2,25,37,5,12,December,-2.4492935982947064e-16,1.0,18,14,0,2,3,0.8,1.8,23,25,-2,36,7,29,"December, 2008"
2008-2009,19,2008-12-26,Wigan,Newcastle,2,1,H,3,0,1,1,3,1,1,3,11,12,22,22,1,0,December,-2.4492935982947064e-16,1.0,46,30,2,1,2,1.0,1.0,21,20,1,24,25,-1,"December, 2008"
2008-2009,19,2008-12-26,Tottenham,Fulham,0,0,D,1,1,2,1,2,3,0,2,18,8,19,24,10,5,December,-2.4492935982947064e-16,1.0,42,19,1,3,1,2.0,1.4,20,23,-3,16,12,4,"December, 2008"
2008-2009,19,2008-12-26,Stoke,Man United,0,1,A,0,3,2,0,3,4,1,0,17,4,20,32,13,12,December,-2.4492935982947064e-16,1.0,39,28,0,0,1,0.0,5.0,17,30,-13,27,10,17,"December, 2008"
2008-2009,19,2008-12-26,Portsmouth,West Ham,1,4,A,0,3,1,1,3,2,0,3,10,18,23,19,8,4,December,-2.4492935982947064e-16,1.0,33,45,3,2,0,1.0,0.2,20,28,-8,18,26,-8,"December, 2008"
2008-2009,19,2008-12-26,Sunderland,Blackburn,0,0,D,1,1,0,1,4,2,1,2,15,19,21,16,4,5,December,-2.4492935982947064e-16,1.0,40,4,1,0,4,0.6,1.4,21,26,-5,20,34,-14,"December, 2008"
2008-2009,19,2008-12-26,Man City,Hull,5,1,H,3,0,3,0,2,0,1,4,18,6,18,27,12,9,December,-2.4492935982947064e-16,1.0,27,21,0,1,0,2.0,2.0,31,27,4,27,31,-4,"December, 2008"
2008-2009,19,2008-12-26,Liverpool,Bolton,3,0,H,3,0,5,0,0,0,4,1,2,9,39,23,7,16,December,-2.4492935982947064e-16,1.0,25,6,4,0,1,2.4,0.6,27,12,15,22,24,-2,"December, 2008"
2008-2009,19,2008-12-26,Chelsea,West Brom,2,0,H,3,0,5,0,0,2,1,2,2,20,38,15,18,23,December,-2.4492935982947064e-16,1.0,14,44,5,0,0,2.8,0.4,36,7,29,14,33,-19,"December, 2008"
2008-2009,19,2008-12-26,Aston Villa,Arsenal,2,2,D,1,1,2,2,1,3,1,1,3,5,34,31,2,3,December,-2.4492935982947064e-16,1.0,1,0,1,2,2,1.0,1.0,30,20,10,30,21,9,"December, 2008"
2008-2009,19,2008-12-26,Middlesbrough,Everton,0,1,A,0,3,0,1,4,3,1,1,15,7,20,26,8,6,December,-2.4492935982947064e-16,1.0,29,18,1,2,2,0.6,1.2,17,27,-10,23,25,-2,"December, 2008"
2008-2009,20,2008-12-28,West Brom,Tottenham,2,0,H,3,0,2,1,2,2,1,2,20,16,15,20,4,5,December,-2.4492935982947064e-16,1.0,44,42,1,2,2,1.4,1.4,14,35,-21,20,23,-3,"December, 2008"
2008-2009,20,2008-12-28,Arsenal,Portsmouth,1,0,H,3,0,3,1,1,1,1,3,5,11,32,23,6,9,December,-2.4492935982947064e-16,1.0,0,33,1,4,0,1.2,0.8,32,23,9,21,32,-11,"December, 2008"
2008-2009,20,2008-12-28,Blackburn,Man City,2,2,D,1,1,2,1,2,3,0,2,19,15,17,21,4,4,December,-2.4492935982947064e-16,1.0,4,27,4,1,0,2.4,0.8,20,34,-14,36,28,8,"December, 2008"
2008-2009,20,2008-12-28,Bolton,Wigan,0,1,A,0,3,0,4,1,1,1,3,10,9,23,25,1,2,December,-2.4492935982947064e-16,1.0,6,46,2,1,2,1.6,1.0,22,27,-5,23,21,2,"December, 2008"
2008-2009,20,2008-12-28,Everton,Sunderland,3,0,H,3,0,3,1,1,0,1,4,6,15,29,22,9,7,December,-2.4492935982947064e-16,1.0,18,40,4,1,0,2.6,0.8,24,25,-1,21,26,-5,"December, 2008"
2008-2009,20,2008-12-28,Fulham,Chelsea,2,2,D,1,1,3,0,2,5,0,0,9,2,25,41,7,16,December,-2.4492935982947064e-16,1.0,19,14,1,2,2,0.8,1.2,16,12,4,38,7,31,"December, 2008"
2008-2009,20,2008-12-28,Newcastle,Liverpool,1,5,A,0,3,1,1,3,5,0,0,13,2,22,42,11,20,December,-2.4492935982947064e-16,1.0,30,25,1,0,4,0.6,2.4,25,27,-2,30,12,18,"December, 2008"
2008-2009,20,2008-12-28,West Ham,Stoke,2,1,H,3,0,2,0,3,2,0,3,13,18,22,20,5,2,December,-2.4492935982947064e-16,1.0,45,39,0,0,0,0.0,0.0,22,27,-5,17,31,-14,"December, 2008"
2008-2009,20,2008-12-29,Man United,Middlesbrough,1,0,H,3,0,4,1,0,0,1,4,3,17,35,20,14,15,December,-2.4492935982947064e-16,1.0,28,29,2,3,0,1.8,1.0,28,10,18,17,28,-11,"December, 2008"
2008-2009,20,2008-12-30,Hull,Aston Villa,0,1,A,0,3,0,1,4,2,2,1,8,5,27,35,3,8,December,-2.4492935982947064e-16,1.0,21,1,0,0,0,0.0,0.0,28,36,-8,32,22,10,"December, 2008"
2008-2009,21,2009-01-10,Arsenal,Bolton,1,0,H,3,0,3,1,1,0,4,1,5,11,35,23,6,12,January,0.4999999999999999,0.8660254037844387,0,6,4,0,1,2.2,1.4,33,23,10,22,28,-6,"January, 2009"
2008-2009,21,2009-01-10,Aston Villa,West Brom,2,1,H,3,0,2,2,1,2,1,2,5,20,38,18,15,20,January,0.4999999999999999,0.8660254037844387,1,44,2,3,0,1.2,0.8,33,22,11,16,35,-19,"January, 2009"
2008-2009,21,2009-01-10,Everton,Hull,2,0,H,3,0,3,1,1,0,1,4,6,8,32,27,2,5,January,0.4999999999999999,0.8660254037844387,18,21,0,1,0,2.0,2.0,27,25,2,28,37,-9,"January, 2009"
2008-2009,21,2009-01-10,Middlesbrough,Sunderland,1,1,D,1,1,0,1,4,0,1,4,17,15,20,22,2,2,January,0.4999999999999999,0.8660254037844387,29,40,1,1,3,1.4,1.8,17,29,-12,21,29,-8,"January, 2009"
2008-2009,21,2009-01-10,Newcastle,West Ham,2,2,D,1,1,1,1,3,2,0,3,15,10,22,25,5,3,January,0.4999999999999999,0.8660254037844387,30,45,2,2,1,2.0,1.6,26,32,-6,24,28,-4,"January, 2009"
2008-2009,21,2009-01-10,Stoke,Liverpool,0,0,D,1,1,2,0,3,5,0,0,18,1,20,45,17,25,January,0.4999999999999999,0.8660254037844387,39,25,0,1,0,0.0,0.0,18,33,-15,35,13,22,"January, 2009"
2008-2009,21,2009-01-11,Man United,Chelsea,3,0,H,3,0,4,1,0,5,0,0,4,2,38,42,2,4,January,0.4999999999999999,0.8660254037844387,28,14,1,3,1,1.0,0.8,29,10,19,40,9,31,"January, 2009"
2008-2009,21,2009-01-11,Wigan,Tottenham,1,0,H,3,0,1,1,3,2,1,2,7,18,28,20,11,8,January,0.4999999999999999,0.8660254037844387,46,42,0,3,2,1.0,2.2,24,21,3,20,25,-5,"January, 2009"
2008-2009,21,2009-01-14,Man United,Wigan,1,0,H,3,0,4,1,0,1,1,3,3,7,41,31,4,10,January,0.4999999999999999,0.8660254037844387,28,46,5,0,0,2.8,0.6,32,10,22,25,21,4,"January, 2009"
2008-2009,22,2009-01-17,Blackburn,Newcastle,3,0,H,3,0,2,1,2,1,1,3,19,11,18,23,8,5,January,0.4999999999999999,0.8660254037844387,4,30,4,0,1,1.8,1.0,22,36,-14,28,34,-6,"January, 2009"
2008-2009,22,2009-01-17,Bolton,Man United,0,1,A,0,3,0,4,1,4,1,0,11,2,23,44,9,21,January,0.4999999999999999,0.8660254037844387,6,28,1,0,4,0.4,2.4,22,29,-7,33,10,23,"January, 2009"
2008-2009,22,2009-01-17,Chelsea,Stoke,2,1,H,3,0,5,0,0,2,0,3,3,18,42,21,15,21,January,0.4999999999999999,0.8660254037844387,14,39,1,0,0,2.0,0.0,40,12,28,18,33,-15,"January, 2009"
2008-2009,22,2009-01-17,Hull,Arsenal,1,3,A,0,3,0,1,4,3,1,1,8,5,27,38,3,11,January,0.4999999999999999,0.8660254037844387,21,0,1,0,0,2.0,1.0,28,39,-11,34,23,11,"January, 2009"
2008-2009,22,2009-01-17,Man City,Wigan,1,0,H,3,0,3,0,2,1,1,3,15,7,22,31,8,9,January,0.4999999999999999,0.8660254037844387,27,46,0,2,3,0.4,1.6,38,30,8,25,22,3,"January, 2009"
2008-2009,22,2009-01-17,Sunderland,Aston Villa,1,2,A,0,3,0,1,4,2,2,1,13,5,23,41,8,18,January,0.4999999999999999,0.8660254037844387,40,1,1,1,3,1.0,1.6,22,30,-8,35,23,12,"January, 2009"
2008-2009,22,2009-01-17,West Brom,Middlesbrough,3,0,H,3,0,2,1,2,0,1,4,20,17,18,21,3,3,January,0.4999999999999999,0.8660254037844387,44,29,1,1,3,0.8,2.0,17,37,-20,18,30,-12,"January, 2009"
2008-2009,22,2009-01-18,Tottenham,Portsmouth,1,1,D,1,1,2,1,2,1,1,3,20,15,20,23,5,3,January,0.4999999999999999,0.8660254037844387,42,33,3,1,1,1.2,0.8,20,26,-6,21,33,-12,"January, 2009"
2008-2009,22,2009-01-18,West Ham,Fulham,3,1,H,3,0,2,0,3,3,0,2,10,9,26,26,1,0,January,0.4999999999999999,0.8660254037844387,45,19,3,2,0,1.6,1.0,26,30,-4,18,14,4,"January, 2009"
2008-2009,22,2009-01-19,Liverpool,Everton,1,1,D,1,1,5,0,0,3,1,1,2,6,46,35,4,11,January,0.4999999999999999,0.8660254037844387,25,18,3,1,1,1.0,0.8,35,13,22,29,25,4,"January, 2009"
2008-2009,23,2009-01-27,Tottenham,Stoke,3,1,H,3,0,2,1,2,2,0,3,16,19,21,21,3,0,January,0.4999999999999999,0.8660254037844387,42,39,0,0,1,1.0,2.0,21,27,-6,19,35,-16,"January, 2009"
2008-2009,23,2009-01-27,West Brom,Man United,0,5,A,0,3,2,1,2,4,1,0,19,1,21,47,18,26,January,0.4999999999999999,0.8660254037844387,44,28,0,1,4,0.4,2.6,20,37,-17,34,10,24,"January, 2009"
2008-2009,23,2009-01-27,Portsmouth,Aston Villa,0,1,A,0,3,1,1,3,2,2,1,12,4,24,44,8,20,January,0.4999999999999999,0.8660254037844387,33,1,2,3,0,1.4,0.6,22,34,-12,37,24,13,"January, 2009"
2008-2009,23,2009-01-27,Sunderland,Fulham,1,0,H,3,0,0,1,4,3,0,2,15,10,23,26,5,3,January,0.4999999999999999,0.8660254037844387,40,19,2,2,1,1.4,1.0,23,32,-9,19,17,2,"January, 2009"
2008-2009,23,2009-01-28,Blackburn,Bolton,2,2,D,1,1,2,1,2,0,4,1,17,15,21,23,2,2,January,0.4999999999999999,0.8660254037844387,4,6,3,1,1,1.6,0.8,25,36,-11,22,30,-8,"January, 2009"
2008-2009,23,2009-01-28,Chelsea,Middlesbrough,2,0,H,3,0,5,0,0,0,1,4,4,18,45,21,14,24,January,0.4999999999999999,0.8660254037844387,14,29,4,0,1,2.4,0.4,42,13,29,18,33,-15,"January, 2009"
2008-2009,23,2009-01-28,Everton,Arsenal,1,1,D,1,1,3,1,1,3,1,1,6,5,36,41,1,5,January,0.4999999999999999,0.8660254037844387,18,0,1,1,3,0.8,1.8,30,26,4,37,24,13,"January, 2009"
2008-2009,23,2009-01-28,Man City,Newcastle,2,1,H,3,0,3,0,2,1,1,3,12,16,25,23,4,2,January,0.4999999999999999,0.8660254037844387,27,30,3,2,0,1.6,0.6,39,30,9,28,37,-9,"January, 2009"
2008-2009,23,2009-01-28,West Ham,Hull,2,0,H,3,0,2,0,3,0,1,4,8,10,29,27,2,2,January,0.4999999999999999,0.8660254037844387,45,21,0,0,1,0.0,1.0,29,31,-2,29,42,-13,"January, 2009"
2008-2009,23,2009-01-28,Wigan,Liverpool,1,1,D,1,1,1,1,3,5,0,0,8,3,31,47,5,16,January,0.4999999999999999,0.8660254037844387,46,25,0,1,4,0.6,2.2,25,23,2,36,14,22,"January, 2009"
2008-2009,24,2009-01-31,Stoke,Man City,1,0,H,3,0,2,0,3,3,0,2,20,10,21,28,10,7,January,0.4999999999999999,0.8660254037844387,39,27,0,0,1,0.0,3.0,20,38,-18,41,31,10,"January, 2009"
2008-2009,24,2009-01-31,Middlesbrough,Blackburn,0,0,D,1,1,0,1,4,2,1,2,19,17,21,22,2,1,January,0.4999999999999999,0.8660254037844387,29,4,0,2,3,0.8,1.4,18,35,-17,27,38,-11,"January, 2009"
2008-2009,24,2009-01-31,Man United,Everton,1,0,H,3,0,4,1,0,3,1,1,1,6,50,37,5,13,January,0.4999999999999999,0.8660254037844387,28,18,4,1,0,2.2,0.8,39,10,29,31,27,4,"January, 2009"
2008-2009,24,2009-01-31,Hull,West Brom,2,2,D,1,1,0,1,4,2,1,2,12,20,27,21,8,6,January,0.4999999999999999,0.8660254037844387,21,44,1,0,0,3.0,0.0,29,44,-15,20,42,-22,"January, 2009"
2008-2009,24,2009-01-31,Bolton,Tottenham,3,2,H,3,0,0,4,1,2,1,2,14,13,24,24,1,0,January,0.4999999999999999,0.8660254037844387,6,42,1,2,2,1.0,1.6,24,32,-8,24,28,-4,"January, 2009"
2008-2009,24,2009-01-31,Aston Villa,Wigan,0,0,D,1,1,2,2,1,1,1,3,4,8,47,32,4,15,January,0.4999999999999999,0.8660254037844387,1,46,2,2,1,1.4,0.8,38,24,14,26,24,2,"January, 2009"
2008-2009,24,2009-01-31,Arsenal,West Ham,0,0,D,1,1,3,1,1,2,0,3,5,8,42,32,3,10,January,0.4999999999999999,0.8660254037844387,0,45,3,0,2,1.0,0.4,38,25,13,31,31,0,"January, 2009"
2008-2009,24,2009-01-31,Fulham,Portsmouth,3,1,H,3,0,3,0,2,1,1,3,12,15,26,24,3,2,January,0.4999999999999999,0.8660254037844387,19,33,1,3,1,0.8,1.0,19,18,1,22,35,-13,"January, 2009"
2008-2009,24,2009-02-01,Liverpool,Chelsea,2,0,H,3,0,5,0,0,5,0,0,3,2,48,48,1,0,February,0.8660254037844386,0.5000000000000001,25,14,2,2,1,0.8,0.4,37,15,22,44,13,31,"February, 2009"
2008-2009,24,2009-02-01,Newcastle,Sunderland,1,1,D,1,1,1,1,3,0,1,4,17,13,23,26,4,3,February,0.8660254037844386,0.5000000000000001,30,40,3,1,1,2.2,1.2,29,39,-10,24,32,-8,"February, 2009"
2008-2009,25,2009-02-07,Sunderland,Stoke,2,0,H,3,0,0,1,4,2,0,3,12,17,27,24,5,3,February,0.8660254037844386,0.5000000000000001,40,39,0,0,1,0.0,1.0,25,33,-8,21,38,-17,"February, 2009"
2008-2009,25,2009-02-07,Wigan,Fulham,0,0,D,1,1,1,1,3,3,0,2,7,11,33,29,4,4,February,0.8660254037844386,0.5000000000000001,46,19,1,3,1,0.6,0.8,26,24,2,22,19,3,"February, 2009"
2008-2009,25,2009-02-07,West Brom,Newcastle,2,3,A,0,3,2,1,2,1,1,3,20,15,22,24,5,2,February,0.8660254037844386,0.5000000000000001,44,30,0,1,4,0.4,2.2,22,44,-22,30,40,-10,"February, 2009"
2008-2009,25,2009-02-07,Portsmouth,Liverpool,2,3,A,0,3,1,1,3,5,0,0,16,2,24,51,14,27,February,0.8660254037844386,0.5000000000000001,33,25,1,2,2,0.6,1.2,23,38,-15,39,15,24,"February, 2009"
2008-2009,25,2009-02-07,Everton,Bolton,3,0,H,3,0,3,1,1,0,4,1,6,12,37,27,6,10,February,0.8660254037844386,0.5000000000000001,18,6,4,1,0,1.4,0.4,31,28,3,27,34,-7,"February, 2009"
2008-2009,25,2009-02-07,Chelsea,Hull,0,0,D,1,1,5,0,0,0,1,4,4,11,48,28,7,20,February,0.8660254037844386,0.5000000000000001,14,21,1,0,0,3.0,0.0,44,15,29,31,46,-15,"February, 2009"
2008-2009,25,2009-02-07,Blackburn,Aston Villa,0,2,A,0,3,2,1,2,2,2,1,18,4,23,48,14,25,February,0.8660254037844386,0.5000000000000001,4,1,0,1,4,0.8,2.4,27,38,-11,38,24,14,"February, 2009"
2008-2009,25,2009-02-07,Man City,Middlesbrough,1,0,H,3,0,3,0,2,0,1,4,11,19,28,22,8,6,February,0.8660254037844386,0.5000000000000001,27,29,3,0,2,1.4,2.2,41,32,9,18,35,-17,"February, 2009"
2008-2009,25,2009-02-08,Tottenham,Arsenal,0,0,D,1,1,2,1,2,3,1,1,15,5,24,43,10,19,February,0.8660254037844386,0.5000000000000001,42,0,0,2,3,1.6,2.8,26,31,-5,38,25,13,"February, 2009"
2008-2009,25,2009-02-08,West Ham,Man United,0,1,A,0,3,2,0,3,4,1,0,8,2,33,53,6,20,February,0.8660254037844386,0.5000000000000001,45,28,3,0,2,1.0,1.4,31,31,0,40,10,30,"February, 2009"
2008-2009,25,2009-02-14,Portsmouth,Man City,2,0,H,3,0,1,1,3,3,0,2,16,9,24,31,7,7,February,0.8660254037844386,0.5000000000000001,33,27,1,2,2,0.6,2.0,25,41,-16,42,32,10,"February, 2009"
2008-2009,25,2009-02-18,Man United,Fulham,3,0,H,3,0,4,1,0,3,0,2,1,10,56,30,9,26,February,0.8660254037844386,0.5000000000000001,28,19,5,0,0,3.2,0.8,41,10,31,22,19,3,"February, 2009"
2008-2009,26,2009-02-21,Aston Villa,Chelsea,0,1,A,0,3,2,2,1,5,0,0,3,4,51,49,1,2,February,0.8660254037844386,0.5000000000000001,1,14,1,3,1,1.4,1.4,40,24,16,44,15,29,"February, 2009"
2008-2009,26,2009-02-21,Arsenal,Sunderland,0,0,D,1,1,3,1,1,0,1,4,5,11,44,30,6,14,February,0.8660254037844386,0.5000000000000001,0,40,4,1,0,2.2,0.8,38,25,13,27,33,-6,"February, 2009"
2008-2009,26,2009-02-21,Bolton,West Ham,2,1,H,3,0,0,4,1,2,0,3,14,8,27,33,6,6,February,0.8660254037844386,0.5000000000000001,6,45,3,1,1,2.0,1.0,27,37,-10,31,32,-1,"February, 2009"
2008-2009,26,2009-02-21,Man United,Blackburn,2,1,H,3,0,4,1,0,2,1,2,1,18,59,23,17,36,February,0.8660254037844386,0.5000000000000001,28,4,4,1,0,2.0,0.4,44,10,34,27,40,-13,"February, 2009"
2008-2009,26,2009-02-21,Middlesbrough,Wigan,0,0,D,1,1,0,1,4,1,1,3,19,7,22,34,12,12,February,0.8660254037844386,0.5000000000000001,29,46,3,1,1,0.8,0.4,18,36,-18,26,24,2,"February, 2009"
2008-2009,26,2009-02-21,Stoke,Portsmouth,2,2,D,1,1,2,0,3,1,1,3,17,15,24,27,2,3,February,0.8660254037844386,0.5000000000000001,39,33,0,0,1,1.0,2.0,21,40,-19,27,41,-14,"February, 2009"
2008-2009,26,2009-02-22,Fulham,West Brom,2,0,H,3,0,3,0,2,2,1,2,11,20,30,22,9,8,February,0.8660254037844386,0.5000000000000001,19,44,2,2,1,1.6,0.6,22,22,0,24,47,-23,"February, 2009"
2008-2009,26,2009-02-22,Liverpool,Man City,1,1,D,1,1,5,0,0,3,0,2,2,10,54,31,8,23,February,0.8660254037844386,0.5000000000000001,25,27,3,2,0,1.0,0.4,42,17,25,42,34,8,"February, 2009"
2008-2009,26,2009-02-22,Newcastle,Everton,0,0,D,1,1,1,1,3,3,1,1,15,6,27,40,9,13,February,0.8660254037844386,0.5000000000000001,30,18,1,2,2,1.4,2.2,33,42,-9,34,28,6,"February, 2009"
2008-2009,26,2009-02-23,Hull,Tottenham,1,2,A,0,3,0,1,4,2,1,2,13,16,29,25,3,4,February,0.8660254037844386,0.5000000000000001,21,42,1,0,0,1.0,0.0,31,46,-15,26,31,-5,"February, 2009"
2008-2009,27,2009-02-28,Everton,West Brom,2,0,H,3,0,3,1,1,2,1,2,6,20,41,22,14,19,February,0.8660254037844386,0.5000000000000001,18,44,2,1,2,1.2,1.8,34,28,6,24,49,-25,"February, 2009"
2008-2009,27,2009-02-28,Middlesbrough,Liverpool,2,0,H,3,0,0,1,4,5,0,0,19,3,23,55,16,32,February,0.8660254037844386,0.5000000000000001,29,25,0,2,3,0.8,1.6,18,36,-18,43,18,25,"February, 2009"
2008-2009,27,2009-02-28,Arsenal,Fulham,0,0,D,1,1,3,1,1,3,0,2,5,8,45,33,3,12,February,0.8660254037844386,0.5000000000000001,0,19,3,0,2,1.8,1.0,38,25,13,24,22,2,"February, 2009"
2008-2009,27,2009-02-28,Chelsea,Wigan,2,1,H,3,0,5,0,0,1,1,3,3,7,52,35,4,17,February,0.8660254037844386,0.5000000000000001,14,46,4,1,0,2.2,0.6,45,15,30,26,24,2,"February, 2009"
2008-2009,27,2009-03-01,Aston Villa,Stoke,2,2,D,1,1,2,2,1,2,0,3,4,18,51,25,14,26,March,1.0,6.123233995736766e-17,1,39,0,0,1,2.0,3.0,40,25,15,23,42,-19,"March, 2009"
2008-2009,27,2009-03-01,Bolton,Newcastle,1,0,H,3,0,0,4,1,1,1,3,12,15,30,28,3,2,March,1.0,6.123233995736766e-17,6,30,2,1,2,1.0,1.2,29,38,-9,33,42,-9,"March, 2009"
2008-2009,27,2009-03-01,Hull,Blackburn,1,2,A,0,3,0,1,4,2,1,2,13,19,29,23,6,6,March,1.0,6.123233995736766e-17,21,4,0,1,0,1.0,1.0,32,48,-16,28,42,-14,"March, 2009"
2008-2009,27,2009-03-01,West Ham,Man City,1,0,H,3,0,2,0,3,3,0,2,9,11,33,32,2,1,March,1.0,6.123233995736766e-17,45,27,0,1,4,0.2,1.8,32,34,-2,43,35,8,"March, 2009"
2008-2009,28,2009-03-03,Liverpool,Sunderland,2,0,H,3,0,5,0,0,0,1,4,3,12,55,31,9,24,March,1.0,6.123233995736766e-17,25,40,5,0,0,1.8,0.0,43,20,23,27,33,-6,"March, 2009"
2008-2009,28,2009-03-03,Portsmouth,Chelsea,0,1,A,0,3,1,1,3,5,0,0,16,3,28,55,13,27,March,1.0,6.123233995736766e-17,33,14,0,1,4,0.4,2.0,29,43,-14,47,16,31,"March, 2009"
2008-2009,28,2009-03-03,West Brom,Arsenal,1,3,A,0,3,2,1,2,3,1,1,20,5,22,46,15,24,March,1.0,6.123233995736766e-17,44,0,1,1,3,0.8,1.6,24,51,-27,38,25,13,"March, 2009"
2008-2009,28,2009-03-04,Wigan,West Ham,0,1,A,0,3,1,1,3,2,0,3,9,7,35,36,2,1,March,1.0,6.123233995736766e-17,46,45,2,1,2,1.0,1.2,27,26,1,33,34,-1,"March, 2009"
2008-2009,28,2009-03-04,Tottenham,Middlesbrough,4,0,H,3,0,2,1,2,0,1,4,15,19,28,26,4,2,March,1.0,6.123233995736766e-17,42,29,2,2,1,1.6,1.4,28,32,-4,20,36,-16,"March, 2009"
2008-2009,28,2009-03-04,Stoke,Bolton,2,0,H,3,0,2,0,3,0,4,1,19,11,26,33,8,7,March,1.0,6.123233995736766e-17,39,6,0,0,1,1.0,3.0,25,44,-19,30,38,-8,"March, 2009"
2008-2009,28,2009-03-04,Fulham,Hull,0,1,A,0,3,3,0,2,0,1,4,9,13,34,29,4,5,March,1.0,6.123233995736766e-17,19,21,0,0,1,1.0,2.0,24,22,2,33,50,-17,"March, 2009"
2008-2009,28,2009-03-04,Man City,Aston Villa,2,0,H,3,0,3,0,2,2,2,1,11,4,32,52,7,20,March,1.0,6.123233995736766e-17,27,1,2,1,2,1.4,1.6,43,36,7,42,27,15,"March, 2009"
2008-2009,28,2009-03-04,Blackburn,Everton,0,0,D,1,1,2,1,2,3,1,1,17,6,26,44,11,18,March,1.0,6.123233995736766e-17,4,18,1,3,1,1.0,1.0,30,43,-13,36,28,8,"March, 2009"
2008-2009,28,2009-03-04,Newcastle,Man United,1,2,A,0,3,1,1,3,4,1,0,15,1,28,62,14,34,March,1.0,6.123233995736766e-17,30,28,0,2,3,0.8,3.2,33,43,-10,46,11,35,"March, 2009"
2008-2009,28,2009-03-07,Sunderland,Tottenham,1,1,D,1,1,0,1,4,2,1,2,14,13,31,31,1,0,March,1.0,6.123233995736766e-17,40,42,2,1,2,1.2,1.4,27,35,-8,32,32,0,"March, 2009"
2008-2009,28,2009-03-11,Fulham,Blackburn,1,2,A,0,3,3,0,2,2,1,2,10,18,34,27,8,7,March,1.0,6.123233995736766e-17,19,4,0,3,2,0.8,1.4,24,23,1,30,43,-13,"March, 2009"
2008-2009,29,2009-03-14,Sunderland,Wigan,1,2,A,0,3,0,1,4,1,1,3,14,10,32,35,4,3,March,1.0,6.123233995736766e-17,40,46,1,1,3,0.6,1.2,28,36,-8,27,27,0,"March, 2009"
2008-2009,29,2009-03-14,Middlesbrough,Portsmouth,1,1,D,1,1,0,1,4,1,1,3,19,18,26,28,1,2,March,1.0,6.123233995736766e-17,29,33,2,1,2,0.8,1.2,20,40,-20,29,44,-15,"March, 2009"
2008-2009,29,2009-03-14,Hull,Newcastle,1,1,D,1,1,0,1,4,1,1,3,14,17,32,28,3,4,March,1.0,6.123233995736766e-17,21,30,1,0,0,2.0,1.0,34,50,-16,34,45,-11,"March, 2009"
2008-2009,29,2009-03-14,Man United,Liverpool,1,4,A,0,3,4,1,0,5,0,0,1,3,65,58,2,7,March,1.0,6.123233995736766e-17,28,25,4,0,1,1.6,0.4,48,12,36,45,20,25,"March, 2009"
2008-2009,29,2009-03-14,Bolton,Fulham,1,3,A,0,3,0,4,1,3,0,2,11,10,33,34,1,1,March,1.0,6.123233995736766e-17,6,19,1,2,2,1.0,1.2,30,40,-10,25,25,0,"March, 2009"
2008-2009,29,2009-03-14,Arsenal,Blackburn,4,0,H,3,0,3,1,1,2,1,2,5,15,49,30,10,19,March,1.0,6.123233995736766e-17,0,4,4,1,0,3.0,0.6,41,26,15,32,44,-12,"March, 2009"
2008-2009,29,2009-03-14,Everton,Stoke,3,1,H,3,0,3,1,1,2,0,3,6,16,45,29,10,16,March,1.0,6.123233995736766e-17,18,39,1,0,0,3.0,2.0,36,28,8,27,44,-17,"March, 2009"
2008-2009,29,2009-03-15,Aston Villa,Tottenham,1,2,A,0,3,2,2,1,2,1,2,5,13,52,32,8,20,March,1.0,6.123233995736766e-17,1,42,2,2,1,2.0,1.8,42,29,13,33,33,0,"March, 2009"
2008-2009,29,2009-03-15,Chelsea,Man City,1,0,H,3,0,5,0,0,3,0,2,3,10,58,35,7,23,March,1.0,6.123233995736766e-17,14,27,5,0,0,3.0,0.2,48,16,32,45,36,9,"March, 2009"
2008-2009,29,2009-03-16,West Ham,West Brom,0,0,D,1,1,2,0,3,2,1,2,7,20,39,22,13,17,March,1.0,6.123233995736766e-17,45,44,3,0,2,1.2,1.0,34,34,0,25,54,-29,"March, 2009"
2008-2009,30,2009-03-21,West Brom,Bolton,1,1,D,1,1,2,1,2,0,4,1,20,12,23,33,8,10,March,1.0,6.123233995736766e-17,44,6,1,3,1,0.6,0.8,25,54,-29,31,43,-12,"March, 2009"
2008-2009,30,2009-03-21,Stoke,Middlesbrough,1,0,H,3,0,2,0,3,0,1,4,18,19,29,27,1,2,March,1.0,6.123233995736766e-17,39,29,0,0,1,1.0,2.0,28,47,-19,21,41,-20,"March, 2009"
2008-2009,30,2009-03-21,Portsmouth,Everton,2,1,H,3,0,1,1,3,3,1,1,17,6,29,48,11,19,March,1.0,6.123233995736766e-17,33,18,2,1,2,1.2,1.2,30,45,-15,39,29,10,"March, 2009"
2008-2009,30,2009-03-21,Tottenham,Chelsea,1,0,H,3,0,2,1,2,5,0,0,11,2,35,61,9,26,March,1.0,6.123233995736766e-17,42,14,1,2,2,1.4,1.8,35,34,1,49,16,33,"March, 2009"
2008-2009,30,2009-03-21,Fulham,Man United,2,0,H,3,0,3,0,2,4,1,0,9,1,37,65,8,28,March,1.0,6.123233995736766e-17,19,28,0,0,5,0.4,3.0,28,26,2,49,16,33,"March, 2009"
2008-2009,30,2009-03-21,Blackburn,West Ham,1,1,D,1,1,2,1,2,2,0,3,15,7,30,40,8,10,March,1.0,6.123233995736766e-17,4,45,0,0,5,0.8,2.2,32,48,-16,34,34,0,"March, 2009"
2008-2009,30,2009-03-21,Newcastle,Arsenal,1,3,A,0,3,1,1,3,3,1,1,16,4,29,52,12,23,March,1.0,6.123233995736766e-17,30,0,0,3,2,0.4,1.6,35,46,-11,45,26,19,"March, 2009"
2008-2009,30,2009-03-22,Liverpool,Aston Villa,5,0,H,3,0,5,0,0,2,2,1,3,5,61,52,2,9,March,1.0,6.123233995736766e-17,25,1,2,3,0,1.4,0.8,49,21,28,43,31,12,"March, 2009"
2008-2009,30,2009-03-22,Man City,Sunderland,1,0,H,3,0,3,0,2,0,1,4,11,14,35,32,3,3,March,1.0,6.123233995736766e-17,27,40,5,0,0,2.0,0.6,45,37,8,29,38,-9,"March, 2009"
2008-2009,30,2009-03-22,Wigan,Hull,1,0,H,3,0,1,1,3,0,1,4,11,13,38,33,2,5,March,1.0,6.123233995736766e-17,46,21,1,0,0,5.0,0.0,29,28,1,35,51,-16,"March, 2009"
2008-2009,31,2009-04-04,West Brom,Stoke,0,2,A,0,3,2,1,2,2,0,3,20,17,24,32,3,8,April,0.8660254037844388,-0.4999999999999998,44,39,0,0,1,0.0,1.0,26,55,-29,29,47,-18,"April, 2009"
2008-2009,31,2009-04-04,Arsenal,Man City,2,0,H,3,0,3,1,1,3,0,2,4,10,55,38,6,17,April,0.8660254037844388,-0.4999999999999998,0,27,3,0,2,1.4,1.2,48,27,21,46,37,9,"April, 2009"
2008-2009,31,2009-04-04,Blackburn,Tottenham,2,1,H,3,0,2,1,2,2,1,2,17,11,31,38,6,7,April,0.8660254037844388,-0.4999999999999998,4,42,1,3,1,1.0,1.0,33,49,-16,36,34,2,"April, 2009"
2008-2009,31,2009-04-04,Bolton,Middlesbrough,4,1,H,3,0,0,4,1,0,1,4,12,19,34,27,7,7,April,0.8660254037844388,-0.4999999999999998,6,29,2,2,1,1.0,1.2,32,44,-12,21,42,-21,"April, 2009"
2008-2009,31,2009-04-04,Fulham,Liverpool,0,1,A,0,3,3,0,2,5,0,0,9,2,40,64,7,24,April,0.8660254037844388,-0.4999999999999998,19,25,1,1,3,0.2,1.6,30,26,4,54,21,33,"April, 2009"
2008-2009,31,2009-04-04,Hull,Portsmouth,0,0,D,1,1,0,1,4,1,1,3,14,16,33,32,2,1,April,0.8660254037844388,-0.4999999999999998,21,33,0,1,0,2.0,2.0,35,52,-17,32,46,-14,"April, 2009"
2008-2009,31,2009-04-04,Newcastle,Chelsea,0,2,A,0,3,1,1,3,5,0,0,18,3,29,61,15,32,April,0.8660254037844388,-0.4999999999999998,30,14,0,2,3,0.2,1.0,36,49,-13,49,17,32,"April, 2009"
2008-2009,31,2009-04-04,West Ham,Sunderland,2,0,H,3,0,2,0,3,0,1,4,8,17,41,32,9,9,April,0.8660254037844388,-0.4999999999999998,45,40,3,1,1,1.6,0.8,35,35,0,29,39,-10,"April, 2009"
2008-2009,31,2009-04-05,Man United,Aston Villa,3,2,H,3,0,4,1,0,2,2,1,2,5,65,52,3,13,April,0.8660254037844388,-0.4999999999999998,28,1,4,1,0,2.8,0.4,49,18,31,43,36,7,"April, 2009"
2008-2009,31,2009-04-05,Everton,Wigan,4,0,H,3,0,3,1,1,1,1,3,6,8,48,41,2,7,April,0.8660254037844388,-0.4999999999999998,18,46,3,1,1,1.6,1.0,40,31,9,30,28,2,"April, 2009"
2008-2009,32,2009-04-11,Chelsea,Bolton,4,3,H,3,0,5,0,0,0,4,1,3,12,64,37,9,27,April,0.8660254037844388,-0.4999999999999998,14,6,3,2,0,1.4,0.6,51,17,34,36,45,-9,"April, 2009"
2008-2009,32,2009-04-11,Liverpool,Blackburn,4,0,H,3,0,5,0,0,2,1,2,3,14,67,34,11,33,April,0.8660254037844388,-0.4999999999999998,25,4,2,2,1,1.4,0.8,55,21,34,35,50,-15,"April, 2009"
2008-2009,32,2009-04-11,Middlesbrough,Hull,3,1,H,3,0,0,1,4,0,1,4,19,14,27,34,5,7,April,0.8660254037844388,-0.4999999999999998,29,21,0,0,1,1.0,2.0,22,46,-24,35,52,-17,"April, 2009"
2008-2009,32,2009-04-11,Portsmouth,West Brom,2,2,D,1,1,1,1,3,2,1,2,16,20,33,24,4,9,April,0.8660254037844388,-0.4999999999999998,33,44,2,1,2,1.2,1.4,32,46,-14,26,57,-31,"April, 2009"
2008-2009,32,2009-04-11,Stoke,Newcastle,1,1,D,1,1,2,0,3,1,1,3,13,19,35,29,6,6,April,0.8660254037844388,-0.4999999999999998,39,30,0,1,0,2.0,2.0,31,47,-16,36,51,-15,"April, 2009"
2008-2009,32,2009-04-11,Sunderland,Man United,1,2,A,0,3,0,1,4,4,1,0,17,2,32,68,15,36,April,0.8660254037844388,-0.4999999999999998,40,28,0,1,4,0.2,1.8,29,41,-12,52,20,32,"April, 2009"
2008-2009,32,2009-04-11,Tottenham,West Ham,1,0,H,3,0,2,1,2,2,0,3,11,7,38,44,4,6,April,0.8660254037844388,-0.4999999999999998,42,45,4,1,0,2.4,0.8,37,36,1,37,35,2,"April, 2009"
2008-2009,32,2009-04-11,Wigan,Arsenal,1,4,A,0,3,1,1,3,3,1,1,9,4,41,58,5,17,April,0.8660254037844388,-0.4999999999999998,46,0,0,1,4,0.2,1.2,30,32,-2,50,27,23,"April, 2009"
2008-2009,32,2009-04-12,Aston Villa,Everton,3,3,D,1,1,2,2,1,3,1,1,5,6,52,51,1,1,April,0.8660254037844388,-0.4999999999999998,1,18,3,2,0,1.8,1.0,45,39,6,44,31,13,"April, 2009"
2008-2009,32,2009-04-12,Man City,Fulham,1,3,A,0,3,3,0,2,3,0,2,11,10,38,40,1,2,April,0.8660254037844388,-0.4999999999999998,27,19,2,2,1,2.4,1.8,46,39,7,30,27,3,"April, 2009"
2008-2009,33,2009-04-18,Sunderland,Hull,1,0,H,3,0,0,1,4,0,1,4,17,15,32,34,2,2,April,0.8660254037844388,-0.4999999999999998,40,21,1,0,0,4.0,1.0,30,43,-13,36,55,-19,"April, 2009"
2008-2009,33,2009-04-18,Stoke,Blackburn,1,0,H,3,0,2,0,3,2,1,2,14,16,36,34,2,2,April,0.8660254037844388,-0.4999999999999998,39,4,0,0,1,0.0,3.0,32,48,-16,35,54,-19,"April, 2009"
2008-2009,33,2009-04-18,Aston Villa,West Ham,1,1,D,1,1,2,2,1,2,0,3,5,7,53,44,2,9,April,0.8660254037844388,-0.4999999999999998,1,45,3,2,0,1.2,0.6,48,42,6,37,36,1,"April, 2009"
2008-2009,33,2009-04-18,Middlesbrough,Fulham,0,0,D,1,1,0,1,4,3,0,2,19,8,30,43,11,13,April,0.8660254037844388,-0.4999999999999998,29,19,3,0,2,1.4,1.4,25,47,-22,33,28,5,"April, 2009"
2008-2009,33,2009-04-18,Portsmouth,Bolton,1,0,H,3,0,1,1,3,0,4,1,14,12,34,37,2,3,April,0.8660254037844388,-0.4999999999999998,33,6,2,0,3,1.4,1.4,34,48,-14,39,49,-10,"April, 2009"
2008-2009,33,2009-04-19,Man City,West Brom,4,2,H,3,0,3,0,2,2,1,2,12,20,38,25,8,13,April,0.8660254037844388,-0.4999999999999998,27,44,0,2,3,0.4,1.4,47,42,5,28,59,-31,"April, 2009"
2008-2009,33,2009-04-19,Tottenham,Newcastle,1,0,H,3,0,2,1,2,1,1,3,10,19,41,30,9,11,April,0.8660254037844388,-0.4999999999999998,42,30,0,0,5,1.2,3.0,38,36,2,37,52,-15,"April, 2009"
2008-2009,34,2009-04-21,Liverpool,Arsenal,4,4,D,1,1,5,0,0,3,1,1,2,4,70,61,2,9,April,0.8660254037844388,-0.4999999999999998,25,0,1,3,1,1.4,1.4,59,21,38,54,28,26,"April, 2009"
2008-2009,34,2009-04-22,Chelsea,Everton,0,0,D,1,1,5,0,0,3,1,1,3,6,67,52,3,15,April,0.8660254037844388,-0.4999999999999998,14,18,2,3,0,1.2,0.8,55,20,35,47,34,13,"April, 2009"
2008-2009,34,2009-04-22,Man United,Portsmouth,2,0,H,3,0,4,1,0,1,1,3,2,14,71,37,12,34,April,0.8660254037844388,-0.4999999999999998,28,33,3,1,1,1.6,0.6,54,21,33,35,48,-13,"April, 2009"
2008-2009,35,2009-04-25,West Brom,Sunderland,3,0,H,3,0,2,1,2,0,1,4,20,15,25,35,5,10,April,0.8660254037844388,-0.4999999999999998,44,40,1,2,2,1.0,1.8,30,63,-33,31,43,-12,"April, 2009"
2008-2009,35,2009-04-25,West Ham,Chelsea,0,1,A,0,3,2,0,3,5,0,0,8,3,45,68,5,23,April,0.8660254037844388,-0.4999999999999998,45,14,0,1,4,0.4,2.2,38,37,1,55,20,35,"April, 2009"
2008-2009,35,2009-04-25,Man United,Tottenham,5,2,H,3,0,4,1,0,2,1,2,2,10,74,44,8,30,April,0.8660254037844388,-0.4999999999999998,28,42,3,2,0,1.4,0.2,56,21,35,39,36,3,"April, 2009"
2008-2009,35,2009-04-25,Bolton,Aston Villa,1,1,D,1,1,0,4,1,2,2,1,13,5,37,54,8,17,April,0.8660254037844388,-0.4999999999999998,6,1,1,2,2,1.2,2.2,39,50,-11,49,43,6,"April, 2009"
2008-2009,35,2009-04-25,Fulham,Stoke,1,0,H,3,0,3,0,2,2,0,3,9,12,44,39,3,5,April,0.8660254037844388,-0.4999999999999998,19,39,0,1,0,0.0,0.0,33,28,5,33,48,-15,"April, 2009"
2008-2009,35,2009-04-25,Everton,Man City,1,2,A,0,3,3,1,1,3,0,2,6,10,53,41,4,12,April,0.8660254037844388,-0.4999999999999998,18,27,3,1,1,1.2,0.6,47,34,13,51,44,7,"April, 2009"
2008-2009,35,2009-04-25,Hull,Liverpool,1,3,A,0,3,0,1,4,5,0,0,16,2,34,71,14,37,April,0.8660254037844388,-0.4999999999999998,21,25,0,1,0,2.0,2.0,36,56,-20,63,25,38,"April, 2009"
2008-2009,35,2009-04-26,Arsenal,Middlesbrough,2,0,H,3,0,3,1,1,0,1,4,4,18,62,31,14,31,April,0.8660254037844388,-0.4999999999999998,0,29,0,4,1,1.0,1.2,58,32,26,25,47,-22,"April, 2009"
2008-2009,35,2009-04-26,Blackburn,Wigan,2,0,H,3,0,2,1,2,1,1,3,16,11,34,41,5,7,April,0.8660254037844388,-0.4999999999999998,4,46,3,0,2,2.2,2.0,35,55,-20,31,36,-5,"April, 2009"
2008-2009,35,2009-04-27,Newcastle,Portsmouth,0,0,D,1,1,1,1,3,1,1,3,19,14,30,37,5,7,April,0.8660254037844388,-0.4999999999999998,30,33,2,1,2,1.2,1.2,37,53,-16,35,50,-15,"April, 2009"
2008-2009,36,2009-05-02,Wigan,Bolton,0,0,D,1,1,1,1,3,0,4,1,11,13,41,38,2,3,May,0.4999999999999999,-0.8660254037844387,46,6,3,0,2,1.0,1.4,31,38,-7,40,51,-11,"May, 2009"
2008-2009,36,2009-05-02,Tottenham,West Brom,1,0,H,3,0,2,1,2,2,1,2,10,20,44,28,10,16,May,0.4999999999999999,-0.8660254037844387,42,44,1,2,2,0.8,1.4,41,41,0,33,63,-30,"May, 2009"
2008-2009,36,2009-05-02,Stoke,West Ham,0,1,A,0,3,2,0,3,2,0,3,12,9,39,45,3,6,May,0.4999999999999999,-0.8660254037844387,39,45,0,0,1,1.0,2.0,33,49,-16,38,38,0,"May, 2009"
2008-2009,36,2009-05-02,Portsmouth,Arsenal,0,3,A,0,3,1,1,3,3,1,1,14,4,38,65,10,27,May,0.4999999999999999,-0.8660254037844387,33,0,0,3,2,0.6,1.2,35,50,-15,60,32,28,"May, 2009"
2008-2009,36,2009-05-02,Man City,Blackburn,3,1,H,3,0,3,0,2,2,1,2,9,15,44,37,6,7,May,0.4999999999999999,-0.8660254037844387,27,4,0,2,3,1.2,2.4,53,45,8,37,55,-18,"May, 2009"
2008-2009,36,2009-05-02,Chelsea,Fulham,3,1,H,3,0,5,0,0,3,0,2,3,7,71,47,4,24,May,0.4999999999999999,-0.8660254037844387,14,19,2,3,0,1.6,1.0,56,20,36,34,28,6,"May, 2009"
2008-2009,36,2009-05-02,Middlesbrough,Man United,0,2,A,0,3,0,1,4,4,1,0,19,1,31,77,18,46,May,0.4999999999999999,-0.8660254037844387,29,28,0,2,3,1.0,2.0,25,49,-24,61,23,38,"May, 2009"
2008-2009,36,2009-05-03,Liverpool,Newcastle,3,0,H,3,0,5,0,0,1,1,3,2,18,74,31,16,43,May,0.4999999999999999,-0.8660254037844387,25,30,4,0,1,2.8,0.6,66,26,40,37,53,-16,"May, 2009"
2008-2009,36,2009-05-03,Sunderland,Everton,0,2,A,0,3,0,1,4,3,1,1,16,6,35,53,10,18,May,0.4999999999999999,-0.8660254037844387,40,18,0,1,4,0.6,2.8,31,46,-15,48,36,12,"May, 2009"
2008-2009,36,2009-05-04,Aston Villa,Hull,1,0,H,3,0,2,2,1,0,1,4,6,17,55,34,11,21,May,0.4999999999999999,-0.8660254037844387,1,21,1,0,0,1.0,0.0,50,44,6,37,59,-22,"May, 2009"
2008-2009,37,2009-05-09,West Brom,Wigan,3,1,H,3,0,2,1,2,1,1,3,20,11,28,42,9,14,May,0.4999999999999999,-0.8660254037844387,44,46,1,0,2,1.0,1.3333333333333333,33,64,-31,31,38,-7,"May, 2009"
2008-2009,37,2009-05-09,West Ham,Liverpool,0,3,A,0,3,2,0,3,5,0,0,9,2,48,77,7,29,May,0.4999999999999999,-0.8660254037844387,45,25,1,1,3,0.6,1.6,39,38,1,69,26,43,"May, 2009"
2008-2009,37,2009-05-09,Hull,Stoke,1,2,A,0,3,0,1,4,2,0,3,17,14,34,39,3,5,May,0.4999999999999999,-0.8660254037844387,21,39,0,1,0,1.0,1.0,37,60,-23,33,50,-17,"May, 2009"
2008-2009,37,2009-05-09,Everton,Tottenham,0,0,D,1,1,3,1,1,2,1,2,6,10,56,47,4,9,May,0.4999999999999999,-0.8660254037844387,18,42,3,1,1,1.4,0.6,50,36,14,42,41,1,"May, 2009"
2008-2009,37,2009-05-09,Fulham,Aston Villa,3,1,H,3,0,3,0,2,2,2,1,10,5,47,58,5,11,May,0.4999999999999999,-0.8660254037844387,19,1,1,3,1,1.0,1.0,35,31,4,51,44,7,"May, 2009"
2008-2009,37,2009-05-09,Bolton,Sunderland,0,0,D,1,1,0,4,1,0,1,4,13,16,39,35,3,4,May,0.4999999999999999,-0.8660254037844387,6,40,3,1,1,1.8,0.8,40,51,-11,31,48,-17,"May, 2009"
2008-2009,37,2009-05-09,Blackburn,Portsmouth,2,0,H,3,0,2,1,2,1,1,3,15,14,37,38,1,1,May,0.4999999999999999,-0.8660254037844387,4,33,2,0,3,1.2,1.4,38,58,-20,35,53,-18,"May, 2009"
2008-2009,37,2009-05-10,Arsenal,Chelsea,1,4,A,0,3,3,1,1,5,0,0,4,3,68,74,1,6,May,0.4999999999999999,-0.8660254037844387,0,14,2,2,1,1.2,1.0,63,32,31,59,21,38,"May, 2009"
2008-2009,37,2009-05-10,Man United,Man City,2,0,H,3,0,4,1,0,3,0,2,2,10,80,47,8,33,May,0.4999999999999999,-0.8660254037844387,28,27,3,0,2,1.2,0.8,63,23,40,56,46,10,"May, 2009"
2008-2009,37,2009-05-11,Newcastle,Middlesbrough,3,1,H,3,0,1,1,3,0,1,4,18,19,31,31,1,0,May,0.4999999999999999,-0.8660254037844387,30,29,0,4,1,0.6,0.8,37,56,-19,25,51,-26,"May, 2009"
2008-2009,37,2009-05-13,Wigan,Man United,1,2,A,0,3,1,1,3,4,1,0,11,1,42,83,10,41,May,0.4999999999999999,-0.8660254037844387,46,28,0,0,5,0.4,2.6,32,41,-9,65,23,42,"May, 2009"
2008-2009,38,2009-05-16,Tottenham,Man City,2,1,H,3,0,2,1,2,3,0,2,8,10,48,47,2,1,May,0.4999999999999999,-0.8660254037844387,42,27,4,0,1,1.8,1.2,42,41,1,56,48,8,"May, 2009"
2008-2009,38,2009-05-16,Stoke,Wigan,2,0,H,3,0,2,0,3,1,1,3,12,11,42,42,1,0,May,0.4999999999999999,-0.8660254037844387,39,46,0,1,0,0.0,0.0,35,51,-16,33,43,-10,"May, 2009"
2008-2009,38,2009-05-16,Newcastle,Fulham,0,1,A,0,3,1,1,3,3,0,2,18,7,34,50,11,16,May,0.4999999999999999,-0.8660254037844387,30,19,2,0,3,1.2,1.2,40,57,-17,38,32,6,"May, 2009"
2008-2009,38,2009-05-16,Middlesbrough,Aston Villa,1,1,D,1,1,0,1,4,2,2,1,19,6,31,58,13,27,May,0.4999999999999999,-0.8660254037844387,29,1,1,2,2,1.0,1.8,26,54,-28,52,47,5,"May, 2009"
2008-2009,38,2009-05-16,Man United,Arsenal,0,0,D,1,1,4,1,0,3,1,1,1,4,86,68,3,18,May,0.4999999999999999,-0.8660254037844387,28,0,1,1,3,1.2,1.6,67,24,43,64,36,28,"May, 2009"
2008-2009,38,2009-05-16,Everton,West Ham,3,1,H,3,0,3,1,1,2,0,3,6,9,57,48,3,9,May,0.4999999999999999,-0.8660254037844387,18,45,3,1,1,1.6,0.6,50,36,14,39,41,-2,"May, 2009"
2008-2009,38,2009-05-16,Bolton,Hull,1,1,D,1,1,0,4,1,0,1,4,13,18,40,34,5,6,May,0.4999999999999999,-0.8660254037844387,6,21,1,0,0,1.0,0.0,40,51,-11,38,62,-24,"May, 2009"
2008-2009,38,2009-05-17,Chelsea,Blackburn,2,0,H,3,0,5,0,0,2,1,2,3,14,77,40,11,37,May,0.4999999999999999,-0.8660254037844387,14,4,4,1,0,1.6,0.0,63,22,41,40,58,-18,"May, 2009"
2008-2009,38,2009-05-17,West Brom,Liverpool,0,2,A,0,3,2,1,2,5,0,0,20,2,31,80,18,49,May,0.4999999999999999,-0.8660254037844387,44,25,0,0,5,0.0,2.8,36,65,-29,72,26,46,"May, 2009"
2008-2009,38,2009-05-18,Portsmouth,Sunderland,3,1,H,3,0,1,1,3,0,1,4,15,16,38,36,1,2,May,0.4999999999999999,-0.8660254037844387,33,40,4,0,1,1.8,1.0,35,55,-20,31,48,-17,"May, 2009"
2008-2009,39,2009-05-24,Wigan,Portsmouth,1,0,H,3,0,1,1,3,1,1,3,12,14,42,41,2,1,May,0.4999999999999999,-0.8660254037844387,46,33,2,0,3,0.6,1.2,33,45,-12,38,56,-18,"May, 2009"
2008-2009,39,2009-05-24,West Ham,Middlesbrough,2,1,H,3,0,2,0,3,0,1,4,10,19,48,32,9,16,May,0.4999999999999999,-0.8660254037844387,45,29,3,1,1,1.6,0.6,40,44,-4,27,55,-28,"May, 2009"
2008-2009,39,2009-05-24,Sunderland,Chelsea,2,3,A,0,3,0,1,4,5,0,0,16,3,36,80,13,44,May,0.4999999999999999,-0.8660254037844387,40,14,0,0,5,0.2,2.4,32,51,-19,65,22,43,"May, 2009"
2008-2009,39,2009-05-24,Man City,Bolton,1,0,H,3,0,3,0,2,0,4,1,10,13,47,41,3,6,May,0.4999999999999999,-0.8660254037844387,27,6,1,2,2,0.8,1.2,57,50,7,41,52,-11,"May, 2009"
2008-2009,39,2009-05-24,Hull,Man United,0,1,A,0,3,0,1,4,4,1,0,17,1,35,87,16,52,May,0.4999999999999999,-0.8660254037844387,21,28,0,0,1,3.0,4.0,39,63,-24,67,24,43,"May, 2009"
2008-2009,39,2009-05-24,Blackburn,West Brom,0,0,D,1,1,2,1,2,2,1,2,15,20,40,31,5,9,May,0.4999999999999999,-0.8660254037844387,4,44,1,3,1,1.2,1.2,40,60,-20,36,67,-31,"May, 2009"
2008-2009,39,2009-05-24,Fulham,Everton,0,2,A,0,3,3,0,2,3,1,1,7,6,53,60,1,7,May,0.4999999999999999,-0.8660254037844387,19,18,2,0,3,0.6,1.6,39,32,7,53,37,16,"May, 2009"
2008-2009,39,2009-05-24,Aston Villa,Newcastle,1,0,H,3,0,2,2,1,1,1,3,6,18,59,34,12,25,May,0.4999999999999999,-0.8660254037844387,1,30,2,1,2,1.4,1.2,53,48,5,40,58,-18,"May, 2009"
2008-2009,39,2009-05-24,Arsenal,Stoke,4,1,H,3,0,3,1,1,2,0,3,4,11,69,45,7,24,May,0.4999999999999999,-0.8660254037844387,0,39,0,0,1,1.0,2.0,64,36,28,37,51,-14,"May, 2009"
2008-2009,39,2009-05-24,Liverpool,Tottenham,3,1,H,3,0,5,0,0,2,1,2,2,8,83,51,6,32,May,0.4999999999999999,-0.8660254037844387,25,42,3,1,1,1.8,0.8,74,26,48,44,42,2,"May, 2009"
2009-2010,1,2009-08-15,Wolves,West Ham,0,2,A,0,3,1,3,1,2,1,2,13,12,0,0,1,0,August,-0.8660254037844384,-0.5000000000000004,48,45,0,0,0,0.0,0.0,0,0,0,0,0,0,"August, 2009"
2009-2010,1,2009-08-15,Stoke,Burnley,2,0,H,3,0,1,1,3,2,0,3,11,8,0,0,3,0,August,-0.8660254037844384,-0.5000000000000004,39,11,0,0,0,0.0,0.0,0,0,0,0,0,0,"August, 2009"
2009-2010,1,2009-08-15,Portsmouth,Fulham,0,1,A,0,3,1,2,2,1,1,3,11,8,0,0,3,0,August,-0.8660254037844384,-0.5000000000000004,33,19,1,2,2,1.0,1.2,0,0,0,0,0,0,"August, 2009"
2009-2010,1,2009-08-15,Everton,Arsenal,1,6,A,0,3,3,2,0,1,1,3,8,5,0,0,3,0,August,-0.8660254037844384,-0.5000000000000004,18,0,1,1,3,0.8,1.8,0,0,0,0,0,0,"August, 2009"
2009-2010,1,2009-08-15,Bolton,Sunderland,0,1,A,0,3,2,1,2,2,0,3,5,15,0,0,10,0,August,-0.8660254037844384,-0.5000000000000004,6,40,3,1,1,1.8,0.8,0,0,0,0,0,0,"August, 2009"
2009-2010,1,2009-08-15,Blackburn,Man City,0,2,A,0,3,2,2,1,1,2,2,4,12,0,0,8,0,August,-0.8660254037844384,-0.5000000000000004,4,27,2,2,1,1.8,1.4,0,0,0,0,0,0,"August, 2009"
2009-2010,1,2009-08-15,Aston Villa,Wigan,0,2,A,0,3,3,0,2,1,2,2,2,19,0,0,17,0,August,-0.8660254037844384,-0.5000000000000004,1,46,2,2,1,1.4,0.8,0,0,0,0,0,0,"August, 2009"
2009-2010,1,2009-08-15,Chelsea,Hull,2,1,H,3,0,4,0,1,0,3,2,7,10,0,0,3,0,August,-0.8660254037844384,-0.5000000000000004,14,21,1,1,0,1.5,0.0,0,0,0,0,0,0,"August, 2009"
2009-2010,1,2009-08-16,Man United,Birmingham,1,0,H,3,0,4,1,0,1,1,3,11,9,0,0,2,0,August,-0.8660254037844384,-0.5000000000000004,28,3,4,1,0,1.8,0.4,0,0,0,0,0,0,"August, 2009"
2009-2010,1,2009-08-16,Tottenham,Liverpool,2,1,H,3,0,3,0,2,2,2,1,11,10,0,0,1,0,August,-0.8660254037844384,-0.5000000000000004,42,25,1,1,3,1.0,1.8,0,0,0,0,0,0,"August, 2009"
2009-2010,2,2009-08-18,Wigan,Wolves,0,1,A,0,3,1,2,2,1,3,1,6,19,3,0,13,3,August,-0.8660254037844384,-0.5000000000000004,46,48,0,0,0,0.0,0.0,2,0,2,0,2,-2,"August, 2009"
2009-2010,2,2009-08-18,Sunderland,Chelsea,1,3,A,0,3,2,0,3,4,0,1,10,6,3,3,4,0,August,-0.8660254037844384,-0.5000000000000004,40,14,0,0,5,0.6,2.6,1,0,1,2,1,1,"August, 2009"
2009-2010,2,2009-08-19,Burnley,Man United,1,0,H,3,0,2,0,3,4,1,0,18,9,0,3,9,3,August,-0.8660254037844384,-0.5000000000000004,11,28,0,0,0,0.0,0.0,0,2,-2,1,0,1,"August, 2009"
2009-2010,2,2009-08-19,Hull,Tottenham,1,5,A,0,3,0,3,2,3,0,2,14,6,0,3,8,3,August,-0.8660254037844384,-0.5000000000000004,21,42,1,0,1,1.0,1.0,1,2,-1,2,1,1,"August, 2009"
2009-2010,2,2009-08-19,Birmingham,Portsmouth,1,0,H,3,0,1,1,3,1,2,2,14,16,0,0,2,0,August,-0.8660254037844384,-0.5000000000000004,3,33,1,2,2,1.6,1.4,0,1,-1,0,1,-1,"August, 2009"
2009-2010,2,2009-08-19,Liverpool,Stoke,4,0,H,3,0,2,2,1,1,1,3,14,5,0,3,9,3,August,-0.8660254037844384,-0.5000000000000004,25,39,0,2,0,0.0,0.0,1,2,-1,2,0,2,"August, 2009"
2009-2010,3,2009-08-22,Wigan,Man United,0,5,A,0,3,1,2,2,4,1,0,10,12,3,3,2,0,August,-0.8660254037844384,-0.5000000000000004,46,28,0,0,5,0.4,2.4,2,1,1,1,1,0,"August, 2009"
2009-2010,3,2009-08-22,Sunderland,Blackburn,2,1,H,3,0,2,0,3,2,2,1,12,17,3,0,5,3,August,-0.8660254037844384,-0.5000000000000004,40,4,1,1,3,0.6,1.0,2,3,-1,0,2,-2,"August, 2009"
2009-2010,3,2009-08-22,Man City,Wolves,1,0,H,3,0,1,2,2,1,3,1,7,14,3,3,7,0,August,-0.8660254037844384,-0.5000000000000004,27,48,0,1,1,1.5,2.0,2,0,2,1,2,-1,"August, 2009"
2009-2010,3,2009-08-22,Birmingham,Stoke,0,0,D,1,1,1,1,3,1,1,3,9,14,3,3,5,0,August,-0.8660254037844384,-0.5000000000000004,3,39,0,0,0,0.0,0.0,1,1,0,2,4,-2,"August, 2009"
2009-2010,3,2009-08-22,Arsenal,Portsmouth,4,1,H,3,0,1,1,3,1,2,2,3,18,3,0,15,3,August,-0.8660254037844384,-0.5000000000000004,0,33,3,2,0,1.4,0.2,6,1,5,0,2,-2,"August, 2009"
2009-2010,3,2009-08-22,Hull,Bolton,1,0,H,3,0,0,3,2,2,1,2,18,15,0,0,3,0,August,-0.8660254037844384,-0.5000000000000004,21,6,0,1,1,0.5,1.0,2,7,-5,0,1,-1,"August, 2009"
2009-2010,3,2009-08-23,Burnley,Everton,1,0,H,3,0,2,0,3,3,2,0,12,19,3,0,7,3,August,-0.8660254037844384,-0.5000000000000004,11,18,0,0,0,0.0,0.0,1,2,-1,1,6,-5,"August, 2009"
2009-2010,3,2009-08-23,Fulham,Chelsea,0,2,A,0,3,1,1,3,4,0,1,12,4,3,6,8,3,August,-0.8660254037844384,-0.5000000000000004,19,14,0,3,2,1.2,1.8,1,0,1,5,2,3,"August, 2009"
2009-2010,3,2009-08-23,West Ham,Tottenham,1,2,A,0,3,2,1,2,3,0,2,11,3,3,6,8,3,August,-0.8660254037844384,-0.5000000000000004,45,42,0,1,4,0.8,2.4,2,0,2,7,2,5,"August, 2009"
2009-2010,3,2009-08-24,Liverpool,Aston Villa,1,3,A,0,3,2,2,1,3,0,2,10,16,3,0,6,3,August,-0.8660254037844384,-0.5000000000000004,25,1,2,3,0,1.8,0.6,5,2,3,0,2,-2,"August, 2009"
2009-2010,4,2009-08-29,Wolves,Hull,1,1,D,1,1,1,3,1,0,3,2,14,15,3,3,1,0,August,-0.8660254037844384,-0.5000000000000004,48,21,0,0,0,0.0,0.0,1,3,-2,3,7,-4,"August, 2009"
2009-2010,4,2009-08-29,Tottenham,Birmingham,2,1,H,3,0,3,0,2,1,1,3,2,11,9,4,9,5,August,-0.8660254037844384,-0.5000000000000004,42,3,2,1,2,1.6,1.6,9,3,6,1,1,0,"August, 2009"
2009-2010,4,2009-08-29,Stoke,Sunderland,1,0,H,3,0,1,1,3,2,0,3,11,7,4,6,4,2,August,-0.8660254037844384,-0.5000000000000004,39,40,1,0,1,0.5,1.0,2,4,-2,4,4,0,"August, 2009"
2009-2010,4,2009-08-29,Man United,Arsenal,2,1,H,3,0,4,1,0,1,1,3,4,3,6,6,1,0,August,-0.8660254037844384,-0.5000000000000004,28,0,1,2,2,1.2,1.4,6,1,5,10,2,8,"August, 2009"
2009-2010,4,2009-08-29,Chelsea,Burnley,3,0,H,3,0,4,0,1,2,0,3,2,8,9,6,6,3,August,-0.8660254037844384,-0.5000000000000004,14,11,0,0,0,0.0,0.0,7,2,5,2,2,0,"August, 2009"
2009-2010,4,2009-08-29,Bolton,Liverpool,2,3,A,0,3,2,1,2,2,2,1,18,11,0,3,7,3,August,-0.8660254037844384,-0.5000000000000004,6,25,0,0,5,0.2,3.0,0,2,-2,6,5,1,"August, 2009"
2009-2010,4,2009-08-29,Blackburn,West Ham,0,0,D,1,1,2,2,1,2,1,2,18,11,0,3,7,3,August,-0.8660254037844384,-0.5000000000000004,4,45,0,1,4,0.8,2.0,1,4,-3,3,2,1,"August, 2009"
2009-2010,4,2009-08-30,Aston Villa,Fulham,2,0,H,3,0,3,0,2,1,1,3,14,15,3,3,1,0,August,-0.8660254037844384,-0.5000000000000004,1,19,1,2,2,1.0,1.4,3,3,0,1,2,-1,"August, 2009"
2009-2010,4,2009-08-30,Everton,Wigan,2,1,H,3,0,3,2,0,1,2,2,20,16,0,3,4,3,August,-0.8660254037844384,-0.5000000000000004,18,46,4,0,1,2.0,0.6,1,7,-6,2,6,-4,"August, 2009"
2009-2010,4,2009-08-30,Portsmouth,Man City,0,1,A,0,3,1,2,2,1,2,2,20,6,0,6,14,6,August,-0.8660254037844384,-0.5000000000000004,33,27,2,1,2,1.0,2.0,1,6,-5,3,0,3,"August, 2009"
2009-2010,5,2009-09-12,Wigan,West Ham,1,0,H,3,0,1,2,2,2,1,2,19,11,3,4,8,1,September,-1.0,-1.8369701987210287e-16,46,45,1,1,3,0.6,1.4,3,8,-5,3,2,1,"September, 2009"
2009-2010,5,2009-09-12,Tottenham,Man United,1,3,A,0,3,3,0,2,4,1,0,2,5,12,9,3,3,September,-1.0,-1.8369701987210287e-16,42,28,0,2,3,0.6,2.2,11,4,7,8,2,6,"September, 2009"
2009-2010,5,2009-09-12,Stoke,Chelsea,1,2,A,0,3,1,1,3,4,0,1,6,1,7,12,5,5,September,-1.0,-1.8369701987210287e-16,39,14,0,0,2,0.5,2.0,3,4,-1,10,2,8,"September, 2009"
2009-2010,5,2009-09-12,Sunderland,Hull,4,1,H,3,0,2,0,3,0,3,2,9,14,6,4,5,2,September,-1.0,-1.8369701987210287e-16,40,21,2,0,0,2.5,0.5,4,5,-1,4,8,-4,"September, 2009"
2009-2010,5,2009-09-12,Man City,Arsenal,4,2,H,3,0,1,2,2,1,1,3,5,7,9,6,2,3,September,-1.0,-1.8369701987210287e-16,27,0,1,0,4,1.0,1.8,4,0,4,11,4,7,"September, 2009"
2009-2010,5,2009-09-12,Portsmouth,Bolton,2,3,A,0,3,1,2,2,2,1,2,20,19,0,0,1,0,September,-1.0,-1.8369701987210287e-16,33,6,3,0,2,1.6,1.2,1,7,-6,2,5,-3,"September, 2009"
2009-2010,5,2009-09-12,Liverpool,Burnley,4,0,H,3,0,2,2,1,2,0,3,7,10,6,6,3,0,September,-1.0,-1.8369701987210287e-16,25,11,0,0,0,0.0,0.0,9,7,2,2,5,-3,"September, 2009"
2009-2010,5,2009-09-12,Blackburn,Wolves,3,1,H,3,0,2,2,1,1,3,1,18,13,1,4,5,3,September,-1.0,-1.8369701987210287e-16,4,48,1,1,0,3.5,1.5,1,4,-3,2,4,-2,"September, 2009"
2009-2010,5,2009-09-13,Birmingham,Aston Villa,0,1,A,0,3,1,1,3,3,0,2,14,9,4,6,5,2,September,-1.0,-1.8369701987210287e-16,3,1,1,0,4,1.0,2.2,2,3,-1,5,3,2,"September, 2009"
2009-2010,5,2009-09-13,Fulham,Everton,2,1,H,3,0,1,1,3,3,2,0,18,19,3,3,1,0,September,-1.0,-1.8369701987210287e-16,19,18,1,0,4,0.4,2.0,1,4,-3,3,8,-5,"September, 2009"
2009-2010,6,2009-09-19,Hull,Birmingham,0,1,A,0,3,0,3,2,1,1,3,18,16,4,4,2,0,September,-1.0,-1.8369701987210287e-16,21,3,0,0,0,0.0,0.0,5,12,-7,2,4,-2,"September, 2009"
2009-2010,6,2009-09-19,Burnley,Sunderland,3,1,H,3,0,2,0,3,2,0,3,11,8,6,9,3,3,September,-1.0,-1.8369701987210287e-16,11,40,0,0,0,0.0,0.0,2,9,-7,8,6,2,"September, 2009"
2009-2010,6,2009-09-19,West Ham,Liverpool,2,3,A,0,3,2,1,2,2,2,1,14,7,4,9,7,5,September,-1.0,-1.8369701987210287e-16,45,25,1,1,3,0.4,1.8,3,3,0,13,7,6,"September, 2009"
2009-2010,6,2009-09-19,Aston Villa,Portsmouth,2,0,H,3,0,3,0,2,1,2,2,7,20,9,0,13,9,September,-1.0,-1.8369701987210287e-16,1,33,1,2,2,0.4,1.0,6,3,3,3,10,-7,"September, 2009"
2009-2010,6,2009-09-19,Arsenal,Wigan,4,0,H,3,0,1,1,3,1,2,2,9,11,6,6,2,0,September,-1.0,-1.8369701987210287e-16,0,46,4,1,0,1.8,0.4,13,8,5,4,8,-4,"September, 2009"
2009-2010,6,2009-09-19,Bolton,Stoke,1,1,D,1,1,2,1,2,1,1,3,18,9,3,7,9,4,September,-1.0,-1.8369701987210287e-16,6,39,1,0,1,1.5,1.5,5,7,-2,4,6,-2,"September, 2009"
2009-2010,6,2009-09-20,Chelsea,Tottenham,3,0,H,3,0,4,0,1,3,0,2,1,5,15,12,4,3,September,-1.0,-1.8369701987210287e-16,14,42,2,2,1,1.6,1.2,12,3,9,12,7,5,"September, 2009"
2009-2010,6,2009-09-20,Everton,Blackburn,3,0,H,3,0,3,2,0,2,2,1,19,15,3,4,4,1,September,-1.0,-1.8369701987210287e-16,18,4,1,3,1,0.8,0.8,4,10,-6,4,5,-1,"September, 2009"
2009-2010,6,2009-09-20,Man United,Man City,4,3,H,3,0,4,1,0,1,2,2,2,4,12,12,2,0,September,-1.0,-1.8369701987210287e-16,28,27,3,0,2,1.0,0.6,11,3,8,8,2,6,"September, 2009"
2009-2010,6,2009-09-20,Wolves,Fulham,2,1,H,3,0,1,3,1,1,1,3,18,12,4,6,6,2,September,-1.0,-1.8369701987210287e-16,48,19,1,1,0,1.0,0.5,3,7,-4,3,5,-2,"September, 2009"
2009-2010,7,2009-09-26,Tottenham,Burnley,5,0,H,3,0,3,0,2,2,0,3,7,10,12,9,3,3,September,-1.0,-1.8369701987210287e-16,42,11,0,0,0,0.0,0.0,12,10,2,5,10,-5,"September, 2009"
2009-2010,7,2009-09-26,Birmingham,Bolton,1,2,A,0,3,1,1,3,2,1,2,11,17,7,4,6,3,September,-1.0,-1.8369701987210287e-16,3,6,2,0,3,0.6,1.2,3,4,-1,6,8,-2,"September, 2009"
2009-2010,7,2009-09-26,Blackburn,Aston Villa,2,1,H,3,0,2,2,1,3,0,2,18,5,4,12,13,8,September,-1.0,-1.8369701987210287e-16,4,1,0,1,4,0.8,2.4,4,8,-4,8,3,5,"September, 2009"
2009-2010,7,2009-09-26,Fulham,Arsenal,0,1,A,0,3,1,1,3,1,1,3,16,7,6,9,9,3,September,-1.0,-1.8369701987210287e-16,19,0,1,1,3,0.6,1.6,4,7,-3,17,8,9,"September, 2009"
2009-2010,7,2009-09-26,Liverpool,Hull,6,1,H,3,0,2,2,1,0,3,2,4,19,12,4,15,8,September,-1.0,-1.8369701987210287e-16,25,21,1,1,0,2.5,1.5,16,9,7,5,13,-8,"September, 2009"
2009-2010,7,2009-09-26,Portsmouth,Everton,0,1,A,0,3,1,2,2,3,2,0,20,15,0,6,5,6,September,-1.0,-1.8369701987210287e-16,33,18,2,1,2,1.2,1.4,3,12,-9,7,10,-3,"September, 2009"
2009-2010,7,2009-09-26,Stoke,Man United,0,2,A,0,3,1,1,3,4,1,0,11,3,8,15,8,7,September,-1.0,-1.8369701987210287e-16,39,28,0,0,2,0.0,3.0,5,7,-2,15,6,9,"September, 2009"
2009-2010,7,2009-09-26,Wigan,Chelsea,3,1,H,3,0,1,2,2,4,0,1,17,1,6,18,16,12,September,-1.0,-1.8369701987210287e-16,46,14,0,1,4,0.4,2.0,4,12,-8,15,3,12,"September, 2009"
2009-2010,7,2009-09-27,Sunderland,Wolves,5,2,H,3,0,2,0,3,1,3,1,8,16,9,7,8,2,September,-1.0,-1.8369701987210287e-16,40,48,0,0,0,0.0,0.0,9,9,0,5,8,-3,"September, 2009"
2009-2010,7,2009-09-28,Man City,West Ham,3,1,H,3,0,1,2,2,2,1,2,6,18,12,4,12,8,September,-1.0,-1.8369701987210287e-16,27,45,3,1,1,1.4,0.4,11,6,5,5,6,-1,"September, 2009"
2009-2010,8,2009-10-03,Bolton,Tottenham,2,2,D,1,1,2,1,2,3,0,2,13,4,7,15,9,8,October,-0.8660254037844386,0.5,6,42,1,2,2,1.2,2.0,8,9,-1,17,10,7,"October, 2009"
2009-2010,8,2009-10-03,Burnley,Birmingham,2,1,H,3,0,2,0,3,1,1,3,11,14,9,7,3,2,October,-0.8660254037844386,0.5,11,3,0,0,0,0.0,0.0,5,15,-10,4,6,-2,"October, 2009"
2009-2010,8,2009-10-03,Hull,Wigan,2,1,H,3,0,0,3,2,1,2,2,19,11,4,9,8,5,October,-0.8660254037844386,0.5,21,46,0,0,2,0.0,3.0,6,19,-13,7,13,-6,"October, 2009"
2009-2010,8,2009-10-03,Man United,Sunderland,2,2,D,1,1,4,1,0,2,0,3,1,8,18,12,7,6,October,-0.8660254037844386,0.5,28,40,4,1,0,1.6,0.2,17,6,11,14,11,3,"October, 2009"
2009-2010,8,2009-10-03,Wolves,Portsmouth,0,1,A,0,3,1,3,1,1,2,2,16,20,7,0,4,7,October,-0.8660254037844386,0.5,48,33,0,2,0,0.0,0.0,7,13,-6,3,13,-10,"October, 2009"
2009-2010,8,2009-10-04,Arsenal,Blackburn,6,2,H,3,0,1,1,3,2,2,1,7,14,12,7,7,5,October,-0.8660254037844386,0.5,0,4,4,1,0,2.6,0.2,18,8,10,6,9,-3,"October, 2009"
2009-2010,8,2009-10-04,Chelsea,Liverpool,2,0,H,3,0,4,0,1,2,2,1,2,5,18,15,3,3,October,-0.8660254037844386,0.5,14,25,0,2,3,0.2,1.2,16,6,10,22,10,12,"October, 2009"
2009-2010,8,2009-10-04,Everton,Stoke,1,1,D,1,1,3,2,0,1,1,3,10,13,9,8,3,1,October,-0.8660254037844386,0.5,18,39,2,0,0,3.0,1.5,8,10,-2,5,9,-4,"October, 2009"
2009-2010,8,2009-10-04,West Ham,Fulham,2,2,D,1,1,2,1,2,1,1,3,19,18,4,6,1,2,October,-0.8660254037844386,0.5,45,19,4,1,0,2.2,1.2,6,9,-3,4,8,-4,"October, 2009"
2009-2010,8,2009-10-05,Aston Villa,Man City,1,1,D,1,1,3,0,2,1,2,2,8,6,12,15,2,3,October,-0.8660254037844386,0.5,1,27,2,1,2,1.4,1.2,9,5,4,14,7,7,"October, 2009"
2009-2010,9,2009-10-17,Sunderland,Liverpool,1,0,H,3,0,2,0,3,2,2,1,8,7,13,15,1,2,October,-0.8660254037844386,0.5,40,25,0,0,5,0.0,2.0,16,13,3,22,12,10,"October, 2009"
2009-2010,9,2009-10-17,Stoke,West Ham,2,1,H,3,0,1,1,3,2,1,2,11,19,9,5,8,4,October,-0.8660254037844386,0.5,39,45,0,0,2,0.5,1.5,6,10,-4,8,11,-3,"October, 2009"
2009-2010,9,2009-10-17,Portsmouth,Tottenham,1,2,A,0,3,1,2,2,3,0,2,20,4,3,16,16,13,October,-0.8660254037844386,0.5,33,42,1,2,2,0.8,1.0,4,13,-9,19,12,7,"October, 2009"
2009-2010,9,2009-10-17,Arsenal,Birmingham,3,1,H,3,0,1,1,3,1,1,3,5,14,15,7,9,8,October,-0.8660254037844386,0.5,0,3,2,2,1,1.4,1.0,24,10,14,5,8,-3,"October, 2009"
2009-2010,9,2009-10-17,Everton,Wolves,1,1,D,1,1,3,2,0,1,3,1,10,17,10,7,7,3,October,-0.8660254037844386,0.5,18,48,1,0,1,1.5,1.0,9,11,-2,7,14,-7,"October, 2009"
2009-2010,9,2009-10-17,Aston Villa,Chelsea,2,1,H,3,0,3,0,2,4,0,1,7,1,13,21,6,8,October,-0.8660254037844386,0.5,1,14,1,2,2,1.2,1.4,10,6,4,18,6,12,"October, 2009"
2009-2010,9,2009-10-17,Man United,Bolton,2,1,H,3,0,4,1,0,2,1,2,2,13,19,8,11,11,October,-0.8660254037844386,0.5,28,6,4,0,1,1.8,0.4,19,8,11,10,11,-1,"October, 2009"
2009-2010,9,2009-10-18,Blackburn,Burnley,3,2,H,3,0,2,2,1,2,0,3,17,10,7,12,7,5,October,-0.8660254037844386,0.5,4,11,0,0,0,0.0,0.0,8,15,-7,7,16,-9,"October, 2009"
2009-2010,9,2009-10-18,Wigan,Man City,1,1,D,1,1,1,2,2,1,2,2,13,5,9,16,8,7,October,-0.8660254037844386,0.5,46,27,2,2,1,0.8,0.6,8,15,-7,15,8,7,"October, 2009"
2009-2010,9,2009-10-19,Fulham,Hull,2,0,H,3,0,1,1,3,0,3,2,16,18,7,7,2,0,October,-0.8660254037844386,0.5,19,21,0,0,2,0.5,1.5,6,10,-4,8,20,-12,"October, 2009"
2009-2010,10,2009-10-24,Tottenham,Stoke,0,1,A,0,3,3,0,2,1,1,3,3,10,19,12,7,7,October,-0.8660254037844386,0.5,42,39,1,0,1,2.0,1.5,21,13,8,8,11,-3,"October, 2009"
2009-2010,10,2009-10-24,Wolves,Aston Villa,1,1,D,1,1,1,3,1,3,0,2,17,6,8,16,11,8,October,-0.8660254037844386,0.5,48,1,0,0,2,1.0,3.5,8,15,-7,12,7,5,"October, 2009"
2009-2010,10,2009-10-24,Hull,Portsmouth,0,0,D,1,1,0,3,2,1,2,2,18,20,7,3,2,4,October,-0.8660254037844386,0.5,21,33,0,2,0,1.0,1.0,8,22,-14,5,15,-10,"October, 2009"
2009-2010,10,2009-10-24,Birmingham,Sunderland,2,1,H,3,0,1,1,3,2,0,3,17,7,7,16,10,9,October,-0.8660254037844386,0.5,3,40,3,1,1,1.2,0.8,6,11,-5,17,13,4,"October, 2009"
2009-2010,10,2009-10-24,Burnley,Wigan,1,3,A,0,3,2,0,3,1,2,2,10,15,12,10,5,2,October,-0.8660254037844386,0.5,11,46,0,0,0,0.0,0.0,9,19,-10,9,16,-7,"October, 2009"
2009-2010,10,2009-10-24,Chelsea,Blackburn,5,0,H,3,0,4,0,1,2,2,1,2,15,21,10,13,11,October,-0.8660254037844386,0.5,14,4,4,1,0,1.6,0.0,19,8,11,11,17,-6,"October, 2009"
2009-2010,10,2009-10-25,Bolton,Everton,3,2,H,3,0,2,1,2,3,2,0,17,12,8,11,5,3,October,-0.8660254037844386,0.5,6,18,0,1,4,0.4,1.8,11,13,-2,10,12,-2,"October, 2009"
2009-2010,10,2009-10-25,Liverpool,Man United,2,0,H,3,0,2,2,1,4,1,0,8,2,15,22,6,7,October,-0.8660254037844386,0.5,25,28,2,0,3,1.2,1.4,22,13,9,21,9,12,"October, 2009"
2009-2010,10,2009-10-25,Man City,Fulham,2,2,D,1,1,1,2,2,1,1,3,6,14,17,10,8,7,October,-0.8660254037844386,0.5,27,19,1,2,2,2.0,2.2,16,9,7,8,10,-2,"October, 2009"
2009-2010,10,2009-10-25,West Ham,Arsenal,2,2,D,1,1,2,1,2,1,1,3,19,4,5,18,15,13,October,-0.8660254037844386,0.5,45,0,1,1,3,0.2,1.0,9,13,-4,27,11,16,"October, 2009"
2009-2010,11,2009-10-31,Sunderland,West Ham,2,2,D,1,1,2,0,3,2,1,2,8,20,16,6,12,10,October,-0.8660254037844386,0.5,40,45,1,0,4,0.6,1.8,18,15,3,11,15,-4,"October, 2009"
2009-2010,11,2009-10-31,Stoke,Wolves,2,2,D,1,1,1,1,3,1,3,1,9,17,15,9,8,6,October,-0.8660254037844386,0.5,39,48,0,0,0,0.0,0.0,9,11,-2,9,16,-7,"October, 2009"
2009-2010,11,2009-10-31,Portsmouth,Wigan,4,0,H,3,0,1,2,2,1,2,2,20,12,4,13,8,9,October,-0.8660254037844386,0.5,33,46,2,0,3,1.0,0.8,5,15,-10,12,17,-5,"October, 2009"
2009-2010,11,2009-10-31,Man United,Blackburn,2,0,H,3,0,4,1,0,2,2,1,3,16,22,10,13,12,October,-0.8660254037844386,0.5,28,4,4,1,0,2.2,0.6,21,11,10,11,22,-11,"October, 2009"
2009-2010,11,2009-10-31,Everton,Aston Villa,1,1,D,1,1,3,2,0,3,0,2,13,7,11,17,6,6,October,-0.8660254037844386,0.5,18,1,0,3,2,1.6,2.2,12,15,-3,13,8,5,"October, 2009"
2009-2010,11,2009-10-31,Burnley,Hull,2,0,H,3,0,2,0,3,0,3,2,11,18,12,8,7,4,October,-0.8660254037844386,0.5,11,21,0,0,0,0.0,0.0,10,22,-12,8,22,-14,"October, 2009"
2009-2010,11,2009-10-31,Bolton,Chelsea,0,4,A,0,3,2,1,2,4,0,1,12,1,11,24,11,13,October,-0.8660254037844386,0.5,6,14,0,2,3,1.2,2.0,14,15,-1,24,8,16,"October, 2009"
2009-2010,11,2009-10-31,Arsenal,Tottenham,3,0,H,3,0,1,1,3,3,0,2,3,4,19,19,1,0,October,-0.8660254037844386,0.5,0,42,2,3,0,2.2,1.6,29,13,16,21,14,7,"October, 2009"
2009-2010,11,2009-10-31,Fulham,Liverpool,3,1,H,3,0,1,1,3,2,2,1,13,5,11,18,8,7,October,-0.8660254037844386,0.5,19,25,1,1,3,0.2,1.0,10,12,-2,24,13,11,"October, 2009"
2009-2010,11,2009-11-01,Birmingham,Man City,0,0,D,1,1,1,1,3,1,2,2,15,6,10,18,9,8,November,-0.5000000000000004,0.8660254037844384,3,27,1,0,4,1.0,2.2,8,12,-4,18,11,7,"November, 2009"
2009-2010,11,2009-11-04,West Ham,Aston Villa,2,1,H,3,0,2,1,2,3,0,2,19,7,7,18,12,11,November,-0.5000000000000004,0.8660254037844384,45,1,0,2,3,0.6,1.2,13,17,-4,14,9,5,"November, 2009"
2009-2010,12,2009-11-07,Wolves,Arsenal,1,4,A,0,3,1,3,1,1,1,3,18,3,10,22,15,12,November,-0.5000000000000004,0.8660254037844384,48,0,0,0,2,0.5,3.0,11,18,-7,32,13,19,"November, 2009"
2009-2010,12,2009-11-07,Tottenham,Sunderland,2,0,H,3,0,3,0,2,2,0,3,6,8,19,17,2,2,November,-0.5000000000000004,0.8660254037844384,42,40,1,2,2,1.0,1.0,21,17,4,20,17,3,"November, 2009"
2009-2010,12,2009-11-07,Aston Villa,Bolton,5,1,H,3,0,3,0,2,2,1,2,7,15,18,11,8,7,November,-0.5000000000000004,0.8660254037844384,1,6,2,3,0,2.4,1.2,15,11,4,14,19,-5,"November, 2009"
2009-2010,12,2009-11-07,Blackburn,Portsmouth,3,1,H,3,0,2,2,1,1,2,2,18,20,10,7,2,3,November,-0.5000000000000004,0.8660254037844384,4,33,3,0,2,1.6,0.8,11,24,-13,9,15,-6,"November, 2009"
2009-2010,12,2009-11-07,Man City,Burnley,3,3,D,1,1,1,2,2,2,0,3,5,10,19,15,5,4,November,-0.5000000000000004,0.8660254037844384,27,11,0,0,0,0.0,0.0,18,11,7,12,22,-10,"November, 2009"
2009-2010,12,2009-11-08,Chelsea,Man United,1,0,H,3,0,4,0,1,4,1,0,1,3,27,25,2,2,November,-0.5000000000000004,0.8660254037844384,14,28,1,2,2,0.6,1.4,28,8,20,23,11,12,"November, 2009"
2009-2010,12,2009-11-08,Hull,Stoke,2,1,H,3,0,0,3,2,1,1,3,19,9,8,16,10,8,November,-0.5000000000000004,0.8660254037844384,21,39,0,1,1,1.0,1.5,8,24,-16,11,13,-2,"November, 2009"
2009-2010,12,2009-11-08,West Ham,Everton,1,2,A,0,3,2,1,2,3,2,0,18,14,10,12,4,2,November,-0.5000000000000004,0.8660254037844384,45,18,1,1,3,0.8,1.8,15,18,-3,13,16,-3,"November, 2009"
2009-2010,12,2009-11-08,Wigan,Fulham,1,1,D,1,1,1,2,2,1,1,3,13,12,13,14,1,1,November,-0.5000000000000004,0.8660254037844384,46,19,0,4,1,0.4,0.8,12,21,-9,13,13,0,"November, 2009"
2009-2010,12,2009-11-09,Liverpool,Birmingham,2,2,D,1,1,2,2,1,1,1,3,7,15,18,11,8,7,November,-0.5000000000000004,0.8660254037844384,25,3,0,4,1,1.0,1.4,25,16,9,8,12,-4,"November, 2009"
2009-2010,13,2009-11-21,Sunderland,Arsenal,1,0,H,3,0,2,0,3,1,1,3,8,3,17,25,5,8,November,-0.5000000000000004,0.8660254037844384,40,0,0,2,3,0.6,1.6,20,19,1,36,14,22,"November, 2009"
2009-2010,13,2009-11-21,Man United,Everton,3,0,H,3,0,4,1,0,3,2,0,3,12,25,15,9,10,November,-0.5000000000000004,0.8660254037844384,28,18,4,1,0,1.8,0.8,23,12,11,15,17,-2,"November, 2009"
2009-2010,13,2009-11-21,Hull,West Ham,3,3,D,1,1,0,3,2,2,1,2,17,18,11,10,1,1,November,-0.5000000000000004,0.8660254037844384,21,45,1,0,1,0.5,1.0,10,25,-15,16,20,-4,"November, 2009"
2009-2010,13,2009-11-21,Liverpool,Man City,2,2,D,1,1,2,2,1,1,2,2,7,6,19,20,1,1,November,-0.5000000000000004,0.8660254037844384,25,27,2,3,0,1.0,0.6,27,18,9,21,14,7,"November, 2009"
2009-2010,13,2009-11-21,Burnley,Aston Villa,1,1,D,1,1,2,0,3,3,0,2,10,5,16,21,5,5,November,-0.5000000000000004,0.8660254037844384,11,1,0,0,0,0.0,0.0,15,25,-10,20,12,8,"November, 2009"
2009-2010,13,2009-11-21,Birmingham,Fulham,1,0,H,3,0,1,1,3,1,1,3,15,11,12,15,4,3,November,-0.5000000000000004,0.8660254037844384,3,19,1,2,2,0.6,1.0,10,14,-4,14,14,0,"November, 2009"
2009-2010,13,2009-11-21,Chelsea,Wolves,4,0,H,3,0,4,0,1,1,3,1,1,19,30,10,18,20,November,-0.5000000000000004,0.8660254037844384,14,48,2,0,0,5.0,1.0,29,8,21,12,22,-10,"November, 2009"
2009-2010,13,2009-11-22,Bolton,Blackburn,0,2,A,0,3,2,1,2,2,2,1,18,15,11,13,3,2,November,-0.5000000000000004,0.8660254037844384,6,4,0,2,3,1.0,2.0,15,24,-9,14,25,-11,"November, 2009"
2009-2010,13,2009-11-22,Stoke,Portsmouth,1,0,H,3,0,1,1,3,1,2,2,10,20,16,7,10,9,November,-0.5000000000000004,0.8660254037844384,39,33,0,1,1,1.5,2.0,12,15,-3,10,18,-8,"November, 2009"
2009-2010,13,2009-11-22,Tottenham,Wigan,9,1,H,3,0,3,0,2,1,2,2,5,15,22,14,10,8,November,-0.5000000000000004,0.8660254037844384,42,46,1,3,1,1.6,1.0,23,17,6,13,22,-9,"November, 2009"
2009-2010,13,2009-11-25,Fulham,Blackburn,3,0,H,3,0,1,1,3,2,2,1,12,11,15,16,1,1,November,-0.5000000000000004,0.8660254037844384,19,4,0,3,2,1.0,1.4,14,15,-1,16,25,-9,"November, 2009"
2009-2010,13,2009-11-25,Hull,Everton,3,2,H,3,0,0,3,2,3,2,0,16,14,12,15,2,3,November,-0.5000000000000004,0.8660254037844384,21,18,0,1,1,1.0,2.0,13,28,-15,15,20,-5,"November, 2009"
2009-2010,14,2009-11-28,West Ham,Burnley,5,3,H,3,0,2,1,2,2,0,3,18,11,11,17,7,6,November,-0.5000000000000004,0.8660254037844384,45,11,0,0,0,0.0,0.0,19,23,-4,16,26,-10,"November, 2009"
2009-2010,14,2009-11-28,Wigan,Sunderland,1,0,H,3,0,1,2,2,2,0,3,17,8,14,20,9,6,November,-0.5000000000000004,0.8660254037844384,46,40,3,1,1,1.4,0.8,14,31,-17,21,19,2,"November, 2009"
2009-2010,14,2009-11-28,Portsmouth,Man United,1,4,A,0,3,1,2,2,4,1,0,20,2,7,28,18,21,November,-0.5000000000000004,0.8660254037844384,33,28,1,1,3,0.6,1.4,10,19,-9,26,12,14,"November, 2009"
2009-2010,14,2009-11-28,Man City,Hull,1,1,D,1,1,1,2,2,0,3,2,6,15,21,15,9,6,November,-0.5000000000000004,0.8660254037844384,27,21,1,1,0,3.5,1.5,23,16,7,16,30,-14,"November, 2009"
2009-2010,14,2009-11-28,Fulham,Bolton,1,1,D,1,1,1,1,3,2,1,2,10,18,18,11,8,7,November,-0.5000000000000004,0.8660254037844384,19,6,3,1,1,1.6,1.0,17,15,2,15,26,-11,"November, 2009"
2009-2010,14,2009-11-28,Blackburn,Stoke,0,0,D,1,1,2,2,1,1,1,3,12,9,16,19,3,3,November,-0.5000000000000004,0.8660254037844384,4,39,1,0,1,1.5,0.5,16,28,-12,13,15,-2,"November, 2009"
2009-2010,14,2009-11-28,Aston Villa,Tottenham,1,1,D,1,1,3,0,2,3,0,2,5,4,22,25,1,3,November,-0.5000000000000004,0.8660254037844384,1,42,2,1,2,2.0,2.0,21,13,8,32,18,14,"November, 2009"
2009-2010,14,2009-11-29,Arsenal,Chelsea,0,3,A,0,3,1,1,3,4,0,1,4,1,25,33,3,8,November,-0.5000000000000004,0.8660254037844384,0,14,2,1,2,1.2,1.6,36,15,21,33,8,25,"November, 2009"
2009-2010,14,2009-11-29,Everton,Liverpool,0,2,A,0,3,3,2,0,2,2,1,16,7,15,20,9,5,November,-0.5000000000000004,0.8660254037844384,18,25,0,2,3,0.4,1.2,17,23,-6,29,20,9,"November, 2009"
2009-2010,14,2009-11-29,Wolves,Birmingham,0,1,A,0,3,1,3,1,1,1,3,19,15,10,15,4,5,November,-0.5000000000000004,0.8660254037844384,48,3,0,2,0,1.5,1.5,12,26,-14,11,14,-3,"November, 2009"
2009-2010,15,2009-12-05,Wolves,Bolton,2,1,H,3,0,1,3,1,2,1,2,20,18,10,12,2,2,December,-2.4492935982947064e-16,1.0,48,6,0,1,1,1.0,1.5,12,27,-15,16,27,-11,"December, 2009"
2009-2010,15,2009-12-05,Wigan,Birmingham,2,3,A,0,3,1,2,2,1,1,3,14,11,17,18,3,1,December,-2.4492935982947064e-16,1.0,46,3,1,1,2,1.25,1.5,15,31,-16,12,14,-2,"December, 2009"
2009-2010,15,2009-12-05,West Ham,Man United,0,4,A,0,3,2,1,2,4,1,0,17,2,14,31,15,17,December,-2.4492935982947064e-16,1.0,45,28,2,0,3,0.8,1.6,24,26,-2,30,13,17,"December, 2009"
2009-2010,15,2009-12-05,Portsmouth,Burnley,2,0,H,3,0,1,2,2,2,0,3,20,13,7,17,7,10,December,-2.4492935982947064e-16,1.0,33,11,0,0,0,0.0,0.0,11,23,-12,19,31,-12,"December, 2009"
2009-2010,15,2009-12-05,Man City,Chelsea,2,1,H,3,0,1,2,2,4,0,1,7,1,22,36,6,14,December,-2.4492935982947064e-16,1.0,27,14,0,0,5,0.2,2.6,24,17,7,36,8,28,"December, 2009"
2009-2010,15,2009-12-05,Blackburn,Liverpool,0,0,D,1,1,2,2,1,2,2,1,13,6,17,23,7,6,December,-2.4492935982947064e-16,1.0,4,25,1,1,3,0.6,2.0,16,28,-12,31,20,11,"December, 2009"
2009-2010,15,2009-12-05,Aston Villa,Hull,3,0,H,3,0,3,0,2,0,3,2,6,15,23,16,9,7,December,-2.4492935982947064e-16,1.0,1,21,2,0,0,1.0,0.0,22,14,8,17,31,-14,"December, 2009"
2009-2010,15,2009-12-05,Arsenal,Stoke,2,0,H,3,0,1,1,3,1,1,3,4,9,25,20,5,5,December,-2.4492935982947064e-16,1.0,0,39,1,0,1,2.5,1.5,36,18,18,13,15,-2,"December, 2009"
2009-2010,15,2009-12-06,Everton,Tottenham,2,2,D,1,1,3,2,0,3,0,2,16,4,15,26,12,11,December,-2.4492935982947064e-16,1.0,18,42,2,2,1,1.0,0.6,17,25,-8,33,19,14,"December, 2009"
2009-2010,15,2009-12-06,Fulham,Sunderland,1,0,H,3,0,1,1,3,2,0,3,11,9,19,20,2,1,December,-2.4492935982947064e-16,1.0,19,40,0,2,3,0.6,1.4,18,16,2,21,20,1,"December, 2009"
2009-2010,16,2009-12-12,Sunderland,Portsmouth,1,1,D,1,1,2,0,3,1,2,2,11,20,20,10,9,10,December,-2.4492935982947064e-16,1.0,40,33,1,0,4,1.0,1.6,21,21,0,13,23,-10,"December, 2009"
2009-2010,16,2009-12-12,Stoke,Wigan,2,2,D,1,1,1,1,3,1,2,2,11,16,20,17,5,3,December,-2.4492935982947064e-16,1.0,39,46,1,1,0,1.0,0.0,13,17,-4,17,34,-17,"December, 2009"
2009-2010,16,2009-12-12,Tottenham,Wolves,0,1,A,0,3,3,0,2,1,3,1,5,19,27,13,14,14,December,-2.4492935982947064e-16,1.0,42,48,2,0,0,3.5,1.0,35,21,14,14,28,-14,"December, 2009"
2009-2010,16,2009-12-12,Man United,Aston Villa,0,1,A,0,3,4,1,0,3,0,2,2,5,34,26,3,8,December,-2.4492935982947064e-16,1.0,28,1,4,1,0,2.8,0.8,34,13,21,25,14,11,"December, 2009"
2009-2010,16,2009-12-12,Chelsea,Everton,3,3,D,1,1,4,0,1,3,2,0,1,15,36,16,14,20,December,-2.4492935982947064e-16,1.0,14,18,1,4,0,0.6,0.4,37,10,27,19,27,-8,"December, 2009"
2009-2010,16,2009-12-12,Burnley,Fulham,1,1,D,1,1,2,0,3,1,1,3,13,9,17,22,4,5,December,-2.4492935982947064e-16,1.0,11,19,0,0,0,0.0,0.0,19,33,-14,19,16,3,"December, 2009"
2009-2010,16,2009-12-12,Birmingham,West Ham,1,0,H,3,0,1,1,3,2,1,2,9,17,21,14,8,7,December,-2.4492935982947064e-16,1.0,3,45,0,2,3,0.8,1.8,15,16,-1,24,30,-6,"December, 2009"
2009-2010,16,2009-12-12,Hull,Blackburn,0,0,D,1,1,0,3,2,2,2,1,16,12,16,18,4,2,December,-2.4492935982947064e-16,1.0,21,4,0,1,1,1.0,1.5,17,34,-17,16,28,-12,"December, 2009"
2009-2010,16,2009-12-12,Bolton,Man City,3,3,D,1,1,2,1,2,1,2,2,19,6,12,25,13,13,December,-2.4492935982947064e-16,1.0,6,27,1,2,2,0.8,1.0,17,29,-12,26,18,8,"December, 2009"
2009-2010,16,2009-12-13,Liverpool,Arsenal,1,2,A,0,3,2,2,1,1,1,3,7,4,24,28,3,4,December,-2.4492935982947064e-16,1.0,25,0,1,4,0,2.2,1.6,31,20,11,38,18,20,"December, 2009"
2009-2010,17,2009-12-15,Birmingham,Blackburn,2,1,H,3,0,1,1,3,2,2,1,8,12,24,19,4,5,December,-2.4492935982947064e-16,1.0,3,4,3,0,2,1.8,1.4,16,16,0,16,28,-12,"December, 2009"
2009-2010,17,2009-12-15,Bolton,West Ham,3,1,H,3,0,2,1,2,2,1,2,19,18,13,14,1,1,December,-2.4492935982947064e-16,1.0,6,45,3,1,1,1.6,1.2,20,32,-12,24,31,-7,"December, 2009"
2009-2010,17,2009-12-15,Man United,Wolves,3,0,H,3,0,4,1,0,1,3,1,2,18,34,16,16,18,December,-2.4492935982947064e-16,1.0,28,48,1,0,1,0.5,0.5,34,14,20,15,28,-13,"December, 2009"
2009-2010,17,2009-12-15,Sunderland,Aston Villa,0,2,A,0,3,2,0,3,3,0,2,10,4,21,29,6,8,December,-2.4492935982947064e-16,1.0,40,1,1,1,3,1.0,1.4,22,22,0,26,14,12,"December, 2009"
2009-2010,17,2009-12-16,Liverpool,Wigan,2,1,H,3,0,2,2,1,1,2,2,8,14,24,18,6,6,December,-2.4492935982947064e-16,1.0,25,46,3,2,0,1.6,0.8,32,22,10,19,36,-17,"December, 2009"
2009-2010,17,2009-12-16,Tottenham,Man City,3,0,H,3,0,3,0,2,1,2,2,5,8,27,26,3,1,December,-2.4492935982947064e-16,1.0,42,27,4,0,1,1.8,1.2,35,22,13,29,21,8,"December, 2009"
2009-2010,17,2009-12-16,Burnley,Arsenal,1,1,D,1,1,2,0,3,1,1,3,13,4,18,31,9,13,December,-2.4492935982947064e-16,1.0,11,0,0,0,0,0.0,0.0,20,34,-14,40,19,21,"December, 2009"
2009-2010,17,2009-12-16,Chelsea,Portsmouth,2,1,H,3,0,4,0,1,1,2,2,1,20,37,11,19,26,December,-2.4492935982947064e-16,1.0,14,33,4,1,0,1.8,0.2,40,13,27,14,24,-10,"December, 2009"
2009-2010,18,2009-12-19,Portsmouth,Liverpool,2,0,H,3,0,1,2,2,2,2,1,20,7,11,27,13,16,December,-2.4492935982947064e-16,1.0,33,25,1,1,3,1.0,1.8,15,26,-11,34,23,11,"December, 2009"
2009-2010,18,2009-12-19,Arsenal,Hull,3,0,H,3,0,1,1,3,0,3,2,3,16,32,17,13,15,December,-2.4492935982947064e-16,1.0,0,21,1,0,1,2.0,1.5,41,20,21,17,34,-17,"December, 2009"
2009-2010,18,2009-12-19,Aston Villa,Stoke,1,0,H,3,0,3,0,2,1,1,3,4,11,32,21,7,11,December,-2.4492935982947064e-16,1.0,1,39,0,1,1,2.0,2.5,28,14,14,15,19,-4,"December, 2009"
2009-2010,18,2009-12-19,Blackburn,Tottenham,0,2,A,0,3,2,2,1,3,0,2,12,5,19,30,7,11,December,-2.4492935982947064e-16,1.0,4,42,2,2,1,1.2,1.0,17,30,-13,38,22,16,"December, 2009"
2009-2010,18,2009-12-19,Fulham,Man United,3,0,H,3,0,1,1,3,4,1,0,9,2,23,37,7,14,December,-2.4492935982947064e-16,1.0,19,28,1,0,4,0.6,2.0,20,17,3,37,14,23,"December, 2009"
2009-2010,18,2009-12-19,Man City,Sunderland,4,3,H,3,0,1,2,2,2,0,3,9,10,26,21,1,5,December,-2.4492935982947064e-16,1.0,27,40,5,0,0,1.8,0.4,29,24,5,22,24,-2,"December, 2009"
2009-2010,18,2009-12-20,Wolves,Burnley,2,0,H,3,0,1,3,1,2,0,3,18,12,16,19,6,3,December,-2.4492935982947064e-16,1.0,48,11,0,0,0,0.0,0.0,15,31,-16,21,35,-14,"December, 2009"
2009-2010,18,2009-12-20,West Ham,Chelsea,1,1,D,1,1,2,1,2,4,0,1,19,1,14,40,18,26,December,-2.4492935982947064e-16,1.0,45,14,0,1,4,0.4,2.2,25,34,-9,42,14,28,"December, 2009"
2009-2010,18,2009-12-20,Everton,Birmingham,1,1,D,1,1,3,2,0,1,1,3,15,8,17,27,7,10,December,-2.4492935982947064e-16,1.0,18,3,2,3,0,1.2,0.6,22,30,-8,18,17,1,"December, 2009"
2009-2010,19,2009-12-26,Birmingham,Chelsea,0,0,D,1,1,1,1,3,4,0,1,7,1,28,41,6,13,December,-2.4492935982947064e-16,1.0,3,14,0,2,3,0.6,1.4,19,18,1,43,15,28,"December, 2009"
2009-2010,19,2009-12-26,Burnley,Bolton,1,1,D,1,1,2,0,3,2,1,2,14,18,19,16,4,3,December,-2.4492935982947064e-16,1.0,11,6,0,0,0,0.0,0.0,21,37,-16,23,33,-10,"December, 2009"
2009-2010,19,2009-12-26,Fulham,Tottenham,0,0,D,1,1,1,1,3,3,0,2,9,5,26,33,4,7,December,-2.4492935982947064e-16,1.0,19,42,1,3,1,1.4,2.0,23,17,6,40,22,18,"December, 2009"
2009-2010,19,2009-12-26,Liverpool,Wolves,2,0,H,3,0,2,2,1,1,3,1,8,13,27,19,5,8,December,-2.4492935982947064e-16,1.0,25,48,1,1,0,1.0,0.5,34,25,9,17,31,-14,"December, 2009"
2009-2010,19,2009-12-26,Man City,Stoke,2,0,H,3,0,1,2,2,1,1,3,7,11,29,21,4,8,December,-2.4492935982947064e-16,1.0,27,39,1,0,1,1.5,0.5,33,27,6,15,20,-5,"December, 2009"
2009-2010,19,2009-12-26,Sunderland,Everton,1,1,D,1,1,2,0,3,3,2,0,10,15,21,18,5,3,December,-2.4492935982947064e-16,1.0,40,18,0,1,4,0.6,3.0,25,28,-3,23,31,-8,"December, 2009"
2009-2010,19,2009-12-26,West Ham,Portsmouth,2,0,H,3,0,2,1,2,1,2,2,19,20,15,14,1,1,December,-2.4492935982947064e-16,1.0,45,33,1,2,2,1.0,0.8,26,35,-9,17,26,-9,"December, 2009"
2009-2010,19,2009-12-26,Wigan,Blackburn,1,1,D,1,1,1,2,2,2,2,1,17,14,18,19,3,1,December,-2.4492935982947064e-16,1.0,46,4,2,0,3,1.8,2.2,20,38,-18,17,32,-15,"December, 2009"
2009-2010,19,2009-12-27,Hull,Man United,1,3,A,0,3,0,3,2,4,1,0,19,3,17,37,16,20,December,-2.4492935982947064e-16,1.0,21,28,0,0,2,1.5,2.5,17,37,-20,37,17,20,"December, 2009"
2009-2010,19,2009-12-27,Arsenal,Aston Villa,3,0,H,3,0,1,1,3,3,0,2,3,4,35,35,1,0,December,-2.4492935982947064e-16,1.0,0,1,2,2,1,1.2,1.2,44,20,24,29,14,15,"December, 2009"
2009-2010,19,2009-12-28,Blackburn,Sunderland,2,2,D,1,1,2,2,1,2,0,3,12,10,20,22,2,2,December,-2.4492935982947064e-16,1.0,4,40,2,1,2,1.0,1.0,18,33,-15,26,29,-3,"December, 2009"
2009-2010,19,2009-12-28,Chelsea,Fulham,2,1,H,3,0,4,0,1,1,1,3,1,9,42,27,8,15,December,-2.4492935982947064e-16,1.0,14,19,3,2,0,1.8,0.8,43,15,28,23,17,6,"December, 2009"
2009-2010,19,2009-12-28,Everton,Burnley,2,0,H,3,0,3,2,0,2,0,3,14,13,19,20,1,1,December,-2.4492935982947064e-16,1.0,18,11,0,0,1,0.0,1.0,24,32,-8,22,38,-16,"December, 2009"
2009-2010,19,2009-12-28,Stoke,Birmingham,0,1,A,0,3,1,1,3,1,1,3,12,8,21,29,4,8,December,-2.4492935982947064e-16,1.0,39,3,0,1,0,0.0,0.0,15,22,-7,19,18,1,"December, 2009"
2009-2010,19,2009-12-28,Tottenham,West Ham,2,0,H,3,0,3,0,2,2,1,2,5,17,34,18,12,16,December,-2.4492935982947064e-16,1.0,42,45,4,1,0,2.0,0.4,40,22,18,28,35,-7,"December, 2009"
2009-2010,19,2009-12-28,Wolves,Man City,0,3,A,0,3,1,3,1,1,2,2,15,6,19,32,9,13,December,-2.4492935982947064e-16,1.0,48,27,1,1,1,1.3333333333333333,1.3333333333333333,17,33,-16,35,27,8,"December, 2009"
2009-2010,19,2009-12-29,Aston Villa,Liverpool,0,1,A,0,3,3,0,2,2,2,1,5,8,35,30,3,5,December,-2.4492935982947064e-16,1.0,1,25,1,2,2,1.2,2.0,29,17,12,36,25,11,"December, 2009"
2009-2010,19,2009-12-29,Bolton,Hull,2,2,D,1,1,2,1,2,0,3,2,18,19,17,17,1,0,December,-2.4492935982947064e-16,1.0,6,21,1,1,1,0.6666666666666666,0.6666666666666666,24,34,-10,18,40,-22,"December, 2009"
2009-2010,19,2009-12-30,Man United,Wigan,5,0,H,3,0,4,1,0,1,2,2,2,15,40,19,13,21,December,-2.4492935982947064e-16,1.0,28,46,5,0,0,2.8,0.2,40,18,22,21,39,-18,"December, 2009"
2009-2010,19,2009-12-30,Portsmouth,Arsenal,1,4,A,0,3,1,2,2,1,1,3,20,3,14,38,17,24,December,-2.4492935982947064e-16,1.0,33,0,0,1,4,0.4,2.2,17,28,-11,47,20,27,"December, 2009"
2009-2010,19,2010-01-05,Stoke,Fulham,3,2,H,3,0,1,1,3,1,1,3,12,9,21,27,3,6,January,0.4999999999999999,0.8660254037844387,39,19,0,1,1,0.0,0.5,15,23,-8,24,19,5,"January, 2010"
2009-2010,19,2010-01-09,Arsenal,Everton,2,2,D,1,1,1,1,3,3,2,0,3,12,41,22,9,19,January,0.4999999999999999,0.8660254037844387,0,18,4,1,0,3.0,0.8,51,21,30,26,32,-6,"January, 2010"
2009-2010,19,2010-01-09,Birmingham,Man United,1,1,D,1,1,1,1,3,4,1,0,8,2,32,43,6,11,January,0.4999999999999999,0.8660254037844387,3,28,0,1,4,0.4,1.6,20,18,2,45,18,27,"January, 2010"
2009-2010,19,2010-01-11,Man City,Blackburn,4,1,H,3,0,1,2,2,2,2,1,5,13,35,21,8,14,January,0.4999999999999999,0.8660254037844387,27,4,2,2,1,1.8,1.2,38,27,11,20,35,-15,"January, 2010"
2009-2010,20,2010-01-16,Chelsea,Sunderland,7,2,H,3,0,4,0,1,2,0,3,1,11,45,23,10,22,January,0.4999999999999999,0.8660254037844387,14,40,5,0,0,2.8,0.6,45,16,29,28,31,-3,"January, 2010"
2009-2010,20,2010-01-16,Everton,Man City,2,0,H,3,0,3,2,0,1,2,2,11,4,23,38,7,15,January,0.4999999999999999,0.8660254037844387,18,27,3,0,2,1.2,0.8,28,34,-6,42,28,14,"January, 2010"
2009-2010,20,2010-01-16,Man United,Burnley,3,0,H,3,0,4,1,0,2,0,3,2,14,44,20,12,24,January,0.4999999999999999,0.8660254037844387,28,11,0,0,1,0.0,1.0,46,19,27,22,40,-18,"January, 2010"
2009-2010,20,2010-01-16,Stoke,Liverpool,1,1,D,1,1,1,1,3,2,2,1,11,7,24,33,4,9,January,0.4999999999999999,0.8660254037844387,39,25,0,2,1,0.0,1.3333333333333333,18,25,-7,37,25,12,"January, 2010"
2009-2010,20,2010-01-16,Tottenham,Hull,0,0,D,1,1,3,0,2,0,3,2,5,19,37,18,14,19,January,0.4999999999999999,0.8660254037844387,42,21,2,0,1,2.333333333333333,1.0,42,22,20,20,42,-22,"January, 2010"
2009-2010,20,2010-01-16,Wolves,Wigan,0,2,A,0,3,1,3,1,1,2,2,15,17,19,19,2,0,January,0.4999999999999999,0.8660254037844387,48,46,1,0,0,1.0,0.0,17,36,-19,21,44,-23,"January, 2010"
2009-2010,20,2010-01-17,Bolton,Arsenal,0,2,A,0,3,2,1,2,1,1,3,19,3,18,42,16,24,January,0.4999999999999999,0.8660254037844387,6,0,0,0,5,0.8,2.2,26,36,-10,53,23,30,"January, 2010"
2009-2010,20,2010-01-17,Aston Villa,West Ham,0,0,D,1,1,3,0,2,2,1,2,6,18,35,18,12,17,January,0.4999999999999999,0.8660254037844387,1,45,2,2,1,1.2,1.0,29,18,11,28,37,-9,"January, 2010"
2009-2010,20,2010-01-17,Blackburn,Fulham,2,0,H,3,0,2,2,1,1,1,3,14,9,21,27,5,6,January,0.4999999999999999,0.8660254037844387,4,19,2,2,1,1.2,1.4,21,39,-18,26,22,4,"January, 2010"
2009-2010,20,2010-01-20,Arsenal,Bolton,4,2,H,3,0,1,1,3,2,1,2,3,19,45,18,16,27,January,0.4999999999999999,0.8660254037844387,0,6,5,0,0,2.2,0.6,55,23,32,26,38,-12,"January, 2010"
2009-2010,20,2010-01-20,Liverpool,Tottenham,2,0,H,3,0,2,2,1,3,0,2,7,4,34,38,3,4,January,0.4999999999999999,0.8660254037844387,25,42,2,1,2,1.8,1.4,38,26,12,42,22,20,"January, 2010"
2009-2010,20,2010-01-23,Man United,Hull,4,0,H,3,0,4,1,0,0,3,2,3,18,47,19,15,28,January,0.4999999999999999,0.8660254037844387,28,21,3,0,0,2.6666666666666665,1.3333333333333333,49,19,30,20,42,-22,"January, 2010"
2009-2010,21,2010-01-26,Wolves,Liverpool,0,0,D,1,1,1,3,1,2,2,1,18,6,19,37,12,18,January,0.4999999999999999,0.8660254037844387,48,25,0,1,2,0.3333333333333333,1.3333333333333333,17,38,-21,40,26,14,"January, 2010"
2009-2010,21,2010-01-26,Bolton,Burnley,1,0,H,3,0,2,1,2,2,0,3,19,15,18,20,4,2,January,0.4999999999999999,0.8660254037844387,6,11,0,1,0,1.0,1.0,28,42,-14,22,43,-21,"January, 2010"
2009-2010,21,2010-01-26,Portsmouth,West Ham,1,1,D,1,1,1,2,2,2,1,2,20,17,14,19,3,5,January,0.4999999999999999,0.8660254037844387,33,45,1,2,2,0.4,1.2,18,32,-14,28,37,-9,"January, 2010"
2009-2010,21,2010-01-26,Tottenham,Fulham,2,0,H,3,0,3,0,2,1,1,3,4,9,38,27,5,11,January,0.4999999999999999,0.8660254037844387,42,19,1,3,1,1.8,1.2,42,24,18,26,24,2,"January, 2010"
2009-2010,21,2010-01-27,Everton,Sunderland,2,0,H,3,0,3,2,0,2,0,3,11,13,26,23,2,3,January,0.4999999999999999,0.8660254037844387,18,40,4,1,0,2.8,0.4,30,34,-4,30,38,-8,"January, 2010"
2009-2010,21,2010-01-27,Chelsea,Birmingham,3,0,H,3,0,4,0,1,1,1,3,3,8,48,33,5,15,January,0.4999999999999999,0.8660254037844387,14,3,3,2,0,1.2,0.4,52,18,34,21,19,2,"January, 2010"
2009-2010,21,2010-01-27,Aston Villa,Arsenal,0,0,D,1,1,3,0,2,1,1,3,7,2,36,48,5,12,January,0.4999999999999999,0.8660254037844387,1,0,1,2,2,1.2,1.6,29,18,11,59,25,34,"January, 2010"
2009-2010,21,2010-01-27,Blackburn,Wigan,2,1,H,3,0,2,2,1,1,2,2,12,14,24,22,2,2,January,0.4999999999999999,0.8660254037844387,4,46,2,1,2,1.8,2.0,23,39,-16,23,44,-21,"January, 2010"
2009-2010,22,2010-01-30,Wigan,Everton,0,1,A,0,3,1,2,2,3,2,0,14,9,22,29,5,7,January,0.4999999999999999,0.8660254037844387,46,18,1,0,4,0.8,2.0,24,46,-22,32,34,-2,"January, 2010"
2009-2010,22,2010-01-30,Birmingham,Tottenham,1,1,D,1,1,1,1,3,3,0,2,8,4,33,41,4,8,January,0.4999999999999999,0.8660254037844387,3,42,2,0,3,1.6,1.8,21,22,-1,44,24,20,"January, 2010"
2009-2010,22,2010-01-30,Burnley,Chelsea,1,2,A,0,3,2,0,3,4,0,1,18,1,20,51,17,31,January,0.4999999999999999,0.8660254037844387,11,14,0,0,1,0.0,3.0,22,44,-22,55,18,37,"January, 2010"
2009-2010,22,2010-01-30,Fulham,Aston Villa,0,2,A,0,3,1,1,3,3,0,2,10,7,27,37,3,10,January,0.4999999999999999,0.8660254037844387,19,1,2,1,2,1.2,1.2,26,26,0,29,18,11,"January, 2010"
2009-2010,22,2010-01-30,Hull,Wolves,2,2,D,1,1,0,3,2,1,3,1,19,17,19,20,2,1,January,0.4999999999999999,0.8660254037844387,21,48,0,1,0,1.0,1.0,20,46,-26,17,38,-21,"January, 2010"
2009-2010,22,2010-01-30,Liverpool,Bolton,2,0,H,3,0,2,2,1,2,1,2,6,15,38,21,9,17,January,0.4999999999999999,0.8660254037844387,25,6,5,0,0,3.0,0.6,40,26,14,29,42,-13,"January, 2010"
2009-2010,22,2010-01-30,West Ham,Blackburn,0,0,D,1,1,2,1,2,2,2,1,17,11,20,27,6,7,January,0.4999999999999999,0.8660254037844387,45,4,3,2,0,1.6,0.6,29,38,-9,25,40,-15,"January, 2010"
2009-2010,22,2010-01-31,Arsenal,Man United,1,3,A,0,3,1,1,3,4,1,0,3,2,49,50,1,1,January,0.4999999999999999,0.8660254037844387,0,28,1,2,2,1.2,1.4,59,25,34,53,19,34,"January, 2010"
2009-2010,22,2010-01-31,Man City,Portsmouth,2,0,H,3,0,1,2,2,1,2,2,7,20,38,15,13,23,January,0.4999999999999999,0.8660254037844387,27,33,3,1,1,2.0,0.6,42,30,12,19,33,-14,"January, 2010"
2009-2010,22,2010-02-01,Sunderland,Stoke,0,0,D,1,1,2,0,3,1,1,3,13,12,23,25,1,2,February,0.8660254037844386,0.5000000000000001,40,39,1,0,2,0.6666666666666666,0.6666666666666666,30,40,-10,19,26,-7,"February, 2010"
2009-2010,22,2010-02-02,Hull,Chelsea,1,1,D,1,1,0,3,2,4,0,1,19,1,20,54,18,34,February,0.8660254037844386,0.5000000000000001,21,14,0,1,2,0.3333333333333333,1.6666666666666667,22,48,-26,57,19,38,"February, 2010"
2009-2010,22,2010-02-03,Fulham,Portsmouth,1,0,H,3,0,1,1,3,1,2,2,11,20,27,15,9,12,February,0.8660254037844386,0.5000000000000001,19,33,3,1,1,1.2,0.8,26,28,-2,19,35,-16,"February, 2010"
2009-2010,23,2010-02-06,Sunderland,Wigan,1,1,D,1,1,2,0,3,1,2,2,13,17,24,22,4,2,February,0.8660254037844386,0.5000000000000001,40,46,1,1,3,0.8,1.4,30,40,-10,24,47,-23,"February, 2010"
2009-2010,23,2010-02-06,Stoke,Blackburn,3,0,H,3,0,1,1,3,2,2,1,12,11,26,28,1,2,February,0.8660254037844386,0.5000000000000001,39,4,1,1,1,0.3333333333333333,1.0,19,26,-7,25,40,-15,"February, 2010"
2009-2010,23,2010-02-06,Man United,Portsmouth,5,0,H,3,0,4,1,0,1,2,2,2,20,53,15,18,38,February,0.8660254037844386,0.5000000000000001,28,33,4,1,0,2.0,0.4,56,20,36,19,36,-17,"February, 2010"
2009-2010,23,2010-02-06,Tottenham,Aston Villa,0,0,D,1,1,3,0,2,3,0,2,5,7,42,40,2,2,February,0.8660254037844386,0.5000000000000001,42,1,1,2,2,1.8,2.0,45,25,20,31,18,13,"February, 2010"
2009-2010,23,2010-02-06,Hull,Man City,2,1,H,3,0,0,3,2,1,2,2,19,6,21,41,13,20,February,0.8660254037844386,0.5000000000000001,21,27,0,2,1,1.3333333333333333,2.6666666666666665,23,49,-26,44,30,14,"February, 2010"
2009-2010,23,2010-02-06,Burnley,West Ham,2,1,H,3,0,2,0,3,2,1,2,19,16,20,21,3,1,February,0.8660254037844386,0.5000000000000001,11,45,0,0,1,3.0,5.0,23,46,-23,29,38,-9,"February, 2010"
2009-2010,23,2010-02-06,Bolton,Fulham,0,0,D,1,1,2,1,2,1,1,3,16,10,21,30,6,9,February,0.8660254037844386,0.5000000000000001,6,19,0,2,3,0.8,1.6,29,44,-15,27,28,-1,"February, 2010"
2009-2010,23,2010-02-06,Liverpool,Everton,1,0,H,3,0,2,2,1,3,2,0,5,9,41,32,4,9,February,0.8660254037844386,0.5000000000000001,25,18,4,1,0,1.6,0.4,42,26,16,33,34,-1,"February, 2010"
2009-2010,23,2010-02-07,Chelsea,Arsenal,2,0,H,3,0,4,0,1,1,1,3,2,3,55,49,1,6,February,0.8660254037844386,0.5000000000000001,14,0,3,0,2,2.0,1.0,58,20,38,60,28,32,"February, 2010"
2009-2010,23,2010-02-07,Birmingham,Wolves,2,1,H,3,0,1,1,3,1,3,1,8,19,34,21,11,13,February,0.8660254037844386,0.5000000000000001,3,48,1,2,0,1.3333333333333333,1.0,22,23,-1,19,40,-21,"February, 2010"
2009-2010,24,2010-02-09,Fulham,Burnley,3,0,H,3,0,1,1,3,2,0,3,10,15,31,23,5,8,February,0.8660254037844386,0.5000000000000001,19,11,0,1,0,1.0,1.0,27,28,-1,25,47,-22,"February, 2010"
2009-2010,24,2010-02-09,Man City,Bolton,2,0,H,3,0,1,2,2,2,1,2,6,17,41,22,11,19,February,0.8660254037844386,0.5000000000000001,27,6,2,2,1,1.6,1.4,45,32,13,29,44,-15,"February, 2010"
2009-2010,24,2010-02-09,Portsmouth,Sunderland,1,1,D,1,1,1,2,2,2,0,3,20,13,15,25,7,10,February,0.8660254037844386,0.5000000000000001,33,40,3,1,1,1.4,1.0,19,41,-22,31,41,-10,"February, 2010"
2009-2010,24,2010-02-09,Wigan,Stoke,1,1,D,1,1,1,2,2,1,1,3,15,11,23,29,4,6,February,0.8660254037844386,0.5000000000000001,46,39,0,2,1,0.6666666666666666,1.3333333333333333,25,48,-23,22,26,-4,"February, 2010"
2009-2010,24,2010-02-10,West Ham,Birmingham,2,0,H,3,0,2,1,2,1,1,3,18,8,21,37,10,16,February,0.8660254037844386,0.5000000000000001,45,3,3,1,1,1.4,0.6,30,40,-10,24,24,0,"February, 2010"
2009-2010,24,2010-02-10,Everton,Chelsea,2,1,H,3,0,3,2,0,4,0,1,10,1,32,58,9,26,February,0.8660254037844386,0.5000000000000001,18,14,0,4,1,0.8,1.0,33,35,-2,60,20,40,"February, 2010"
2009-2010,24,2010-02-10,Wolves,Tottenham,1,0,H,3,0,1,3,1,3,0,2,19,6,21,43,13,22,February,0.8660254037844386,0.5000000000000001,48,42,1,0,2,1.0,2.333333333333333,20,42,-22,45,25,20,"February, 2010"
2009-2010,24,2010-02-10,Aston Villa,Man United,1,1,D,1,1,3,0,2,4,1,0,7,2,41,56,5,15,February,0.8660254037844386,0.5000000000000001,1,28,1,1,3,0.8,2.2,31,18,13,61,20,41,"February, 2010"
2009-2010,24,2010-02-10,Arsenal,Liverpool,1,0,H,3,0,1,1,3,2,2,1,3,4,49,44,1,5,February,0.8660254037844386,0.5000000000000001,0,25,1,4,0,1.8,1.6,60,30,30,43,26,17,"February, 2010"
2009-2010,24,2010-02-10,Blackburn,Hull,1,0,H,3,0,2,2,1,0,3,2,12,15,28,24,3,4,February,0.8660254037844386,0.5000000000000001,4,21,1,2,0,1.0,0.6666666666666666,25,43,-18,25,50,-25,"February, 2010"
2009-2010,24,2010-02-16,Stoke,Man City,1,1,D,1,1,1,1,3,1,2,2,12,5,30,44,7,14,February,0.8660254037844386,0.5000000000000001,39,27,1,0,2,0.3333333333333333,1.6666666666666667,23,27,-4,47,32,15,"February, 2010"
2009-2010,24,2010-02-17,Wigan,Bolton,0,0,D,1,1,1,2,2,2,1,2,16,19,24,22,3,2,February,0.8660254037844386,0.5000000000000001,46,6,2,1,2,0.8,1.4,26,49,-23,29,46,-17,"February, 2010"
2009-2010,25,2010-02-20,Arsenal,Sunderland,2,0,H,3,0,1,1,3,2,0,3,3,13,52,26,10,26,February,0.8660254037844386,0.5000000000000001,0,40,2,2,1,1.0,0.8,61,30,31,32,42,-10,"February, 2010"
2009-2010,25,2010-02-20,Everton,Man United,3,1,H,3,0,3,2,0,4,1,0,9,2,35,57,7,22,February,0.8660254037844386,0.5000000000000001,18,28,0,1,4,0.4,1.6,35,36,-1,62,21,41,"February, 2010"
2009-2010,25,2010-02-20,Portsmouth,Stoke,1,2,A,0,3,1,2,2,1,1,3,20,11,16,31,9,15,February,0.8660254037844386,0.5000000000000001,33,39,1,1,1,1.3333333333333333,1.3333333333333333,20,42,-22,24,28,-4,"February, 2010"
2009-2010,25,2010-02-20,West Ham,Hull,3,0,H,3,0,2,1,2,0,3,2,15,17,24,24,2,0,February,0.8660254037844386,0.5000000000000001,45,21,1,1,1,1.6666666666666667,1.3333333333333333,32,40,-8,25,51,-26,"February, 2010"
2009-2010,25,2010-02-20,Wolves,Chelsea,0,2,A,0,3,1,3,1,4,0,1,16,1,24,58,15,34,February,0.8660254037844386,0.5000000000000001,48,14,0,0,3,0.6666666666666666,4.666666666666667,21,42,-21,61,22,39,"February, 2010"
2009-2010,25,2010-02-21,Wigan,Tottenham,0,3,A,0,3,1,2,2,3,0,2,15,7,25,43,8,18,February,0.8660254037844386,0.5000000000000001,46,42,1,2,2,0.6,2.8,26,49,-23,45,26,19,"February, 2010"
2009-2010,25,2010-02-21,Fulham,Birmingham,2,1,H,3,0,1,1,3,1,1,3,10,9,34,37,1,3,February,0.8660254037844386,0.5000000000000001,19,3,1,2,2,0.6,0.6,30,28,2,24,26,-2,"February, 2010"
2009-2010,25,2010-02-21,Man City,Liverpool,0,0,D,1,1,1,2,2,2,2,1,5,6,45,44,1,1,February,0.8660254037844386,0.5000000000000001,27,25,0,3,2,1.0,1.4,48,33,15,43,27,16,"February, 2010"
2009-2010,25,2010-02-21,Aston Villa,Burnley,5,2,H,3,0,3,0,2,2,0,3,7,19,42,23,12,19,February,0.8660254037844386,0.5000000000000001,1,11,0,1,0,1.0,1.0,32,19,13,25,50,-25,"February, 2010"
2009-2010,25,2010-02-21,Blackburn,Bolton,3,0,H,3,0,2,2,1,2,1,2,12,18,31,23,6,8,February,0.8660254037844386,0.5000000000000001,4,6,3,2,0,2.0,0.8,26,43,-17,29,46,-17,"February, 2010"
2009-2010,25,2010-02-23,Man United,West Ham,3,0,H,3,0,4,1,0,2,1,2,2,13,57,27,11,30,February,0.8660254037844386,0.5000000000000001,28,45,4,0,1,2.4,0.6,63,24,39,35,40,-5,"February, 2010"
2009-2010,26,2010-02-27,Birmingham,Wigan,1,0,H,3,0,1,1,3,1,2,2,10,15,37,25,5,12,February,0.8660254037844386,0.5000000000000001,3,46,3,1,1,1.8,1.4,25,28,-3,26,52,-26,"February, 2010"
2009-2010,26,2010-02-27,Bolton,Wolves,1,0,H,3,0,2,1,2,1,3,1,18,16,23,24,2,1,February,0.8660254037844386,0.5000000000000001,6,48,1,1,1,1.3333333333333333,1.3333333333333333,29,49,-20,21,44,-23,"February, 2010"
2009-2010,26,2010-02-27,Burnley,Portsmouth,1,2,A,0,3,2,0,3,1,2,2,19,20,23,16,1,7,February,0.8660254037844386,0.5000000000000001,11,33,0,0,1,0.0,2.0,27,55,-28,21,44,-23,"February, 2010"
2009-2010,26,2010-02-27,Chelsea,Man City,2,4,A,0,3,4,0,1,1,2,2,1,5,61,46,4,15,February,0.8660254037844386,0.5000000000000001,14,27,4,0,1,2.6,0.6,63,22,41,48,33,15,"February, 2010"
2009-2010,26,2010-02-27,Stoke,Arsenal,1,3,A,0,3,1,1,3,1,1,3,11,3,34,55,8,21,February,0.8660254037844386,0.5000000000000001,39,0,1,0,2,1.0,2.333333333333333,26,29,-3,63,30,33,"February, 2010"
2009-2010,26,2010-02-28,Tottenham,Everton,2,1,H,3,0,3,0,2,3,2,0,6,10,46,38,4,8,February,0.8660254037844386,0.5000000000000001,42,18,0,3,2,0.6,1.2,48,26,22,38,37,1,"February, 2010"
2009-2010,26,2010-02-28,Sunderland,Fulham,0,0,D,1,1,2,0,3,1,1,3,14,10,26,37,4,11,February,0.8660254037844386,0.5000000000000001,40,19,2,2,1,1.0,0.6,32,44,-12,32,29,3,"February, 2010"
2009-2010,26,2010-02-28,Liverpool,Blackburn,2,1,H,3,0,2,2,1,2,2,1,6,12,45,34,6,11,February,0.8660254037844386,0.5000000000000001,25,4,3,2,0,2.0,0.4,43,27,16,29,43,-14,"February, 2010"
2009-2010,27,2010-03-06,Arsenal,Burnley,3,1,H,3,0,1,1,3,2,0,3,3,19,58,23,16,35,March,1.0,6.123233995736766e-17,0,11,0,1,0,1.0,1.0,66,31,35,28,57,-29,"March, 2010"
2009-2010,27,2010-03-06,West Ham,Bolton,1,2,A,0,3,2,1,2,2,1,2,13,15,27,26,2,1,March,1.0,6.123233995736766e-17,45,6,0,1,4,0.8,2.0,35,43,-8,30,49,-19,"March, 2010"
2009-2010,27,2010-03-06,Wolves,Man United,0,1,A,0,3,1,3,1,4,1,0,17,3,24,60,14,36,March,1.0,6.123233995736766e-17,48,28,1,0,2,0.3333333333333333,1.3333333333333333,21,45,-24,66,24,42,"March, 2010"
2009-2010,27,2010-03-07,Everton,Hull,5,1,H,3,0,3,2,0,0,3,2,10,18,38,24,8,14,March,1.0,6.123233995736766e-17,18,21,1,1,1,2.0,1.6666666666666667,39,39,0,25,54,-29,"March, 2010"
2009-2010,27,2010-03-08,Wigan,Liverpool,1,0,H,3,0,1,2,2,2,2,1,16,6,25,48,10,23,March,1.0,6.123233995736766e-17,46,25,0,2,3,1.0,1.6,26,53,-27,45,28,17,"March, 2010"
2009-2010,27,2010-03-09,Portsmouth,Birmingham,1,2,A,0,3,1,2,2,1,1,3,20,9,19,40,11,21,March,1.0,6.123233995736766e-17,33,3,2,1,2,1.4,1.8,23,45,-22,26,28,-2,"March, 2010"
2009-2010,27,2010-03-09,Sunderland,Bolton,4,0,H,3,0,2,0,3,2,1,2,16,13,27,29,3,2,March,1.0,6.123233995736766e-17,40,6,2,1,2,1.0,1.4,32,44,-12,32,50,-18,"March, 2010"
2009-2010,27,2010-03-10,Burnley,Stoke,1,1,D,1,1,2,0,3,1,1,3,19,11,23,34,8,11,March,1.0,6.123233995736766e-17,11,39,0,0,1,0.0,2.0,29,60,-31,27,32,-5,"March, 2010"
2009-2010,28,2010-03-13,Stoke,Aston Villa,0,0,D,1,1,1,1,3,3,0,2,11,7,35,45,4,10,March,1.0,6.123233995736766e-17,39,1,1,1,1,1.6666666666666667,1.6666666666666667,28,33,-5,37,21,16,"March, 2010"
2009-2010,28,2010-03-13,Tottenham,Blackburn,3,1,H,3,0,3,0,2,2,2,1,4,12,49,34,8,15,March,1.0,6.123233995736766e-17,42,4,2,1,2,1.2,1.0,50,27,23,30,45,-15,"March, 2010"
2009-2010,28,2010-03-13,Chelsea,West Ham,4,1,H,3,0,4,0,1,2,1,2,2,16,61,27,14,34,March,1.0,6.123233995736766e-17,14,45,3,2,0,1.6,0.4,65,26,39,36,45,-9,"March, 2010"
2009-2010,28,2010-03-13,Hull,Arsenal,1,2,A,0,3,0,3,2,1,1,3,19,3,24,61,16,37,March,1.0,6.123233995736766e-17,21,0,1,0,2,1.0,2.333333333333333,26,59,-33,69,32,37,"March, 2010"
2009-2010,28,2010-03-13,Bolton,Wigan,4,0,H,3,0,2,1,2,1,2,2,14,15,29,28,1,1,March,1.0,6.123233995736766e-17,6,46,1,2,2,0.8,0.6,32,54,-22,27,53,-26,"March, 2010"
2009-2010,28,2010-03-13,Birmingham,Everton,2,2,D,1,1,1,1,3,3,2,0,8,9,43,41,1,2,March,1.0,6.123233995736766e-17,3,18,0,3,2,0.6,1.2,28,29,-1,44,40,4,"March, 2010"
2009-2010,28,2010-03-13,Burnley,Wolves,1,2,A,0,3,2,0,3,1,3,1,18,17,24,24,1,0,March,1.0,6.123233995736766e-17,11,48,0,0,1,0.0,2.0,30,61,-31,21,46,-25,"March, 2010"
2009-2010,28,2010-03-14,Man United,Fulham,3,0,H,3,0,4,1,0,1,1,3,3,10,63,38,7,25,March,1.0,6.123233995736766e-17,28,19,3,0,2,1.6,1.0,67,24,43,32,29,3,"March, 2010"
2009-2010,28,2010-03-14,Sunderland,Man City,1,1,D,1,1,2,0,3,1,2,2,14,5,30,49,9,19,March,1.0,6.123233995736766e-17,40,27,0,0,5,0.8,2.2,36,44,-8,52,35,17,"March, 2010"
2009-2010,28,2010-03-15,Liverpool,Portsmouth,4,1,H,3,0,2,2,1,1,2,2,6,20,48,19,14,29,March,1.0,6.123233995736766e-17,25,33,3,1,1,1.6,1.0,45,29,16,24,47,-23,"March, 2010"
2009-2010,28,2010-03-16,Wigan,Aston Villa,1,2,A,0,3,1,2,2,3,0,2,15,7,28,46,8,18,March,1.0,6.123233995736766e-17,46,1,2,1,2,1.0,1.2,27,57,-30,37,21,16,"March, 2010"
2009-2010,29,2010-03-20,Sunderland,Birmingham,3,1,H,3,0,2,0,3,1,1,3,14,9,31,44,5,13,March,1.0,6.123233995736766e-17,40,3,1,1,3,1.0,1.2,37,45,-8,30,31,-1,"March, 2010"
2009-2010,29,2010-03-20,Wigan,Burnley,1,0,H,3,0,1,2,2,2,0,3,16,18,28,24,2,4,March,1.0,6.123233995736766e-17,46,11,1,0,0,3.0,1.0,28,59,-31,31,63,-32,"March, 2010"
2009-2010,29,2010-03-20,Stoke,Tottenham,1,2,A,0,3,1,1,3,3,0,2,11,4,36,52,7,16,March,1.0,6.123233995736766e-17,39,42,2,0,1,1.3333333333333333,1.3333333333333333,28,33,-5,53,28,25,"March, 2010"
2009-2010,29,2010-03-20,Everton,Bolton,2,0,H,3,0,3,2,0,2,1,2,9,13,42,32,4,10,March,1.0,6.123233995736766e-17,18,6,4,0,1,2.0,0.8,46,42,4,36,54,-18,"March, 2010"
2009-2010,29,2010-03-20,Aston Villa,Wolves,2,2,D,1,1,3,0,2,1,3,1,7,17,49,27,10,22,March,1.0,6.123233995736766e-17,1,48,2,1,0,2.6666666666666665,1.0,39,22,17,23,47,-24,"March, 2010"
2009-2010,29,2010-03-20,Arsenal,West Ham,2,0,H,3,0,1,1,3,2,1,2,3,16,64,27,13,37,March,1.0,6.123233995736766e-17,0,45,3,2,0,1.4,0.4,71,33,38,37,49,-12,"March, 2010"
2009-2010,29,2010-03-20,Portsmouth,Hull,3,2,H,3,0,1,2,2,0,3,2,20,19,19,24,1,5,March,1.0,6.123233995736766e-17,33,21,0,3,0,0.6666666666666666,0.6666666666666666,25,51,-26,27,61,-34,"March, 2010"
2009-2010,29,2010-03-21,Blackburn,Chelsea,1,1,D,1,1,2,2,1,4,0,1,13,3,34,64,10,30,March,1.0,6.123233995736766e-17,4,14,0,1,4,0.0,2.0,31,48,-17,69,27,42,"March, 2010"
2009-2010,29,2010-03-21,Fulham,Man City,1,2,A,0,3,1,1,3,1,2,2,10,6,38,50,4,12,March,1.0,6.123233995736766e-17,19,27,2,3,0,2.4,1.8,32,32,0,53,36,17,"March, 2010"
2009-2010,29,2010-03-21,Man United,Liverpool,2,1,H,3,0,4,1,0,2,2,1,2,6,66,51,4,15,March,1.0,6.123233995736766e-17,28,25,2,0,3,1.2,1.6,70,24,46,49,30,19,"March, 2010"
2009-2010,30,2010-03-23,West Ham,Wolves,1,3,A,0,3,2,1,2,1,3,1,17,16,27,28,1,1,March,1.0,6.123233995736766e-17,45,48,1,0,0,2.0,0.0,37,51,-14,25,49,-24,"March, 2010"
2009-2010,30,2010-03-24,Man City,Everton,0,2,A,0,3,1,2,2,3,2,0,5,8,53,45,3,8,March,1.0,6.123233995736766e-17,27,18,1,0,4,0.4,1.4,55,37,18,48,42,6,"March, 2010"
2009-2010,30,2010-03-24,Portsmouth,Chelsea,0,5,A,0,3,1,2,2,4,0,1,20,3,22,65,17,43,March,1.0,6.123233995736766e-17,33,14,0,1,4,0.4,1.8,28,53,-25,70,28,42,"March, 2010"
2009-2010,30,2010-03-24,Aston Villa,Sunderland,1,1,D,1,1,3,0,2,2,0,3,7,13,50,34,6,16,March,1.0,6.123233995736766e-17,1,40,3,1,1,1.4,0.8,41,24,17,40,46,-6,"March, 2010"
2009-2010,30,2010-03-24,Blackburn,Birmingham,2,1,H,3,0,2,2,1,1,1,3,13,9,35,44,4,9,March,1.0,6.123233995736766e-17,4,3,2,0,3,1.4,1.8,32,49,-17,31,34,-3,"March, 2010"
2009-2010,31,2010-03-27,Wolves,Everton,0,0,D,1,1,1,3,1,3,2,0,15,8,31,48,7,17,March,1.0,6.123233995736766e-17,48,18,1,1,1,1.0,1.3333333333333333,28,50,-22,50,42,8,"March, 2010"
2009-2010,31,2010-03-27,West Ham,Stoke,0,1,A,0,3,2,1,2,1,1,3,17,12,27,36,5,9,March,1.0,6.123233995736766e-17,45,39,2,0,1,1.3333333333333333,1.0,38,54,-16,29,35,-6,"March, 2010"
2009-2010,31,2010-03-27,Tottenham,Portsmouth,2,0,H,3,0,3,0,2,1,2,2,4,20,55,22,16,33,March,1.0,6.123233995736766e-17,42,33,3,1,1,1.2,0.8,55,29,26,28,58,-30,"March, 2010"
2009-2010,31,2010-03-27,Birmingham,Arsenal,1,1,D,1,1,1,1,3,1,1,3,9,3,44,67,6,23,March,1.0,6.123233995736766e-17,3,0,0,2,3,0.8,1.8,32,36,-4,73,33,40,"March, 2010"
2009-2010,31,2010-03-27,Chelsea,Aston Villa,7,1,H,3,0,4,0,1,3,0,2,2,7,68,51,5,17,March,1.0,6.123233995736766e-17,14,1,2,1,2,1.6,1.6,75,28,47,42,25,17,"March, 2010"
2009-2010,31,2010-03-27,Bolton,Man United,0,4,A,0,3,2,1,2,4,1,0,14,1,32,69,13,37,March,1.0,6.123233995736766e-17,6,28,1,0,4,0.4,1.4,36,56,-20,72,25,47,"March, 2010"
2009-2010,31,2010-03-27,Hull,Fulham,2,0,H,3,0,0,3,2,1,1,3,19,10,24,38,9,14,March,1.0,6.123233995736766e-17,21,19,2,0,1,1.0,1.0,29,64,-35,33,34,-1,"March, 2010"
2009-2010,31,2010-03-28,Burnley,Blackburn,0,1,A,0,3,2,0,3,2,2,1,19,12,24,38,7,14,March,1.0,6.123233995736766e-17,11,4,0,0,1,2.0,3.0,31,64,-33,34,50,-16,"March, 2010"
2009-2010,31,2010-03-28,Liverpool,Sunderland,3,0,H,3,0,2,2,1,2,0,3,6,13,51,35,7,16,March,1.0,6.123233995736766e-17,25,40,4,0,1,1.6,0.2,50,32,18,41,47,-6,"March, 2010"
2009-2010,31,2010-03-29,Man City,Wigan,3,0,H,3,0,1,2,2,1,2,2,6,16,53,31,10,22,March,1.0,6.123233995736766e-17,27,46,1,3,1,0.8,0.8,55,39,16,29,59,-30,"March, 2010"
2009-2010,32,2010-04-03,Sunderland,Tottenham,3,1,H,3,0,2,0,3,3,0,2,13,5,35,58,8,23,April,0.8660254037844388,-0.4999999999999998,40,42,2,1,2,0.8,1.2,41,50,-9,57,29,28,"April, 2010"
2009-2010,32,2010-04-03,Stoke,Hull,2,0,H,3,0,1,1,3,0,3,2,11,18,39,27,7,12,April,0.8660254037844388,-0.4999999999999998,39,21,1,1,1,1.3333333333333333,1.3333333333333333,30,35,-5,31,64,-33,"April, 2010"
2009-2010,32,2010-04-03,Portsmouth,Blackburn,0,0,D,1,1,1,2,2,2,2,1,20,10,22,41,10,19,April,0.8660254037844388,-0.4999999999999998,33,4,2,0,3,1.0,1.6,28,60,-32,35,50,-15,"April, 2010"
2009-2010,32,2010-04-03,Burnley,Man City,1,6,A,0,3,2,0,3,1,2,2,19,5,24,56,14,32,April,0.8660254037844388,-0.4999999999999998,11,27,0,1,0,3.0,3.0,31,65,-34,58,39,19,"April, 2010"
2009-2010,32,2010-04-03,Bolton,Aston Villa,0,1,A,0,3,2,1,2,3,0,2,15,7,32,51,8,19,April,0.8660254037844388,-0.4999999999999998,6,1,0,2,3,1.0,3.0,36,60,-24,43,32,11,"April, 2010"
2009-2010,32,2010-04-03,Arsenal,Wolves,1,0,H,3,0,1,1,3,1,3,1,3,14,68,32,11,36,April,0.8660254037844388,-0.4999999999999998,0,48,3,0,0,3.333333333333333,0.6666666666666666,74,34,40,28,50,-22,"April, 2010"
2009-2010,32,2010-04-03,Man United,Chelsea,1,2,A,0,3,4,1,0,4,0,1,1,2,72,71,1,1,April,0.8660254037844388,-0.4999999999999998,28,14,2,1,2,1.4,0.8,76,25,51,82,29,53,"April, 2010"
2009-2010,32,2010-04-04,Fulham,Wigan,2,1,H,3,0,1,1,3,1,2,2,12,16,38,31,4,7,April,0.8660254037844388,-0.4999999999999998,19,46,1,4,0,1.0,0.6,33,36,-3,29,62,-33,"April, 2010"
2009-2010,32,2010-04-04,Birmingham,Liverpool,1,1,D,1,1,1,1,3,2,2,1,9,6,45,54,3,9,April,0.8660254037844388,-0.4999999999999998,3,25,0,5,0,1.4,1.4,33,37,-4,53,32,21,"April, 2010"
2009-2010,32,2010-04-04,Everton,West Ham,2,2,D,1,1,3,2,0,2,1,2,8,17,49,27,9,22,April,0.8660254037844388,-0.4999999999999998,18,45,4,1,0,2.2,0.8,50,42,8,38,55,-17,"April, 2010"
2009-2010,33,2010-04-10,West Ham,Sunderland,1,0,H,3,0,2,1,2,2,0,3,17,13,28,38,4,10,April,0.8660254037844388,-0.4999999999999998,45,40,3,1,1,1.8,1.0,40,57,-17,44,51,-7,"April, 2010"
2009-2010,33,2010-04-10,Hull,Burnley,1,4,A,0,3,0,3,2,2,0,3,18,19,27,24,1,3,April,0.8660254037844388,-0.4999999999999998,21,11,0,0,1,0.0,2.0,31,66,-35,32,71,-39,"April, 2010"
2009-2010,33,2010-04-11,Wolves,Stoke,0,0,D,1,1,1,3,1,1,1,3,14,12,32,42,2,10,April,0.8660254037844388,-0.4999999999999998,48,39,0,1,0,2.0,2.0,28,51,-23,32,35,-3,"April, 2010"
2009-2010,33,2010-04-11,Man City,Birmingham,5,1,H,3,0,1,2,2,1,1,3,4,9,59,46,5,13,April,0.8660254037844388,-0.4999999999999998,27,3,3,1,1,1.6,1.0,64,40,24,34,38,-4,"April, 2010"
2009-2010,33,2010-04-11,Blackburn,Man United,0,0,D,1,1,2,2,1,4,1,0,11,2,42,72,9,30,April,0.8660254037844388,-0.4999999999999998,4,28,0,1,4,0.4,1.8,35,50,-15,77,27,50,"April, 2010"
2009-2010,33,2010-04-11,Liverpool,Fulham,0,0,D,1,1,2,2,1,1,1,3,6,12,55,41,6,14,April,0.8660254037844388,-0.4999999999999998,25,19,3,1,1,1.2,0.6,54,33,21,35,37,-2,"April, 2010"
2009-2010,34,2010-04-13,Chelsea,Bolton,1,0,H,3,0,4,0,1,2,1,2,1,15,74,32,14,42,April,0.8660254037844388,-0.4999999999999998,14,6,4,1,0,2.4,0.8,84,30,54,36,61,-25,"April, 2010"
2009-2010,34,2010-04-14,Aston Villa,Everton,2,2,D,1,1,3,0,2,3,2,0,7,8,54,50,1,4,April,0.8660254037844388,-0.4999999999999998,1,18,2,3,0,2.2,1.6,44,32,12,52,44,8,"April, 2010"
2009-2010,34,2010-04-14,Tottenham,Arsenal,2,1,H,3,0,3,0,2,1,1,3,5,3,58,71,2,13,April,0.8660254037844388,-0.4999999999999998,42,0,0,2,3,1.2,2.4,58,32,26,75,34,41,"April, 2010"
2009-2010,34,2010-04-14,Wigan,Portsmouth,0,0,D,1,1,1,2,2,1,2,2,17,20,31,23,3,8,April,0.8660254037844388,-0.4999999999999998,46,33,2,0,3,0.6,1.8,30,64,-34,28,60,-32,"April, 2010"
2009-2010,35,2010-04-17,Tottenham,Chelsea,2,1,H,3,0,3,0,2,4,0,1,5,1,61,77,4,16,April,0.8660254037844388,-0.4999999999999998,42,14,1,2,2,1.2,2.0,60,33,27,85,30,55,"April, 2010"
2009-2010,35,2010-04-17,Sunderland,Burnley,2,1,H,3,0,2,0,3,2,0,3,13,19,38,27,6,11,April,0.8660254037844388,-0.4999999999999998,40,11,0,0,1,1.0,3.0,44,52,-8,36,72,-36,"April, 2010"
2009-2010,35,2010-04-17,Man City,Man United,0,1,A,0,3,1,2,2,4,1,0,4,2,62,73,2,11,April,0.8660254037844388,-0.4999999999999998,27,28,2,0,3,1.2,1.6,69,41,28,77,27,50,"April, 2010"
2009-2010,35,2010-04-17,Stoke,Bolton,1,2,A,0,3,1,1,3,2,1,2,11,15,43,32,4,11,April,0.8660254037844388,-0.4999999999999998,39,6,1,1,1,1.3333333333333333,1.3333333333333333,32,35,-3,36,62,-26,"April, 2010"
2009-2010,35,2010-04-17,Blackburn,Everton,2,3,A,0,3,2,2,1,3,2,0,11,8,43,51,3,8,April,0.8660254037844388,-0.4999999999999998,4,18,1,3,1,0.8,1.2,35,50,-15,54,46,8,"April, 2010"
2009-2010,35,2010-04-17,Birmingham,Hull,0,0,D,1,1,1,1,3,0,3,2,9,19,46,27,10,19,April,0.8660254037844388,-0.4999999999999998,3,21,1,0,0,1.0,0.0,35,43,-8,32,70,-38,"April, 2010"
2009-2010,35,2010-04-17,Fulham,Wolves,0,0,D,1,1,1,1,3,1,3,1,12,14,42,33,2,9,April,0.8660254037844388,-0.4999999999999998,19,48,0,1,2,0.6666666666666666,1.3333333333333333,35,37,-2,28,51,-23,"April, 2010"
2009-2010,35,2010-04-18,Portsmouth,Aston Villa,1,2,A,0,3,1,2,2,3,0,2,20,7,24,55,13,31,April,0.8660254037844388,-0.4999999999999998,33,1,2,1,2,1.0,0.8,28,60,-32,46,34,12,"April, 2010"
2009-2010,35,2010-04-18,Wigan,Arsenal,3,2,H,3,0,1,2,2,1,1,3,16,3,32,71,13,39,April,0.8660254037844388,-0.4999999999999998,46,0,0,1,4,0.2,2.2,30,64,-34,76,36,40,"April, 2010"
2009-2010,35,2010-04-19,Liverpool,West Ham,3,0,H,3,0,2,2,1,2,1,2,7,17,56,31,10,25,April,0.8660254037844388,-0.4999999999999998,25,45,3,1,1,2.0,0.6,54,33,21,41,57,-16,"April, 2010"
2009-2010,35,2010-04-21,Hull,Aston Villa,0,2,A,0,3,0,3,2,3,0,2,18,7,28,58,11,30,April,0.8660254037844388,-0.4999999999999998,21,1,0,0,3,0.0,1.6666666666666667,32,70,-38,48,35,13,"April, 2010"
2009-2010,36,2010-04-24,West Ham,Wigan,3,2,H,3,0,2,1,2,1,2,2,17,15,31,35,2,4,April,0.8660254037844388,-0.4999999999999998,45,46,2,1,2,0.8,0.8,41,60,-19,33,66,-33,"April, 2010"
2009-2010,36,2010-04-24,Wolves,Blackburn,1,1,D,1,1,1,3,1,2,2,1,17,13,34,43,4,9,April,0.8660254037844388,-0.4999999999999998,48,4,0,1,2,1.3333333333333333,3.333333333333333,28,51,-23,37,53,-16,"April, 2010"
2009-2010,36,2010-04-24,Man United,Tottenham,3,1,H,3,0,4,1,0,3,0,2,2,4,76,64,2,12,April,0.8660254037844388,-0.4999999999999998,28,42,3,2,0,2.0,0.8,78,27,51,62,34,28,"April, 2010"
2009-2010,36,2010-04-24,Bolton,Portsmouth,2,2,D,1,1,2,1,2,1,2,2,14,20,35,24,6,11,April,0.8660254037844388,-0.4999999999999998,6,33,2,0,3,1.2,1.6,38,63,-25,29,62,-33,"April, 2010"
2009-2010,36,2010-04-24,Arsenal,Man City,0,0,D,1,1,1,1,3,1,2,2,3,5,71,62,2,9,April,0.8660254037844388,-0.4999999999999998,0,27,3,0,2,1.6,1.6,78,39,39,69,42,27,"April, 2010"
2009-2010,36,2010-04-24,Hull,Sunderland,0,1,A,0,3,0,3,2,2,0,3,18,13,28,41,5,13,April,0.8660254037844388,-0.4999999999999998,21,40,0,0,3,0.6666666666666666,3.0,32,72,-40,46,53,-7,"April, 2010"
2009-2010,36,2010-04-25,Aston Villa,Birmingham,1,0,H,3,0,3,0,2,1,1,3,6,9,61,47,3,14,April,0.8660254037844388,-0.4999999999999998,1,3,5,0,0,2.4,0.6,50,35,15,35,43,-8,"April, 2010"
2009-2010,36,2010-04-25,Burnley,Liverpool,0,4,A,0,3,2,0,3,2,2,1,19,7,27,59,12,32,April,0.8660254037844388,-0.4999999999999998,11,25,0,0,1,0.0,4.0,37,74,-37,57,33,24,"April, 2010"
2009-2010,36,2010-04-25,Chelsea,Stoke,7,0,H,3,0,4,0,1,1,1,3,2,13,77,43,11,34,April,0.8660254037844388,-0.4999999999999998,14,39,3,0,0,2.0,0.6666666666666666,86,32,54,33,37,-4,"April, 2010"
2009-2010,36,2010-04-25,Everton,Fulham,2,1,H,3,0,3,2,0,1,1,3,8,12,54,43,4,11,April,0.8660254037844388,-0.4999999999999998,18,19,3,0,2,1.4,0.6,57,48,9,35,37,-2,"April, 2010"
2009-2010,37,2010-05-01,Birmingham,Burnley,2,1,H,3,0,1,1,3,2,0,3,9,19,47,27,10,20,May,0.4999999999999999,-0.8660254037844387,3,11,0,0,1,1.0,2.0,35,44,-9,37,78,-41,"May, 2010"
2009-2010,37,2010-05-01,Man City,Aston Villa,3,1,H,3,0,1,2,2,3,0,2,6,5,63,64,1,1,May,0.4999999999999999,-0.8660254037844387,27,1,2,2,1,1.4,1.2,69,42,27,51,35,16,"May, 2010"
2009-2010,37,2010-05-01,Portsmouth,Wolves,3,1,H,3,0,1,2,2,1,3,1,20,15,25,35,5,10,May,0.4999999999999999,-0.8660254037844387,33,48,1,2,0,0.3333333333333333,0.0,31,64,-33,29,52,-23,"May, 2010"
2009-2010,37,2010-05-01,Stoke,Everton,0,0,D,1,1,1,1,3,3,2,0,13,8,43,57,5,14,May,0.4999999999999999,-0.8660254037844387,39,18,0,1,2,1.3333333333333333,2.333333333333333,33,44,-11,59,49,10,"May, 2010"
2009-2010,37,2010-05-01,Tottenham,Bolton,1,0,H,3,0,3,0,2,2,1,2,5,14,64,36,9,28,May,0.4999999999999999,-0.8660254037844387,42,6,1,3,1,1.6,1.4,63,37,26,40,65,-25,"May, 2010"
2009-2010,37,2010-05-02,Fulham,West Ham,3,2,H,3,0,1,1,3,2,1,2,13,17,43,34,4,9,May,0.4999999999999999,-0.8660254037844387,19,45,0,1,4,1.0,2.0,36,39,-3,44,62,-18,"May, 2010"
2009-2010,37,2010-05-02,Liverpool,Chelsea,0,2,A,0,3,2,2,1,4,0,1,7,1,62,80,6,18,May,0.4999999999999999,-0.8660254037844387,25,14,2,2,1,0.8,0.6,61,33,28,93,32,61,"May, 2010"
2009-2010,37,2010-05-02,Sunderland,Man United,0,1,A,0,3,2,0,3,4,1,0,11,2,44,79,9,35,May,0.4999999999999999,-0.8660254037844387,40,28,0,1,4,0.6,2.0,47,53,-6,81,28,53,"May, 2010"
2009-2010,37,2010-05-03,Blackburn,Arsenal,2,1,H,3,0,2,2,1,1,1,3,13,3,44,72,10,28,May,0.4999999999999999,-0.8660254037844387,4,0,0,1,4,0.6,3.4,38,54,-16,78,39,39,"May, 2010"
2009-2010,37,2010-05-03,Wigan,Hull,2,2,D,1,1,1,2,2,0,3,2,16,19,35,28,3,7,May,0.4999999999999999,-0.8660254037844387,46,21,2,0,1,2.333333333333333,0.6666666666666666,35,69,-34,32,73,-41,"May, 2010"
2009-2010,37,2010-05-05,Man City,Tottenham,0,1,A,0,3,1,2,2,3,0,2,5,4,66,67,1,1,May,0.4999999999999999,-0.8660254037844387,27,42,1,0,4,1.0,2.0,72,43,29,64,37,27,"May, 2010"
2009-2010,37,2010-05-05,Fulham,Stoke,0,1,A,0,3,1,1,3,1,1,3,11,13,46,44,2,2,May,0.4999999999999999,-0.8660254037844387,19,39,1,1,1,1.0,1.0,39,41,-2,33,44,-11,"May, 2010"
2009-2010,38,2010-05-09,Man United,Stoke,4,0,H,3,0,4,1,0,1,1,3,2,11,82,47,9,35,May,0.4999999999999999,-0.8660254037844387,28,39,3,0,0,2.6666666666666665,0.0,82,28,54,34,44,-10,"May, 2010"
2009-2010,38,2010-05-09,Hull,Liverpool,0,0,D,1,1,0,3,2,2,2,1,19,7,29,62,12,33,May,0.4999999999999999,-0.8660254037844387,21,25,0,1,2,1.3333333333333333,3.6666666666666665,34,75,-41,61,35,26,"May, 2010"
2009-2010,38,2010-05-09,West Ham,Man City,1,1,D,1,1,2,1,2,1,2,2,17,5,34,66,12,32,May,0.4999999999999999,-0.8660254037844387,45,27,1,1,3,0.6,1.8,46,65,-19,72,44,28,"May, 2010"
2009-2010,38,2010-05-09,Everton,Portsmouth,1,0,H,3,0,3,2,0,1,2,2,8,20,58,28,12,30,May,0.4999999999999999,-0.8660254037844387,18,33,2,1,2,1.0,1.2,59,49,10,34,65,-31,"May, 2010"
2009-2010,38,2010-05-09,Wolves,Sunderland,2,1,H,3,0,1,3,1,2,0,3,17,13,35,44,4,9,May,0.4999999999999999,-0.8660254037844387,48,40,0,0,1,2.0,5.0,30,55,-25,47,54,-7,"May, 2010"
2009-2010,38,2010-05-09,Burnley,Tottenham,4,2,H,3,0,2,0,3,3,0,2,20,4,27,70,16,43,May,0.4999999999999999,-0.8660254037844387,11,42,0,0,1,0.0,5.0,38,80,-42,65,37,28,"May, 2010"
2009-2010,38,2010-05-09,Bolton,Birmingham,2,1,H,3,0,2,1,2,1,1,3,14,9,36,50,5,14,May,0.4999999999999999,-0.8660254037844387,6,3,3,0,2,1.2,0.6,40,66,-26,37,45,-8,"May, 2010"
2009-2010,38,2010-05-09,Aston Villa,Blackburn,0,1,A,0,3,3,0,2,2,2,1,6,11,64,47,5,17,May,0.4999999999999999,-0.8660254037844387,1,4,3,1,1,2.2,1.0,52,38,14,40,55,-15,"May, 2010"
2009-2010,38,2010-05-09,Arsenal,Fulham,4,0,H,3,0,1,1,3,1,1,3,3,12,72,46,9,26,May,0.4999999999999999,-0.8660254037844387,0,19,3,1,1,1.2,0.4,79,41,38,39,42,-3,"May, 2010"
2009-2010,38,2010-05-09,Chelsea,Wigan,8,0,H,3,0,4,0,1,1,2,2,1,15,83,36,14,47,May,0.4999999999999999,-0.8660254037844387,14,46,3,1,1,1.4,1.0,95,32,63,37,71,-34,"May, 2010"
2010-2011,1,2010-08-14,Wolves,Stoke,2,1,H,3,0,2,1,2,2,1,2,16,15,0,0,1,0,August,-0.8660254037844384,-0.5000000000000004,48,39,0,2,0,1.0,1.0,0,0,0,0,0,0,"August, 2010"
2010-2011,1,2010-08-14,Wigan,Blackpool,0,4,A,0,3,2,2,1,1,3,1,16,11,0,0,5,0,August,-0.8660254037844384,-0.5000000000000004,46,5,0,0,0,0.0,0.0,0,0,0,0,0,0,"August, 2010"
2010-2011,1,2010-08-14,Tottenham,Man City,0,0,D,1,1,2,1,2,4,0,1,15,11,0,0,4,0,August,-0.8660254037844384,-0.5000000000000004,42,27,4,0,1,1.8,0.8,0,0,0,0,0,0,"August, 2010"
2010-2011,1,2010-08-14,Sunderland,Birmingham,2,2,D,1,1,3,0,2,0,1,4,14,7,0,0,7,0,August,-0.8660254037844384,-0.5000000000000004,40,3,2,1,2,1.6,1.2,0,0,0,0,0,0,"August, 2010"
2010-2011,1,2010-08-14,Chelsea,West Brom,6,0,H,3,0,2,1,2,2,2,1,8,16,0,0,8,0,August,-0.8660254037844384,-0.5000000000000004,14,44,5,0,0,2.4,0.2,0,0,0,0,0,0,"August, 2010"
2010-2011,1,2010-08-14,Bolton,Fulham,0,0,D,1,1,0,0,5,3,1,1,6,8,0,0,2,0,August,-0.8660254037844384,-0.5000000000000004,6,19,0,3,2,0.6,1.2,0,0,0,0,0,0,"August, 2010"
2010-2011,1,2010-08-14,Blackburn,Everton,1,0,H,3,0,2,2,1,2,1,2,4,8,0,0,4,0,August,-0.8660254037844384,-0.5000000000000004,4,18,1,2,2,1.0,1.6,0,0,0,0,0,0,"August, 2010"
2010-2011,1,2010-08-14,Aston Villa,West Ham,3,0,H,3,0,2,2,1,0,1,4,2,18,0,0,16,0,August,-0.8660254037844384,-0.5000000000000004,1,45,1,3,1,1.0,1.0,0,0,0,0,0,0,"August, 2010"
2010-2011,1,2010-08-15,Liverpool,Arsenal,1,1,D,1,1,3,0,2,1,1,3,13,12,0,0,1,0,August,-0.8660254037844384,-0.5000000000000004,25,0,0,3,2,1.4,1.8,0,0,0,0,0,0,"August, 2010"
2010-2011,1,2010-08-16,Man United,Newcastle,3,0,H,3,0,3,1,1,1,3,1,14,15,0,0,1,0,August,-0.8660254037844384,-0.5000000000000004,28,30,3,2,0,3.2,1.0,0,0,0,0,0,0,"August, 2010"
2010-2011,2,2010-08-21,West Ham,Bolton,1,3,A,0,3,0,1,4,0,0,5,19,12,0,1,7,1,August,-0.8660254037844384,-0.5000000000000004,45,6,0,0,5,0.8,2.2,0,3,-3,0,0,0,"August, 2010"
2010-2011,2,2010-08-21,West Brom,Sunderland,1,0,H,3,0,2,2,1,3,0,2,20,10,0,1,10,1,August,-0.8660254037844384,-0.5000000000000004,44,40,2,1,2,1.2,1.4,0,6,-6,2,2,0,"August, 2010"
2010-2011,2,2010-08-21,Stoke,Tottenham,1,2,A,0,3,2,1,2,2,1,2,16,14,0,1,2,1,August,-0.8660254037844384,-0.5000000000000004,39,42,2,0,2,1.25,1.5,1,2,-1,0,0,0,"August, 2010"
2010-2011,2,2010-08-21,Wigan,Chelsea,0,6,A,0,3,2,2,1,2,1,2,19,6,0,3,13,3,August,-0.8660254037844384,-0.5000000000000004,46,14,1,1,3,1.0,2.6,0,4,-4,6,0,6,"August, 2010"
2010-2011,2,2010-08-21,Birmingham,Blackburn,2,1,H,3,0,0,1,4,2,2,1,8,6,1,3,2,2,August,-0.8660254037844384,-0.5000000000000004,3,4,3,0,2,2.0,1.4,2,2,0,1,0,1,"August, 2010"
2010-2011,2,2010-08-21,Arsenal,Blackpool,6,0,H,3,0,1,1,3,1,3,1,9,2,1,3,7,2,August,-0.8660254037844384,-0.5000000000000004,0,5,0,0,0,0.0,0.0,1,1,0,4,0,4,"August, 2010"
2010-2011,2,2010-08-21,Everton,Wolves,1,1,D,1,1,2,1,2,2,1,2,16,6,0,3,10,3,August,-0.8660254037844384,-0.5000000000000004,18,48,1,2,1,1.0,0.75,0,1,-1,2,1,1,"August, 2010"
2010-2011,2,2010-08-22,Fulham,Man United,2,2,D,1,1,3,1,1,3,1,1,13,8,1,3,5,2,August,-0.8660254037844384,-0.5000000000000004,19,28,2,0,3,1.0,1.8,0,0,0,3,0,3,"August, 2010"
2010-2011,2,2010-08-22,Newcastle,Aston Villa,6,0,H,3,0,1,3,1,2,2,1,18,8,0,3,10,3,August,-0.8660254037844384,-0.5000000000000004,30,1,2,1,2,1.2,1.2,0,3,-3,3,0,3,"August, 2010"
2010-2011,2,2010-08-23,Man City,Liverpool,3,0,H,3,0,4,0,1,3,0,2,15,14,1,1,1,0,August,-0.8660254037844384,-0.5000000000000004,27,25,0,3,2,1.0,1.4,0,0,0,1,1,0,"August, 2010"
2010-2011,3,2010-08-28,Tottenham,Wigan,0,1,A,0,3,2,1,2,2,2,1,8,20,4,0,12,4,August,-0.8660254037844384,-0.5000000000000004,42,46,2,2,1,2.6,0.6,2,1,1,0,10,-10,"August, 2010"
2010-2011,3,2010-08-28,Man United,West Ham,3,0,H,3,0,3,1,1,0,1,4,3,19,4,0,16,4,August,-0.8660254037844384,-0.5000000000000004,28,45,5,0,0,2.8,0.2,5,2,3,1,6,-5,"August, 2010"
2010-2011,3,2010-08-28,Wolves,Newcastle,1,1,D,1,1,2,1,2,1,3,1,7,10,4,3,3,1,August,-0.8660254037844384,-0.5000000000000004,48,30,0,2,0,1.0,1.0,3,2,1,6,3,3,"August, 2010"
2010-2011,3,2010-08-28,Blackpool,Fulham,2,2,D,1,1,1,3,1,3,1,1,11,14,3,2,3,1,August,-0.8660254037844384,-0.5000000000000004,5,19,0,0,0,0.0,0.0,4,6,-2,2,2,0,"August, 2010"
2010-2011,3,2010-08-28,Blackburn,Arsenal,1,2,A,0,3,2,2,1,1,1,3,10,2,3,4,8,1,August,-0.8660254037844384,-0.5000000000000004,4,0,1,0,4,0.8,3.4,2,2,0,7,1,6,"August, 2010"
2010-2011,3,2010-08-28,Chelsea,Stoke,2,0,H,3,0,2,1,2,2,1,2,2,18,6,0,16,6,August,-0.8660254037844384,-0.5000000000000004,14,39,4,0,0,3.25,0.5,12,0,12,2,4,-2,"August, 2010"
2010-2011,3,2010-08-29,Aston Villa,Everton,1,0,H,3,0,2,2,1,2,1,2,13,17,3,1,4,2,August,-0.8660254037844384,-0.5000000000000004,1,18,1,4,0,2.2,2.0,3,6,-3,1,2,-1,"August, 2010"
2010-2011,3,2010-08-29,Bolton,Birmingham,2,2,D,1,1,0,0,5,0,1,4,8,9,4,4,1,0,August,-0.8660254037844384,-0.5000000000000004,6,3,4,0,1,1.6,0.6,3,1,2,4,3,1,"August, 2010"
2010-2011,3,2010-08-29,Liverpool,West Brom,1,0,H,3,0,3,0,2,2,2,1,18,14,1,3,4,2,August,-0.8660254037844384,-0.5000000000000004,25,44,5,0,0,2.6,0.0,1,4,-3,1,6,-5,"August, 2010"
2010-2011,3,2010-08-29,Sunderland,Man City,1,0,H,3,0,3,0,2,4,0,1,17,9,1,4,8,3,August,-0.8660254037844384,-0.5000000000000004,40,27,0,1,4,1.0,2.2,2,3,-1,3,0,3,"August, 2010"
2010-2011,4,2010-09-11,West Ham,Chelsea,1,3,A,0,3,0,1,4,2,1,2,20,2,0,9,18,9,September,-1.0,-1.8369701987210287e-16,45,14,0,2,3,0.6,2.2,1,9,-8,14,0,14,"September, 2010"
2010-2011,4,2010-09-11,Arsenal,Bolton,4,1,H,3,0,1,1,3,0,0,5,2,5,7,5,3,2,September,-1.0,-1.8369701987210287e-16,0,6,5,0,0,2.6,1.0,9,2,7,5,3,2,"September, 2010"
2010-2011,4,2010-09-11,Everton,Man United,3,3,D,1,1,2,1,2,3,1,1,18,3,1,7,15,6,September,-1.0,-1.8369701987210287e-16,18,28,1,1,3,1.0,1.6,1,3,-2,8,2,6,"September, 2010"
2010-2011,4,2010-09-11,Fulham,Wolves,2,1,H,3,0,3,1,1,2,1,2,14,6,3,5,8,2,September,-1.0,-1.8369701987210287e-16,19,48,0,2,2,0.5,1.0,4,4,0,4,3,1,"September, 2010"
2010-2011,4,2010-09-11,Man City,Blackburn,1,1,D,1,1,4,0,1,2,2,1,10,15,4,3,5,1,September,-1.0,-1.8369701987210287e-16,27,4,3,2,0,2.6,1.2,3,1,2,3,4,-1,"September, 2010"
2010-2011,4,2010-09-11,Newcastle,Blackpool,0,2,A,0,3,1,3,1,1,3,1,10,14,4,4,4,0,September,-1.0,-1.8369701987210287e-16,30,5,0,0,0,0.0,0.0,7,4,3,6,8,-2,"September, 2010"
2010-2011,4,2010-09-11,West Brom,Tottenham,1,1,D,1,1,2,2,1,2,1,2,16,13,3,4,3,1,September,-1.0,-1.8369701987210287e-16,44,42,2,1,2,1.2,0.8,1,7,-6,2,2,0,"September, 2010"
2010-2011,4,2010-09-11,Wigan,Sunderland,1,1,D,1,1,2,2,1,3,0,2,17,13,3,4,4,1,September,-1.0,-1.8369701987210287e-16,46,40,2,2,1,1.0,1.0,1,10,-9,3,3,0,"September, 2010"
2010-2011,4,2010-09-12,Birmingham,Liverpool,0,0,D,1,1,0,1,4,3,0,2,8,15,5,4,7,1,September,-1.0,-1.8369701987210287e-16,3,25,0,5,0,1.2,1.2,6,5,1,2,4,-2,"September, 2010"
2010-2011,4,2010-09-13,Stoke,Aston Villa,2,1,H,3,0,2,1,2,2,2,1,19,7,0,6,12,6,September,-1.0,-1.8369701987210287e-16,39,1,1,2,1,1.25,1.25,2,6,-4,4,6,-2,"September, 2010"
2010-2011,5,2010-09-18,Aston Villa,Bolton,1,1,D,1,1,2,2,1,0,0,5,7,12,6,5,5,1,September,-1.0,-1.8369701987210287e-16,1,6,4,1,0,3.0,0.8,5,8,-3,6,7,-1,"September, 2010"
2010-2011,5,2010-09-18,Blackburn,Fulham,1,1,D,1,1,2,2,1,3,1,1,15,7,4,6,8,2,September,-1.0,-1.8369701987210287e-16,4,19,3,1,1,1.2,1.0,4,5,-1,6,5,1,"September, 2010"
2010-2011,5,2010-09-18,Everton,Newcastle,0,1,A,0,3,2,1,2,1,3,1,19,15,2,4,4,2,September,-1.0,-1.8369701987210287e-16,18,30,2,2,1,2.0,1.2,4,6,-2,7,6,1,"September, 2010"
2010-2011,5,2010-09-18,Stoke,West Ham,1,1,D,1,1,2,1,2,0,1,4,18,20,3,0,2,3,September,-1.0,-1.8369701987210287e-16,39,45,2,0,2,1.0,1.0,4,7,-3,2,12,-10,"September, 2010"
2010-2011,5,2010-09-18,Sunderland,Arsenal,1,1,D,1,1,3,0,2,1,1,3,12,2,5,10,10,5,September,-1.0,-1.8369701987210287e-16,40,0,1,2,2,0.4,0.8,4,4,0,13,3,10,"September, 2010"
2010-2011,5,2010-09-18,Tottenham,Wolves,3,1,H,3,0,2,1,2,2,1,2,13,12,5,5,1,0,September,-1.0,-1.8369701987210287e-16,42,48,2,0,2,1.75,1.0,3,3,0,5,5,0,"September, 2010"
2010-2011,5,2010-09-18,West Brom,Birmingham,3,1,H,3,0,2,2,1,0,1,4,17,9,4,6,8,2,September,-1.0,-1.8369701987210287e-16,44,3,1,1,3,1.0,1.8,2,8,-6,6,5,1,"September, 2010"
2010-2011,5,2010-09-19,Chelsea,Blackpool,4,0,H,3,0,2,1,2,1,3,1,1,7,12,7,6,5,September,-1.0,-1.8369701987210287e-16,14,5,0,0,0,0.0,0.0,17,1,16,8,8,0,"September, 2010"
2010-2011,5,2010-09-19,Man United,Liverpool,3,2,H,3,0,3,1,1,3,0,2,3,16,8,5,13,3,September,-1.0,-1.8369701987210287e-16,28,25,2,0,3,1.4,1.8,11,5,6,2,4,-2,"September, 2010"
2010-2011,5,2010-09-19,Wigan,Man City,0,2,A,0,3,2,2,1,4,0,1,18,13,4,5,5,1,September,-1.0,-1.8369701987210287e-16,46,27,1,2,2,0.6,1.2,2,11,-9,4,2,2,"September, 2010"
2010-2011,6,2010-09-25,West Ham,Tottenham,1,0,H,3,0,0,1,4,2,1,2,20,6,1,8,14,7,September,-1.0,-1.8369701987210287e-16,45,42,0,0,5,0.2,2.2,3,13,-10,6,4,2,"September, 2010"
2010-2011,6,2010-09-25,Man City,Chelsea,1,0,H,3,0,4,0,1,2,1,2,5,1,8,15,4,7,September,-1.0,-1.8369701987210287e-16,27,14,2,0,3,1.4,1.8,6,2,4,21,1,20,"September, 2010"
2010-2011,6,2010-09-25,Liverpool,Sunderland,2,2,D,1,1,3,0,2,3,0,2,16,13,5,6,3,1,September,-1.0,-1.8369701987210287e-16,25,40,4,0,1,1.8,0.2,4,7,-3,5,5,0,"September, 2010"
2010-2011,6,2010-09-25,Arsenal,West Brom,2,3,A,0,3,1,1,3,2,2,1,2,10,11,7,8,4,September,-1.0,-1.8369701987210287e-16,0,44,4,0,1,2.0,0.8,14,4,10,5,9,-4,"September, 2010"
2010-2011,6,2010-09-25,Blackpool,Blackburn,1,2,A,0,3,1,3,1,2,2,1,11,14,7,5,3,2,September,-1.0,-1.8369701987210287e-16,5,4,0,0,0,0.0,0.0,8,12,-4,5,6,-1,"September, 2010"
2010-2011,6,2010-09-25,Birmingham,Wigan,0,0,D,1,1,0,1,4,2,2,1,12,18,6,4,6,2,September,-1.0,-1.8369701987210287e-16,3,46,3,1,1,1.6,1.4,7,8,-1,2,13,-11,"September, 2010"
2010-2011,6,2010-09-25,Fulham,Everton,0,0,D,1,1,3,1,1,2,1,2,9,19,7,2,10,5,September,-1.0,-1.8369701987210287e-16,19,18,2,0,3,0.8,1.2,7,6,1,4,7,-3,"September, 2010"
2010-2011,6,2010-09-26,Bolton,Man United,2,2,D,1,1,0,0,5,3,1,1,14,3,6,11,11,5,September,-1.0,-1.8369701987210287e-16,6,28,0,0,5,0.2,2.2,7,8,-1,14,7,7,"September, 2010"
2010-2011,6,2010-09-26,Newcastle,Stoke,1,2,A,0,3,1,3,1,2,1,2,9,18,7,4,9,3,September,-1.0,-1.8369701987210287e-16,30,39,0,2,0,1.5,1.5,8,6,2,5,8,-3,"September, 2010"
2010-2011,6,2010-09-26,Wolves,Aston Villa,1,2,A,0,3,2,1,2,2,2,1,17,14,5,7,3,2,September,-1.0,-1.8369701987210287e-16,48,1,0,2,2,1.25,2.5,6,8,-2,6,9,-3,"September, 2010"
2010-2011,7,2010-10-02,West Ham,Fulham,1,1,D,1,1,0,1,4,3,1,1,20,9,4,8,11,4,October,-0.8660254037844386,0.5,45,19,3,1,1,2.0,1.4,4,13,-9,7,6,1,"October, 2010"
2010-2011,7,2010-10-02,Wigan,Wolves,2,0,H,3,0,2,2,1,2,1,2,20,18,5,5,2,0,October,-0.8660254037844386,0.5,46,48,1,0,1,1.0,0.5,2,13,-11,7,10,-3,"October, 2010"
2010-2011,7,2010-10-02,West Brom,Bolton,1,1,D,1,1,2,2,1,0,0,5,8,13,10,7,5,3,October,-0.8660254037844386,0.5,44,6,0,4,1,0.4,0.8,8,11,-3,9,10,-1,"October, 2010"
2010-2011,7,2010-10-02,Birmingham,Everton,0,2,A,0,3,0,1,4,2,1,2,13,20,7,3,7,4,October,-0.8660254037844386,0.5,3,18,0,4,1,1.0,1.4,7,8,-1,4,7,-3,"October, 2010"
2010-2011,7,2010-10-02,Sunderland,Man United,0,0,D,1,1,3,0,2,3,1,1,12,2,7,12,10,5,October,-0.8660254037844386,0.5,40,28,0,1,4,0.6,2.0,7,7,0,16,9,7,"October, 2010"
2010-2011,7,2010-10-02,Stoke,Blackburn,1,0,H,3,0,2,1,2,2,2,1,13,9,7,8,4,1,October,-0.8660254037844386,0.5,39,4,2,1,1,1.0,0.75,7,9,-2,7,7,0,"October, 2010"
2010-2011,7,2010-10-02,Tottenham,Aston Villa,2,1,H,3,0,2,1,2,2,2,1,9,6,8,10,3,2,October,-0.8660254037844386,0.5,42,1,1,2,2,1.0,1.2,6,5,1,8,10,-2,"October, 2010"
2010-2011,7,2010-10-03,Chelsea,Arsenal,2,0,H,3,0,2,1,2,1,1,3,1,3,15,11,2,4,October,-0.8660254037844386,0.5,14,0,4,0,1,2.4,0.8,21,2,19,16,7,9,"October, 2010"
2010-2011,7,2010-10-03,Liverpool,Blackpool,1,2,A,0,3,3,0,2,1,3,1,18,16,6,7,2,1,October,-0.8660254037844386,0.5,25,5,0,0,0,0.0,0.0,6,9,-3,9,14,-5,"October, 2010"
2010-2011,7,2010-10-03,Man City,Newcastle,2,1,H,3,0,4,0,1,1,3,1,4,15,11,7,11,4,October,-0.8660254037844386,0.5,27,30,4,1,0,2.0,0.8,7,2,5,9,8,1,"October, 2010"
2010-2011,8,2010-10-16,Wolves,West Ham,1,1,D,1,1,2,1,2,0,1,4,19,20,5,5,1,0,October,-0.8660254037844386,0.5,48,45,1,0,1,1.5,1.5,7,12,-5,5,14,-9,"October, 2010"
2010-2011,8,2010-10-16,Newcastle,Wigan,2,2,D,1,1,1,3,1,2,2,1,15,14,7,8,1,1,October,-0.8660254037844386,0.5,30,46,1,1,3,0.8,1.2,10,10,0,4,13,-9,"October, 2010"
2010-2011,8,2010-10-16,Man United,West Brom,2,2,D,1,1,3,1,1,2,2,1,5,8,13,11,3,2,October,-0.8660254037844386,0.5,28,44,4,1,0,3.0,0.4,16,9,7,9,12,-3,"October, 2010"
2010-2011,8,2010-10-16,Fulham,Tottenham,1,2,A,0,3,3,1,1,2,1,2,11,5,9,11,6,2,October,-0.8660254037844386,0.5,19,42,1,2,2,0.6,1.6,8,7,1,8,6,2,"October, 2010"
2010-2011,8,2010-10-16,Aston Villa,Chelsea,0,0,D,1,1,2,2,1,2,1,2,8,1,10,18,7,8,October,-0.8660254037844386,0.5,1,14,1,1,3,1.4,3.0,9,12,-3,23,2,21,"October, 2010"
2010-2011,8,2010-10-16,Arsenal,Birmingham,2,1,H,3,0,1,1,3,0,1,4,4,16,11,7,12,4,October,-0.8660254037844386,0.5,0,3,2,3,0,1.8,1.0,16,9,7,7,10,-3,"October, 2010"
2010-2011,8,2010-10-16,Bolton,Stoke,2,1,H,3,0,0,0,5,2,1,2,12,8,8,10,4,2,October,-0.8660254037844386,0.5,6,39,2,1,1,1.5,1.25,10,11,-1,8,9,-1,"October, 2010"
2010-2011,8,2010-10-17,Blackpool,Man City,2,3,A,0,3,1,3,1,4,0,1,10,4,10,14,6,4,October,-0.8660254037844386,0.5,5,27,0,0,0,0.0,0.0,11,15,-4,9,3,6,"October, 2010"
2010-2011,8,2010-10-17,Everton,Liverpool,2,0,H,3,0,2,1,2,3,0,2,17,18,6,6,1,0,October,-0.8660254037844386,0.5,18,25,0,1,4,0.2,1.4,6,7,-1,7,11,-4,"October, 2010"
2010-2011,8,2010-10-18,Blackburn,Sunderland,0,0,D,1,1,2,2,1,3,0,2,16,15,8,8,1,0,October,-0.8660254037844386,0.5,4,40,1,2,2,1.0,1.2,7,8,-1,7,7,0,"October, 2010"
2010-2011,9,2010-10-23,West Ham,Newcastle,1,2,A,0,3,0,1,4,1,3,1,20,17,6,8,3,2,October,-0.8660254037844386,0.5,45,30,1,3,1,2.0,2.0,6,15,-9,12,12,0,"October, 2010"
2010-2011,9,2010-10-23,Wigan,Bolton,1,1,D,1,1,2,2,1,0,0,5,17,9,9,11,8,2,October,-0.8660254037844386,0.5,46,6,2,2,1,0.4,0.8,6,15,-9,12,12,0,"October, 2010"
2010-2011,9,2010-10-23,Tottenham,Everton,1,1,D,1,1,2,1,2,2,1,2,5,13,14,9,8,5,October,-0.8660254037844386,0.5,42,18,1,3,1,0.8,0.8,10,7,3,8,7,1,"October, 2010"
2010-2011,9,2010-10-23,West Brom,Fulham,2,1,H,3,0,2,2,1,3,1,1,7,14,12,9,7,3,October,-0.8660254037844386,0.5,44,19,1,1,3,0.4,1.8,11,14,-3,9,9,0,"October, 2010"
2010-2011,9,2010-10-23,Sunderland,Aston Villa,1,0,H,3,0,3,0,2,2,2,1,14,8,9,11,6,2,October,-0.8660254037844386,0.5,40,1,1,1,3,0.8,1.4,7,7,0,9,12,-3,"October, 2010"
2010-2011,9,2010-10-23,Chelsea,Wolves,2,0,H,3,0,2,1,2,2,1,2,1,18,19,6,17,13,October,-0.8660254037844386,0.5,14,48,4,0,0,4.0,0.5,23,2,21,8,13,-5,"October, 2010"
2010-2011,9,2010-10-23,Birmingham,Blackpool,2,0,H,3,0,0,1,4,1,3,1,17,10,7,10,7,3,October,-0.8660254037844386,0.5,3,5,0,0,0,0.0,0.0,8,12,-4,13,18,-5,"October, 2010"
2010-2011,9,2010-10-24,Liverpool,Blackburn,2,1,H,3,0,3,0,2,2,2,1,18,17,6,9,1,3,October,-0.8660254037844386,0.5,25,4,4,1,0,2.4,0.6,7,13,-6,7,8,-1,"October, 2010"
2010-2011,9,2010-10-24,Man City,Arsenal,0,3,A,0,3,4,0,1,1,1,3,2,5,17,14,3,3,October,-0.8660254037844386,0.5,27,0,2,1,2,1.6,1.4,12,5,7,18,10,8,"October, 2010"
2010-2011,9,2010-10-24,Stoke,Man United,1,2,A,0,3,2,1,2,3,1,1,13,6,10,14,7,4,October,-0.8660254037844386,0.5,39,28,0,0,4,0.0,3.0,9,11,-2,18,11,7,"October, 2010"
2010-2011,10,2010-10-30,Wolves,Man City,2,1,H,3,0,2,1,2,4,0,1,19,4,6,17,15,11,October,-0.8660254037844386,0.5,48,27,1,1,2,1.0,1.75,8,15,-7,12,8,4,"October, 2010"
2010-2011,10,2010-10-30,Man United,Tottenham,2,0,H,3,0,3,1,1,2,1,2,3,5,17,15,2,2,October,-0.8660254037844386,0.5,28,42,3,2,0,2.4,1.0,20,12,8,11,8,3,"October, 2010"
2010-2011,10,2010-10-30,Fulham,Wigan,2,0,H,3,0,3,1,1,2,2,1,16,15,9,10,1,1,October,-0.8660254037844386,0.5,19,46,2,3,0,1.2,0.6,10,11,-1,7,16,-9,"October, 2010"
2010-2011,10,2010-10-30,Blackburn,Chelsea,1,2,A,0,3,2,2,1,2,1,2,17,1,9,22,16,13,October,-0.8660254037844386,0.5,4,14,0,1,4,0.2,2.2,8,10,-2,25,2,23,"October, 2010"
2010-2011,10,2010-10-30,Arsenal,West Ham,1,0,H,3,0,1,1,3,0,1,4,2,20,17,6,18,11,October,-0.8660254037844386,0.5,0,45,3,2,0,1.6,0.4,21,10,11,7,17,-10,"October, 2010"
2010-2011,10,2010-10-30,Everton,Stoke,1,0,H,3,0,2,1,2,2,1,2,11,13,10,10,2,0,October,-0.8660254037844386,0.5,18,39,2,2,0,1.75,1.0,9,8,1,10,13,-3,"October, 2010"
2010-2011,10,2010-10-31,Aston Villa,Birmingham,0,0,D,1,1,2,2,1,0,1,4,12,13,11,10,1,1,October,-0.8660254037844386,0.5,1,3,5,0,0,2.4,0.6,9,13,-4,10,12,-2,"October, 2010"
2010-2011,10,2010-10-31,Bolton,Liverpool,0,1,A,0,3,0,0,5,3,0,2,10,18,12,9,8,3,October,-0.8660254037844386,0.5,6,25,0,0,5,0.6,2.6,13,13,0,9,14,-5,"October, 2010"
2010-2011,10,2010-10-31,Newcastle,Sunderland,5,1,H,3,0,1,3,1,3,0,2,13,9,11,12,4,1,October,-0.8660254037844386,0.5,30,40,2,2,1,1.8,1.0,14,13,1,8,7,1,"October, 2010"
2010-2011,10,2010-11-01,Blackpool,West Brom,2,1,H,3,0,1,3,1,2,2,1,16,6,10,15,10,5,November,-0.5000000000000004,0.8660254037844384,5,44,0,0,0,0.0,0.0,13,20,-7,13,15,-2,"November, 2010"
2010-2011,11,2010-11-06,Fulham,Aston Villa,1,1,D,1,1,3,1,1,2,2,1,11,16,12,12,5,0,November,-0.5000000000000004,0.8660254037844384,19,1,2,1,2,1.0,1.2,12,11,1,9,13,-4,"November, 2010"
2010-2011,11,2010-11-06,Sunderland,Stoke,2,0,H,3,0,3,0,2,2,1,2,15,17,12,10,2,2,November,-0.5000000000000004,0.8660254037844384,40,39,1,1,2,0.5,0.5,9,12,-3,10,14,-4,"November, 2010"
2010-2011,11,2010-11-06,Bolton,Tottenham,4,2,H,3,0,0,0,5,2,1,2,11,5,12,15,6,3,November,-0.5000000000000004,0.8660254037844384,6,42,1,2,2,1.2,1.6,13,14,-1,11,10,1,"November, 2010"
2010-2011,11,2010-11-06,Man United,Wolves,2,1,H,3,0,3,1,1,2,1,2,3,19,20,9,16,11,November,-0.5000000000000004,0.8660254037844384,28,48,3,0,1,1.25,0.25,22,12,10,10,16,-6,"November, 2010"
2010-2011,11,2010-11-06,Blackburn,Wigan,2,1,H,3,0,2,2,1,2,2,1,18,17,9,10,1,1,November,-0.5000000000000004,0.8660254037844384,4,46,3,1,1,1.6,1.2,9,12,-3,7,18,-11,"November, 2010"
2010-2011,11,2010-11-06,Birmingham,West Ham,2,2,D,1,1,0,1,4,0,1,4,15,20,11,6,5,5,November,-0.5000000000000004,0.8660254037844384,3,45,1,1,3,0.4,1.4,10,12,-2,7,18,-11,"November, 2010"
2010-2011,11,2010-11-06,Blackpool,Everton,2,2,D,1,1,1,3,1,2,1,2,9,8,13,13,1,0,November,-0.5000000000000004,0.8660254037844384,5,18,0,0,0,0.0,0.0,15,21,-6,10,8,2,"November, 2010"
2010-2011,11,2010-11-07,Arsenal,Newcastle,0,1,A,0,3,1,1,3,1,3,1,3,9,20,14,6,6,November,-0.5000000000000004,0.8660254037844384,0,30,3,2,0,2.0,0.4,22,10,12,19,14,5,"November, 2010"
2010-2011,11,2010-11-07,Liverpool,Chelsea,2,0,H,3,0,3,0,2,2,1,2,16,1,12,25,15,13,November,-0.5000000000000004,0.8660254037844384,25,14,2,1,2,0.6,0.8,10,14,-4,27,3,24,"November, 2010"
2010-2011,11,2010-11-07,West Brom,Man City,0,2,A,0,3,2,2,1,4,0,1,10,5,15,17,5,2,November,-0.5000000000000004,0.8660254037844384,44,27,3,1,1,1.6,1.0,14,17,-3,13,10,3,"November, 2010"
2010-2011,12,2010-11-09,Stoke,Birmingham,3,2,H,3,0,2,1,2,0,1,4,17,15,10,12,2,2,November,-0.5000000000000004,0.8660254037844384,39,3,0,1,1,0.0,0.5,10,16,-6,12,14,-2,"November, 2010"
2010-2011,12,2010-11-09,Tottenham,Sunderland,1,1,D,1,1,2,1,2,3,0,2,7,8,15,15,1,0,November,-0.5000000000000004,0.8660254037844384,42,40,2,1,2,1.4,1.2,13,14,-1,11,12,-1,"November, 2010"
2010-2011,12,2010-11-10,Wolves,Arsenal,0,2,A,0,3,2,1,2,1,1,3,19,4,9,20,15,11,November,-0.5000000000000004,0.8660254037844384,48,0,0,0,4,0.5,2.75,11,18,-7,22,11,11,"November, 2010"
2010-2011,12,2010-11-10,Wigan,Liverpool,1,1,D,1,1,2,2,1,3,0,2,18,13,10,15,5,5,November,-0.5000000000000004,0.8660254037844384,46,25,1,2,2,1.2,1.4,8,20,-12,12,14,-2,"November, 2010"
2010-2011,12,2010-11-10,West Ham,West Brom,2,2,D,1,1,0,1,4,2,2,1,20,13,7,15,7,8,November,-0.5000000000000004,0.8660254037844384,45,44,3,1,1,1.2,0.8,9,20,-11,14,19,-5,"November, 2010"
2010-2011,12,2010-11-10,Newcastle,Blackburn,1,2,A,0,3,1,3,1,2,2,1,5,16,17,12,11,5,November,-0.5000000000000004,0.8660254037844384,30,4,0,0,5,0.4,2.2,20,14,6,11,13,-2,"November, 2010"
2010-2011,12,2010-11-10,Man City,Man United,0,0,D,1,1,4,0,1,3,1,1,4,2,20,23,2,3,November,-0.5000000000000004,0.8660254037844384,27,28,1,0,4,1.0,1.8,15,10,5,24,13,11,"November, 2010"
2010-2011,12,2010-11-10,Chelsea,Fulham,1,0,H,3,0,2,1,2,3,1,1,1,14,25,13,13,12,November,-0.5000000000000004,0.8660254037844384,14,19,4,1,0,2.2,1.0,27,5,22,13,12,1,"November, 2010"
2010-2011,12,2010-11-10,Aston Villa,Blackpool,3,2,H,3,0,2,2,1,1,3,1,14,12,13,14,2,1,November,-0.5000000000000004,0.8660254037844384,1,5,0,0,0,0.0,0.0,10,14,-4,17,23,-6,"November, 2010"
2010-2011,12,2010-11-10,Everton,Bolton,1,1,D,1,1,2,1,2,0,0,5,12,9,14,15,3,1,November,-0.5000000000000004,0.8660254037844384,18,6,4,0,1,2.0,0.6,12,10,2,17,16,1,"November, 2010"
2010-2011,13,2010-11-13,Wigan,West Brom,1,0,H,3,0,2,2,1,2,2,1,18,12,11,16,6,5,November,-0.5000000000000004,0.8660254037844384,46,44,2,0,2,1.25,1.5,9,21,-12,16,21,-5,"November, 2010"
2010-2011,13,2010-11-13,Aston Villa,Man United,2,2,D,1,1,2,2,1,3,1,1,10,2,16,24,8,8,November,-0.5000000000000004,0.8660254037844384,1,28,1,2,2,0.8,1.6,13,16,-3,24,13,11,"November, 2010"
2010-2011,13,2010-11-13,Man City,Birmingham,0,0,D,1,1,4,0,1,0,1,4,4,17,21,12,13,9,November,-0.5000000000000004,0.8660254037844384,27,3,3,1,1,2.2,1.0,15,10,5,14,17,-3,"November, 2010"
2010-2011,13,2010-11-13,Newcastle,Fulham,0,0,D,1,1,1,3,1,3,1,1,5,15,17,13,10,4,November,-0.5000000000000004,0.8660254037844384,30,19,2,0,3,1.0,1.0,21,16,5,13,13,0,"November, 2010"
2010-2011,13,2010-11-13,Stoke,Liverpool,2,0,H,3,0,2,1,2,3,0,2,17,10,13,16,7,3,November,-0.5000000000000004,0.8660254037844384,39,25,0,3,1,0.25,1.25,13,18,-5,13,15,-2,"November, 2010"
2010-2011,13,2010-11-13,Tottenham,Blackburn,4,2,H,3,0,2,1,2,2,2,1,8,14,16,15,6,1,November,-0.5000000000000004,0.8660254037844384,42,4,3,1,1,1.6,0.8,14,15,-1,13,14,-1,"November, 2010"
2010-2011,13,2010-11-13,West Ham,Blackpool,0,0,D,1,1,0,1,4,1,3,1,20,16,8,14,4,6,November,-0.5000000000000004,0.8660254037844384,45,5,0,0,0,0.0,0.0,11,22,-11,19,26,-7,"November, 2010"
2010-2011,13,2010-11-13,Wolves,Bolton,2,3,A,0,3,2,1,2,0,0,5,19,8,9,16,11,7,November,-0.5000000000000004,0.8660254037844384,48,6,1,1,2,1.0,1.25,11,20,-9,18,17,1,"November, 2010"
2010-2011,13,2010-11-14,Everton,Arsenal,1,2,A,0,3,2,1,2,1,1,3,13,3,15,23,10,8,November,-0.5000000000000004,0.8660254037844384,18,0,0,2,3,1.0,2.6,13,11,2,24,11,13,"November, 2010"
2010-2011,13,2010-11-14,Chelsea,Sunderland,0,3,A,0,3,2,1,2,3,0,2,1,9,28,16,8,12,November,-0.5000000000000004,0.8660254037844384,14,40,5,0,0,3.8,1.0,28,5,23,12,13,-1,"November, 2010"
2010-2011,14,2010-11-20,Arsenal,Tottenham,2,3,A,0,3,1,1,3,2,1,2,2,7,26,19,5,7,November,-0.5000000000000004,0.8660254037844384,0,42,2,2,1,2.0,1.4,26,12,14,18,17,1,"November, 2010"
2010-2011,14,2010-11-20,Birmingham,Chelsea,1,0,H,3,0,0,1,4,2,1,2,18,1,13,28,17,15,November,-0.5000000000000004,0.8660254037844384,3,14,0,2,3,0.4,1.4,14,17,-3,28,8,20,"November, 2010"
2010-2011,14,2010-11-20,Blackpool,Wolves,2,1,H,3,0,1,3,1,2,1,2,16,19,15,9,3,6,November,-0.5000000000000004,0.8660254037844384,5,48,0,0,0,0.0,0.0,19,26,-7,13,23,-10,"November, 2010"
2010-2011,14,2010-11-20,Bolton,Newcastle,5,1,H,3,0,0,0,5,1,3,1,6,8,19,18,2,1,November,-0.5000000000000004,0.8660254037844384,6,30,2,1,2,0.8,1.0,21,19,2,21,16,5,"November, 2010"
2010-2011,14,2010-11-20,Liverpool,West Ham,3,0,H,3,0,3,0,2,0,1,4,13,20,16,9,7,7,November,-0.5000000000000004,0.8660254037844384,25,45,4,1,0,2.6,0.4,13,17,-4,11,22,-11,"November, 2010"
2010-2011,14,2010-11-20,Man United,Wigan,2,0,H,3,0,3,1,1,2,2,1,3,18,25,14,15,11,November,-0.5000000000000004,0.8660254037844384,28,46,5,0,0,3.0,0.2,26,15,11,10,21,-11,"November, 2010"
2010-2011,14,2010-11-20,West Brom,Stoke,0,3,A,0,3,2,2,1,2,1,2,14,13,16,16,1,0,November,-0.5000000000000004,0.8660254037844384,44,39,0,0,2,0.0,1.5,16,22,-6,15,18,-3,"November, 2010"
2010-2011,14,2010-11-21,Fulham,Man City,1,4,A,0,3,3,1,1,4,0,1,17,5,14,22,12,8,November,-0.5000000000000004,0.8660254037844384,19,27,2,2,1,2.0,1.6,13,13,0,15,10,5,"November, 2010"
2010-2011,14,2010-11-21,Blackburn,Aston Villa,2,0,H,3,0,2,2,1,2,2,1,16,12,15,17,4,2,November,-0.5000000000000004,0.8660254037844384,4,1,2,1,2,1.2,1.4,15,18,-3,15,18,-3,"November, 2010"
2010-2011,14,2010-11-22,Sunderland,Everton,2,2,D,1,1,3,0,2,2,1,2,7,16,19,15,9,4,November,-0.5000000000000004,0.8660254037844384,40,18,0,1,4,0.2,1.8,15,13,2,14,13,1,"November, 2010"
2010-2011,15,2010-11-27,West Ham,Wigan,3,1,H,3,0,0,1,4,2,2,1,20,18,9,14,2,5,November,-0.5000000000000004,0.8660254037844384,45,46,3,0,2,1.2,1.0,11,25,-14,10,23,-13,"November, 2010"
2010-2011,15,2010-11-27,Stoke,Man City,1,1,D,1,1,2,1,2,4,0,1,8,4,19,25,4,6,November,-0.5000000000000004,0.8660254037844384,39,27,1,1,2,0.5,1.5,18,18,0,19,11,8,"November, 2010"
2010-2011,15,2010-11-27,Man United,Blackburn,7,1,H,3,0,3,1,1,2,2,1,3,13,28,18,10,10,November,-0.5000000000000004,0.8660254037844384,28,4,3,2,0,1.4,0.4,28,15,13,17,18,-1,"November, 2010"
2010-2011,15,2010-11-27,Aston Villa,Arsenal,2,4,A,0,3,2,2,1,1,1,3,13,3,17,26,10,9,November,-0.5000000000000004,0.8660254037844384,1,0,1,3,1,1.0,1.2,15,20,-5,28,15,13,"November, 2010"
2010-2011,15,2010-11-27,Everton,West Brom,1,4,A,0,3,2,1,2,2,2,1,14,16,16,16,2,0,November,-0.5000000000000004,0.8660254037844384,18,44,2,1,2,1.2,1.6,16,15,1,16,25,-9,"November, 2010"
2010-2011,15,2010-11-27,Bolton,Blackpool,2,2,D,1,1,0,0,5,1,3,1,5,12,22,18,7,4,November,-0.5000000000000004,0.8660254037844384,6,5,0,0,0,0.0,0.0,26,20,6,21,27,-6,"November, 2010"
2010-2011,15,2010-11-27,Wolves,Sunderland,3,2,H,3,0,2,1,2,3,0,2,20,7,9,20,13,11,November,-0.5000000000000004,0.8660254037844384,48,40,1,0,1,2.0,3.0,14,25,-11,17,15,2,"November, 2010"
2010-2011,15,2010-11-27,Fulham,Birmingham,1,1,D,1,1,3,1,1,0,1,4,17,16,14,16,1,2,November,-0.5000000000000004,0.8660254037844384,19,3,2,1,2,1.0,0.8,14,17,-3,15,17,-2,"November, 2010"
2010-2011,15,2010-11-28,Tottenham,Liverpool,2,1,H,3,0,2,1,2,3,0,2,6,10,22,19,4,3,November,-0.5000000000000004,0.8660254037844384,42,25,2,0,3,1.0,1.8,21,19,2,16,17,-1,"November, 2010"
2010-2011,15,2010-11-28,Newcastle,Chelsea,1,1,D,1,1,1,3,1,2,1,2,12,3,18,28,9,10,November,-0.5000000000000004,0.8660254037844384,30,14,0,2,3,0.2,1.2,22,21,1,28,9,19,"November, 2010"
2010-2011,16,2010-12-04,Man City,Bolton,1,0,H,3,0,4,0,1,0,0,5,4,6,26,23,2,3,December,-2.4492935982947064e-16,1.0,27,6,2,2,1,1.2,1.0,20,12,8,28,22,6,"December, 2010"
2010-2011,16,2010-12-04,Wigan,Stoke,2,2,D,1,1,2,2,1,2,1,2,18,9,14,20,9,6,December,-2.4492935982947064e-16,1.0,46,39,0,3,1,0.75,1.25,11,26,-15,19,19,0,"December, 2010"
2010-2011,16,2010-12-04,Chelsea,Everton,1,1,D,1,1,2,1,2,2,1,2,3,16,29,16,13,13,December,-2.4492935982947064e-16,1.0,14,18,1,3,1,1.0,1.0,29,10,19,17,19,-2,"December, 2010"
2010-2011,16,2010-12-04,Arsenal,Fulham,2,1,H,3,0,1,1,3,3,1,1,3,17,29,15,14,14,December,-2.4492935982947064e-16,1.0,0,19,3,1,1,1.6,0.2,32,17,15,15,18,-3,"December, 2010"
2010-2011,16,2010-12-04,Birmingham,Tottenham,1,1,D,1,1,0,1,4,2,1,2,14,5,17,25,9,8,December,-2.4492935982947064e-16,1.0,3,42,2,1,2,1.8,1.6,16,18,-2,23,20,3,"December, 2010"
2010-2011,16,2010-12-04,Blackburn,Wolves,3,0,H,3,0,2,2,1,2,1,2,14,19,18,12,5,6,December,-2.4492935982947064e-16,1.0,4,48,2,2,0,2.75,1.25,18,25,-7,17,27,-10,"December, 2010"
2010-2011,16,2010-12-05,Sunderland,West Ham,1,0,H,3,0,3,0,2,0,1,4,9,19,20,12,10,8,December,-2.4492935982947064e-16,1.0,40,45,1,1,3,0.8,1.4,19,18,1,14,26,-12,"December, 2010"
2010-2011,16,2010-12-05,West Brom,Newcastle,3,1,H,3,0,2,2,1,1,3,1,13,10,19,19,3,0,December,-2.4492935982947064e-16,1.0,44,30,0,1,4,0.6,2.2,20,26,-6,23,22,1,"December, 2010"
2010-2011,16,2010-12-06,Liverpool,Aston Villa,3,0,H,3,0,3,0,2,2,2,1,12,16,19,17,4,2,December,-2.4492935982947064e-16,1.0,25,1,2,2,1,1.8,1.0,17,19,-2,17,24,-7,"December, 2010"
2010-2011,17,2010-12-11,Aston Villa,West Brom,2,1,H,3,0,2,2,1,2,2,1,16,9,17,22,7,5,December,-2.4492935982947064e-16,1.0,1,44,3,2,0,1.4,0.8,17,27,-10,23,27,-4,"December, 2010"
2010-2011,17,2010-12-11,Everton,Wigan,0,0,D,1,1,2,1,2,2,2,1,16,18,17,15,2,2,December,-2.4492935982947064e-16,1.0,18,46,4,0,1,1.8,0.6,18,20,-2,13,28,-15,"December, 2010"
2010-2011,17,2010-12-11,Fulham,Sunderland,0,0,D,1,1,3,1,1,3,0,2,18,7,15,23,11,8,December,-2.4492935982947064e-16,1.0,19,40,1,2,2,0.4,0.8,16,20,-4,20,18,2,"December, 2010"
2010-2011,17,2010-12-11,Newcastle,Liverpool,3,1,H,3,0,1,3,1,3,0,2,13,8,19,22,5,3,December,-2.4492935982947064e-16,1.0,30,25,1,0,4,0.6,3.0,24,25,-1,20,19,1,"December, 2010"
2010-2011,17,2010-12-11,Stoke,Blackpool,0,1,A,0,3,2,1,2,1,3,1,11,14,21,19,3,2,December,-2.4492935982947064e-16,1.0,39,5,0,0,0,0.0,0.0,21,21,0,23,29,-6,"December, 2010"
2010-2011,17,2010-12-11,West Ham,Man City,1,3,A,0,3,0,1,4,4,0,1,20,4,12,29,16,17,December,-2.4492935982947064e-16,1.0,45,27,1,2,2,0.8,1.6,14,27,-13,21,12,9,"December, 2010"
2010-2011,17,2010-12-12,Wolves,Birmingham,1,0,H,3,0,2,1,2,0,1,4,19,16,12,18,3,6,December,-2.4492935982947064e-16,1.0,48,3,0,2,2,1.0,1.5,17,30,-13,17,19,-2,"December, 2010"
2010-2011,17,2010-12-12,Bolton,Blackburn,2,1,H,3,0,0,0,5,2,2,1,7,13,23,21,6,2,December,-2.4492935982947064e-16,1.0,6,4,0,2,3,0.6,2.2,28,23,5,21,25,-4,"December, 2010"
2010-2011,17,2010-12-12,Tottenham,Chelsea,1,1,D,1,1,2,1,2,2,1,2,6,4,26,30,2,4,December,-2.4492935982947064e-16,1.0,42,14,2,2,1,1.6,1.8,24,21,3,30,11,19,"December, 2010"
2010-2011,17,2010-12-13,Man United,Arsenal,1,0,H,3,0,3,1,1,1,1,3,3,1,31,32,2,1,December,-2.4492935982947064e-16,1.0,28,0,3,1,1,1.6,1.0,35,16,19,34,18,16,"December, 2010"
2010-2011,17,2010-12-18,Sunderland,Bolton,1,0,H,3,0,3,0,2,0,0,5,7,6,24,26,1,2,December,-2.4492935982947064e-16,1.0,40,6,2,1,2,1.2,1.2,20,18,2,30,24,6,"December, 2010"
2010-2011,17,2010-12-18,Blackburn,West Ham,1,1,D,1,1,2,2,1,0,1,4,13,20,21,12,7,9,December,-2.4492935982947064e-16,1.0,4,45,0,3,2,0.6,1.4,22,27,-5,15,30,-15,"December, 2010"
2010-2011,17,2010-12-20,Man City,Everton,1,2,A,0,3,4,0,1,2,1,2,3,15,32,18,12,14,December,-2.4492935982947064e-16,1.0,27,18,1,0,4,0.4,1.6,24,13,11,18,20,-2,"December, 2010"
2010-2011,18,2010-12-26,Newcastle,Man City,1,3,A,0,3,1,3,1,4,0,1,9,3,22,32,6,10,December,-2.4492935982947064e-16,1.0,30,27,0,1,4,1.0,2.2,27,26,1,25,15,10,"December, 2010"
2010-2011,18,2010-12-26,Wolves,Wigan,1,2,A,0,3,2,1,2,2,2,1,20,19,15,16,1,1,December,-2.4492935982947064e-16,1.0,48,46,1,0,2,0.3333333333333333,1.3333333333333333,18,30,-12,13,28,-15,"December, 2010"
2010-2011,18,2010-12-26,Man United,Sunderland,2,0,H,3,0,3,1,1,3,0,2,1,7,34,27,6,7,December,-2.4492935982947064e-16,1.0,28,40,3,2,0,1.2,0.6,36,16,20,21,18,3,"December, 2010"
2010-2011,18,2010-12-26,Blackburn,Stoke,0,2,A,0,3,2,2,1,2,1,2,12,13,22,21,1,1,December,-2.4492935982947064e-16,1.0,4,39,1,1,3,0.6,1.0,23,28,-5,21,22,-1,"December, 2010"
2010-2011,18,2010-12-26,Bolton,West Brom,2,0,H,3,0,0,0,5,2,2,1,7,12,26,22,5,4,December,-2.4492935982947064e-16,1.0,6,44,1,4,0,0.8,0.4,30,25,5,24,29,-5,"December, 2010"
2010-2011,18,2010-12-26,Fulham,West Ham,1,3,A,0,3,3,1,1,0,1,4,17,20,16,13,3,3,December,-2.4492935982947064e-16,1.0,19,45,1,2,2,1.6,2.0,16,20,-4,16,31,-15,"December, 2010"
2010-2011,18,2010-12-26,Aston Villa,Tottenham,1,2,A,0,3,2,2,1,2,1,2,15,5,20,27,10,7,December,-2.4492935982947064e-16,1.0,1,42,1,2,2,1.0,1.2,19,28,-9,25,22,3,"December, 2010"
2010-2011,18,2010-12-27,Arsenal,Chelsea,3,1,H,3,0,1,1,3,2,1,2,3,4,32,31,1,1,December,-2.4492935982947064e-16,1.0,0,14,1,0,4,0.6,2.4,34,19,15,31,12,19,"December, 2010"
2010-2011,18,2010-12-28,West Ham,Everton,1,1,D,1,1,0,1,4,2,1,2,19,14,16,21,5,5,December,-2.4492935982947064e-16,1.0,45,18,0,2,3,1.2,2.2,19,32,-13,20,21,-1,"December, 2010"
2010-2011,18,2010-12-28,West Brom,Blackburn,1,3,A,0,3,2,2,1,2,2,1,12,13,22,22,1,0,December,-2.4492935982947064e-16,1.0,44,4,1,3,1,1.0,1.0,24,31,-7,23,30,-7,"December, 2010"
2010-2011,18,2010-12-28,Sunderland,Blackpool,0,2,A,0,3,3,0,2,1,3,1,7,11,27,22,4,5,December,-2.4492935982947064e-16,1.0,40,5,0,0,0,0.0,0.0,21,20,1,24,29,-5,"December, 2010"
2010-2011,18,2010-12-28,Tottenham,Newcastle,2,0,H,3,0,2,1,2,1,3,1,5,10,30,22,5,8,December,-2.4492935982947064e-16,1.0,42,30,1,0,4,1.2,2.4,27,23,4,28,29,-1,"December, 2010"
2010-2011,18,2010-12-28,Man City,Aston Villa,4,0,H,3,0,4,0,1,2,2,1,3,15,35,20,12,15,December,-2.4492935982947064e-16,1.0,27,1,2,2,1,1.8,1.4,28,16,12,20,30,-10,"December, 2010"
2010-2011,18,2010-12-28,Birmingham,Man United,1,1,D,1,1,0,1,4,3,1,1,17,1,18,37,16,19,December,-2.4492935982947064e-16,1.0,3,28,0,1,4,0.2,1.4,17,20,-3,38,16,22,"December, 2010"
2010-2011,18,2010-12-28,Stoke,Fulham,0,2,A,0,3,2,1,2,3,1,1,8,18,24,16,10,8,December,-2.4492935982947064e-16,1.0,39,19,2,1,1,1.0,0.75,23,22,1,17,23,-6,"December, 2010"
2010-2011,18,2010-12-29,Chelsea,Bolton,1,0,H,3,0,2,1,2,0,0,5,5,6,31,29,1,2,December,-2.4492935982947064e-16,1.0,14,6,4,1,0,2.4,0.8,32,15,17,32,25,7,"December, 2010"
2010-2011,18,2010-12-29,Liverpool,Wolves,0,1,A,0,3,3,0,2,2,1,2,12,20,22,15,8,7,December,-2.4492935982947064e-16,1.0,25,48,2,2,0,1.0,0.25,21,22,-1,19,32,-13,"December, 2010"
2010-2011,18,2010-12-29,Wigan,Arsenal,2,2,D,1,1,2,2,1,1,1,3,18,3,19,35,15,16,December,-2.4492935982947064e-16,1.0,46,0,1,1,3,0.8,2.2,15,29,-14,37,20,17,"December, 2010"
2010-2011,19,2011-01-01,Tottenham,Fulham,1,0,H,3,0,2,1,2,3,1,1,5,17,33,19,12,14,January,0.4999999999999999,0.8660254037844387,42,19,2,2,1,1.0,0.6,29,23,6,19,23,-4,"January, 2011"
2010-2011,19,2011-01-01,West Ham,Wolves,2,0,H,3,0,0,1,4,2,1,2,20,19,17,18,1,1,January,0.4999999999999999,0.8660254037844387,45,48,1,1,1,1.3333333333333333,1.3333333333333333,20,33,-13,20,32,-12,"January, 2011"
2010-2011,19,2011-01-01,Sunderland,Blackburn,3,0,H,3,0,3,0,2,2,2,1,8,11,27,25,3,2,January,0.4999999999999999,0.8660254037844387,40,4,2,3,0,1.2,0.8,21,22,-1,26,31,-5,"January, 2011"
2010-2011,19,2011-01-01,West Brom,Man United,1,2,A,0,3,2,2,1,3,1,1,14,3,22,38,11,16,January,0.4999999999999999,0.8660254037844387,44,28,0,1,4,0.6,3.2,25,34,-9,39,17,22,"January, 2011"
2010-2011,19,2011-01-01,Man City,Blackpool,1,0,H,3,0,4,0,1,1,3,1,3,9,38,25,6,13,January,0.4999999999999999,0.8660254037844387,27,5,1,0,0,3.0,2.0,32,16,16,26,29,-3,"January, 2011"
2010-2011,19,2011-01-01,Liverpool,Bolton,2,1,H,3,0,3,0,2,0,0,5,12,6,22,29,6,7,January,0.4999999999999999,0.8660254037844387,25,6,5,0,0,2.2,0.4,21,23,-2,32,26,6,"January, 2011"
2010-2011,19,2011-01-01,Birmingham,Arsenal,0,3,A,0,3,0,1,4,1,1,3,17,3,19,36,14,17,January,0.4999999999999999,0.8660254037844387,3,0,0,3,2,1.2,1.8,18,21,-3,39,22,17,"January, 2011"
2010-2011,19,2011-01-01,Stoke,Everton,2,0,H,3,0,2,1,2,2,1,2,11,12,24,22,1,2,January,0.4999999999999999,0.8660254037844387,39,18,0,2,3,0.8,1.6,23,24,-1,21,22,-1,"January, 2011"
2010-2011,19,2011-01-02,Chelsea,Aston Villa,3,3,D,1,1,2,1,2,2,2,1,5,16,34,20,11,14,January,0.4999999999999999,0.8660254037844387,14,1,3,1,1,2.2,0.6,33,15,18,20,34,-14,"January, 2011"
2010-2011,19,2011-01-02,Wigan,Newcastle,0,1,A,0,3,2,2,1,1,3,1,17,12,20,22,5,2,January,0.4999999999999999,0.8660254037844387,46,30,2,2,1,1.4,1.2,17,31,-14,28,31,-3,"January, 2011"
2010-2011,20,2011-01-04,Blackpool,Birmingham,1,2,A,0,3,1,3,1,0,1,4,11,19,25,19,8,6,January,0.4999999999999999,0.8660254037844387,5,3,0,0,1,0.0,2.0,26,30,-4,18,24,-6,"January, 2011"
2010-2011,20,2011-01-04,Fulham,West Brom,3,0,H,3,0,3,1,1,2,2,1,19,15,19,22,4,3,January,0.4999999999999999,0.8660254037844387,19,44,2,1,2,1.8,0.8,19,24,-5,26,36,-10,"January, 2011"
2010-2011,20,2011-01-04,Man United,Stoke,2,1,H,3,0,3,1,1,2,1,2,1,8,41,27,7,14,January,0.4999999999999999,0.8660254037844387,28,39,5,0,0,2.8,0.2,41,18,23,25,24,1,"January, 2011"
2010-2011,20,2011-01-05,Wolves,Chelsea,1,0,H,3,0,2,1,2,2,1,2,20,5,18,35,15,17,January,0.4999999999999999,0.8660254037844387,48,14,0,0,5,0.4,3.6,20,34,-14,36,18,18,"January, 2011"
2010-2011,20,2011-01-05,Newcastle,West Ham,5,0,H,3,0,1,3,1,0,1,4,10,19,25,20,9,5,January,0.4999999999999999,0.8660254037844387,30,45,2,2,1,2.0,1.8,29,31,-2,22,33,-11,"January, 2011"
2010-2011,20,2011-01-05,Everton,Tottenham,2,1,H,3,0,2,1,2,2,1,2,14,4,22,36,10,14,January,0.4999999999999999,0.8660254037844387,18,42,1,3,1,1.0,1.0,21,24,-3,30,23,7,"January, 2011"
2010-2011,20,2011-01-05,Blackburn,Liverpool,3,1,H,3,0,2,2,1,3,0,2,12,9,25,25,3,0,January,0.4999999999999999,0.8660254037844387,4,25,0,1,4,0.6,2.2,26,34,-8,23,24,-1,"January, 2011"
2010-2011,20,2011-01-05,Aston Villa,Sunderland,0,1,A,0,3,2,2,1,3,0,2,17,6,21,30,11,9,January,0.4999999999999999,0.8660254037844387,1,40,3,1,1,1.4,0.8,23,37,-14,24,22,2,"January, 2011"
2010-2011,20,2011-01-05,Arsenal,Man City,0,0,D,1,1,1,1,3,4,0,1,3,2,39,41,1,2,January,0.4999999999999999,0.8660254037844387,0,27,2,1,2,1.4,1.4,42,22,20,33,16,17,"January, 2011"
2010-2011,20,2011-01-05,Bolton,Wigan,1,1,D,1,1,0,0,5,2,2,1,7,19,29,20,12,9,January,0.4999999999999999,0.8660254037844387,6,46,1,3,1,1.0,0.4,33,28,5,17,32,-15,"January, 2011"
2010-2011,20,2011-01-12,Blackpool,Liverpool,2,1,H,3,0,1,3,1,3,0,2,13,12,25,25,1,0,January,0.4999999999999999,0.8660254037844387,5,25,1,0,0,2.0,1.0,27,32,-5,24,27,-3,"January, 2011"
2010-2011,21,2011-01-15,Wigan,Fulham,1,1,D,1,1,2,2,1,3,1,1,19,15,21,22,4,1,January,0.4999999999999999,0.8660254037844387,46,19,0,2,3,0.4,1.4,18,33,-15,22,24,-2,"January, 2011"
2010-2011,21,2011-01-15,Chelsea,Blackburn,2,0,H,3,0,2,1,2,2,2,1,5,10,35,28,5,7,January,0.4999999999999999,0.8660254037844387,14,4,4,1,0,2.4,0.4,36,19,17,29,35,-6,"January, 2011"
2010-2011,21,2011-01-15,Man City,Wolves,4,3,H,3,0,4,0,1,2,1,2,2,17,42,21,15,21,January,0.4999999999999999,0.8660254037844387,27,48,2,1,2,1.6,1.2,33,16,17,21,34,-13,"January, 2011"
2010-2011,21,2011-01-15,Stoke,Bolton,2,0,H,3,0,2,1,2,0,0,5,11,7,27,30,4,3,January,0.4999999999999999,0.8660254037844387,39,6,1,1,3,1.2,1.6,26,26,0,34,29,5,"January, 2011"
2010-2011,21,2011-01-15,West Brom,Blackpool,3,2,H,3,0,2,2,1,1,3,1,16,10,22,28,6,6,January,0.4999999999999999,0.8660254037844387,44,5,0,0,1,1.0,2.0,26,39,-13,29,33,-4,"January, 2011"
2010-2011,21,2011-01-15,West Ham,Arsenal,0,3,A,0,3,0,1,4,1,1,3,20,3,20,40,17,20,January,0.4999999999999999,0.8660254037844387,45,0,0,2,3,0.4,1.4,22,38,-16,42,22,20,"January, 2011"
2010-2011,21,2011-01-16,Tottenham,Man United,0,0,D,1,1,2,1,2,3,1,1,5,2,36,44,3,8,January,0.4999999999999999,0.8660254037844387,42,28,0,1,4,0.8,2.6,31,25,6,43,19,24,"January, 2011"
2010-2011,21,2011-01-16,Sunderland,Newcastle,1,1,D,1,1,3,0,2,1,3,1,6,9,33,28,3,5,January,0.4999999999999999,0.8660254037844387,40,30,1,2,2,1.0,2.0,25,22,3,34,31,3,"January, 2011"
2010-2011,21,2011-01-16,Liverpool,Everton,2,2,D,1,1,3,0,2,2,1,2,13,12,25,25,1,0,January,0.4999999999999999,0.8660254037844387,25,18,3,1,1,1.2,0.6,25,29,-4,23,25,-2,"January, 2011"
2010-2011,21,2011-01-16,Birmingham,Aston Villa,1,1,D,1,1,0,1,4,2,2,1,16,19,22,21,3,1,January,0.4999999999999999,0.8660254037844387,3,1,0,1,4,0.4,1.8,20,25,-5,23,38,-15,"January, 2011"
2010-2011,22,2011-01-22,Arsenal,Wigan,3,0,H,3,0,1,1,3,2,2,1,3,18,43,22,15,21,January,0.4999999999999999,0.8660254037844387,0,46,3,1,1,2.6,1.2,45,22,23,19,34,-15,"January, 2011"
2010-2011,22,2011-01-22,Aston Villa,Man City,1,0,H,3,0,2,2,1,4,0,1,17,3,22,45,14,23,January,0.4999999999999999,0.8660254037844387,1,27,1,1,3,1.2,2.4,24,39,-15,37,19,18,"January, 2011"
2010-2011,22,2011-01-22,Blackpool,Sunderland,1,2,A,0,3,1,3,1,3,0,2,10,6,28,34,4,6,January,0.4999999999999999,0.8660254037844387,5,40,1,0,0,2.0,0.0,31,36,-5,26,23,3,"January, 2011"
2010-2011,22,2011-01-22,Everton,West Ham,2,2,D,1,1,2,1,2,0,1,4,12,20,26,20,8,6,January,0.4999999999999999,0.8660254037844387,18,45,3,2,0,2.2,1.2,25,27,-2,22,41,-19,"January, 2011"
2010-2011,22,2011-01-22,Fulham,Stoke,2,0,H,3,0,3,1,1,2,1,2,16,8,23,30,8,7,January,0.4999999999999999,0.8660254037844387,19,39,2,1,2,1.0,0.8,23,25,-2,28,26,2,"January, 2011"
2010-2011,22,2011-01-22,Man United,Birmingham,5,0,H,3,0,3,1,1,0,1,4,2,17,45,23,15,22,January,0.4999999999999999,0.8660254037844387,28,3,3,2,0,1.0,0.4,43,19,24,21,26,-5,"January, 2011"
2010-2011,22,2011-01-22,Newcastle,Tottenham,1,1,D,1,1,1,3,1,2,1,2,9,5,29,37,4,8,January,0.4999999999999999,0.8660254037844387,30,42,3,0,2,1.8,1.2,35,32,3,31,25,6,"January, 2011"
2010-2011,22,2011-01-22,Wolves,Liverpool,0,3,A,0,3,2,1,2,3,0,2,19,14,21,26,5,5,January,0.4999999999999999,0.8660254037844387,48,25,1,2,2,0.4,0.8,24,38,-14,27,31,-4,"January, 2011"
2010-2011,22,2011-01-23,Blackburn,West Brom,2,0,H,3,0,2,2,1,2,2,1,12,15,28,25,3,3,January,0.4999999999999999,0.8660254037844387,4,44,2,2,1,1.4,1.0,29,37,-8,29,41,-12,"January, 2011"
2010-2011,22,2011-01-24,Bolton,Chelsea,0,4,A,0,3,0,0,5,2,1,2,9,4,30,38,5,8,January,0.4999999999999999,0.8660254037844387,6,14,0,0,5,0.6,2.4,34,31,3,38,19,19,"January, 2011"
2010-2011,22,2011-01-25,Blackpool,Man United,2,3,A,0,3,1,3,1,3,1,1,12,1,28,48,11,20,January,0.4999999999999999,0.8660254037844387,5,28,0,0,0,0.0,0.0,32,38,-6,48,19,29,"January, 2011"
2010-2011,22,2011-01-25,Wigan,Aston Villa,1,2,A,0,3,2,2,1,2,2,1,18,16,22,25,2,3,January,0.4999999999999999,0.8660254037844387,46,1,2,1,2,1.0,1.2,19,37,-18,25,39,-14,"January, 2011"
2010-2011,22,2011-01-26,Liverpool,Fulham,1,0,H,3,0,3,0,2,3,1,1,11,15,29,26,4,3,January,0.4999999999999999,0.8660254037844387,25,19,2,2,1,0.8,0.6,30,31,-1,25,25,0,"January, 2011"
2010-2011,23,2011-02-01,Arsenal,Everton,2,1,H,3,0,1,1,3,2,1,2,2,14,46,27,12,19,February,0.8660254037844386,0.5000000000000001,0,18,3,2,0,2.8,1.2,48,22,26,27,29,-2,"February, 2011"
2010-2011,23,2011-02-01,Man United,Aston Villa,3,1,H,3,0,3,1,1,2,2,1,1,13,51,28,12,23,February,0.8660254037844386,0.5000000000000001,28,1,1,3,1,1.2,1.2,51,21,30,27,40,-13,"February, 2011"
2010-2011,23,2011-02-01,Sunderland,Chelsea,2,4,A,0,3,3,0,2,2,1,2,6,4,37,41,2,4,February,0.8660254037844386,0.5000000000000001,40,14,1,0,4,1.6,3.6,28,24,4,42,19,23,"February, 2011"
2010-2011,23,2011-02-01,West Brom,Wigan,2,2,D,1,1,2,2,1,2,2,1,16,18,25,22,2,3,February,0.8660254037844386,0.5000000000000001,44,46,2,0,3,1.2,1.2,29,43,-14,20,39,-19,"February, 2011"
2010-2011,23,2011-02-02,Liverpool,Stoke,2,0,H,3,0,3,0,2,2,1,2,8,11,32,30,3,2,February,0.8660254037844386,0.5000000000000001,25,39,1,3,1,1.0,0.6,31,31,0,28,28,0,"February, 2011"
2010-2011,23,2011-02-02,Fulham,Newcastle,1,0,H,3,0,3,1,1,1,3,1,15,10,26,30,5,4,February,0.8660254037844386,0.5000000000000001,19,30,2,1,2,0.6,0.8,25,26,-1,36,33,3,"February, 2011"
2010-2011,23,2011-02-02,Bolton,Wolves,1,0,H,3,0,0,0,5,2,1,2,11,20,30,21,9,9,February,0.8660254037844386,0.5000000000000001,6,48,3,1,1,1.6,1.2,34,35,-1,24,41,-17,"February, 2011"
2010-2011,23,2011-02-02,Blackpool,West Ham,1,3,A,0,3,1,3,1,0,1,4,12,20,28,21,8,7,February,0.8660254037844386,0.5000000000000001,5,45,0,1,0,0.0,0.0,34,41,-7,24,43,-19,"February, 2011"
2010-2011,23,2011-02-02,Birmingham,Man City,2,2,D,1,1,0,1,4,4,0,1,17,3,23,45,14,22,February,0.8660254037844386,0.5000000000000001,3,27,1,2,2,0.8,1.4,21,31,-10,37,20,17,"February, 2011"
2010-2011,23,2011-02-02,Blackburn,Tottenham,0,1,A,0,3,2,2,1,2,1,2,8,5,31,38,3,7,February,0.8660254037844386,0.5000000000000001,4,42,1,0,4,1.0,2.2,31,37,-6,32,26,6,"February, 2011"
2010-2011,24,2011-02-05,Aston Villa,Fulham,2,2,D,1,1,2,2,1,3,1,1,14,12,28,29,2,1,February,0.8660254037844386,0.5000000000000001,1,19,2,2,1,1.2,0.8,28,43,-15,26,26,0,"February, 2011"
2010-2011,24,2011-02-05,Everton,Blackpool,5,3,H,3,0,2,1,2,1,3,1,15,14,27,28,1,1,February,0.8660254037844386,0.5000000000000001,18,5,0,1,0,2.0,2.0,28,31,-3,35,44,-9,"February, 2011"
2010-2011,24,2011-02-05,Man City,West Brom,3,0,H,3,0,4,0,1,2,2,1,3,16,46,26,13,20,February,0.8660254037844386,0.5000000000000001,27,44,2,1,2,1.4,1.2,39,22,17,31,45,-14,"February, 2011"
2010-2011,24,2011-02-05,Newcastle,Arsenal,4,4,D,1,1,1,3,1,1,1,3,10,2,30,49,8,19,February,0.8660254037844386,0.5000000000000001,30,0,1,1,3,0.6,2.0,36,34,2,50,23,27,"February, 2011"
2010-2011,24,2011-02-05,Stoke,Sunderland,3,2,H,3,0,2,1,2,3,0,2,13,6,30,37,7,7,February,0.8660254037844386,0.5000000000000001,39,40,2,1,2,0.4,0.8,28,30,-2,30,28,2,"February, 2011"
2010-2011,24,2011-02-05,Tottenham,Bolton,2,1,H,3,0,2,1,2,0,0,5,5,8,41,33,3,8,February,0.8660254037844386,0.5000000000000001,42,6,2,1,2,1.8,1.8,33,26,7,35,35,0,"February, 2011"
2010-2011,24,2011-02-05,Wigan,Blackburn,4,3,H,3,0,2,2,1,2,2,1,19,11,23,31,8,8,February,0.8660254037844386,0.5000000000000001,46,4,1,1,3,1.2,1.4,22,41,-19,31,38,-7,"February, 2011"
2010-2011,24,2011-02-05,Wolves,Man United,2,1,H,3,0,2,1,2,3,1,1,20,1,21,54,19,33,February,0.8660254037844386,0.5000000000000001,48,28,1,0,4,0.4,1.4,24,42,-18,54,22,32,"February, 2011"
2010-2011,24,2011-02-06,Chelsea,Liverpool,0,1,A,0,3,2,1,2,3,0,2,4,7,44,35,3,9,February,0.8660254037844386,0.5000000000000001,14,25,2,0,3,0.8,1.0,46,21,25,33,31,2,"February, 2011"
2010-2011,24,2011-02-06,West Ham,Birmingham,0,1,A,0,3,0,1,4,0,1,4,19,18,24,24,1,0,February,0.8660254037844386,0.5000000000000001,45,3,2,2,1,1.2,0.8,27,44,-17,23,33,-10,"February, 2011"
2010-2011,25,2011-02-12,Man United,Man City,2,1,H,3,0,3,1,1,4,0,1,1,3,54,49,2,5,February,0.8660254037844386,0.5000000000000001,28,27,4,1,0,1.6,0.6,55,24,31,42,22,20,"February, 2011"
2010-2011,25,2011-02-12,Sunderland,Tottenham,1,2,A,0,3,3,0,2,2,1,2,7,5,37,44,2,7,February,0.8660254037844386,0.5000000000000001,40,42,2,2,1,1.4,1.2,32,31,1,35,27,8,"February, 2011"
2010-2011,25,2011-02-12,Liverpool,Wigan,1,1,D,1,1,3,0,2,2,2,1,6,18,38,26,12,12,February,0.8660254037844386,0.5000000000000001,25,46,2,2,1,1.4,1.2,34,31,3,26,44,-18,"February, 2011"
2010-2011,25,2011-02-12,West Brom,West Ham,3,3,D,1,1,2,2,1,0,1,4,18,19,26,24,1,2,February,0.8660254037844386,0.5000000000000001,44,45,1,2,2,1.0,1.2,31,48,-17,27,45,-18,"February, 2011"
2010-2011,25,2011-02-12,Blackburn,Newcastle,0,0,D,1,1,2,2,1,1,3,1,11,10,31,31,1,0,February,0.8660254037844386,0.5000000000000001,4,30,5,0,0,2.2,0.6,34,42,-8,40,38,2,"February, 2011"
2010-2011,25,2011-02-12,Birmingham,Stoke,1,0,H,3,0,0,1,4,2,1,2,16,9,27,33,7,6,February,0.8660254037844386,0.5000000000000001,3,39,1,1,1,1.0,1.0,24,33,-9,31,32,-1,"February, 2011"
2010-2011,25,2011-02-12,Arsenal,Wolves,2,0,H,3,0,1,1,3,2,1,2,2,19,50,24,17,26,February,0.8660254037844386,0.5000000000000001,0,48,5,0,0,2.6,0.4,54,27,27,26,43,-17,"February, 2011"
2010-2011,25,2011-02-12,Blackpool,Aston Villa,1,1,D,1,1,1,3,1,2,2,1,16,15,28,29,1,1,February,0.8660254037844386,0.5000000000000001,5,1,0,0,1,2.0,3.0,38,49,-11,30,45,-15,"February, 2011"
2010-2011,25,2011-02-13,Bolton,Everton,2,0,H,3,0,0,0,5,2,1,2,8,13,33,30,5,3,February,0.8660254037844386,0.5000000000000001,6,18,1,1,3,0.8,1.8,36,37,-1,33,34,-1,"February, 2011"
2010-2011,25,2011-02-14,Fulham,Chelsea,0,0,D,1,1,3,1,1,2,1,2,12,5,30,44,7,14,February,0.8660254037844386,0.5000000000000001,19,14,0,1,4,0.8,2.0,28,28,0,46,22,24,"February, 2011"
2010-2011,25,2011-02-15,Birmingham,Newcastle,0,2,A,0,3,0,1,4,1,3,1,14,10,30,32,4,2,February,0.8660254037844386,0.5000000000000001,3,30,0,2,3,0.6,1.2,25,33,-8,40,38,2,"February, 2011"
2010-2011,25,2011-02-20,West Brom,Wolves,1,1,D,1,1,2,2,1,2,1,2,17,20,27,24,3,3,February,0.8660254037844386,0.5000000000000001,44,48,0,0,0,0.0,0.0,34,51,-17,26,45,-19,"February, 2011"
2010-2011,25,2011-02-22,Blackpool,Tottenham,3,1,H,3,0,1,3,1,2,1,2,16,4,29,47,12,18,February,0.8660254037844386,0.5000000000000001,5,42,0,0,0,0.0,0.0,39,50,-11,37,28,9,"February, 2011"
2010-2011,25,2011-02-23,Arsenal,Stoke,1,0,H,3,0,1,1,3,2,1,2,2,10,53,33,8,20,February,0.8660254037844386,0.5000000000000001,0,39,3,0,1,2.5,1.0,56,27,29,31,33,-2,"February, 2011"
2010-2011,26,2011-02-26,Aston Villa,Blackburn,4,1,H,3,0,2,2,1,2,2,1,16,11,30,32,5,2,February,0.8660254037844386,0.5000000000000001,1,4,2,0,3,1.2,1.4,31,46,-15,34,42,-8,"February, 2011"
2010-2011,26,2011-02-26,Everton,Sunderland,2,0,H,3,0,2,1,2,3,0,2,15,7,30,37,8,7,February,0.8660254037844386,0.5000000000000001,18,40,3,2,0,2.0,0.6,33,36,-3,33,33,0,"February, 2011"
2010-2011,26,2011-02-26,Newcastle,Bolton,1,1,D,1,1,1,3,1,0,0,5,9,8,35,36,1,1,February,0.8660254037844386,0.5000000000000001,30,6,2,1,2,1.0,1.4,42,38,4,38,37,1,"February, 2011"
2010-2011,26,2011-02-26,Wigan,Man United,0,4,A,0,3,2,2,1,3,1,1,18,1,27,57,17,30,February,0.8660254037844386,0.5000000000000001,46,28,0,0,5,0.2,3.0,27,45,-18,57,25,32,"February, 2011"
2010-2011,26,2011-02-26,Wolves,Blackpool,4,0,H,3,0,2,1,2,1,3,1,20,13,25,32,7,7,February,0.8660254037844386,0.5000000000000001,48,5,0,0,1,1.0,2.0,27,46,-19,42,51,-9,"February, 2011"
2010-2011,26,2011-02-27,West Ham,Liverpool,3,1,H,3,0,0,1,4,3,0,2,20,6,25,39,14,14,February,0.8660254037844386,0.5000000000000001,45,25,0,1,4,0.4,2.4,30,48,-18,35,32,3,"February, 2011"
2010-2011,26,2011-02-27,Man City,Fulham,1,1,D,1,1,4,0,1,3,1,1,3,15,49,31,12,18,February,0.8660254037844386,0.5000000000000001,27,19,2,2,1,2.0,1.6,43,24,19,28,28,0,"February, 2011"
2010-2011,26,2011-02-28,Stoke,West Brom,1,1,D,1,1,2,1,2,2,2,1,11,19,33,28,8,5,February,0.8660254037844386,0.5000000000000001,39,44,3,0,0,2.0,0.0,31,34,-3,35,52,-17,"February, 2011"
2010-2011,26,2011-03-01,Chelsea,Man United,2,1,H,3,0,2,1,2,3,1,1,5,1,45,60,4,15,March,1.0,6.123233995736766e-17,14,28,3,1,1,1.2,1.2,46,22,24,61,25,36,"March, 2011"
2010-2011,27,2011-03-05,West Ham,Stoke,3,0,H,3,0,0,1,4,2,1,2,19,12,28,34,7,6,March,1.0,6.123233995736766e-17,45,39,2,1,2,1.0,1.0,33,49,-16,32,35,-3,"March, 2011"
2010-2011,27,2011-03-05,Arsenal,Sunderland,0,0,D,1,1,1,1,3,3,0,2,2,8,56,37,6,19,March,1.0,6.123233995736766e-17,0,40,1,3,1,0.8,0.6,57,27,30,33,35,-2,"March, 2011"
2010-2011,27,2011-03-05,Birmingham,West Brom,1,3,A,0,3,0,1,4,2,2,1,16,17,30,29,1,1,March,1.0,6.123233995736766e-17,3,44,2,1,2,1.8,1.6,25,35,-10,36,53,-17,"March, 2011"
2010-2011,27,2011-03-05,Bolton,Aston Villa,3,2,H,3,0,0,0,5,2,2,1,8,12,37,33,4,4,March,1.0,6.123233995736766e-17,6,1,0,2,3,1.0,2.4,39,38,1,35,47,-12,"March, 2011"
2010-2011,27,2011-03-05,Fulham,Blackburn,3,2,H,3,0,3,1,1,2,2,1,13,14,32,32,1,0,March,1.0,6.123233995736766e-17,19,4,1,1,3,1.0,1.2,29,29,0,35,46,-11,"March, 2011"
2010-2011,27,2011-03-05,Man City,Wigan,1,0,H,3,0,4,0,1,2,2,1,3,20,50,27,17,23,March,1.0,6.123233995736766e-17,27,46,3,1,1,1.6,0.6,44,25,19,27,49,-22,"March, 2011"
2010-2011,27,2011-03-05,Newcastle,Everton,1,2,A,0,3,1,3,1,2,1,2,9,12,36,33,3,3,March,1.0,6.123233995736766e-17,30,18,2,2,1,1.4,1.4,43,39,4,35,36,-1,"March, 2011"
2010-2011,27,2011-03-06,Wolves,Tottenham,3,3,D,1,1,2,1,2,2,1,2,19,5,28,47,14,19,March,1.0,6.123233995736766e-17,48,42,2,0,3,1.0,2.0,31,46,-15,38,31,7,"March, 2011"
2010-2011,27,2011-03-06,Liverpool,Man United,3,1,H,3,0,3,0,2,3,1,1,7,1,39,60,6,21,March,1.0,6.123233995736766e-17,25,28,3,0,2,2.2,1.4,36,35,1,62,27,35,"March, 2011"
2010-2011,27,2011-03-07,Blackpool,Chelsea,1,3,A,0,3,1,3,1,2,1,2,15,4,32,48,11,16,March,1.0,6.123233995736766e-17,5,14,0,0,1,0.0,4.0,42,55,-13,48,23,25,"March, 2011"
2010-2011,27,2011-03-09,Everton,Birmingham,1,1,D,1,1,2,1,2,0,1,4,10,18,36,30,8,6,March,1.0,6.123233995736766e-17,18,3,2,3,0,1.8,1.0,37,37,0,26,38,-12,"March, 2011"
2010-2011,28,2011-03-19,West Brom,Arsenal,2,2,D,1,1,2,2,1,1,1,3,18,2,32,57,16,25,March,1.0,6.123233995736766e-17,44,0,2,0,3,1.4,2.0,39,54,-15,57,27,30,"March, 2011"
2010-2011,28,2011-03-19,Tottenham,West Ham,0,0,D,1,1,2,1,2,0,1,4,5,19,48,31,14,17,March,1.0,6.123233995736766e-17,42,45,4,0,1,1.4,0.4,41,34,7,36,49,-13,"March, 2011"
2010-2011,28,2011-03-19,Stoke,Newcastle,4,0,H,3,0,2,1,2,1,3,1,12,10,34,36,2,2,March,1.0,6.123233995736766e-17,39,30,1,2,0,1.6666666666666667,1.3333333333333333,32,38,-6,44,41,3,"March, 2011"
2010-2011,28,2011-03-19,Wigan,Birmingham,2,1,H,3,0,2,2,1,0,1,4,20,19,27,31,1,4,March,1.0,6.123233995736766e-17,46,3,1,1,3,1.2,1.4,27,50,-23,27,39,-12,"March, 2011"
2010-2011,28,2011-03-19,Everton,Fulham,2,1,H,3,0,2,1,2,3,1,1,9,11,37,35,2,2,March,1.0,6.123233995736766e-17,18,19,3,1,1,1.2,0.6,38,38,0,32,31,1,"March, 2011"
2010-2011,28,2011-03-19,Blackburn,Blackpool,2,2,D,1,1,2,2,1,1,3,1,14,16,32,32,2,0,March,1.0,6.123233995736766e-17,4,5,1,0,0,2.0,1.0,37,49,-12,43,58,-15,"March, 2011"
2010-2011,28,2011-03-19,Aston Villa,Wolves,0,1,A,0,3,2,2,1,2,1,2,13,19,33,29,6,4,March,1.0,6.123233995736766e-17,1,48,3,2,0,2.4,1.2,37,50,-13,34,49,-15,"March, 2011"
2010-2011,28,2011-03-19,Man United,Bolton,1,0,H,3,0,3,1,1,0,0,5,1,7,60,40,6,20,March,1.0,6.123233995736766e-17,28,6,4,1,0,2.2,0.6,63,30,33,42,40,2,"March, 2011"
2010-2011,28,2011-03-20,Chelsea,Man City,2,0,H,3,0,2,1,2,4,0,1,4,3,51,53,1,2,March,1.0,6.123233995736766e-17,14,27,2,0,3,1.4,1.6,51,24,27,45,25,20,"March, 2011"
2010-2011,28,2011-03-20,Sunderland,Liverpool,0,2,A,0,3,3,0,2,3,0,2,9,6,38,42,3,4,March,1.0,6.123233995736766e-17,40,25,1,1,3,0.6,1.6,33,35,-2,39,36,3,"March, 2011"
2010-2011,29,2011-04-02,West Ham,Man United,2,4,A,0,3,0,1,4,3,1,1,18,1,32,63,17,31,April,0.8660254037844388,-0.4999999999999998,45,28,0,0,5,0.0,2.6,36,49,-13,64,30,34,"April, 2011"
2010-2011,29,2011-04-02,Arsenal,Blackburn,0,0,D,1,1,1,1,3,2,2,1,2,13,58,33,11,25,April,0.8660254037844388,-0.4999999999999998,0,4,4,0,1,3.4,1.0,59,29,30,39,51,-12,"April, 2011"
2010-2011,29,2011-04-02,Birmingham,Bolton,2,1,H,3,0,0,1,4,0,0,5,19,7,31,40,12,9,April,0.8660254037844388,-0.4999999999999998,3,6,1,1,3,1.0,1.8,28,41,-13,42,41,1,"April, 2011"
2010-2011,29,2011-04-02,Everton,Aston Villa,2,2,D,1,1,2,1,2,2,2,1,7,15,40,33,8,7,April,0.8660254037844388,-0.4999999999999998,18,1,0,3,2,1.6,2.0,40,39,1,37,51,-14,"April, 2011"
2010-2011,29,2011-04-02,Newcastle,Wolves,4,1,H,3,0,1,3,1,2,1,2,11,19,36,32,8,4,April,0.8660254037844388,-0.4999999999999998,30,48,0,3,0,1.0,1.0,44,45,-1,35,49,-14,"April, 2011"
2010-2011,29,2011-04-02,Stoke,Chelsea,1,1,D,1,1,2,1,2,2,1,2,11,3,37,54,8,17,April,0.8660254037844388,-0.4999999999999998,39,14,0,0,5,0.4,3.0,36,38,-2,53,24,29,"April, 2011"
2010-2011,29,2011-04-02,West Brom,Liverpool,2,1,H,3,0,2,2,1,3,0,2,17,6,33,45,11,12,April,0.8660254037844388,-0.4999999999999998,44,25,0,0,5,0.0,1.8,41,56,-15,41,36,5,"April, 2011"
2010-2011,29,2011-04-02,Wigan,Tottenham,0,0,D,1,1,2,2,1,2,1,2,20,5,30,49,15,19,April,0.8660254037844388,-0.4999999999999998,46,42,2,1,2,0.6,2.4,29,51,-22,41,34,7,"April, 2011"
2010-2011,29,2011-04-03,Man City,Sunderland,5,0,H,3,0,4,0,1,3,0,2,4,12,53,38,8,15,April,0.8660254037844388,-0.4999999999999998,27,40,3,1,1,1.8,1.0,45,27,18,33,37,-4,"April, 2011"
2010-2011,29,2011-04-03,Fulham,Blackpool,3,0,H,3,0,3,1,1,1,3,1,13,17,35,33,4,2,April,0.8660254037844388,-0.4999999999999998,19,5,0,1,0,2.0,2.0,33,33,0,45,60,-15,"April, 2011"
2010-2011,30,2011-04-09,Blackburn,Birmingham,1,1,D,1,1,2,2,1,0,1,4,14,15,34,34,1,0,April,0.8660254037844388,-0.4999999999999998,4,3,2,0,3,1.4,2.0,39,51,-12,30,42,-12,"April, 2011"
2010-2011,30,2011-04-09,Bolton,West Ham,3,0,H,3,0,0,0,5,0,1,4,8,18,40,32,10,8,April,0.8660254037844388,-0.4999999999999998,6,45,5,0,0,2.6,1.0,43,43,0,38,53,-15,"April, 2011"
2010-2011,30,2011-04-09,Chelsea,Wigan,1,0,H,3,0,2,1,2,2,2,1,4,20,55,31,16,24,April,0.8660254037844388,-0.4999999999999998,14,46,4,0,1,3.6,0.8,54,25,29,29,51,-22,"April, 2011"
2010-2011,30,2011-04-09,Man United,Fulham,2,0,H,3,0,3,1,1,3,1,1,1,10,66,38,9,28,April,0.8660254037844388,-0.4999999999999998,28,19,2,1,2,1.6,1.4,68,32,36,36,33,3,"April, 2011"
2010-2011,30,2011-04-09,Sunderland,West Brom,2,3,A,0,3,3,0,2,2,2,1,12,13,38,36,1,2,April,0.8660254037844388,-0.4999999999999998,40,44,2,1,2,1.2,1.0,33,42,-9,43,57,-14,"April, 2011"
2010-2011,30,2011-04-09,Tottenham,Stoke,3,2,H,3,0,2,1,2,2,1,2,5,12,50,38,7,12,April,0.8660254037844388,-0.4999999999999998,42,39,3,0,2,1.6,1.2,41,34,7,37,39,-2,"April, 2011"
2010-2011,30,2011-04-09,Wolves,Everton,0,3,A,0,3,2,1,2,2,1,2,18,8,32,41,10,9,April,0.8660254037844388,-0.4999999999999998,48,18,1,3,1,0.8,1.0,36,53,-17,42,41,1,"April, 2011"
2010-2011,30,2011-04-10,Aston Villa,Newcastle,1,0,H,3,0,2,2,1,1,3,1,16,9,34,39,7,5,April,0.8660254037844388,-0.4999999999999998,1,30,2,1,2,1.0,1.8,39,53,-14,48,46,2,"April, 2011"
2010-2011,30,2011-04-10,Blackpool,Arsenal,1,3,A,0,3,1,3,1,1,1,3,17,2,33,59,15,26,April,0.8660254037844388,-0.4999999999999998,5,0,0,0,1,0.0,6.0,45,63,-18,59,29,30,"April, 2011"
2010-2011,30,2011-04-11,Liverpool,Man City,3,0,H,3,0,3,0,2,4,0,1,6,4,45,56,2,11,April,0.8660254037844388,-0.4999999999999998,25,27,1,3,1,1.2,1.6,42,38,4,50,27,23,"April, 2011"
2010-2011,31,2011-04-16,West Ham,Aston Villa,1,2,A,0,3,0,1,4,2,2,1,19,15,32,37,4,5,April,0.8660254037844388,-0.4999999999999998,45,1,1,2,2,0.6,1.2,38,56,-18,40,53,-13,"April, 2011"
2010-2011,31,2011-04-16,West Brom,Chelsea,1,3,A,0,3,2,2,1,2,1,2,10,3,39,58,7,19,April,0.8660254037844388,-0.4999999999999998,44,14,0,0,5,0.2,3.4,46,59,-13,55,25,30,"April, 2011"
2010-2011,31,2011-04-16,Birmingham,Sunderland,2,0,H,3,0,0,1,4,3,0,2,16,13,35,38,3,3,April,0.8660254037844388,-0.4999999999999998,3,40,1,2,2,1.4,2.0,31,43,-12,35,45,-10,"April, 2011"
2010-2011,31,2011-04-16,Blackpool,Wigan,1,3,A,0,3,1,3,1,2,2,1,17,20,33,31,3,2,April,0.8660254037844388,-0.4999999999999998,5,46,1,0,0,4.0,0.0,46,66,-20,29,52,-23,"April, 2011"
2010-2011,31,2011-04-16,Everton,Blackburn,2,0,H,3,0,2,1,2,2,2,1,7,16,44,35,9,9,April,0.8660254037844388,-0.4999999999999998,18,4,2,1,2,1.6,1.2,45,41,4,40,52,-12,"April, 2011"
2010-2011,31,2011-04-17,Arsenal,Liverpool,1,1,D,1,1,1,1,3,3,0,2,2,6,62,48,4,14,April,0.8660254037844388,-0.4999999999999998,0,25,2,3,0,1.8,1.4,62,30,32,45,38,7,"April, 2011"
2010-2011,32,2011-04-19,Newcastle,Man United,0,0,D,1,1,1,3,1,3,1,1,10,1,39,69,9,30,April,0.8660254037844388,-0.4999999999999998,30,28,0,1,4,0.6,3.4,48,47,1,70,32,38,"April, 2011"
2010-2011,32,2011-04-20,Tottenham,Arsenal,3,3,D,1,1,2,1,2,1,1,3,5,3,53,63,2,10,April,0.8660254037844388,-0.4999999999999998,42,0,2,2,1,1.8,2.0,44,36,8,63,31,32,"April, 2011"
2010-2011,32,2011-04-20,Chelsea,Birmingham,3,1,H,3,0,2,1,2,0,1,4,3,14,61,38,11,23,April,0.8660254037844388,-0.4999999999999998,14,3,3,1,1,1.4,0.6,58,26,32,33,43,-10,"April, 2011"
2010-2011,33,2011-04-23,Tottenham,West Brom,2,2,D,1,1,2,1,2,2,2,1,5,13,54,39,8,15,April,0.8660254037844388,-0.4999999999999998,42,44,2,1,2,0.8,1.2,47,39,8,47,62,-15,"April, 2011"
2010-2011,33,2011-04-23,Chelsea,West Ham,3,0,H,3,0,2,1,2,0,1,4,2,19,64,32,17,32,April,0.8660254037844388,-0.4999999999999998,14,45,3,2,0,2.0,0.8,61,27,34,39,58,-19,"April, 2011"
2010-2011,33,2011-04-23,Wolves,Fulham,1,1,D,1,1,2,1,2,3,1,1,19,14,32,38,5,6,April,0.8660254037844388,-0.4999999999999998,48,19,2,2,1,1.0,0.8,36,56,-20,36,35,1,"April, 2011"
2010-2011,33,2011-04-23,Sunderland,Wigan,4,2,H,3,0,3,0,2,2,2,1,14,17,38,34,3,4,April,0.8660254037844388,-0.4999999999999998,40,46,0,3,2,0.8,1.2,35,47,-12,32,53,-21,"April, 2011"
2010-2011,33,2011-04-23,Aston Villa,Stoke,1,1,D,1,1,2,2,1,2,1,2,10,13,40,38,3,2,April,0.8660254037844388,-0.4999999999999998,1,39,1,2,2,1.2,1.4,42,54,-12,39,42,-3,"April, 2011"
2010-2011,33,2011-04-23,Liverpool,Birmingham,5,0,H,3,0,3,0,2,0,1,4,6,15,49,38,9,11,April,0.8660254037844388,-0.4999999999999998,25,3,0,5,0,1.0,1.0,46,39,7,34,46,-12,"April, 2011"
2010-2011,33,2011-04-23,Blackpool,Newcastle,1,1,D,1,1,1,3,1,1,3,1,18,10,33,40,8,7,April,0.8660254037844388,-0.4999999999999998,5,30,1,0,0,2.0,0.0,47,69,-22,48,47,1,"April, 2011"
2010-2011,33,2011-04-23,Man United,Everton,1,0,H,3,0,3,1,1,2,1,2,1,7,70,47,6,23,April,0.8660254037844388,-0.4999999999999998,28,18,2,2,1,1.8,1.4,70,32,38,47,41,6,"April, 2011"
2010-2011,33,2011-04-24,Bolton,Arsenal,2,1,H,3,0,0,0,5,1,1,3,8,3,43,64,5,21,April,0.8660254037844388,-0.4999999999999998,6,0,0,0,5,0.8,2.8,46,43,3,66,34,32,"April, 2011"
2010-2011,33,2011-04-25,Blackburn,Man City,0,1,A,0,3,2,2,1,4,0,1,16,4,35,56,12,21,April,0.8660254037844388,-0.4999999999999998,4,27,0,2,3,1.0,2.4,40,54,-14,50,30,20,"April, 2011"
2010-2011,33,2011-04-26,Stoke,Wolves,3,0,H,3,0,2,1,2,2,1,2,14,19,39,33,5,6,April,0.8660254037844388,-0.4999999999999998,39,48,0,2,1,1.0,1.3333333333333333,40,43,-3,37,57,-20,"April, 2011"
2010-2011,33,2011-04-27,Fulham,Bolton,3,0,H,3,0,3,1,1,0,0,5,14,8,39,46,6,7,April,0.8660254037844388,-0.4999999999999998,19,6,2,3,0,1.2,0.6,37,36,1,48,44,4,"April, 2011"
2010-2011,34,2011-04-30,Wigan,Everton,1,1,D,1,1,2,2,1,2,1,2,18,7,34,47,11,13,April,0.8660254037844388,-0.4999999999999998,46,18,1,1,3,0.4,1.4,34,57,-23,47,42,5,"April, 2011"
2010-2011,34,2011-04-30,West Brom,Aston Villa,2,1,H,3,0,2,2,1,2,2,1,14,12,40,41,2,1,April,0.8660254037844388,-0.4999999999999998,44,1,0,1,4,0.8,1.6,49,64,-15,43,55,-12,"April, 2011"
2010-2011,34,2011-04-30,Sunderland,Fulham,0,3,A,0,3,3,0,2,3,1,1,12,10,41,42,2,1,April,0.8660254037844388,-0.4999999999999998,40,19,1,3,1,0.2,0.2,39,49,-10,40,36,4,"April, 2011"
2010-2011,34,2011-04-30,Blackpool,Stoke,0,0,D,1,1,1,3,1,2,1,2,17,10,34,42,7,8,April,0.8660254037844388,-0.4999999999999998,5,39,1,0,0,1.0,0.0,48,70,-22,43,43,0,"April, 2011"
2010-2011,34,2011-04-30,Blackburn,Bolton,1,0,H,3,0,2,2,1,0,0,5,16,8,35,46,8,11,April,0.8660254037844388,-0.4999999999999998,4,6,2,2,1,1.6,0.8,40,55,-15,48,47,1,"April, 2011"
2010-2011,34,2011-04-30,Chelsea,Tottenham,2,1,H,3,0,2,1,2,2,1,2,2,5,67,55,3,12,April,0.8660254037844388,-0.4999999999999998,14,42,1,2,2,1.2,1.0,64,27,37,49,41,8,"April, 2011"
2010-2011,34,2011-05-01,Liverpool,Newcastle,3,0,H,3,0,3,0,2,1,3,1,6,12,52,41,6,11,May,0.4999999999999999,-0.8660254037844387,25,30,4,0,1,3.0,0.8,51,39,12,49,48,1,"May, 2011"
2010-2011,34,2011-05-01,Arsenal,Man United,1,0,H,3,0,1,1,3,3,1,1,3,1,64,73,2,9,May,0.4999999999999999,-0.8660254037844387,0,28,1,1,3,0.8,1.4,67,36,31,71,32,39,"May, 2011"
2010-2011,34,2011-05-01,Birmingham,Wolves,1,1,D,1,1,0,1,4,2,1,2,16,19,38,33,3,5,May,0.4999999999999999,-0.8660254037844387,3,48,2,2,1,1.2,1.0,34,51,-17,37,60,-23,"May, 2011"
2010-2011,34,2011-05-01,Man City,West Ham,2,1,H,3,0,4,0,1,0,1,4,4,20,59,32,16,27,May,0.4999999999999999,-0.8660254037844387,27,45,3,1,1,2.0,0.8,51,30,21,39,61,-22,"May, 2011"
2010-2011,35,2011-05-07,Tottenham,Blackpool,1,1,D,1,1,2,1,2,1,3,1,6,18,55,35,12,20,May,0.4999999999999999,-0.8660254037844387,42,5,0,0,1,1.0,3.0,50,43,7,48,70,-22,"May, 2011"
2010-2011,35,2011-05-07,West Ham,Blackburn,1,1,D,1,1,0,1,4,2,2,1,20,16,32,38,4,6,May,0.4999999999999999,-0.8660254037844387,45,4,1,4,0,1.2,0.6,40,63,-23,41,55,-14,"May, 2011"
2010-2011,35,2011-05-07,Newcastle,Birmingham,2,1,H,3,0,1,3,1,0,1,4,14,15,41,39,1,2,May,0.4999999999999999,-0.8660254037844387,30,3,3,2,0,1.2,0.4,49,51,-2,35,52,-17,"May, 2011"
2010-2011,35,2011-05-07,Bolton,Sunderland,1,2,A,0,3,0,0,5,3,0,2,8,14,46,41,6,5,May,0.4999999999999999,-0.8660254037844387,6,40,1,1,3,0.8,1.4,48,48,0,39,52,-13,"May, 2011"
2010-2011,35,2011-05-07,Everton,Man City,2,1,H,3,0,2,1,2,4,0,1,7,4,48,62,3,14,May,0.4999999999999999,-0.8660254037844387,18,27,4,0,1,1.6,0.6,48,43,5,53,31,22,"May, 2011"
2010-2011,35,2011-05-07,Aston Villa,Wigan,1,1,D,1,1,2,2,1,2,2,1,13,18,41,35,5,6,May,0.4999999999999999,-0.8660254037844387,1,46,3,1,1,1.6,0.8,44,57,-13,35,58,-23,"May, 2011"
2010-2011,35,2011-05-08,Man United,Chelsea,2,1,H,3,0,3,1,1,2,1,2,1,2,73,70,1,3,May,0.4999999999999999,-0.8660254037844387,28,14,1,1,3,1.2,1.2,71,33,38,66,28,38,"May, 2011"
2010-2011,35,2011-05-08,Stoke,Arsenal,3,1,H,3,0,2,1,2,1,1,3,12,3,43,67,9,24,May,0.4999999999999999,-0.8660254037844387,39,0,1,0,4,0.8,2.2,43,43,0,68,36,32,"May, 2011"
2010-2011,35,2011-05-08,Wolves,West Brom,3,1,H,3,0,2,1,2,2,2,1,19,13,34,43,6,9,May,0.4999999999999999,-0.8660254037844387,48,44,0,1,0,1.0,1.0,38,61,-23,51,65,-14,"May, 2011"
2010-2011,35,2011-05-09,Fulham,Liverpool,2,5,A,0,3,3,1,1,3,0,2,10,6,45,55,4,10,May,0.4999999999999999,-0.8660254037844387,19,25,1,2,2,0.6,0.6,43,36,7,54,39,15,"May, 2011"
2010-2011,35,2011-05-10,Man City,Tottenham,1,0,H,3,0,4,0,1,2,1,2,4,6,62,56,2,6,May,0.4999999999999999,-0.8660254037844387,27,42,0,1,4,0.4,1.6,54,33,21,51,44,7,"May, 2011"
2010-2011,36,2011-05-14,Sunderland,Wolves,1,3,A,0,3,3,0,2,2,1,2,12,18,44,37,6,7,May,0.4999999999999999,-0.8660254037844387,40,48,1,0,2,2.6666666666666665,2.333333333333333,41,53,-12,41,62,-21,"May, 2011"
2010-2011,36,2011-05-14,West Brom,Everton,1,0,H,3,0,2,2,1,2,1,2,13,7,43,51,6,8,May,0.4999999999999999,-0.8660254037844387,44,18,2,1,2,2.2,1.4,52,68,-16,50,44,6,"May, 2011"
2010-2011,36,2011-05-14,Blackburn,Man United,1,1,D,1,1,2,2,1,3,1,1,15,1,39,76,14,37,May,0.4999999999999999,-0.8660254037844387,4,28,0,1,4,0.4,2.6,42,56,-14,73,34,39,"May, 2011"
2010-2011,36,2011-05-14,Blackpool,Bolton,4,3,H,3,0,1,3,1,0,0,5,18,9,36,46,9,10,May,0.4999999999999999,-0.8660254037844387,5,6,0,1,0,2.0,2.0,49,71,-22,49,50,-1,"May, 2011"
2010-2011,36,2011-05-15,Arsenal,Aston Villa,1,2,A,0,3,1,1,3,2,2,1,3,14,67,42,11,25,May,0.4999999999999999,-0.8660254037844387,0,1,2,2,1,1.8,1.2,69,39,30,45,58,-13,"May, 2011"
2010-2011,36,2011-05-15,Birmingham,Fulham,0,2,A,0,3,0,1,4,3,1,1,17,11,39,45,6,6,May,0.4999999999999999,-0.8660254037844387,3,19,1,2,2,0.8,1.2,36,54,-18,45,41,4,"May, 2011"
2010-2011,36,2011-05-15,Chelsea,Newcastle,2,2,D,1,1,2,1,2,1,3,1,2,13,70,44,11,26,May,0.4999999999999999,-0.8660254037844387,14,30,3,2,0,1.4,0.4,67,30,37,51,52,-1,"May, 2011"
2010-2011,36,2011-05-15,Liverpool,Tottenham,0,2,A,0,3,3,0,2,2,1,2,5,6,58,56,1,2,May,0.4999999999999999,-0.8660254037844387,25,42,2,0,3,1.6,1.4,59,41,18,51,45,6,"May, 2011"
2010-2011,36,2011-05-15,Wigan,West Ham,3,2,H,3,0,2,2,1,0,1,4,19,20,36,33,1,3,May,0.4999999999999999,-0.8660254037844387,46,45,1,0,4,1.0,1.8,36,59,-23,41,64,-23,"May, 2011"
2010-2011,36,2011-05-17,Man City,Stoke,3,0,H,3,0,4,0,1,2,1,2,4,9,65,46,5,19,May,0.4999999999999999,-0.8660254037844387,27,39,2,2,1,1.4,0.6,55,33,22,46,44,2,"May, 2011"
2010-2011,37,2011-05-22,Stoke,Wigan,0,1,A,0,3,2,1,2,2,2,1,12,18,46,39,6,7,May,0.4999999999999999,-0.8660254037844387,39,46,1,4,0,1.4,1.0,46,47,-1,39,61,-22,"May, 2011"
2010-2011,37,2011-05-22,Wolves,Blackburn,2,3,A,0,3,2,1,2,2,2,1,17,16,40,40,1,0,May,0.4999999999999999,-0.8660254037844387,48,4,0,2,3,1.0,2.8,44,63,-19,43,57,-14,"May, 2011"
2010-2011,37,2011-05-22,West Ham,Sunderland,0,3,A,0,3,0,1,4,3,0,2,20,14,33,44,6,11,May,0.4999999999999999,-0.8660254037844387,45,40,3,1,1,1.2,0.6,43,67,-24,42,56,-14,"May, 2011"
2010-2011,37,2011-05-22,Tottenham,Birmingham,2,1,H,3,0,2,1,2,0,1,4,5,18,59,39,13,20,May,0.4999999999999999,-0.8660254037844387,42,3,1,2,2,1.4,2.0,53,45,8,36,56,-20,"May, 2011"
2010-2011,37,2011-05-22,Newcastle,West Brom,3,3,D,1,1,1,3,1,2,2,1,13,12,45,46,1,1,May,0.4999999999999999,-0.8660254037844387,30,44,4,0,1,2.4,1.2,53,54,-1,53,68,-15,"May, 2011"
2010-2011,37,2011-05-22,Man United,Blackpool,4,2,H,3,0,3,1,1,1,3,1,1,18,77,39,17,38,May,0.4999999999999999,-0.8660254037844387,28,5,1,0,0,3.0,2.0,74,35,39,53,74,-21,"May, 2011"
2010-2011,37,2011-05-22,Fulham,Arsenal,2,2,D,1,1,3,1,1,1,1,3,8,4,48,67,4,19,May,0.4999999999999999,-0.8660254037844387,19,0,1,1,3,0.4,1.4,47,41,6,70,41,29,"May, 2011"
2010-2011,37,2011-05-22,Everton,Chelsea,1,0,H,3,0,2,1,2,2,1,2,7,2,51,71,5,20,May,0.4999999999999999,-0.8660254037844387,18,14,1,4,0,1.2,1.0,50,45,5,69,32,37,"May, 2011"
2010-2011,37,2011-05-22,Bolton,Man City,0,2,A,0,3,0,0,5,4,0,1,11,3,46,68,8,22,May,0.4999999999999999,-0.8660254037844387,6,27,1,1,3,1.0,1.4,52,54,-2,58,33,25,"May, 2011"
2010-2011,37,2011-05-22,Aston Villa,Liverpool,1,0,H,3,0,2,2,1,3,0,2,13,6,45,58,7,13,May,0.4999999999999999,-0.8660254037844387,1,25,1,1,3,0.6,2.0,47,59,-12,59,43,16,"May, 2011"
2011-2012,1,2011-08-13,QPR,Bolton,0,4,A,0,3,2,0,3,1,3,1,14,8,0,0,6,0,August,-0.8660254037844384,-0.5000000000000004,34,6,2,0,0,1.5,0.5,0,0,0,0,0,0,"August, 2011"
2011-2012,1,2011-08-13,Newcastle,Arsenal,0,0,D,1,1,2,0,3,1,3,1,12,6,0,0,6,0,August,-0.8660254037844384,-0.5000000000000004,30,0,1,1,3,1.2,2.6,0,0,0,0,0,0,"August, 2011"
2011-2012,1,2011-08-13,Wigan,Norwich,1,1,D,1,1,4,0,1,1,1,3,18,13,0,0,5,0,August,-0.8660254037844384,-0.5000000000000004,46,31,0,0,0,0.0,0.0,0,0,0,0,0,0,"August, 2011"
2011-2012,1,2011-08-13,Fulham,Aston Villa,0,0,D,1,1,3,0,2,0,3,2,7,3,0,0,4,0,August,-0.8660254037844384,-0.5000000000000004,19,1,1,2,2,1.2,1.6,0,0,0,0,0,0,"August, 2011"
2011-2012,1,2011-08-13,Blackburn,Wolves,1,2,A,0,3,1,0,4,0,3,2,3,20,0,0,17,0,August,-0.8660254037844384,-0.5000000000000004,4,48,3,2,0,2.4,1.2,0,0,0,0,0,0,"August, 2011"
2011-2012,1,2011-08-13,Liverpool,Sunderland,1,1,D,1,1,2,0,3,0,3,2,8,15,0,0,7,0,August,-0.8660254037844384,-0.5000000000000004,25,40,3,1,1,1.8,0.6,0,0,0,0,0,0,"August, 2011"
2011-2012,1,2011-08-14,Stoke,Chelsea,0,0,D,1,1,0,3,2,2,1,2,15,11,0,0,4,0,August,-0.8660254037844384,-0.5000000000000004,39,14,0,1,4,0.6,2.8,0,0,0,0,0,0,"August, 2011"
2011-2012,1,2011-08-14,West Brom,Man United,1,2,A,0,3,2,2,1,3,1,1,18,15,0,0,3,0,August,-0.8660254037844384,-0.5000000000000004,44,28,0,1,4,0.8,3.0,0,0,0,0,0,0,"August, 2011"
2011-2012,1,2011-08-15,Man City,Swansea,4,0,H,3,0,5,0,0,2,2,1,15,16,0,0,1,0,August,-0.8660254037844384,-0.5000000000000004,27,41,0,0,0,0.0,0.0,0,0,0,0,0,0,"August, 2011"
2011-2012,2,2011-08-20,Swansea,Wigan,0,0,D,1,1,2,2,1,4,0,1,20,11,0,1,9,1,August,-0.8660254037844384,-0.5000000000000004,41,46,0,0,0,0.0,0.0,0,4,-4,1,1,0,"August, 2011"
2011-2012,2,2011-08-20,Arsenal,Liverpool,0,2,A,0,3,1,3,1,2,0,3,9,5,1,1,4,0,August,-0.8660254037844384,-0.5000000000000004,0,25,2,3,0,1.8,1.4,0,0,0,1,1,0,"August, 2011"
2011-2012,2,2011-08-20,Aston Villa,Blackburn,3,1,H,3,0,0,3,2,1,0,4,9,17,1,0,8,1,August,-0.8660254037844384,-0.5000000000000004,1,4,2,0,3,1.4,1.2,0,0,0,1,2,-1,"August, 2011"
2011-2012,2,2011-08-20,Chelsea,West Brom,2,1,H,3,0,2,1,2,2,2,1,10,17,1,0,7,1,August,-0.8660254037844384,-0.5000000000000004,14,44,5,0,0,3.2,0.4,0,0,0,1,2,-1,"August, 2011"
2011-2012,2,2011-08-20,Everton,QPR,0,1,A,0,3,2,3,0,2,0,3,15,19,0,0,4,0,August,-0.8660254037844384,-0.5000000000000004,18,34,1,0,1,1.5,1.5,0,0,0,0,4,-4,"August, 2011"
2011-2012,2,2011-08-20,Sunderland,Newcastle,0,1,A,0,3,0,3,2,2,0,3,10,13,1,1,3,0,August,-0.8660254037844384,-0.5000000000000004,40,30,1,2,2,1.0,2.0,1,1,0,0,0,0,"August, 2011"
2011-2012,2,2011-08-21,Norwich,Stoke,1,1,D,1,1,1,1,3,0,3,2,11,13,1,1,2,0,August,-0.8660254037844384,-0.5000000000000004,31,39,0,0,0,0.0,0.0,1,1,0,0,0,0,"August, 2011"
2011-2012,2,2011-08-21,Wolves,Fulham,2,0,H,3,0,0,3,2,3,0,2,8,13,3,1,5,2,August,-0.8660254037844384,-0.5000000000000004,48,19,2,2,1,1.2,1.0,2,1,1,0,0,0,"August, 2011"
2011-2012,2,2011-08-21,Bolton,Man City,2,3,A,0,3,1,3,1,5,0,0,5,6,3,3,1,0,August,-0.8660254037844384,-0.5000000000000004,6,27,0,1,4,0.6,1.8,4,0,4,4,0,4,"August, 2011"
2011-2012,2,2011-08-22,Man United,Tottenham,3,0,H,3,0,3,1,1,3,1,1,8,17,3,0,9,3,August,-0.8660254037844384,-0.5000000000000004,28,42,4,1,0,2.6,0.8,2,1,1,0,0,0,"August, 2011"
2011-2012,3,2011-08-27,Aston Villa,Wolves,0,0,D,1,1,0,3,2,0,3,2,4,3,4,6,1,2,August,-0.8660254037844384,-0.5000000000000004,1,48,2,2,1,1.8,1.0,3,1,2,4,1,3,"August, 2011"
2011-2012,3,2011-08-27,Blackburn,Everton,0,1,A,0,3,1,0,4,2,3,0,19,17,0,0,2,0,August,-0.8660254037844384,-0.5000000000000004,4,18,1,1,3,0.6,1.6,2,5,-3,0,1,-1,"August, 2011"
2011-2012,3,2011-08-27,Chelsea,Norwich,3,1,H,3,0,2,1,2,1,1,3,6,11,4,2,5,2,August,-0.8660254037844384,-0.5000000000000004,14,31,2,0,0,3.5,0.5,2,1,1,2,2,0,"August, 2011"
2011-2012,3,2011-08-27,Liverpool,Bolton,3,1,H,3,0,2,0,3,1,3,1,6,8,4,3,2,1,August,-0.8660254037844384,-0.5000000000000004,25,6,5,0,0,2.2,0.6,3,1,2,6,3,3,"August, 2011"
2011-2012,3,2011-08-27,Swansea,Sunderland,0,0,D,1,1,2,2,1,0,3,2,17,14,1,1,3,0,August,-0.8660254037844384,-0.5000000000000004,41,40,0,0,0,0.0,0.0,0,4,-4,1,2,-1,"August, 2011"
2011-2012,3,2011-08-27,Wigan,QPR,2,0,H,3,0,4,0,1,2,0,3,12,10,2,3,2,1,August,-0.8660254037844384,-0.5000000000000004,46,34,0,0,0,0.0,0.0,1,1,0,1,4,-3,"August, 2011"
2011-2012,3,2011-08-28,Newcastle,Fulham,2,1,H,3,0,2,0,3,3,0,2,8,16,4,1,8,3,August,-0.8660254037844384,-0.5000000000000004,30,19,1,1,3,0.6,0.8,1,0,1,0,2,-2,"August, 2011"
2011-2012,3,2011-08-28,Man United,Arsenal,8,2,H,3,0,3,1,1,1,3,1,5,16,6,1,11,5,August,-0.8660254037844384,-0.5000000000000004,28,0,3,1,1,1.2,0.6,5,1,4,0,2,-2,"August, 2011"
2011-2012,3,2011-08-28,Tottenham,Man City,1,5,A,0,3,3,1,1,5,0,0,19,6,0,6,13,6,August,-0.8660254037844384,-0.5000000000000004,42,27,3,1,1,1.2,0.4,0,3,-3,7,2,5,"August, 2011"
2011-2012,3,2011-08-28,West Brom,Stoke,0,1,A,0,3,2,2,1,0,3,2,18,12,0,2,6,2,August,-0.8660254037844384,-0.5000000000000004,44,39,0,1,3,0.25,1.75,2,4,-2,1,1,0,"August, 2011"
2011-2012,4,2011-09-10,Stoke,Liverpool,1,0,H,3,0,0,3,2,2,0,3,8,3,5,7,5,2,September,-1.0,-1.8369701987210287e-16,39,25,1,2,2,0.6,1.4,2,1,1,6,2,4,"September, 2011"
2011-2012,4,2011-09-10,Man City,Wigan,3,0,H,3,0,5,0,0,4,0,1,2,8,9,5,6,4,September,-1.0,-1.8369701987210287e-16,27,46,4,1,0,1.6,0.2,12,3,9,3,1,2,"September, 2011"
2011-2012,4,2011-09-10,Arsenal,Swansea,1,0,H,3,0,1,3,1,2,2,1,17,15,1,2,2,1,September,-1.0,-1.8369701987210287e-16,0,41,0,0,0,0.0,0.0,2,10,-8,0,4,-4,"September, 2011"
2011-2012,4,2011-09-10,Bolton,Man United,0,5,A,0,3,1,3,1,3,1,1,11,1,3,9,10,6,September,-1.0,-1.8369701987210287e-16,6,28,0,1,4,0.6,2.0,7,6,1,13,3,10,"September, 2011"
2011-2012,4,2011-09-10,Sunderland,Chelsea,1,2,A,0,3,0,3,2,2,1,2,14,5,2,7,9,5,September,-1.0,-1.8369701987210287e-16,40,14,1,0,4,2.0,3.4,1,2,-1,5,2,3,"September, 2011"
2011-2012,4,2011-09-10,Everton,Aston Villa,2,2,D,1,1,2,3,0,0,3,2,11,7,3,5,4,2,September,-1.0,-1.8369701987210287e-16,18,1,0,4,1,1.6,1.8,1,1,0,3,1,2,"September, 2011"
2011-2012,4,2011-09-10,Wolves,Tottenham,0,2,A,0,3,0,3,2,3,1,1,6,20,7,0,14,7,September,-1.0,-1.8369701987210287e-16,48,42,2,1,2,1.2,1.6,4,1,3,1,8,-7,"September, 2011"
2011-2012,4,2011-09-11,Norwich,West Brom,0,1,A,0,3,1,1,3,2,2,1,15,20,2,0,5,2,September,-1.0,-1.8369701987210287e-16,31,44,1,1,0,1.5,1.0,3,5,-2,2,5,-3,"September, 2011"
2011-2012,4,2011-09-11,Fulham,Blackburn,1,1,D,1,1,3,0,2,1,0,4,18,20,1,0,2,1,September,-1.0,-1.8369701987210287e-16,19,4,2,1,2,1.6,1.4,1,4,-3,2,6,-4,"September, 2011"
2011-2012,4,2011-09-12,QPR,Newcastle,0,0,D,1,1,2,0,3,2,0,3,15,6,3,7,9,4,September,-1.0,-1.8369701987210287e-16,34,30,0,0,2,1.5,2.5,1,6,-5,3,1,2,"September, 2011"
2011-2012,5,2011-09-17,Wolves,QPR,0,3,A,0,3,0,3,2,2,0,3,9,14,7,4,5,3,September,-1.0,-1.8369701987210287e-16,48,34,0,0,0,0.0,0.0,4,3,1,1,6,-5,"September, 2011"
2011-2012,5,2011-09-17,Swansea,West Brom,3,0,H,3,0,2,2,1,2,2,1,20,15,2,3,5,1,September,-1.0,-1.8369701987210287e-16,41,44,0,0,0,0.0,0.0,0,5,-5,3,5,-2,"September, 2011"
2011-2012,5,2011-09-17,Everton,Wigan,3,1,H,3,0,2,3,0,4,0,1,11,9,4,5,2,1,September,-1.0,-1.8369701987210287e-16,18,46,3,2,0,1.6,0.4,3,3,0,3,4,-1,"September, 2011"
2011-2012,5,2011-09-17,Aston Villa,Newcastle,1,1,D,1,1,0,3,2,2,0,3,8,4,6,8,4,2,September,-1.0,-1.8369701987210287e-16,1,30,3,0,2,1.2,1.8,5,3,2,3,1,2,"September, 2011"
2011-2012,5,2011-09-17,Blackburn,Arsenal,4,3,H,3,0,1,0,4,1,3,1,20,12,1,4,8,3,September,-1.0,-1.8369701987210287e-16,4,0,1,1,3,1.0,2.6,3,7,-4,3,10,-7,"September, 2011"
2011-2012,5,2011-09-17,Bolton,Norwich,1,2,A,0,3,1,3,1,1,1,3,15,18,3,2,3,1,September,-1.0,-1.8369701987210287e-16,6,31,1,0,1,1.5,1.5,7,11,-4,3,6,-3,"September, 2011"
2011-2012,5,2011-09-18,Fulham,Man City,2,2,D,1,1,3,0,2,5,0,0,20,2,2,12,18,10,September,-1.0,-1.8369701987210287e-16,19,27,1,2,2,1.6,2.0,2,5,-3,15,3,12,"September, 2011"
2011-2012,5,2011-09-18,Man United,Chelsea,3,1,H,3,0,3,1,1,2,1,2,2,3,12,10,1,2,September,-1.0,-1.8369701987210287e-16,28,14,2,0,3,1.4,1.2,18,3,15,7,3,4,"September, 2011"
2011-2012,5,2011-09-18,Sunderland,Stoke,4,0,H,3,0,0,3,2,0,3,2,20,5,2,8,15,6,September,-1.0,-1.8369701987210287e-16,40,39,2,1,2,1.2,0.8,2,4,-2,3,1,2,"September, 2011"
2011-2012,5,2011-09-18,Tottenham,Liverpool,4,0,H,3,0,3,1,1,2,0,3,19,6,3,7,13,4,September,-1.0,-1.8369701987210287e-16,42,25,3,0,2,1.4,1.4,3,8,-5,6,3,3,"September, 2011"
2011-2012,6,2011-09-24,Arsenal,Bolton,3,0,H,3,0,1,3,1,1,3,1,17,19,4,3,2,1,September,-1.0,-1.8369701987210287e-16,0,6,4,0,1,2.4,1.0,6,14,-8,8,13,-5,"September, 2011"
2011-2012,6,2011-09-24,Chelsea,Swansea,4,1,H,3,0,2,1,2,2,2,1,3,15,10,5,12,5,September,-1.0,-1.8369701987210287e-16,14,41,0,0,0,0.0,0.0,8,6,2,3,5,-2,"September, 2011"
2011-2012,6,2011-09-24,Liverpool,Wolves,2,1,H,3,0,2,0,3,0,3,2,8,10,7,7,2,0,September,-1.0,-1.8369701987210287e-16,25,48,3,1,1,1.2,0.2,6,7,-1,4,6,-2,"September, 2011"
2011-2012,6,2011-09-24,Man City,Everton,2,0,H,3,0,5,0,0,2,3,0,2,8,13,7,6,6,September,-1.0,-1.8369701987210287e-16,27,18,1,0,4,0.8,1.8,17,5,12,6,4,2,"September, 2011"
2011-2012,6,2011-09-24,Newcastle,Blackburn,3,1,H,3,0,2,0,3,1,0,4,5,17,9,4,12,5,September,-1.0,-1.8369701987210287e-16,30,4,0,1,4,0.4,1.6,4,2,2,7,10,-3,"September, 2011"
2011-2012,6,2011-09-24,Stoke,Man United,1,1,D,1,1,0,3,2,3,1,1,6,2,8,15,4,7,September,-1.0,-1.8369701987210287e-16,39,28,0,0,5,0.4,2.2,3,5,-2,21,4,17,"September, 2011"
2011-2012,6,2011-09-24,West Brom,Fulham,0,0,D,1,1,2,2,1,3,0,2,19,18,3,3,1,0,September,-1.0,-1.8369701987210287e-16,44,19,2,0,3,0.8,2.4,3,8,-5,4,7,-3,"September, 2011"
2011-2012,6,2011-09-24,Wigan,Tottenham,1,2,A,0,3,4,0,1,3,1,1,15,12,5,6,3,1,September,-1.0,-1.8369701987210287e-16,46,42,2,1,2,0.6,2.4,4,7,-3,7,8,-1,"September, 2011"
2011-2012,6,2011-09-25,QPR,Aston Villa,1,1,D,1,1,2,0,3,0,3,2,10,8,7,7,2,0,September,-1.0,-1.8369701987210287e-16,34,1,1,0,1,1.5,2.0,4,6,-2,6,4,2,"September, 2011"
2011-2012,6,2011-09-26,Norwich,Sunderland,2,1,H,3,0,1,1,3,0,3,2,14,13,5,5,1,0,September,-1.0,-1.8369701987210287e-16,31,40,0,0,0,0.0,0.0,5,7,-2,6,4,2,"September, 2011"
2011-2012,7,2011-10-01,Sunderland,West Brom,2,2,D,1,1,0,3,2,2,2,1,14,18,5,4,4,1,October,-0.8660254037844386,0.5,40,44,2,0,3,1.4,1.4,7,6,1,3,8,-5,"October, 2011"
2011-2012,7,2011-10-01,Wolves,Newcastle,1,2,A,0,3,0,3,2,2,0,3,12,5,7,12,7,5,October,-0.8660254037844386,0.5,48,30,0,3,1,1.0,1.75,5,8,-3,7,3,4,"October, 2011"
2011-2012,7,2011-10-01,Man United,Norwich,2,0,H,3,0,3,1,1,1,1,3,2,9,16,8,7,8,October,-0.8660254037844386,0.5,28,31,1,0,1,1.0,1.5,22,5,17,7,8,-1,"October, 2011"
2011-2012,7,2011-10-01,Blackburn,Man City,0,4,A,0,3,1,0,4,5,0,0,18,2,4,16,16,12,October,-0.8660254037844386,0.5,4,27,0,1,4,0.6,2.2,8,13,-5,19,5,14,"October, 2011"
2011-2012,7,2011-10-01,Everton,Liverpool,0,2,A,0,3,2,3,0,2,0,3,11,6,7,10,5,3,October,-0.8660254037844386,0.5,18,25,1,2,2,1.0,1.2,6,6,0,8,8,0,"October, 2011"
2011-2012,7,2011-10-01,Aston Villa,Wigan,2,0,H,3,0,0,3,2,4,0,1,8,15,8,5,7,3,October,-0.8660254037844386,0.5,1,46,2,2,1,1.0,1.0,7,5,2,5,9,-4,"October, 2011"
2011-2012,7,2011-10-02,Bolton,Chelsea,1,5,A,0,3,1,3,1,2,1,2,20,4,3,13,16,10,October,-0.8660254037844386,0.5,6,14,0,0,5,0.6,2.8,8,16,-8,12,7,5,"October, 2011"
2011-2012,7,2011-10-02,Fulham,QPR,6,0,H,3,0,3,0,2,2,0,3,18,9,4,8,9,4,October,-0.8660254037844386,0.5,19,34,0,0,0,0.0,0.0,4,7,-3,5,7,-2,"October, 2011"
2011-2012,7,2011-10-02,Swansea,Stoke,2,0,H,3,0,2,2,1,0,3,2,17,8,5,9,9,4,October,-0.8660254037844386,0.5,41,39,0,0,0,0.0,0.0,4,9,-5,4,6,-2,"October, 2011"
2011-2012,7,2011-10-02,Tottenham,Arsenal,2,1,H,3,0,3,1,1,1,3,1,7,15,9,7,8,2,October,-0.8660254037844386,0.5,42,0,2,2,1,1.6,1.8,9,9,0,9,14,-5,"October, 2011"
2011-2012,8,2011-10-15,Wigan,Bolton,1,3,A,0,3,4,0,1,1,3,1,18,20,5,3,2,2,October,-0.8660254037844386,0.5,46,6,0,4,1,0.4,1.2,5,11,-6,9,21,-12,"October, 2011"
2011-2012,8,2011-10-15,Stoke,Fulham,2,0,H,3,0,0,3,2,3,0,2,9,12,9,7,3,2,October,-0.8660254037844386,0.5,39,19,2,0,3,0.8,1.4,4,8,-4,10,7,3,"October, 2011"
2011-2012,8,2011-10-15,QPR,Blackburn,1,1,D,1,1,2,0,3,1,0,4,11,19,8,4,8,4,October,-0.8660254037844386,0.5,34,4,0,0,2,0.0,1.0,5,13,-8,8,17,-9,"October, 2011"
2011-2012,8,2011-10-15,Man City,Aston Villa,4,1,H,3,0,5,0,0,0,3,2,2,7,19,11,5,8,October,-0.8660254037844386,0.5,27,1,3,1,1,2.0,0.6,23,5,18,9,5,4,"October, 2011"
2011-2012,8,2011-10-15,Liverpool,Man United,1,1,D,1,1,2,0,3,3,1,1,5,1,13,19,4,6,October,-0.8660254037844386,0.5,25,28,3,0,2,2.4,1.4,10,8,2,24,5,19,"October, 2011"
2011-2012,8,2011-10-15,Chelsea,Everton,3,1,H,3,0,2,1,2,2,3,0,3,13,16,7,10,9,October,-0.8660254037844386,0.5,14,18,0,3,2,1.0,1.4,17,8,9,6,8,-2,"October, 2011"
2011-2012,8,2011-10-15,Norwich,Swansea,3,1,H,3,0,1,1,3,2,2,1,9,10,8,8,1,0,October,-0.8660254037844386,0.5,31,41,0,0,0,0.0,0.0,7,10,-3,6,9,-3,"October, 2011"
2011-2012,8,2011-10-16,Arsenal,Sunderland,2,1,H,3,0,1,3,1,0,3,2,15,16,7,6,1,1,October,-0.8660254037844386,0.5,0,40,1,3,1,0.6,0.4,10,16,-6,9,8,1,"October, 2011"
2011-2012,8,2011-10-16,Newcastle,Tottenham,2,2,D,1,1,2,0,3,3,1,1,4,6,15,12,2,3,October,-0.8660254037844386,0.5,30,42,2,1,2,1.4,1.2,9,4,5,11,10,1,"October, 2011"
2011-2012,8,2011-10-16,West Brom,Wolves,2,0,H,3,0,2,2,1,0,3,2,18,15,5,7,3,2,October,-0.8660254037844386,0.5,44,48,0,1,1,1.0,2.0,5,10,-5,6,10,-4,"October, 2011"
2011-2012,9,2011-10-22,Wolves,Swansea,2,2,D,1,1,0,3,2,2,2,1,17,14,7,8,3,1,October,-0.8660254037844386,0.5,48,41,0,0,0,0.0,0.0,6,12,-6,7,12,-5,"October, 2011"
2011-2012,9,2011-10-22,Newcastle,Wigan,1,0,H,3,0,2,0,3,4,0,1,4,19,16,5,15,11,October,-0.8660254037844386,0.5,30,46,1,2,2,1.2,1.4,11,6,5,6,14,-8,"October, 2011"
2011-2012,9,2011-10-22,Bolton,Sunderland,0,2,A,0,3,1,3,1,0,3,2,18,17,6,6,1,0,October,-0.8660254037844386,0.5,6,40,0,1,4,0.2,1.6,12,22,-10,10,10,0,"October, 2011"
2011-2012,9,2011-10-22,Aston Villa,West Brom,1,2,A,0,3,0,3,2,2,2,1,8,12,11,8,4,3,October,-0.8660254037844386,0.5,1,44,3,1,1,1.4,1.0,10,9,1,7,10,-3,"October, 2011"
2011-2012,9,2011-10-22,Liverpool,Norwich,1,1,D,1,1,2,0,3,1,1,3,5,9,14,11,4,3,October,-0.8660254037844386,0.5,25,31,2,0,0,2.5,0.5,11,9,2,10,11,-1,"October, 2011"
2011-2012,9,2011-10-23,Arsenal,Stoke,3,1,H,3,0,1,3,1,0,3,2,11,8,10,12,3,2,October,-0.8660254037844386,0.5,0,39,4,0,1,2.2,1.0,12,17,-5,6,8,-2,"October, 2011"
2011-2012,9,2011-10-23,Blackburn,Tottenham,1,2,A,0,3,1,0,4,3,1,1,19,6,5,13,13,8,October,-0.8660254037844386,0.5,4,42,1,0,4,1.0,2.2,9,18,-9,13,12,1,"October, 2011"
2011-2012,9,2011-10-23,Fulham,Everton,1,3,A,0,3,3,0,2,2,3,0,16,17,7,7,1,0,October,-0.8660254037844386,0.5,19,18,1,1,3,0.8,1.4,10,9,1,7,11,-4,"October, 2011"
2011-2012,9,2011-10-23,Man United,Man City,1,6,A,0,3,3,1,1,5,0,0,2,1,20,22,1,2,October,-0.8660254037844386,0.5,28,27,4,1,0,1.8,0.8,25,6,19,27,6,21,"October, 2011"
2011-2012,9,2011-10-23,QPR,Chelsea,1,0,H,3,0,2,0,3,2,1,2,15,3,9,19,12,10,October,-0.8660254037844386,0.5,34,14,0,1,1,1.0,1.5,6,14,-8,20,9,11,"October, 2011"
2011-2012,10,2011-10-29,Everton,Man United,0,1,A,0,3,2,3,0,3,1,1,13,2,10,20,11,10,October,-0.8660254037844386,0.5,18,28,1,1,3,1.2,1.8,10,12,-2,26,12,14,"October, 2011"
2011-2012,10,2011-10-29,Chelsea,Arsenal,3,5,A,0,3,2,1,2,1,3,1,3,7,19,13,4,6,October,-0.8660254037844386,0.5,14,0,4,0,1,2.4,0.8,20,10,10,15,18,-3,"October, 2011"
2011-2012,10,2011-10-29,Man City,Wolves,3,1,H,3,0,5,0,0,0,3,2,1,16,25,8,15,17,October,-0.8660254037844386,0.5,27,48,3,1,1,2.4,1.6,33,7,26,8,14,-6,"October, 2011"
2011-2012,10,2011-10-29,Norwich,Blackburn,3,3,D,1,1,1,1,3,1,0,4,8,20,12,5,12,7,October,-0.8660254037844386,0.5,31,4,0,1,1,0.5,2.0,11,12,-1,10,20,-10,"October, 2011"
2011-2012,10,2011-10-29,Sunderland,Aston Villa,2,2,D,1,1,0,3,2,0,3,2,14,11,9,11,3,2,October,-0.8660254037844386,0.5,40,1,2,1,2,0.8,1.0,12,10,2,11,11,0,"October, 2011"
2011-2012,10,2011-10-29,Swansea,Bolton,3,1,H,3,0,2,2,1,1,3,1,15,19,9,6,4,3,October,-0.8660254037844386,0.5,41,6,0,0,0,0.0,0.0,9,14,-5,12,24,-12,"October, 2011"
2011-2012,10,2011-10-29,West Brom,Liverpool,0,2,A,0,3,2,2,1,2,0,3,13,7,11,15,6,4,October,-0.8660254037844386,0.5,44,25,1,0,4,0.4,1.8,9,11,-2,12,10,2,"October, 2011"
2011-2012,10,2011-10-29,Wigan,Fulham,0,2,A,0,3,4,0,1,3,0,2,20,17,5,7,3,2,October,-0.8660254037844386,0.5,46,19,0,3,2,0.6,1.2,6,15,-9,11,12,-1,"October, 2011"
2011-2012,10,2011-10-30,Tottenham,QPR,3,1,H,3,0,3,1,1,2,0,3,6,12,16,12,6,4,October,-0.8660254037844386,0.5,42,34,2,0,0,2.0,1.0,15,13,2,7,14,-7,"October, 2011"
2011-2012,10,2011-10-31,Stoke,Newcastle,1,3,A,0,3,0,3,2,2,0,3,11,4,12,19,7,7,October,-0.8660254037844386,0.5,39,30,2,2,0,2.25,1.0,7,11,-4,12,6,6,"October, 2011"
2011-2012,11,2011-11-05,QPR,Man City,2,3,A,0,3,2,0,3,5,0,0,12,1,12,28,11,16,November,-0.5000000000000004,0.8660254037844384,34,27,1,0,1,0.5,1.0,8,17,-9,36,8,28,"November, 2011"
2011-2012,11,2011-11-05,Man United,Sunderland,1,0,H,3,0,3,1,1,0,3,2,2,14,23,10,12,13,November,-0.5000000000000004,0.8660254037844384,28,40,3,2,0,1.4,0.6,27,12,15,14,12,2,"November, 2011"
2011-2012,11,2011-11-05,Liverpool,Swansea,0,0,D,1,1,2,0,3,2,2,1,7,10,18,12,3,6,November,-0.5000000000000004,0.8660254037844384,25,41,0,0,0,0.0,0.0,14,10,4,12,15,-3,"November, 2011"
2011-2012,11,2011-11-05,Newcastle,Everton,2,1,H,3,0,2,0,3,2,3,0,4,16,22,10,12,12,November,-0.5000000000000004,0.8660254037844384,30,18,1,2,2,1.0,1.4,15,7,8,10,13,-3,"November, 2011"
2011-2012,11,2011-11-05,Aston Villa,Norwich,3,2,H,3,0,0,3,2,1,1,3,9,8,12,13,1,1,November,-0.5000000000000004,0.8660254037844384,1,31,1,1,0,1.5,0.0,13,13,0,14,15,-1,"November, 2011"
2011-2012,11,2011-11-05,Arsenal,West Brom,3,0,H,3,0,1,3,1,2,2,1,7,13,16,11,6,5,November,-0.5000000000000004,0.8660254037844384,0,44,3,1,1,2.2,1.4,20,21,-1,9,13,-4,"November, 2011"
2011-2012,11,2011-11-05,Blackburn,Chelsea,0,1,A,0,3,1,0,4,2,1,2,18,4,6,19,14,13,November,-0.5000000000000004,0.8660254037844384,4,14,0,1,4,0.4,2.4,13,23,-10,23,15,8,"November, 2011"
2011-2012,11,2011-11-06,Bolton,Stoke,5,0,H,3,0,1,3,1,0,3,2,19,11,6,12,8,6,November,-0.5000000000000004,0.8660254037844384,6,39,2,1,2,1.0,1.4,13,27,-14,8,14,-6,"November, 2011"
2011-2012,11,2011-11-06,Fulham,Tottenham,1,3,A,0,3,3,0,2,3,1,1,15,5,10,19,10,9,November,-0.5000000000000004,0.8660254037844384,19,42,0,2,3,0.2,1.0,13,12,1,18,14,4,"November, 2011"
2011-2012,11,2011-11-06,Wolves,Wigan,3,1,H,3,0,0,3,2,4,0,1,18,20,8,5,2,3,November,-0.5000000000000004,0.8660254037844384,48,46,1,0,3,0.5,1.5,9,17,-8,6,17,-11,"November, 2011"
2011-2012,12,2011-11-19,Wigan,Blackburn,3,3,D,1,1,4,0,1,1,0,4,20,19,5,6,1,1,November,-0.5000000000000004,0.8660254037844384,46,4,1,1,3,1.4,2.0,7,20,-13,13,24,-11,"November, 2011"
2011-2012,12,2011-11-19,West Brom,Bolton,2,1,H,3,0,2,2,1,1,3,1,17,18,11,9,1,2,November,-0.5000000000000004,0.8660254037844384,44,6,0,4,1,0.4,0.8,9,16,-7,18,27,-9,"November, 2011"
2011-2012,12,2011-11-19,Swansea,Man United,0,1,A,0,3,2,2,1,3,1,1,12,2,13,26,10,13,November,-0.5000000000000004,0.8660254037844384,41,28,0,0,0,0.0,0.0,12,15,-3,28,12,16,"November, 2011"
2011-2012,12,2011-11-19,Sunderland,Fulham,0,0,D,1,1,0,3,2,3,0,2,16,17,10,10,1,0,November,-0.5000000000000004,0.8660254037844384,40,19,1,2,2,0.2,0.8,14,13,1,14,15,-1,"November, 2011"
2011-2012,12,2011-11-19,Stoke,QPR,2,3,A,0,3,0,3,2,2,0,3,13,12,12,12,1,0,November,-0.5000000000000004,0.8660254037844384,39,34,0,0,0,0.0,0.0,8,19,-11,10,20,-10,"November, 2011"
2011-2012,12,2011-11-19,Man City,Newcastle,3,1,H,3,0,5,0,0,2,0,3,1,3,31,25,2,6,November,-0.5000000000000004,0.8660254037844384,27,30,4,1,0,2.2,1.0,39,10,29,17,8,9,"November, 2011"
2011-2012,12,2011-11-19,Everton,Wolves,2,1,H,3,0,2,3,0,0,3,2,17,13,10,11,4,1,November,-0.5000000000000004,0.8660254037844384,18,48,1,3,1,1.2,0.8,11,15,-4,12,18,-6,"November, 2011"
2011-2012,12,2011-11-19,Norwich,Arsenal,1,2,A,0,3,1,1,3,1,3,1,9,7,13,19,2,6,November,-0.5000000000000004,0.8660254037844384,31,0,0,0,2,1.0,4.0,16,18,-2,23,21,2,"November, 2011"
2011-2012,12,2011-11-20,Chelsea,Liverpool,1,2,A,0,3,2,1,2,2,0,3,4,7,22,19,3,3,November,-0.5000000000000004,0.8660254037844384,14,25,2,0,3,0.8,1.0,24,15,9,14,10,4,"November, 2011"
2011-2012,12,2011-11-21,Tottenham,Aston Villa,2,0,H,3,0,3,1,1,0,3,2,5,8,22,15,3,7,November,-0.5000000000000004,0.8660254037844384,42,1,3,2,0,1.4,0.8,21,15,6,16,15,1,"November, 2011"
2011-2012,13,2011-11-26,West Brom,Tottenham,1,3,A,0,3,2,2,1,3,1,1,13,5,14,25,8,11,November,-0.5000000000000004,0.8660254037844384,44,42,1,2,2,1.2,1.2,11,17,-6,23,15,8,"November, 2011"
2011-2012,13,2011-11-26,Sunderland,Wigan,1,2,A,0,3,0,3,2,4,0,1,16,20,11,6,4,5,November,-0.5000000000000004,0.8660254037844384,40,46,1,2,2,1.4,1.4,14,13,1,10,23,-13,"November, 2011"
2011-2012,13,2011-11-26,Norwich,QPR,2,1,H,3,0,1,1,3,2,0,3,12,10,13,15,2,2,November,-0.5000000000000004,0.8660254037844384,31,34,0,0,0,0.0,0.0,17,20,-3,13,22,-9,"November, 2011"
2011-2012,13,2011-11-26,Stoke,Blackburn,3,1,H,3,0,0,3,2,1,0,4,15,19,12,7,4,5,November,-0.5000000000000004,0.8660254037844384,39,4,4,1,0,1.4,0.0,10,22,-12,16,27,-11,"November, 2011"
2011-2012,13,2011-11-26,Chelsea,Wolves,3,0,H,3,0,2,1,2,0,3,2,6,17,22,11,11,11,November,-0.5000000000000004,0.8660254037844384,14,48,4,0,1,2.6,0.6,25,17,8,13,20,-7,"November, 2011"
2011-2012,13,2011-11-26,Bolton,Everton,0,2,A,0,3,1,3,1,2,3,0,18,12,9,13,6,4,November,-0.5000000000000004,0.8660254037844384,6,18,2,1,2,1.2,1.6,19,29,-10,13,16,-3,"November, 2011"
2011-2012,13,2011-11-26,Arsenal,Fulham,1,1,D,1,1,1,3,1,3,0,2,7,16,22,11,9,11,November,-0.5000000000000004,0.8660254037844384,0,19,3,2,0,1.8,0.6,25,22,3,14,15,-1,"November, 2011"
2011-2012,13,2011-11-26,Man United,Newcastle,1,1,D,1,1,3,1,1,2,0,3,2,5,29,25,3,4,November,-0.5000000000000004,0.8660254037844384,28,30,3,2,0,2.2,0.6,29,12,17,18,11,7,"November, 2011"
2011-2012,13,2011-11-27,Liverpool,Man City,1,1,D,1,1,2,0,3,5,0,0,7,1,22,34,6,12,November,-0.5000000000000004,0.8660254037844384,25,27,1,3,1,1.2,1.2,16,11,5,42,11,31,"November, 2011"
2011-2012,13,2011-11-27,Swansea,Aston Villa,0,0,D,1,1,2,2,1,0,3,2,14,10,13,15,4,2,November,-0.5000000000000004,0.8660254037844384,41,1,0,0,0,0.0,0.0,12,16,-4,16,17,-1,"November, 2011"
2011-2012,14,2011-12-03,Wigan,Arsenal,0,4,A,0,3,4,0,1,1,3,1,19,7,9,23,12,14,December,-2.4492935982947064e-16,1.0,46,0,1,1,3,1.2,3.0,12,24,-12,26,23,3,"December, 2011"
2011-2012,14,2011-12-03,QPR,West Brom,1,1,D,1,1,2,0,3,2,2,1,11,14,15,14,3,1,December,-2.4492935982947064e-16,1.0,34,44,0,0,0,0.0,0.0,14,24,-10,12,20,-8,"December, 2011"
2011-2012,14,2011-12-03,Newcastle,Chelsea,0,3,A,0,3,2,0,3,2,1,2,4,5,26,25,1,1,December,-2.4492935982947064e-16,1.0,30,14,0,3,2,0.6,1.4,19,12,7,28,17,11,"December, 2011"
2011-2012,14,2011-12-03,Tottenham,Bolton,3,0,H,3,0,3,1,1,1,3,1,4,19,28,9,15,19,December,-2.4492935982947064e-16,1.0,42,6,2,1,2,1.8,2.0,26,16,10,19,31,-12,"December, 2011"
2011-2012,14,2011-12-03,Blackburn,Swansea,4,2,H,3,0,1,0,4,2,2,1,20,13,7,14,7,7,December,-2.4492935982947064e-16,1.0,4,41,0,0,0,0.0,0.0,17,30,-13,12,16,-4,"December, 2011"
2011-2012,14,2011-12-03,Aston Villa,Man United,0,1,A,0,3,0,3,2,3,1,1,8,2,16,30,6,14,December,-2.4492935982947064e-16,1.0,1,28,1,2,2,1.4,1.8,16,17,-1,30,13,17,"December, 2011"
2011-2012,14,2011-12-03,Man City,Norwich,5,1,H,3,0,5,0,0,1,1,3,1,9,35,16,8,19,December,-2.4492935982947064e-16,1.0,27,31,1,1,0,2.0,1.5,43,12,31,19,21,-2,"December, 2011"
2011-2012,14,2011-12-04,Everton,Stoke,0,1,A,0,3,2,3,0,0,3,2,8,13,16,15,5,1,December,-2.4492935982947064e-16,1.0,18,39,2,2,1,1.0,0.8,15,16,-1,13,23,-10,"December, 2011"
2011-2012,14,2011-12-04,Wolves,Sunderland,2,1,H,3,0,0,3,2,0,3,2,17,16,11,11,1,0,December,-2.4492935982947064e-16,1.0,48,40,3,0,1,2.5,2.25,13,23,-10,15,15,0,"December, 2011"
2011-2012,14,2011-12-05,Fulham,Liverpool,1,0,H,3,0,3,0,2,2,0,3,16,7,12,23,9,11,December,-2.4492935982947064e-16,1.0,19,25,1,1,3,1.0,1.6,15,16,-1,17,12,5,"December, 2011"
2011-2012,15,2011-12-10,Swansea,Fulham,2,0,H,3,0,2,2,1,3,0,2,15,13,14,15,2,1,December,-2.4492935982947064e-16,1.0,41,19,0,0,0,0.0,0.0,14,20,-6,16,16,0,"December, 2011"
2011-2012,15,2011-12-10,Arsenal,Everton,1,0,H,3,0,1,3,1,2,3,0,5,10,26,16,5,10,December,-2.4492935982947064e-16,1.0,0,18,3,2,0,2.6,1.2,30,23,7,15,17,-2,"December, 2011"
2011-2012,15,2011-12-10,Bolton,Aston Villa,1,2,A,0,3,1,3,1,0,3,2,19,9,9,16,10,7,December,-2.4492935982947064e-16,1.0,6,1,1,2,2,1.2,2.0,19,34,-15,16,18,-2,"December, 2011"
2011-2012,15,2011-12-10,Liverpool,QPR,1,0,H,3,0,2,0,3,2,0,3,7,12,23,16,5,7,December,-2.4492935982947064e-16,1.0,25,34,2,0,0,1.5,0.5,17,13,4,15,25,-10,"December, 2011"
2011-2012,15,2011-12-10,Man United,Wolves,4,1,H,3,0,3,1,1,0,3,2,2,16,33,14,14,19,December,-2.4492935982947064e-16,1.0,28,48,3,0,2,1.4,0.8,31,13,18,15,24,-9,"December, 2011"
2011-2012,15,2011-12-10,Norwich,Newcastle,4,2,H,3,0,1,1,3,2,0,3,11,7,16,26,4,10,December,-2.4492935982947064e-16,1.0,31,30,1,1,0,2.0,1.5,20,26,-6,19,15,4,"December, 2011"
2011-2012,15,2011-12-10,West Brom,Wigan,1,2,A,0,3,2,2,1,4,0,1,15,20,15,9,5,6,December,-2.4492935982947064e-16,1.0,44,46,2,1,2,1.4,1.2,13,21,-8,12,28,-16,"December, 2011"
2011-2012,15,2011-12-11,Stoke,Tottenham,2,1,H,3,0,0,3,2,3,1,1,10,3,18,31,7,13,December,-2.4492935982947064e-16,1.0,39,42,1,0,4,1.2,2.0,14,23,-9,29,16,13,"December, 2011"
2011-2012,15,2011-12-11,Sunderland,Blackburn,2,1,H,3,0,0,3,2,1,0,4,18,19,11,10,1,1,December,-2.4492935982947064e-16,1.0,40,4,2,3,0,1.4,0.6,16,17,-1,21,32,-11,"December, 2011"
2011-2012,15,2011-12-12,Chelsea,Man City,2,1,H,3,0,2,1,2,5,0,0,5,1,28,38,4,10,December,-2.4492935982947064e-16,1.0,14,27,2,0,3,1.2,1.4,31,17,14,48,13,35,"December, 2011"
2011-2012,16,2011-12-17,Wigan,Chelsea,1,1,D,1,1,4,0,1,2,1,2,18,3,12,31,15,19,December,-2.4492935982947064e-16,1.0,46,14,1,0,4,0.8,3.6,14,29,-15,33,18,15,"December, 2011"
2011-2012,16,2011-12-17,Wolves,Stoke,1,2,A,0,3,0,3,2,0,3,2,17,8,14,21,9,7,December,-2.4492935982947064e-16,1.0,48,39,1,2,1,1.0,1.5,16,28,-12,16,24,-8,"December, 2011"
2011-2012,16,2011-12-17,Newcastle,Swansea,0,0,D,1,1,2,0,3,2,2,1,7,14,26,17,7,9,December,-2.4492935982947064e-16,1.0,30,41,0,0,0,0.0,0.0,21,19,2,16,20,-4,"December, 2011"
2011-2012,16,2011-12-17,Blackburn,West Brom,1,2,A,0,3,1,0,4,2,2,1,19,15,10,15,4,5,December,-2.4492935982947064e-16,1.0,4,44,2,2,1,1.4,1.0,22,34,-12,14,23,-9,"December, 2011"
2011-2012,16,2011-12-17,Everton,Norwich,1,1,D,1,1,2,3,0,1,1,3,13,10,16,19,3,3,December,-2.4492935982947064e-16,1.0,18,31,2,0,0,2.0,1.0,15,18,-3,24,28,-4,"December, 2011"
2011-2012,16,2011-12-17,Fulham,Bolton,2,0,H,3,0,3,0,2,1,3,1,15,20,15,9,5,6,December,-2.4492935982947064e-16,1.0,19,6,2,3,0,1.4,0.4,16,18,-2,20,36,-16,"December, 2011"
2011-2012,16,2011-12-18,Aston Villa,Liverpool,0,2,A,0,3,0,3,2,2,0,3,10,7,19,26,3,7,December,-2.4492935982947064e-16,1.0,1,25,2,0,3,0.8,2.0,18,19,-1,18,13,5,"December, 2011"
2011-2012,16,2011-12-18,Man City,Arsenal,1,0,H,3,0,5,0,0,1,3,1,1,5,38,29,4,9,December,-2.4492935982947064e-16,1.0,27,0,1,2,2,0.8,1.4,49,15,34,31,23,8,"December, 2011"
2011-2012,16,2011-12-18,QPR,Man United,0,2,A,0,3,2,0,3,3,1,1,15,2,16,36,13,20,December,-2.4492935982947064e-16,1.0,34,28,0,1,1,1.0,1.5,15,26,-11,35,14,21,"December, 2011"
2011-2012,16,2011-12-18,Tottenham,Sunderland,1,0,H,3,0,3,1,1,0,3,2,4,16,31,14,12,17,December,-2.4492935982947064e-16,1.0,42,40,2,2,1,1.4,1.2,30,18,12,18,18,0,"December, 2011"
2011-2012,17,2011-12-20,Blackburn,Bolton,1,2,A,0,3,1,0,4,1,3,1,19,20,10,9,1,1,December,-2.4492935982947064e-16,1.0,4,6,3,1,1,1.8,0.8,23,36,-13,20,38,-18,"December, 2011"
2011-2012,17,2011-12-20,Wolves,Norwich,2,2,D,1,1,0,3,2,1,1,3,17,9,14,20,8,6,December,-2.4492935982947064e-16,1.0,48,31,0,0,0,0.0,0.0,17,30,-13,25,29,-4,"December, 2011"
2011-2012,17,2011-12-21,Wigan,Liverpool,0,0,D,1,1,4,0,1,2,0,3,18,6,13,29,12,16,December,-2.4492935982947064e-16,1.0,46,25,1,3,1,1.0,1.0,15,30,-15,20,13,7,"December, 2011"
2011-2012,17,2011-12-21,QPR,Sunderland,2,3,A,0,3,2,0,3,0,3,2,15,17,16,14,2,2,December,-2.4492935982947064e-16,1.0,34,40,0,0,0,0.0,0.0,15,28,-13,18,19,-1,"December, 2011"
2011-2012,17,2011-12-21,Newcastle,West Brom,2,3,A,0,3,2,0,3,2,2,1,7,14,27,18,7,9,December,-2.4492935982947064e-16,1.0,30,44,3,1,1,2.4,1.8,21,19,2,16,24,-8,"December, 2011"
2011-2012,17,2011-12-21,Everton,Swansea,1,0,H,3,0,2,3,0,2,2,1,14,12,17,18,2,1,December,-2.4492935982947064e-16,1.0,18,41,0,0,0,0.0,0.0,16,19,-3,16,20,-4,"December, 2011"
2011-2012,17,2011-12-21,Fulham,Man United,0,5,A,0,3,3,0,2,3,1,1,12,2,18,39,10,21,December,-2.4492935982947064e-16,1.0,19,28,2,1,2,1.4,1.4,18,18,0,37,14,23,"December, 2011"
2011-2012,17,2011-12-21,Aston Villa,Arsenal,1,2,A,0,3,0,3,2,1,3,1,10,5,19,29,5,10,December,-2.4492935982947064e-16,1.0,1,0,1,2,2,1.2,2.0,18,21,-3,31,24,7,"December, 2011"
2011-2012,17,2011-12-21,Man City,Stoke,3,0,H,3,0,5,0,0,0,3,2,2,8,41,24,6,17,December,-2.4492935982947064e-16,1.0,27,39,2,2,1,1.4,0.6,50,15,35,18,25,-7,"December, 2011"
2011-2012,17,2011-12-22,Tottenham,Chelsea,1,1,D,1,1,3,1,1,2,1,2,3,4,34,32,1,2,December,-2.4492935982947064e-16,1.0,42,14,2,1,2,1.0,1.4,31,18,13,34,19,15,"December, 2011"
2011-2012,18,2011-12-26,Sunderland,Everton,1,1,D,1,1,0,3,2,2,3,0,15,11,17,20,4,3,December,-2.4492935982947064e-16,1.0,40,18,0,2,3,0.6,1.8,21,21,0,17,19,-2,"December, 2011"
2011-2012,18,2011-12-26,West Brom,Man City,0,0,D,1,1,2,2,1,5,0,0,11,2,21,44,9,23,December,-2.4492935982947064e-16,1.0,44,27,2,0,3,1.2,2.0,19,26,-7,53,15,38,"December, 2011"
2011-2012,18,2011-12-26,Man United,Wigan,5,0,H,3,0,3,1,1,4,0,1,2,18,42,14,16,28,December,-2.4492935982947064e-16,1.0,28,46,5,0,0,3.6,0.2,42,14,28,15,30,-15,"December, 2011"
2011-2012,18,2011-12-26,Stoke,Aston Villa,0,0,D,1,1,0,3,2,0,3,2,8,12,24,19,4,5,December,-2.4492935982947064e-16,1.0,39,1,1,3,1,1.0,1.0,18,28,-10,19,23,-4,"December, 2011"
2011-2012,18,2011-12-26,Chelsea,Fulham,1,1,D,1,1,2,1,2,3,0,2,4,13,33,18,9,15,December,-2.4492935982947064e-16,1.0,14,19,4,1,0,1.6,0.4,35,20,15,18,23,-5,"December, 2011"
2011-2012,18,2011-12-26,Bolton,Newcastle,0,2,A,0,3,1,3,1,2,0,3,19,7,12,27,12,15,December,-2.4492935982947064e-16,1.0,6,30,2,2,1,1.4,0.6,22,39,-17,23,22,1,"December, 2011"
2011-2012,18,2011-12-26,Liverpool,Blackburn,1,1,D,1,1,2,0,3,1,0,4,6,20,30,10,14,20,December,-2.4492935982947064e-16,1.0,25,4,3,1,1,1.8,1.0,20,13,7,24,38,-14,"December, 2011"
2011-2012,18,2011-12-27,Arsenal,Wolves,1,1,D,1,1,1,3,1,0,3,2,5,17,32,15,12,17,December,-2.4492935982947064e-16,1.0,0,48,5,0,0,2.4,0.4,33,25,8,19,32,-13,"December, 2011"
2011-2012,18,2011-12-27,Norwich,Tottenham,0,2,A,0,3,1,1,3,3,1,1,11,3,21,35,8,14,December,-2.4492935982947064e-16,1.0,31,42,0,1,1,0.0,1.0,27,31,-4,32,19,13,"December, 2011"
2011-2012,18,2011-12-27,Swansea,QPR,1,1,D,1,1,2,2,1,2,0,3,15,17,18,16,2,2,December,-2.4492935982947064e-16,1.0,41,34,0,0,0,0.0,0.0,16,21,-5,17,31,-14,"December, 2011"
2011-2012,19,2011-12-30,Liverpool,Newcastle,3,1,H,3,0,2,0,3,2,0,3,6,7,31,30,1,1,December,-2.4492935982947064e-16,1.0,25,30,4,0,1,3.0,0.8,21,14,7,25,22,3,"December, 2011"
2011-2012,19,2011-12-31,Man United,Blackburn,2,3,A,0,3,3,1,1,1,0,4,2,20,45,11,18,34,December,-2.4492935982947064e-16,1.0,28,4,3,2,0,2.4,0.6,47,14,33,25,39,-14,"December, 2011"
2011-2012,19,2011-12-31,Swansea,Tottenham,1,1,D,1,1,2,2,1,3,1,1,14,3,19,38,11,19,December,-2.4492935982947064e-16,1.0,41,42,0,0,0,0.0,0.0,17,22,-5,34,19,15,"December, 2011"
2011-2012,19,2011-12-31,Stoke,Wigan,2,2,D,1,1,0,3,2,4,0,1,8,19,25,14,11,11,December,-2.4492935982947064e-16,1.0,39,46,1,3,1,1.4,1.2,18,28,-10,15,35,-20,"December, 2011"
2011-2012,19,2011-12-31,Norwich,Fulham,1,1,D,1,1,1,1,3,3,0,2,12,13,21,19,1,2,December,-2.4492935982947064e-16,1.0,31,19,0,0,2,0.0,3.5,27,33,-6,19,24,-5,"December, 2011"
2011-2012,19,2011-12-31,Bolton,Wolves,1,1,D,1,1,1,3,1,0,3,2,19,17,12,16,2,4,December,-2.4492935982947064e-16,1.0,6,48,4,0,1,1.6,1.0,22,41,-19,20,33,-13,"December, 2011"
2011-2012,19,2011-12-31,Arsenal,QPR,1,0,H,3,0,1,3,1,2,0,3,6,16,33,17,10,16,December,-2.4492935982947064e-16,1.0,0,34,1,1,0,2.0,0.5,34,26,8,18,32,-14,"December, 2011"
2011-2012,19,2011-12-31,Chelsea,Aston Villa,1,3,A,0,3,2,1,2,0,3,2,5,12,34,20,7,14,December,-2.4492935982947064e-16,1.0,14,1,2,2,1,2.4,1.2,36,21,15,19,23,-4,"December, 2011"
2011-2012,19,2012-01-01,Sunderland,Man City,1,0,H,3,0,0,3,2,5,0,0,15,1,18,45,14,27,January,0.4999999999999999,0.8660254037844387,40,27,1,1,3,1.0,2.2,22,22,0,53,15,38,"January, 2012"
2011-2012,19,2012-01-01,West Brom,Everton,0,1,A,0,3,2,2,1,2,3,0,11,13,22,21,2,1,January,0.4999999999999999,0.8660254037844387,44,18,2,1,2,1.6,1.4,19,26,-7,18,20,-2,"January, 2012"
2011-2012,19,2012-01-02,QPR,Norwich,1,2,A,0,3,2,0,3,1,1,3,17,13,17,22,4,5,January,0.4999999999999999,0.8660254037844387,34,31,0,0,1,1.0,2.0,18,33,-15,28,34,-6,"January, 2012"
2011-2012,19,2012-01-02,Fulham,Arsenal,2,1,H,3,0,3,0,2,1,3,1,15,4,20,36,11,16,January,0.4999999999999999,0.8660254037844387,19,0,0,2,3,0.8,2.0,20,25,-5,35,26,9,"January, 2012"
2011-2012,19,2012-01-02,Wolves,Chelsea,1,2,A,0,3,0,3,2,2,1,2,16,5,17,34,11,17,January,0.4999999999999999,0.8660254037844387,48,14,1,0,4,0.2,2.2,21,34,-13,37,24,13,"January, 2012"
2011-2012,19,2012-01-02,Aston Villa,Swansea,0,2,A,0,3,0,3,2,2,2,1,10,15,23,20,5,3,January,0.4999999999999999,0.8660254037844387,1,41,0,1,0,0.0,0.0,22,24,-2,18,23,-5,"January, 2012"
2011-2012,19,2012-01-02,Blackburn,Stoke,1,2,A,0,3,1,0,4,0,3,2,19,8,14,26,11,12,January,0.4999999999999999,0.8660254037844387,4,39,0,1,4,0.2,1.8,28,41,-13,20,30,-10,"January, 2012"
2011-2012,19,2012-01-03,Wigan,Sunderland,1,4,A,0,3,4,0,1,0,3,2,18,15,15,21,3,6,January,0.4999999999999999,0.8660254037844387,46,40,2,2,1,1.4,1.4,17,37,-20,23,22,1,"January, 2012"
2011-2012,19,2012-01-03,Man City,Liverpool,3,0,H,3,0,5,0,0,2,0,3,1,6,45,34,5,11,January,0.4999999999999999,0.8660254037844387,27,25,1,3,1,1.2,1.2,53,16,37,24,15,9,"January, 2012"
2011-2012,19,2012-01-03,Tottenham,West Brom,1,0,H,3,0,3,1,1,2,2,1,3,14,39,22,11,17,January,0.4999999999999999,0.8660254037844387,42,44,2,2,1,1.4,1.2,35,20,15,19,27,-8,"January, 2012"
2011-2012,19,2012-01-04,Everton,Bolton,1,2,A,0,3,2,3,0,1,3,1,11,20,24,13,9,11,January,0.4999999999999999,0.8660254037844387,18,6,2,1,2,1.4,1.2,19,20,-1,23,42,-19,"January, 2012"
2011-2012,19,2012-01-04,Newcastle,Man United,3,0,H,3,0,2,0,3,3,1,1,7,2,30,45,5,15,January,0.4999999999999999,0.8660254037844387,30,28,0,3,2,0.6,1.4,26,25,1,49,17,32,"January, 2012"
2011-2012,19,2012-01-11,Tottenham,Everton,2,0,H,3,0,3,1,1,2,3,0,3,11,42,24,8,18,January,0.4999999999999999,0.8660254037844387,42,18,1,3,1,1.2,1.2,36,20,16,20,22,-2,"January, 2012"
2011-2012,20,2012-01-14,Man United,Bolton,3,0,H,3,0,3,1,1,1,3,1,2,19,45,16,17,29,January,0.4999999999999999,0.8660254037844387,28,6,4,1,0,2.8,0.6,49,20,29,25,43,-18,"January, 2012"
2011-2012,20,2012-01-14,Aston Villa,Everton,1,1,D,1,1,0,3,2,2,3,0,13,11,23,24,2,1,January,0.4999999999999999,0.8660254037844387,1,18,1,4,0,1.6,1.4,22,26,-4,20,24,-4,"January, 2012"
2011-2012,20,2012-01-14,Blackburn,Fulham,3,1,H,3,0,1,0,4,3,0,2,20,14,14,23,6,9,January,0.4999999999999999,0.8660254037844387,4,19,1,2,2,1.2,1.6,29,43,-14,22,26,-4,"January, 2012"
2011-2012,20,2012-01-14,Chelsea,Sunderland,1,0,H,3,0,2,1,2,0,3,2,4,11,37,24,7,13,January,0.4999999999999999,0.8660254037844387,14,40,4,0,1,3.2,1.8,39,25,14,27,23,4,"January, 2012"
2011-2012,20,2012-01-14,Liverpool,Stoke,0,0,D,1,1,2,0,3,0,3,2,6,8,34,29,2,5,January,0.4999999999999999,0.8660254037844387,25,39,2,1,2,1.4,0.8,24,18,6,22,31,-9,"January, 2012"
2011-2012,20,2012-01-14,Tottenham,Wolves,1,1,D,1,1,3,1,1,0,3,2,3,17,45,17,14,28,January,0.4999999999999999,0.8660254037844387,42,48,2,1,2,1.6,1.2,38,20,18,22,36,-14,"January, 2012"
2011-2012,20,2012-01-14,West Brom,Norwich,1,2,A,0,3,2,2,1,1,1,3,15,10,22,25,5,3,January,0.4999999999999999,0.8660254037844387,44,31,1,1,1,1.0,1.0,19,28,-9,30,35,-5,"January, 2012"
2011-2012,20,2012-01-15,Newcastle,QPR,1,0,H,3,0,2,0,3,2,0,3,7,18,33,17,11,16,January,0.4999999999999999,0.8660254037844387,30,34,2,1,0,1.6666666666666667,1.0,29,25,4,19,35,-16,"January, 2012"
2011-2012,20,2012-01-15,Swansea,Arsenal,3,2,H,3,0,2,2,1,1,3,1,13,5,23,36,8,13,January,0.4999999999999999,0.8660254037844387,41,0,0,0,1,0.0,1.0,20,23,-3,36,28,8,"January, 2012"
2011-2012,20,2012-01-16,Wigan,Man City,0,1,A,0,3,4,0,1,5,0,0,20,1,15,48,19,33,January,0.4999999999999999,0.8660254037844387,46,27,0,1,4,0.2,2.0,18,41,-23,56,16,40,"January, 2012"
2011-2012,21,2012-01-21,Sunderland,Swansea,2,0,H,3,0,0,3,2,2,2,1,14,10,24,26,4,2,January,0.4999999999999999,0.8660254037844387,40,41,0,1,0,0.0,0.0,27,24,3,23,25,-2,"January, 2012"
2011-2012,21,2012-01-21,Stoke,West Brom,1,2,A,0,3,0,3,2,2,2,1,8,15,30,22,7,8,January,0.4999999999999999,0.8660254037844387,39,44,4,1,0,1.6,0.2,22,31,-9,20,30,-10,"January, 2012"
2011-2012,21,2012-01-21,Wolves,Aston Villa,2,3,A,0,3,0,3,2,0,3,2,19,15,18,24,4,6,January,0.4999999999999999,0.8660254037844387,48,1,1,3,1,1.0,1.0,23,37,-14,23,27,-4,"January, 2012"
2011-2012,21,2012-01-21,QPR,Wigan,3,1,H,3,0,2,0,3,4,0,1,19,20,17,15,1,2,January,0.4999999999999999,0.8660254037844387,34,46,0,0,1,0.0,2.0,19,36,-17,18,42,-24,"January, 2012"
2011-2012,21,2012-01-21,Norwich,Chelsea,0,0,D,1,1,1,1,3,2,1,2,9,4,28,40,5,12,January,0.4999999999999999,0.8660254037844387,31,14,0,0,3,0.6666666666666666,3.333333333333333,32,36,-4,40,25,15,"January, 2012"
2011-2012,21,2012-01-21,Fulham,Newcastle,5,2,H,3,0,3,0,2,2,0,3,14,6,23,36,8,13,January,0.4999999999999999,0.8660254037844387,19,30,3,1,1,1.0,0.6,23,29,-6,30,25,5,"January, 2012"
2011-2012,21,2012-01-21,Everton,Blackburn,1,1,D,1,1,2,3,0,1,0,4,11,18,25,17,7,8,January,0.4999999999999999,0.8660254037844387,18,4,4,0,1,1.8,0.6,21,25,-4,32,44,-12,"January, 2012"
2011-2012,21,2012-01-21,Bolton,Liverpool,3,1,H,3,0,1,3,1,2,0,3,19,7,16,35,12,19,January,0.4999999999999999,0.8660254037844387,6,25,0,0,5,0.8,2.2,25,46,-21,24,18,6,"January, 2012"
2011-2012,21,2012-01-22,Arsenal,Man United,1,2,A,0,3,1,3,1,3,1,1,5,2,36,48,3,12,January,0.4999999999999999,0.8660254037844387,0,28,1,0,4,1.0,2.8,38,31,7,52,20,32,"January, 2012"
2011-2012,21,2012-01-22,Man City,Tottenham,3,2,H,3,0,5,0,0,3,1,1,1,3,51,46,2,5,January,0.4999999999999999,0.8660254037844387,27,42,2,1,2,1.2,1.0,57,16,41,39,21,18,"January, 2012"
2011-2012,22,2012-01-31,Wolves,Liverpool,0,3,A,0,3,0,3,2,2,0,3,19,7,18,35,12,17,January,0.4999999999999999,0.8660254037844387,48,25,1,1,3,0.4,1.4,25,40,-15,25,21,4,"January, 2012"
2011-2012,22,2012-01-31,Swansea,Chelsea,1,1,D,1,1,2,2,1,2,1,2,14,4,26,41,10,15,January,0.4999999999999999,0.8660254037844387,41,14,0,0,1,1.0,4.0,23,27,-4,40,25,15,"January, 2012"
2011-2012,22,2012-01-31,Tottenham,Wigan,3,1,H,3,0,3,1,1,4,0,1,3,20,46,15,17,31,January,0.4999999999999999,0.8660254037844387,42,46,3,1,1,2.8,0.6,41,24,17,19,45,-26,"January, 2012"
2011-2012,22,2012-01-31,Everton,Man City,1,0,H,3,0,2,3,0,5,0,0,14,1,26,54,13,28,January,0.4999999999999999,0.8660254037844387,18,27,4,0,1,1.6,0.8,22,26,-4,60,18,42,"January, 2012"
2011-2012,22,2012-01-31,Man United,Stoke,2,0,H,3,0,3,1,1,0,3,2,2,8,51,30,6,21,January,0.4999999999999999,0.8660254037844387,28,39,4,1,0,2.2,0.6,54,21,33,23,33,-10,"January, 2012"
2011-2012,22,2012-02-01,Aston Villa,QPR,2,2,D,1,1,0,3,2,2,0,3,12,16,27,20,4,7,February,0.8660254037844386,0.5000000000000001,1,34,1,1,1,1.6666666666666667,1.3333333333333333,26,29,-3,22,37,-15,"February, 2012"
2011-2012,22,2012-02-01,Blackburn,Newcastle,0,2,A,0,3,1,0,4,2,0,3,18,7,18,36,11,18,February,0.8660254037844386,0.5000000000000001,4,30,3,1,1,1.6,1.0,33,45,-12,32,30,2,"February, 2012"
2011-2012,22,2012-02-01,Bolton,Arsenal,0,0,D,1,1,1,3,1,1,3,1,17,7,19,36,10,17,February,0.8660254037844386,0.5000000000000001,6,0,1,0,4,1.0,2.8,28,47,-19,39,33,6,"February, 2012"
2011-2012,22,2012-02-01,Fulham,West Brom,1,1,D,1,1,3,0,2,2,2,1,14,15,26,25,1,1,February,0.8660254037844386,0.5000000000000001,19,44,2,1,2,1.2,0.6,28,31,-3,22,31,-9,"February, 2012"
2011-2012,22,2012-02-01,Sunderland,Norwich,3,0,H,3,0,0,3,2,1,1,3,12,10,27,29,2,2,February,0.8660254037844386,0.5000000000000001,40,31,0,0,1,1.0,2.0,29,24,5,32,36,-4,"February, 2012"
2011-2012,23,2012-02-04,Stoke,Sunderland,0,1,A,0,3,0,3,2,0,3,2,10,9,30,30,1,0,February,0.8660254037844386,0.5000000000000001,39,40,2,1,2,0.8,1.6,23,35,-12,32,24,8,"February, 2012"
2011-2012,23,2012-02-04,QPR,Wolves,1,2,A,0,3,2,0,3,0,3,2,16,18,21,18,2,3,February,0.8660254037844386,0.5000000000000001,34,48,1,0,0,3.0,0.0,24,39,-15,25,43,-18,"February, 2012"
2011-2012,23,2012-02-04,West Brom,Swansea,1,2,A,0,3,2,2,1,2,2,1,15,13,26,27,2,1,February,0.8660254037844386,0.5000000000000001,44,41,0,0,1,0.0,3.0,23,32,-9,24,28,-4,"February, 2012"
2011-2012,23,2012-02-04,Man City,Fulham,3,0,H,3,0,5,0,0,3,0,2,1,13,54,27,12,27,February,0.8660254037844386,0.5000000000000001,27,19,2,3,0,2.2,1.4,60,19,41,29,32,-3,"February, 2012"
2011-2012,23,2012-02-04,Arsenal,Blackburn,7,1,H,3,0,1,3,1,1,0,4,7,18,37,18,11,19,February,0.8660254037844386,0.5000000000000001,0,4,2,1,2,2.4,1.8,39,33,6,33,47,-14,"February, 2012"
2011-2012,23,2012-02-04,Norwich,Bolton,2,0,H,3,0,1,1,3,1,3,1,11,17,29,20,6,9,February,0.8660254037844386,0.5000000000000001,31,6,2,0,1,1.6666666666666667,1.3333333333333333,32,39,-7,28,47,-19,"February, 2012"
2011-2012,23,2012-02-04,Wigan,Everton,1,1,D,1,1,4,0,1,2,3,0,20,12,15,29,8,14,February,0.8660254037844386,0.5000000000000001,46,18,0,2,3,0.6,1.4,20,48,-28,23,26,-3,"February, 2012"
2011-2012,23,2012-02-05,Newcastle,Aston Villa,2,1,H,3,0,2,0,3,0,3,2,6,13,39,28,7,11,February,0.8660254037844386,0.5000000000000001,30,1,2,1,2,1.8,0.6,34,30,4,28,31,-3,"February, 2012"
2011-2012,23,2012-02-05,Chelsea,Man United,3,3,D,1,1,2,1,2,3,1,1,4,2,42,54,2,12,February,0.8660254037844386,0.5000000000000001,14,28,3,0,2,1.4,1.4,41,26,15,56,21,35,"February, 2012"
2011-2012,23,2012-02-06,Liverpool,Tottenham,0,0,D,1,1,2,0,3,3,1,1,7,3,38,49,4,11,February,0.8660254037844386,0.5000000000000001,25,42,1,0,4,0.8,2.0,28,21,7,44,25,19,"February, 2012"
2011-2012,24,2012-02-11,Swansea,Norwich,2,3,A,0,3,2,2,1,1,1,3,11,10,30,32,1,2,February,0.8660254037844386,0.5000000000000001,41,31,0,0,1,1.0,3.0,26,29,-3,34,39,-5,"February, 2012"
2011-2012,24,2012-02-11,Sunderland,Arsenal,1,2,A,0,3,0,3,2,1,3,1,8,6,33,40,2,7,February,0.8660254037844386,0.5000000000000001,40,0,1,2,2,0.6,1.0,33,24,9,46,34,12,"February, 2012"
2011-2012,24,2012-02-11,Man United,Liverpool,2,1,H,3,0,3,1,1,2,0,3,2,7,55,39,5,16,February,0.8660254037844386,0.5000000000000001,28,25,2,1,2,1.4,1.8,59,24,35,28,21,7,"February, 2012"
2011-2012,24,2012-02-11,Tottenham,Newcastle,5,0,H,3,0,3,1,1,2,0,3,3,6,50,42,3,8,February,0.8660254037844386,0.5000000000000001,42,30,2,2,1,1.4,1.0,44,25,19,36,31,5,"February, 2012"
2011-2012,24,2012-02-11,Everton,Chelsea,2,0,H,3,0,2,3,0,2,1,2,11,4,30,43,7,13,February,0.8660254037844386,0.5000000000000001,18,14,2,2,1,1.6,1.6,24,27,-3,44,29,15,"February, 2012"
2011-2012,24,2012-02-11,Bolton,Wigan,1,2,A,0,3,1,3,1,4,0,1,19,20,20,16,1,4,February,0.8660254037844386,0.5000000000000001,6,46,2,3,0,1.8,0.6,28,49,-21,21,49,-28,"February, 2012"
2011-2012,24,2012-02-11,Blackburn,QPR,3,2,H,3,0,1,0,4,2,0,3,19,16,18,21,3,3,February,0.8660254037844386,0.5000000000000001,4,34,2,1,0,1.0,0.3333333333333333,34,54,-20,25,41,-16,"February, 2012"
2011-2012,24,2012-02-11,Fulham,Stoke,2,1,H,3,0,3,0,2,0,3,2,14,12,27,30,2,3,February,0.8660254037844386,0.5000000000000001,19,39,2,0,3,1.2,1.2,29,35,-6,23,36,-13,"February, 2012"
2011-2012,24,2012-02-12,Aston Villa,Man City,0,1,A,0,3,0,3,2,5,0,0,14,2,28,57,12,29,February,0.8660254037844386,0.5000000000000001,1,27,1,1,3,0.8,2.4,29,33,-4,63,19,44,"February, 2012"
2011-2012,24,2012-02-12,Wolves,West Brom,1,5,A,0,3,0,3,2,2,2,1,17,15,21,26,2,5,February,0.8660254037844386,0.5000000000000001,48,44,1,1,1,1.3333333333333333,1.3333333333333333,27,44,-17,24,34,-10,"February, 2012"
2011-2012,25,2012-02-25,Wigan,Aston Villa,0,0,D,1,1,4,0,1,0,3,2,20,15,19,28,5,9,February,0.8660254037844386,0.5000000000000001,46,1,1,1,3,1.0,1.4,23,50,-27,29,34,-5,"February, 2012"
2011-2012,25,2012-02-25,Chelsea,Bolton,3,0,H,3,0,2,1,2,1,3,1,5,19,43,20,14,23,February,0.8660254037844386,0.5000000000000001,14,6,5,0,0,3.0,0.2,44,31,13,29,51,-22,"February, 2012"
2011-2012,25,2012-02-25,Man City,Blackburn,3,0,H,3,0,5,0,0,1,0,4,1,17,60,21,16,39,February,0.8660254037844386,0.5000000000000001,27,4,4,1,0,2.4,0.4,64,19,45,37,56,-19,"February, 2012"
2011-2012,25,2012-02-25,Newcastle,Wolves,2,2,D,1,1,2,0,3,0,3,2,6,17,42,21,11,21,February,0.8660254037844386,0.5000000000000001,30,48,2,3,0,1.8,1.0,36,36,0,28,49,-21,"February, 2012"
2011-2012,25,2012-02-25,QPR,Fulham,0,1,A,0,3,2,0,3,3,0,2,17,12,21,30,5,9,February,0.8660254037844386,0.5000000000000001,34,19,0,0,1,0.0,6.0,27,44,-17,31,36,-5,"February, 2012"
2011-2012,25,2012-02-25,West Brom,Sunderland,4,0,H,3,0,2,2,1,0,3,2,14,9,29,33,5,4,February,0.8660254037844386,0.5000000000000001,44,40,3,1,1,1.8,1.6,29,35,-6,34,26,8,"February, 2012"
2011-2012,25,2012-02-26,Norwich,Man United,1,2,A,0,3,1,1,3,3,1,1,8,2,35,58,6,23,February,0.8660254037844386,0.5000000000000001,31,28,1,0,2,1.0,1.3333333333333333,37,41,-4,61,25,36,"February, 2012"
2011-2012,25,2012-02-26,Stoke,Swansea,2,0,H,3,0,0,3,2,2,2,1,14,13,30,30,1,0,February,0.8660254037844386,0.5000000000000001,39,41,0,0,1,0.0,2.0,24,38,-14,28,32,-4,"February, 2012"
2011-2012,25,2012-02-26,Arsenal,Tottenham,5,2,H,3,0,1,3,1,3,1,1,5,3,43,53,2,10,February,0.8660254037844386,0.5000000000000001,0,42,1,1,3,2.0,2.0,48,35,13,49,25,24,"February, 2012"
2011-2012,26,2012-03-03,Blackburn,Aston Villa,1,1,D,1,1,1,0,4,0,3,2,18,15,21,29,3,8,March,1.0,6.123233995736766e-17,4,1,3,0,2,1.4,1.6,37,59,-22,29,34,-5,"March, 2012"
2011-2012,26,2012-03-03,Liverpool,Arsenal,1,2,A,0,3,2,0,3,1,3,1,7,4,39,46,3,7,March,1.0,6.123233995736766e-17,25,0,1,2,2,1.0,1.0,29,23,6,53,37,16,"March, 2012"
2011-2012,26,2012-03-03,Man City,Bolton,2,0,H,3,0,5,0,0,1,3,1,1,19,63,20,18,43,March,1.0,6.123233995736766e-17,27,6,4,1,0,2.2,1.0,67,19,48,29,54,-25,"March, 2012"
2011-2012,26,2012-03-03,QPR,Everton,1,1,D,1,1,2,0,3,2,3,0,18,10,21,33,8,12,March,1.0,6.123233995736766e-17,34,18,2,0,1,1.3333333333333333,1.0,27,45,-18,26,27,-1,"March, 2012"
2011-2012,26,2012-03-03,Stoke,Norwich,1,0,H,3,0,0,3,2,1,1,3,12,8,33,35,4,2,March,1.0,6.123233995736766e-17,39,31,0,1,0,1.0,1.0,26,38,-12,38,43,-5,"March, 2012"
2011-2012,26,2012-03-03,West Brom,Chelsea,1,0,H,3,0,2,2,1,2,1,2,13,5,32,46,8,14,March,1.0,6.123233995736766e-17,44,14,0,0,5,0.4,3.2,33,35,-2,47,31,16,"March, 2012"
2011-2012,26,2012-03-03,Wigan,Swansea,0,2,A,0,3,4,0,1,2,2,1,20,15,20,30,5,10,March,1.0,6.123233995736766e-17,46,41,0,1,0,0.0,0.0,23,50,-27,28,34,-6,"March, 2012"
2011-2012,26,2012-03-04,Tottenham,Man United,1,3,A,0,3,3,1,1,3,1,1,3,2,53,61,1,8,March,1.0,6.123233995736766e-17,42,28,0,1,4,0.4,2.2,51,30,21,63,26,37,"March, 2012"
2011-2012,26,2012-03-04,Newcastle,Sunderland,1,1,D,1,1,2,0,3,0,3,2,6,13,43,33,7,10,March,1.0,6.123233995736766e-17,30,40,2,2,1,1.8,1.0,38,38,0,34,30,4,"March, 2012"
2011-2012,26,2012-03-04,Fulham,Wolves,5,0,H,3,0,3,0,2,0,3,2,13,17,33,22,4,11,March,1.0,6.123233995736766e-17,19,48,1,2,2,0.8,1.2,32,36,-4,30,51,-21,"March, 2012"
2011-2012,27,2012-03-10,Aston Villa,Fulham,1,0,H,3,0,0,3,2,3,0,2,15,8,30,36,7,6,March,1.0,6.123233995736766e-17,1,19,2,3,0,1.4,0.6,30,35,-5,37,36,1,"March, 2012"
2011-2012,27,2012-03-10,Bolton,QPR,2,1,H,3,0,1,3,1,2,0,3,19,16,20,22,3,2,March,1.0,6.123233995736766e-17,6,34,1,0,2,1.6666666666666667,1.0,29,56,-27,28,46,-18,"March, 2012"
2011-2012,27,2012-03-10,Chelsea,Stoke,1,0,H,3,0,2,1,2,0,3,2,5,9,46,36,4,10,March,1.0,6.123233995736766e-17,14,39,3,2,0,2.4,0.4,47,32,15,27,38,-11,"March, 2012"
2011-2012,27,2012-03-10,Everton,Tottenham,1,0,H,3,0,2,3,0,3,1,1,13,3,34,53,10,19,March,1.0,6.123233995736766e-17,18,42,1,2,2,1.2,1.6,27,28,-1,52,33,19,"March, 2012"
2011-2012,27,2012-03-10,Sunderland,Liverpool,1,0,H,3,0,0,3,2,2,0,3,13,7,34,39,6,5,March,1.0,6.123233995736766e-17,40,25,1,2,2,0.8,1.6,35,31,4,30,25,5,"March, 2012"
2011-2012,27,2012-03-10,Wolves,Blackburn,0,2,A,0,3,0,3,2,1,0,4,19,18,22,22,1,0,March,1.0,6.123233995736766e-17,48,4,1,1,3,1.2,2.2,30,56,-26,38,60,-22,"March, 2012"
2011-2012,27,2012-03-11,Man United,West Brom,2,0,H,3,0,3,1,1,2,2,1,2,12,64,35,10,29,March,1.0,6.123233995736766e-17,28,44,4,1,0,3.0,0.8,66,27,39,34,35,-1,"March, 2012"
2011-2012,27,2012-03-11,Norwich,Wigan,1,1,D,1,1,1,1,3,4,0,1,13,20,35,20,7,15,March,1.0,6.123233995736766e-17,31,46,0,1,0,1.0,1.0,38,44,-6,23,52,-29,"March, 2012"
2011-2012,27,2012-03-11,Swansea,Man City,1,0,H,3,0,2,2,1,5,0,0,15,2,33,66,13,33,March,1.0,6.123233995736766e-17,41,27,0,0,1,0.0,4.0,30,34,-4,69,19,50,"March, 2012"
2011-2012,27,2012-03-12,Arsenal,Newcastle,2,1,H,3,0,1,3,1,2,0,3,4,6,49,44,2,5,March,1.0,6.123233995736766e-17,0,30,2,2,1,2.0,1.2,55,38,17,39,39,0,"March, 2012"
2011-2012,27,2012-03-13,Liverpool,Everton,3,0,H,3,0,2,0,3,2,3,0,7,9,39,37,2,2,March,1.0,6.123233995736766e-17,25,18,3,1,1,1.4,0.8,30,26,4,28,28,0,"March, 2012"
2011-2012,28,2012-03-17,Wigan,West Brom,1,1,D,1,1,4,0,1,2,2,1,20,14,21,35,6,14,March,1.0,6.123233995736766e-17,46,44,3,1,1,1.6,1.4,24,53,-29,34,37,-3,"March, 2012"
2011-2012,28,2012-03-17,Fulham,Swansea,0,3,A,0,3,3,0,2,2,2,1,10,11,36,36,1,0,March,1.0,6.123233995736766e-17,19,41,0,0,1,0.0,2.0,37,37,0,31,34,-3,"March, 2012"
2011-2012,28,2012-03-18,Newcastle,Norwich,1,0,H,3,0,2,0,3,1,1,3,6,13,44,36,7,8,March,1.0,6.123233995736766e-17,30,31,0,1,2,1.6666666666666667,2.6666666666666665,40,41,-1,39,45,-6,"March, 2012"
2011-2012,28,2012-03-18,Wolves,Man United,0,5,A,0,3,0,3,2,3,1,1,19,1,22,67,18,45,March,1.0,6.123233995736766e-17,48,28,1,0,4,0.8,2.2,30,58,-28,68,27,41,"March, 2012"
2011-2012,29,2012-03-20,Blackburn,Sunderland,2,0,H,3,0,1,0,4,0,3,2,16,9,25,37,7,12,March,1.0,6.123233995736766e-17,4,40,0,2,3,0.8,1.8,40,60,-20,36,31,5,"March, 2012"
2011-2012,29,2012-03-21,Everton,Arsenal,0,1,A,0,3,2,3,0,1,3,1,10,4,37,52,6,15,March,1.0,6.123233995736766e-17,18,0,0,1,4,1.0,2.6,28,31,-3,57,39,18,"March, 2012"
2011-2012,29,2012-03-21,Man City,Chelsea,2,1,H,3,0,5,0,0,2,1,2,2,5,66,49,3,17,March,1.0,6.123233995736766e-17,27,14,3,0,2,1.6,1.4,69,20,49,48,32,16,"March, 2012"
2011-2012,29,2012-03-21,QPR,Liverpool,3,2,H,3,0,2,0,3,2,0,3,18,7,22,42,11,20,March,1.0,6.123233995736766e-17,34,25,0,0,3,0.3333333333333333,1.3333333333333333,29,48,-19,33,26,7,"March, 2012"
2011-2012,29,2012-03-21,Tottenham,Stoke,1,1,D,1,1,3,1,1,0,3,2,4,14,53,36,10,17,March,1.0,6.123233995736766e-17,42,39,3,0,2,1.6,1.4,52,34,18,27,39,-12,"March, 2012"
2011-2012,30,2012-03-24,Chelsea,Tottenham,0,0,D,1,1,2,1,2,3,1,1,5,4,49,54,1,5,March,1.0,6.123233995736766e-17,14,42,2,2,1,1.6,1.0,49,34,15,53,35,18,"March, 2012"
2011-2012,30,2012-03-24,Swansea,Everton,0,2,A,0,3,2,2,1,2,3,0,9,12,39,37,3,2,March,1.0,6.123233995736766e-17,41,18,0,0,1,0.0,1.0,34,34,0,28,32,-4,"March, 2012"
2011-2012,30,2012-03-24,Sunderland,QPR,3,1,H,3,0,0,3,2,2,0,3,11,18,37,25,7,12,March,1.0,6.123233995736766e-17,40,34,1,0,0,3.0,2.0,36,33,3,32,50,-18,"March, 2012"
2011-2012,30,2012-03-24,Stoke,Man City,1,1,D,1,1,0,3,2,5,0,0,12,2,37,69,10,32,March,1.0,6.123233995736766e-17,39,27,0,2,3,0.4,2.0,28,40,-12,71,21,50,"March, 2012"
2011-2012,30,2012-03-24,Arsenal,Aston Villa,3,0,H,3,0,1,3,1,0,3,2,3,15,55,33,12,22,March,1.0,6.123233995736766e-17,0,1,3,1,1,2.0,1.0,58,39,19,31,35,-4,"March, 2012"
2011-2012,30,2012-03-24,Liverpool,Wigan,1,2,A,0,3,2,0,3,4,0,1,7,19,42,22,12,20,March,1.0,6.123233995736766e-17,25,46,1,3,1,0.8,0.8,35,29,6,25,54,-29,"March, 2012"
2011-2012,30,2012-03-24,Bolton,Blackburn,2,1,H,3,0,1,3,1,1,0,4,18,16,23,28,2,5,March,1.0,6.123233995736766e-17,6,4,2,0,3,0.8,1.6,31,57,-26,42,60,-18,"March, 2012"
2011-2012,30,2012-03-24,Norwich,Wolves,2,1,H,3,0,1,1,3,0,3,2,14,20,36,22,6,14,March,1.0,6.123233995736766e-17,31,48,0,1,0,2.0,2.0,39,46,-7,30,63,-33,"March, 2012"
2011-2012,30,2012-03-25,West Brom,Newcastle,1,3,A,0,3,2,2,1,2,0,3,14,6,36,47,8,11,March,1.0,6.123233995736766e-17,44,30,2,1,2,2.4,2.2,35,38,-3,41,41,0,"March, 2012"
2011-2012,30,2012-03-26,Man United,Fulham,1,0,H,3,0,3,1,1,3,0,2,2,13,70,36,11,34,March,1.0,6.123233995736766e-17,28,19,3,1,1,2.4,1.0,73,27,46,37,40,-3,"March, 2012"
2011-2012,31,2012-03-31,Everton,West Brom,2,0,H,3,0,2,3,0,2,2,1,9,14,40,36,5,4,March,1.0,6.123233995736766e-17,18,44,3,0,2,1.2,1.2,30,32,-2,36,41,-5,"March, 2012"
2011-2012,31,2012-03-31,Wigan,Stoke,2,0,H,3,0,4,0,1,0,3,2,19,13,25,38,6,13,March,1.0,6.123233995736766e-17,46,39,1,4,0,1.6,1.4,27,55,-28,29,41,-12,"March, 2012"
2011-2012,31,2012-03-31,Wolves,Bolton,2,3,A,0,3,0,3,2,1,3,1,20,19,22,26,1,4,March,1.0,6.123233995736766e-17,48,6,1,1,3,1.0,1.4,31,65,-34,33,58,-25,"March, 2012"
2011-2012,31,2012-03-31,QPR,Arsenal,2,1,H,3,0,2,0,3,1,3,1,18,3,25,58,15,33,March,1.0,6.123233995736766e-17,34,0,0,1,2,0.3333333333333333,1.6666666666666667,33,53,-20,61,39,22,"March, 2012"
2011-2012,31,2012-03-31,Aston Villa,Chelsea,2,4,A,0,3,0,3,2,2,1,2,15,5,33,50,10,17,March,1.0,6.123233995736766e-17,1,14,2,2,1,1.8,2.4,31,38,-7,49,34,15,"March, 2012"
2011-2012,31,2012-03-31,Fulham,Norwich,2,1,H,3,0,3,0,2,1,1,3,13,11,36,39,2,3,March,1.0,6.123233995736766e-17,19,31,2,1,0,2.6666666666666665,0.3333333333333333,37,41,-4,41,47,-6,"March, 2012"
2011-2012,31,2012-03-31,Man City,Sunderland,3,3,D,1,1,5,0,0,0,3,2,2,9,70,40,7,30,March,1.0,6.123233995736766e-17,27,40,2,1,2,2.0,1.2,72,22,50,39,34,5,"March, 2012"
2011-2012,31,2012-04-01,Newcastle,Liverpool,2,0,H,3,0,2,0,3,2,0,3,6,8,50,42,2,8,April,0.8660254037844388,-0.4999999999999998,30,25,1,0,4,1.0,3.0,44,42,2,36,31,5,"April, 2012"
2011-2012,31,2012-04-01,Tottenham,Swansea,3,1,H,3,0,3,1,1,2,2,1,4,10,55,39,6,16,April,0.8660254037844388,-0.4999999999999998,42,41,0,1,0,1.0,1.0,53,35,18,34,36,-2,"April, 2012"
2011-2012,31,2012-04-02,Blackburn,Man United,0,2,A,0,3,1,0,4,3,1,1,17,1,28,73,16,45,April,0.8660254037844388,-0.4999999999999998,4,28,1,2,2,1.0,2.4,43,62,-19,74,27,47,"April, 2012"
2011-2012,32,2012-04-06,Swansea,Newcastle,0,2,A,0,3,2,2,1,2,0,3,11,6,39,53,5,14,April,0.8660254037844388,-0.4999999999999998,41,30,0,1,0,0.0,0.0,35,39,-4,46,42,4,"April, 2012"
2011-2012,32,2012-04-07,Bolton,Fulham,0,3,A,0,3,1,3,1,3,0,2,16,10,29,39,6,10,April,0.8660254037844388,-0.4999999999999998,6,19,0,3,2,0.2,1.2,36,60,-24,39,42,-3,"April, 2012"
2011-2012,32,2012-04-07,Chelsea,Wigan,2,1,H,3,0,2,1,2,4,0,1,6,19,53,28,13,25,April,0.8660254037844388,-0.4999999999999998,14,46,3,1,1,3.4,0.8,53,36,17,29,55,-26,"April, 2012"
2011-2012,32,2012-04-07,Liverpool,Aston Villa,1,1,D,1,1,2,0,3,0,3,2,8,15,42,33,7,9,April,0.8660254037844388,-0.4999999999999998,25,1,3,0,2,1.4,0.8,36,33,3,33,42,-9,"April, 2012"
2011-2012,32,2012-04-07,Norwich,Everton,2,2,D,1,1,1,1,3,2,3,0,12,8,39,43,4,4,April,0.8660254037844388,-0.4999999999999998,31,18,0,1,2,1.0,1.6666666666666667,42,49,-7,32,32,0,"April, 2012"
2011-2012,32,2012-04-07,Stoke,Wolves,2,1,H,3,0,0,3,2,0,3,2,13,20,38,22,7,16,April,0.8660254037844388,-0.4999999999999998,39,48,2,2,1,1.6,1.0,29,43,-14,33,68,-35,"April, 2012"
2011-2012,32,2012-04-07,Sunderland,Tottenham,0,0,D,1,1,0,3,2,3,1,1,10,4,41,58,6,17,April,0.8660254037844388,-0.4999999999999998,40,42,1,1,3,1.0,1.4,42,37,5,56,36,20,"April, 2012"
2011-2012,32,2012-04-07,West Brom,Blackburn,3,0,H,3,0,2,2,1,1,0,4,14,18,36,28,4,8,April,0.8660254037844388,-0.4999999999999998,44,4,1,2,2,1.0,1.6,36,43,-7,43,64,-21,"April, 2012"
2011-2012,32,2012-04-08,Arsenal,Man City,1,0,H,3,0,1,3,1,5,0,0,4,2,58,71,2,13,April,0.8660254037844388,-0.4999999999999998,0,27,1,2,2,1.0,1.0,62,41,21,75,25,50,"April, 2012"
2011-2012,32,2012-04-08,Man United,QPR,2,0,H,3,0,3,1,1,2,0,3,1,17,76,28,16,48,April,0.8660254037844388,-0.4999999999999998,28,34,2,1,0,1.6666666666666667,0.6666666666666666,76,27,49,35,54,-19,"April, 2012"
2011-2012,32,2012-04-09,Newcastle,Bolton,2,0,H,3,0,2,0,3,1,3,1,6,16,56,29,10,27,April,0.8660254037844388,-0.4999999999999998,30,6,2,1,2,1.0,1.4,48,42,6,36,63,-27,"April, 2012"
2011-2012,32,2012-04-09,Fulham,Chelsea,1,1,D,1,1,3,0,2,2,1,2,10,5,42,56,5,14,April,0.8660254037844388,-0.4999999999999998,19,14,0,2,3,0.4,1.2,42,42,0,55,37,18,"April, 2012"
2011-2012,32,2012-04-09,Tottenham,Norwich,1,2,A,0,3,3,1,1,1,1,3,4,12,59,40,8,19,April,0.8660254037844388,-0.4999999999999998,42,31,2,1,0,1.3333333333333333,0.0,56,36,20,44,51,-7,"April, 2012"
2011-2012,32,2012-04-09,Aston Villa,Stoke,1,1,D,1,1,0,3,2,0,3,2,15,11,34,41,4,7,April,0.8660254037844388,-0.4999999999999998,1,39,1,3,1,0.6,0.6,34,43,-9,31,44,-13,"April, 2012"
2011-2012,32,2012-04-09,Everton,Sunderland,4,0,H,3,0,2,3,0,0,3,2,7,9,44,42,2,2,April,0.8660254037844388,-0.4999999999999998,18,40,2,3,0,1.6,0.8,34,34,0,42,37,5,"April, 2012"
2011-2012,32,2012-04-10,Blackburn,Liverpool,2,3,A,0,3,1,0,4,2,0,3,18,8,28,43,10,15,April,0.8660254037844388,-0.4999999999999998,4,25,1,2,2,1.2,1.2,43,67,-24,37,34,3,"April, 2012"
2011-2012,32,2012-04-11,Wolves,Arsenal,0,3,A,0,3,0,3,2,1,3,1,20,3,22,61,17,39,April,0.8660254037844388,-0.4999999999999998,48,0,0,1,4,0.4,2.0,34,70,-36,63,41,22,"April, 2012"
2011-2012,32,2012-04-11,Wigan,Man United,1,0,H,3,0,4,0,1,3,1,1,19,1,28,79,18,51,April,0.8660254037844388,-0.4999999999999998,46,28,0,0,5,0.0,4.2,30,57,-27,78,27,51,"April, 2012"
2011-2012,32,2012-04-11,QPR,Swansea,3,0,H,3,0,2,0,3,2,2,1,17,13,28,39,4,11,April,0.8660254037844388,-0.4999999999999998,34,41,0,1,0,1.0,1.0,35,56,-21,35,41,-6,"April, 2012"
2011-2012,32,2012-04-11,Man City,West Brom,4,0,H,3,0,5,0,0,2,2,1,2,13,71,39,11,32,April,0.8660254037844388,-0.4999999999999998,27,44,3,1,1,2.0,0.8,75,26,49,39,43,-4,"April, 2012"
2011-2012,33,2012-04-14,Norwich,Man City,1,6,A,0,3,1,1,3,5,0,0,10,2,43,74,8,31,April,0.8660254037844388,-0.4999999999999998,31,27,0,1,2,1.3333333333333333,3.0,46,52,-6,79,26,53,"April, 2012"
2011-2012,33,2012-04-14,Sunderland,Wolves,0,0,D,1,1,0,3,2,0,3,2,11,20,42,22,9,20,April,0.8660254037844388,-0.4999999999999998,40,48,1,0,4,2.0,2.4,42,41,1,34,73,-39,"April, 2012"
2011-2012,33,2012-04-14,Swansea,Blackburn,3,0,H,3,0,2,2,1,1,0,4,14,19,39,28,5,11,April,0.8660254037844388,-0.4999999999999998,41,4,0,0,1,2.0,4.0,35,44,-9,45,70,-25,"April, 2012"
2011-2012,33,2012-04-14,West Brom,QPR,1,0,H,3,0,2,2,1,2,0,3,14,16,39,31,2,8,April,0.8660254037844388,-0.4999999999999998,44,34,0,1,0,1.0,1.0,39,47,-8,38,56,-18,"April, 2012"
2011-2012,33,2012-04-15,Man United,Aston Villa,4,0,H,3,0,3,1,1,0,3,2,1,15,79,35,14,44,April,0.8660254037844388,-0.4999999999999998,28,1,2,2,1,1.4,1.0,78,28,50,35,44,-9,"April, 2012"
2011-2012,33,2012-04-16,Arsenal,Wigan,1,2,A,0,3,1,3,1,4,0,1,3,17,64,31,14,33,April,0.8660254037844388,-0.4999999999999998,0,46,3,1,1,3.0,1.0,66,41,25,31,57,-26,"April, 2012"
2011-2012,34,2012-04-21,QPR,Tottenham,1,0,H,3,0,2,0,3,3,1,1,17,5,31,59,12,28,April,0.8660254037844388,-0.4999999999999998,34,42,0,0,3,1.0,2.333333333333333,38,57,-19,57,38,19,"April, 2012"
2011-2012,34,2012-04-21,Newcastle,Stoke,3,0,H,3,0,2,0,3,0,3,2,5,14,59,42,9,17,April,0.8660254037844388,-0.4999999999999998,30,39,1,2,2,1.4,2.0,50,42,8,32,45,-13,"April, 2012"
2011-2012,34,2012-04-21,Fulham,Wigan,2,1,H,3,0,3,0,2,4,0,1,10,16,43,34,6,9,April,0.8660254037844388,-0.4999999999999998,19,46,3,2,0,1.6,0.6,43,43,0,33,58,-25,"April, 2012"
2011-2012,34,2012-04-21,Bolton,Swansea,1,1,D,1,1,1,3,1,2,2,1,19,12,29,42,7,13,April,0.8660254037844388,-0.4999999999999998,6,41,0,0,1,1.0,3.0,36,65,-29,38,44,-6,"April, 2012"
2011-2012,34,2012-04-21,Blackburn,Norwich,2,0,H,3,0,1,0,4,1,1,3,19,11,28,43,8,15,April,0.8660254037844388,-0.4999999999999998,4,31,1,2,0,2.333333333333333,1.3333333333333333,45,73,-28,47,58,-11,"April, 2012"
2011-2012,34,2012-04-21,Aston Villa,Sunderland,0,0,D,1,1,0,3,2,0,3,2,15,9,35,43,6,8,April,0.8660254037844388,-0.4999999999999998,1,40,1,2,2,1.0,1.0,35,48,-13,42,41,1,"April, 2012"
2011-2012,34,2012-04-21,Arsenal,Chelsea,0,0,D,1,1,1,3,1,2,1,2,3,6,64,57,3,7,April,0.8660254037844388,-0.4999999999999998,0,14,2,0,3,1.6,2.2,67,43,24,56,38,18,"April, 2012"
2011-2012,34,2012-04-22,Liverpool,West Brom,0,1,A,0,3,2,0,3,2,2,1,8,13,46,42,5,4,April,0.8660254037844388,-0.4999999999999998,25,44,4,0,1,1.8,0.4,40,36,4,40,47,-7,"April, 2012"
2011-2012,34,2012-04-22,Man United,Everton,4,4,D,1,1,3,1,1,2,3,0,1,7,82,47,6,35,April,0.8660254037844388,-0.4999999999999998,28,18,3,1,1,1.8,1.2,82,28,54,38,34,4,"April, 2012"
2011-2012,34,2012-04-22,Wolves,Man City,0,2,A,0,3,0,3,2,5,0,0,20,2,23,77,18,54,April,0.8660254037844388,-0.4999999999999998,48,27,1,0,4,1.2,2.4,34,73,-39,85,27,58,"April, 2012"
2011-2012,34,2012-04-24,Aston Villa,Bolton,1,2,A,0,3,0,3,2,1,3,1,15,19,36,30,4,6,April,0.8660254037844388,-0.4999999999999998,1,6,3,1,1,2.2,1.2,35,48,-13,37,66,-29,"April, 2012"
2011-2012,35,2012-04-28,Wigan,Newcastle,4,0,H,3,0,4,0,1,2,0,3,17,4,34,62,13,28,April,0.8660254037844388,-0.4999999999999998,46,30,1,2,2,1.2,1.4,34,60,-26,53,42,11,"April, 2012"
2011-2012,35,2012-04-28,West Brom,Aston Villa,0,0,D,1,1,2,2,1,0,3,2,11,15,45,36,4,9,April,0.8660254037844388,-0.4999999999999998,44,1,2,0,3,1.4,1.6,41,47,-6,36,50,-14,"April, 2012"
2011-2012,35,2012-04-28,Swansea,Wolves,4,4,D,1,1,2,2,1,0,3,2,12,20,43,23,8,20,April,0.8660254037844388,-0.4999999999999998,41,48,0,1,0,2.0,2.0,39,45,-6,34,75,-41,"April, 2012"
2011-2012,35,2012-04-28,Stoke,Arsenal,1,1,D,1,1,0,3,2,1,3,1,14,3,42,65,11,23,April,0.8660254037844388,-0.4999999999999998,39,0,1,0,4,1.0,2.0,32,48,-16,67,43,24,"April, 2012"
2011-2012,35,2012-04-28,Norwich,Liverpool,0,3,A,0,3,1,1,3,2,0,3,13,8,43,46,5,3,April,0.8660254037844388,-0.4999999999999998,31,25,0,1,2,0.6666666666666666,2.0,47,60,-13,40,37,3,"April, 2012"
2011-2012,35,2012-04-28,Everton,Fulham,4,0,H,3,0,2,3,0,3,0,2,7,9,48,46,2,2,April,0.8660254037844388,-0.4999999999999998,18,19,3,1,1,1.6,1.0,42,38,4,45,44,1,"April, 2012"
2011-2012,35,2012-04-28,Sunderland,Bolton,2,2,D,1,1,0,3,2,1,3,1,11,18,44,33,7,11,April,0.8660254037844388,-0.4999999999999998,40,6,5,0,0,2.0,0.2,42,41,1,39,67,-28,"April, 2012"
2011-2012,35,2012-04-29,Chelsea,QPR,6,1,H,3,0,2,1,2,2,0,3,6,17,58,34,11,24,April,0.8660254037844388,-0.4999999999999998,14,34,1,1,1,1.0,1.0,56,38,18,39,57,-18,"April, 2012"
2011-2012,35,2012-04-29,Tottenham,Blackburn,2,0,H,3,0,3,1,1,1,0,4,6,19,59,31,13,28,April,0.8660254037844388,-0.4999999999999998,42,4,5,0,0,2.4,0.8,57,39,18,47,73,-26,"April, 2012"
2011-2012,35,2012-04-30,Man City,Man United,1,0,H,3,0,5,0,0,3,1,1,2,1,80,83,1,3,April,0.8660254037844388,-0.4999999999999998,27,28,1,1,3,2.0,1.6,87,27,60,86,32,54,"April, 2012"
2011-2012,35,2012-05-01,Liverpool,Fulham,0,1,A,0,3,2,0,3,3,0,2,8,9,49,46,1,3,May,0.4999999999999999,-0.8660254037844387,25,19,2,1,2,1.4,1.2,43,37,6,45,48,-3,"May, 2012"
2011-2012,35,2012-05-01,Stoke,Everton,1,1,D,1,1,0,3,2,2,3,0,14,7,43,51,7,8,May,0.4999999999999999,-0.8660254037844387,39,18,2,2,1,0.8,0.4,33,49,-16,46,38,8,"May, 2012"
2011-2012,35,2012-05-02,Chelsea,Newcastle,0,2,A,0,3,2,1,2,2,0,3,6,5,61,62,1,1,May,0.4999999999999999,-0.8660254037844387,14,30,2,3,0,1.6,0.6,62,39,23,53,46,7,"May, 2012"
2011-2012,35,2012-05-02,Bolton,Tottenham,1,4,A,0,3,1,3,1,3,1,1,18,4,34,62,14,28,May,0.4999999999999999,-0.8660254037844387,6,42,1,1,3,1.4,2.0,41,69,-28,59,39,20,"May, 2012"
2011-2012,36,2012-05-05,Arsenal,Norwich,3,3,D,1,1,1,3,1,1,1,3,3,14,66,43,11,23,May,0.4999999999999999,-0.8660254037844387,0,31,3,0,0,3.333333333333333,1.0,68,44,24,47,63,-16,"May, 2012"
2011-2012,36,2012-05-06,QPR,Stoke,1,0,H,3,0,2,0,3,0,3,2,18,14,34,44,4,10,May,0.4999999999999999,-0.8660254037844387,34,39,1,0,0,3.0,2.0,40,63,-23,34,50,-16,"May, 2012"
2011-2012,36,2012-05-06,Newcastle,Man City,0,2,A,0,3,2,0,3,5,0,0,5,2,65,83,3,18,May,0.4999999999999999,-0.8660254037844387,30,27,0,1,4,1.2,2.4,55,46,9,88,27,61,"May, 2012"
2011-2012,36,2012-05-06,Man United,Swansea,2,0,H,3,0,3,1,1,2,2,1,2,12,83,44,10,39,May,0.4999999999999999,-0.8660254037844387,28,41,1,0,0,1.0,0.0,86,33,53,43,49,-6,"May, 2012"
2011-2012,36,2012-05-06,Wolves,Everton,0,0,D,1,1,0,3,2,2,3,0,20,7,24,52,13,28,May,0.4999999999999999,-0.8660254037844387,48,18,0,3,2,0.6,1.4,38,79,-41,47,39,8,"May, 2012"
2011-2012,36,2012-05-06,Bolton,West Brom,2,2,D,1,1,1,3,1,2,2,1,18,10,34,46,8,12,May,0.4999999999999999,-0.8660254037844387,6,44,1,3,1,1.0,0.8,42,73,-31,41,47,-6,"May, 2012"
2011-2012,36,2012-05-06,Aston Villa,Tottenham,1,1,D,1,1,0,3,2,3,1,1,15,4,37,65,11,28,May,0.4999999999999999,-0.8660254037844387,1,42,0,2,3,0.6,1.4,36,50,-14,63,40,23,"May, 2012"
2011-2012,36,2012-05-06,Fulham,Sunderland,2,1,H,3,0,3,0,2,0,3,2,9,11,49,45,2,4,May,0.4999999999999999,-0.8660254037844387,19,40,2,3,0,0.8,0.0,46,48,-2,44,43,1,"May, 2012"
2011-2012,36,2012-05-07,Blackburn,Wigan,0,1,A,0,3,1,0,4,4,0,1,19,17,31,37,2,6,May,0.4999999999999999,-0.8660254037844387,4,46,2,2,1,2.2,2.0,47,75,-28,38,60,-22,"May, 2012"
2011-2012,36,2012-05-08,Liverpool,Chelsea,4,1,H,3,0,2,0,3,2,1,2,9,6,49,61,3,12,May,0.4999999999999999,-0.8660254037844387,25,14,3,0,2,1.0,1.0,43,38,5,62,41,21,"May, 2012"
2011-2012,37,2012-05-13,Chelsea,Blackburn,2,1,H,3,0,2,1,2,1,0,4,6,19,61,31,13,30,May,0.4999999999999999,-0.8660254037844387,14,4,4,1,0,2.2,0.4,63,45,18,47,76,-29,"May, 2012"
2011-2012,37,2012-05-13,West Brom,Arsenal,2,3,A,0,3,2,2,1,1,3,1,10,4,47,67,6,20,May,0.4999999999999999,-0.8660254037844387,44,0,1,1,3,1.2,2.2,43,49,-6,71,47,24,"May, 2012"
2011-2012,37,2012-05-13,Tottenham,Fulham,2,0,H,3,0,3,1,1,3,0,2,4,9,66,52,5,14,May,0.4999999999999999,-0.8660254037844387,42,19,4,1,0,1.6,0.4,64,41,23,48,49,-1,"May, 2012"
2011-2012,37,2012-05-13,Swansea,Liverpool,1,0,H,3,0,2,2,1,2,0,3,14,8,44,52,6,8,May,0.4999999999999999,-0.8660254037844387,41,25,0,1,0,0.0,0.0,43,51,-8,47,39,8,"May, 2012"
2011-2012,37,2012-05-13,Sunderland,Man United,0,1,A,0,3,0,3,2,3,1,1,12,2,45,86,10,41,May,0.4999999999999999,-0.8660254037844387,40,28,0,2,3,0.4,1.2,45,45,0,88,33,55,"May, 2012"
2011-2012,37,2012-05-13,Wigan,Wolves,3,2,H,3,0,4,0,1,0,3,2,15,20,40,25,5,15,May,0.4999999999999999,-0.8660254037844387,46,48,3,0,2,1.4,1.0,39,60,-21,38,79,-41,"May, 2012"
2011-2012,37,2012-05-13,Norwich,Aston Villa,2,0,H,3,0,1,1,3,0,3,2,13,16,44,38,3,6,May,0.4999999999999999,-0.8660254037844387,31,1,0,1,2,0.6666666666666666,2.0,50,66,-16,37,51,-14,"May, 2012"
2011-2012,37,2012-05-13,Man City,QPR,3,2,H,3,0,5,0,0,2,0,3,1,17,86,37,16,49,May,0.4999999999999999,-0.8660254037844387,27,34,2,0,1,1.6666666666666667,1.0,90,27,63,41,63,-22,"May, 2012"
2011-2012,37,2012-05-13,Everton,Newcastle,3,1,H,3,0,2,3,0,2,0,3,7,5,53,65,2,12,May,0.4999999999999999,-0.8660254037844387,18,30,1,2,2,1.0,1.2,47,39,8,55,48,7,"May, 2012"
2011-2012,37,2012-05-13,Stoke,Bolton,2,2,D,1,1,0,3,2,1,3,1,14,18,44,35,4,9,May,0.4999999999999999,-0.8660254037844387,39,6,1,1,3,1.0,2.0,34,51,-17,44,75,-31,"May, 2012"
2012-2013,1,2012-08-18,Arsenal,Sunderland,0,0,D,1,1,4,1,0,1,2,2,1,15,0,0,14,0,August,-0.8660254037844384,-0.5000000000000004,0,40,3,2,0,1.4,0.6,0,0,0,0,0,0,"August, 2012"
2012-2013,1,2012-08-18,Fulham,Norwich,5,0,H,3,0,1,0,4,3,0,2,6,11,0,0,5,0,August,-0.8660254037844384,-0.5000000000000004,19,31,3,1,0,2.5,0.5,0,0,0,0,0,0,"August, 2012"
2012-2013,1,2012-08-18,Newcastle,Tottenham,2,1,H,3,0,1,2,2,3,2,0,10,16,0,0,6,0,August,-0.8660254037844384,-0.5000000000000004,30,42,0,2,3,0.6,2.2,0,0,0,0,0,0,"August, 2012"
2012-2013,1,2012-08-18,QPR,Swansea,0,5,A,0,3,0,1,4,1,1,3,11,15,0,0,4,0,August,-0.8660254037844384,-0.5000000000000004,34,41,1,1,0,2.0,0.5,0,0,0,0,0,0,"August, 2012"
2012-2013,1,2012-08-18,Reading,Stoke,1,1,D,1,1,1,1,3,2,2,1,12,14,0,0,2,0,August,-0.8660254037844384,-0.5000000000000004,35,39,0,0,0,0.0,0.0,0,0,0,0,0,0,"August, 2012"
2012-2013,1,2012-08-18,West Brom,Liverpool,3,0,H,3,0,1,1,3,3,2,0,15,11,0,0,4,0,August,-0.8660254037844384,-0.5000000000000004,44,25,2,0,3,0.6,1.2,0,0,0,0,0,0,"August, 2012"
2012-2013,1,2012-08-18,West Ham,Aston Villa,1,0,H,3,0,2,1,2,2,1,2,15,9,0,0,6,0,August,-0.8660254037844384,-0.5000000000000004,45,1,1,2,2,0.8,1.4,0,0,0,0,0,0,"August, 2012"
2012-2013,1,2012-08-19,Wigan,Chelsea,0,2,A,0,3,1,2,2,4,1,0,14,11,0,0,3,0,August,-0.8660254037844384,-0.5000000000000004,46,14,0,1,4,0.4,3.6,0,0,0,0,0,0,"August, 2012"
2012-2013,1,2012-08-19,Man City,Southampton,3,2,H,3,0,3,1,1,0,3,2,12,14,0,0,2,0,August,-0.8660254037844384,-0.5000000000000004,27,38,2,1,2,1.0,1.0,0,0,0,0,0,0,"August, 2012"
2012-2013,1,2012-08-20,Everton,Man United,1,0,H,3,0,2,1,2,2,2,1,12,13,0,0,1,0,August,-0.8660254037844384,-0.5000000000000004,18,28,1,2,2,2.0,2.0,0,0,0,0,0,0,"August, 2012"
2012-2013,1,2012-08-22,Chelsea,Reading,4,2,H,3,0,4,1,0,1,1,3,4,9,3,1,5,2,August,-0.8660254037844384,-0.5000000000000004,14,35,3,1,0,1.5,0.75,2,0,2,1,1,0,"August, 2012"
2012-2013,2,2012-08-25,Aston Villa,Everton,1,3,A,0,3,2,1,2,2,1,2,15,7,0,3,8,3,August,-0.8660254037844384,-0.5000000000000004,1,18,1,4,0,1.6,1.4,0,1,-1,1,0,1,"August, 2012"
2012-2013,2,2012-08-25,Chelsea,Newcastle,2,0,H,3,0,4,1,0,1,2,2,1,7,6,3,6,3,August,-0.8660254037844384,-0.5000000000000004,14,30,2,2,1,1.6,1.0,6,2,4,2,1,1,"August, 2012"
2012-2013,2,2012-08-25,Man United,Fulham,3,2,H,3,0,2,2,1,1,0,4,15,3,0,3,12,3,August,-0.8660254037844384,-0.5000000000000004,28,19,4,1,0,2.6,0.4,0,1,-1,5,0,5,"August, 2012"
2012-2013,2,2012-08-25,Norwich,QPR,1,1,D,1,1,3,0,2,0,1,4,19,20,0,0,1,0,August,-0.8660254037844384,-0.5000000000000004,31,34,2,0,0,2.0,1.0,0,5,-5,0,5,-5,"August, 2012"
2012-2013,2,2012-08-25,Southampton,Wigan,0,2,A,0,3,0,3,2,1,2,2,16,18,0,0,2,0,August,-0.8660254037844384,-0.5000000000000004,38,46,0,0,0,0.0,0.0,2,3,-1,0,2,-2,"August, 2012"
2012-2013,2,2012-08-25,Swansea,West Ham,3,0,H,3,0,1,1,3,2,1,2,3,7,3,3,4,0,August,-0.8660254037844384,-0.5000000000000004,41,45,0,0,0,0.0,0.0,5,0,5,1,0,1,"August, 2012"
2012-2013,2,2012-08-25,Tottenham,West Brom,1,1,D,1,1,3,2,0,1,1,3,17,5,0,3,12,3,August,-0.8660254037844384,-0.5000000000000004,42,44,3,2,0,1.6,0.8,1,2,-1,3,0,3,"August, 2012"
2012-2013,2,2012-08-26,Liverpool,Man City,2,2,D,1,1,3,2,0,3,1,1,20,6,0,3,14,3,August,-0.8660254037844384,-0.5000000000000004,25,27,1,2,2,0.8,1.4,0,3,-3,3,2,1,"August, 2012"
2012-2013,2,2012-08-26,Stoke,Arsenal,0,0,D,1,1,2,2,1,4,1,0,11,12,1,1,1,0,August,-0.8660254037844384,-0.5000000000000004,39,0,1,1,3,1.2,1.8,1,1,0,0,0,0,"August, 2012"
2012-2013,3,2012-09-01,Wigan,Stoke,2,2,D,1,1,1,2,2,2,2,1,9,12,3,2,3,1,September,-1.0,-1.8369701987210287e-16,46,39,2,3,0,1.6,1.0,2,2,0,1,1,0,"September, 2012"
2012-2013,3,2012-09-01,West Ham,Fulham,3,0,H,3,0,2,1,2,1,0,4,10,6,3,3,4,0,September,-1.0,-1.8369701987210287e-16,45,19,2,2,1,2.2,1.6,1,3,-2,7,3,4,"September, 2012"
2012-2013,3,2012-09-01,West Brom,Everton,2,0,H,3,0,1,1,3,2,1,2,5,4,4,6,1,2,September,-1.0,-1.8369701987210287e-16,44,18,2,0,3,1.0,1.2,4,1,3,4,1,3,"September, 2012"
2012-2013,3,2012-09-01,Swansea,Sunderland,2,2,D,1,1,1,1,3,1,2,2,3,13,6,1,10,5,September,-1.0,-1.8369701987210287e-16,41,40,0,1,1,0.0,1.0,8,0,8,0,0,0,"September, 2012"
2012-2013,3,2012-09-01,Man City,QPR,3,1,H,3,0,3,1,1,0,1,4,5,18,4,1,13,3,September,-1.0,-1.8369701987210287e-16,27,34,3,0,1,2.0,1.25,5,4,1,1,6,-5,"September, 2012"
2012-2013,3,2012-09-01,Tottenham,Norwich,1,1,D,1,1,3,2,0,3,0,2,14,17,1,1,3,0,September,-1.0,-1.8369701987210287e-16,42,31,2,1,1,1.25,0.5,2,3,-1,1,6,-5,"September, 2012"
2012-2013,3,2012-09-02,Liverpool,Arsenal,0,2,A,0,3,3,2,0,4,1,0,17,13,1,2,4,1,September,-1.0,-1.8369701987210287e-16,25,0,1,2,2,1.0,1.0,2,5,-3,0,0,0,"September, 2012"
2012-2013,3,2012-09-02,Newcastle,Aston Villa,1,1,D,1,1,1,2,2,2,1,2,12,20,3,0,8,3,September,-1.0,-1.8369701987210287e-16,30,1,2,1,2,1.8,0.8,2,3,-1,1,4,-3,"September, 2012"
2012-2013,3,2012-09-02,Southampton,Man United,2,3,A,0,3,0,3,2,2,2,1,20,11,0,3,9,3,September,-1.0,-1.8369701987210287e-16,38,28,1,0,4,0.8,2.0,2,5,-3,3,3,0,"September, 2012"
2012-2013,4,2012-09-15,Stoke,Man City,1,1,D,1,1,2,2,1,3,1,1,13,5,3,7,8,4,September,-1.0,-1.8369701987210287e-16,39,27,0,3,2,0.6,1.8,3,3,0,8,5,3,"September, 2012"
2012-2013,4,2012-09-15,Sunderland,Liverpool,1,1,D,1,1,1,2,2,3,2,0,15,19,2,1,4,1,September,-1.0,-1.8369701987210287e-16,40,25,1,2,2,0.8,1.6,2,2,0,2,7,-5,"September, 2012"
2012-2013,4,2012-09-15,Norwich,West Ham,0,0,D,1,1,3,0,2,2,1,2,16,9,2,6,7,4,September,-1.0,-1.8369701987210287e-16,31,45,0,0,0,0.0,0.0,2,7,-5,4,3,1,"September, 2012"
2012-2013,4,2012-09-15,QPR,Chelsea,0,0,D,1,1,0,1,4,4,1,0,19,1,1,9,18,8,September,-1.0,-1.8369701987210287e-16,34,14,1,1,2,1.0,2.25,2,9,-7,8,2,6,"September, 2012"
2012-2013,4,2012-09-15,Fulham,West Brom,3,0,H,3,0,1,0,4,1,1,3,12,4,3,7,8,4,September,-1.0,-1.8369701987210287e-16,19,44,2,2,1,1.4,0.6,7,6,1,6,1,5,"September, 2012"
2012-2013,4,2012-09-15,Man United,Wigan,4,0,H,3,0,2,2,1,1,2,2,7,10,6,4,3,2,September,-1.0,-1.8369701987210287e-16,28,46,4,0,1,3.2,0.2,6,5,1,4,4,0,"September, 2012"
2012-2013,4,2012-09-15,Aston Villa,Swansea,2,0,H,3,0,2,1,2,1,1,3,17,3,1,7,14,6,September,-1.0,-1.8369701987210287e-16,1,41,0,1,1,0.0,1.0,2,5,-3,10,2,8,"September, 2012"
2012-2013,4,2012-09-15,Arsenal,Southampton,6,1,H,3,0,4,1,0,0,3,2,8,20,5,0,12,5,September,-1.0,-1.8369701987210287e-16,0,38,3,2,0,2.4,0.8,2,0,2,4,8,-4,"September, 2012"
2012-2013,4,2012-09-16,Reading,Tottenham,1,3,A,0,3,1,1,3,3,2,0,19,16,1,2,3,1,September,-1.0,-1.8369701987210287e-16,35,42,1,0,3,1.75,2.25,3,5,-2,3,4,-1,"September, 2012"
2012-2013,4,2012-09-17,Everton,Newcastle,2,2,D,1,1,2,1,2,1,2,2,9,13,6,4,4,2,September,-1.0,-1.8369701987210287e-16,18,30,2,1,2,1.2,1.0,4,3,1,3,4,-1,"September, 2012"
2012-2013,5,2012-09-22,Wigan,Fulham,1,2,A,0,3,1,2,2,1,0,4,15,9,4,6,6,2,September,-1.0,-1.8369701987210287e-16,46,19,0,1,4,0.6,1.8,4,8,-4,10,6,4,"September, 2012"
2012-2013,5,2012-09-22,West Ham,Sunderland,1,1,D,1,1,2,1,2,1,2,2,8,15,7,3,7,4,September,-1.0,-1.8369701987210287e-16,45,40,2,1,2,1.0,1.2,4,3,1,3,3,0,"September, 2012"
2012-2013,5,2012-09-22,West Brom,Reading,1,0,H,3,0,1,1,3,1,1,3,7,20,7,1,13,6,September,-1.0,-1.8369701987210287e-16,44,35,0,0,0,0.0,0.0,6,4,2,4,8,-4,"September, 2012"
2012-2013,5,2012-09-22,Southampton,Aston Villa,4,1,H,3,0,0,3,2,2,1,2,20,12,0,4,8,4,September,-1.0,-1.8369701987210287e-16,38,1,0,2,3,1.0,1.8,5,14,-9,4,5,-1,"September, 2012"
2012-2013,5,2012-09-22,Chelsea,Stoke,1,0,H,3,0,4,1,0,2,2,1,1,12,10,4,11,6,September,-1.0,-1.8369701987210287e-16,14,39,3,2,0,2.2,0.2,8,2,6,4,4,0,"September, 2012"
2012-2013,5,2012-09-22,Swansea,Everton,0,3,A,0,3,1,1,3,2,1,2,5,7,7,7,2,0,September,-1.0,-1.8369701987210287e-16,41,18,0,0,2,0.0,1.5,10,4,6,6,5,1,"September, 2012"
2012-2013,5,2012-09-23,Liverpool,Man United,1,2,A,0,3,3,2,0,2,2,1,18,5,2,9,13,7,September,-1.0,-1.8369701987210287e-16,25,28,1,1,3,1.6,1.8,3,8,-5,10,5,5,"September, 2012"
2012-2013,5,2012-09-23,Man City,Arsenal,1,1,D,1,1,3,1,1,4,1,0,7,6,8,8,1,0,September,-1.0,-1.8369701987210287e-16,27,0,1,2,2,0.2,0.8,9,6,3,8,1,7,"September, 2012"
2012-2013,5,2012-09-23,Newcastle,Norwich,1,0,H,3,0,1,2,2,3,0,2,11,16,5,3,5,2,September,-1.0,-1.8369701987210287e-16,30,31,1,1,2,1.5,2.0,5,6,-1,2,7,-5,"September, 2012"
2012-2013,5,2012-09-23,Tottenham,QPR,2,1,H,3,0,3,2,0,0,1,4,11,19,5,2,8,3,September,-1.0,-1.8369701987210287e-16,42,34,3,0,1,1.75,1.0,6,5,1,2,9,-7,"September, 2012"
2012-2013,6,2012-09-29,Reading,Newcastle,2,2,D,1,1,1,1,3,1,2,2,20,10,1,8,10,7,September,-1.0,-1.8369701987210287e-16,35,30,2,0,2,1.25,1.75,4,9,-5,6,6,0,"September, 2012"
2012-2013,6,2012-09-29,Sunderland,Wigan,1,0,H,3,0,1,2,2,1,2,2,14,16,4,4,2,0,September,-1.0,-1.8369701987210287e-16,40,46,2,2,1,2.2,1.4,4,4,0,5,10,-5,"September, 2012"
2012-2013,6,2012-09-29,Stoke,Swansea,2,0,H,3,0,2,2,1,1,1,3,14,11,4,7,3,3,September,-1.0,-1.8369701987210287e-16,39,41,1,0,1,1.0,1.0,4,5,-1,10,7,3,"September, 2012"
2012-2013,6,2012-09-29,Norwich,Liverpool,2,5,A,0,3,3,0,2,3,2,0,16,18,3,2,2,1,September,-1.0,-1.8369701987210287e-16,31,25,0,1,3,0.5,2.25,2,8,-6,4,10,-6,"September, 2012"
2012-2013,6,2012-09-29,Man United,Tottenham,2,3,A,0,3,2,2,1,3,2,0,3,8,12,8,5,4,September,-1.0,-1.8369701987210287e-16,28,42,4,1,0,2.2,0.4,12,6,6,8,6,2,"September, 2012"
2012-2013,6,2012-09-29,Fulham,Man City,1,2,A,0,3,1,0,4,3,1,1,6,7,9,9,1,0,September,-1.0,-1.8369701987210287e-16,19,27,0,2,3,1.0,2.4,12,7,5,10,7,3,"September, 2012"
2012-2013,6,2012-09-29,Everton,Southampton,3,1,H,3,0,2,1,2,0,3,2,3,16,10,3,13,7,September,-1.0,-1.8369701987210287e-16,18,38,2,3,0,1.6,1.2,9,5,4,9,15,-6,"September, 2012"
2012-2013,6,2012-09-29,Arsenal,Chelsea,1,2,A,0,3,4,1,0,4,1,0,5,1,9,13,4,4,September,-1.0,-1.8369701987210287e-16,0,14,2,1,2,1.6,1.6,9,2,7,9,2,7,"September, 2012"
2012-2013,6,2012-09-30,Aston Villa,West Brom,1,1,D,1,1,2,1,2,1,1,3,15,6,4,10,9,6,September,-1.0,-1.8369701987210287e-16,1,44,2,1,2,1.2,1.2,5,9,-4,7,4,3,"September, 2012"
2012-2013,6,2012-10-01,QPR,West Ham,1,2,A,0,3,0,1,4,2,1,2,20,10,2,8,10,6,October,-0.8660254037844386,0.5,34,45,1,0,1,1.5,0.5,3,11,-8,5,4,1,"October, 2012"
2012-2013,7,2012-10-06,Wigan,Everton,2,2,D,1,1,1,2,2,2,1,2,16,4,4,13,12,9,October,-0.8660254037844386,0.5,46,18,0,3,2,0.6,1.2,5,11,-6,12,6,6,"October, 2012"
2012-2013,7,2012-10-06,West Ham,Arsenal,1,3,A,0,3,2,1,2,4,1,0,7,8,11,9,1,2,October,-0.8660254037844386,0.5,45,0,0,2,3,0.4,1.6,7,5,2,10,4,6,"October, 2012"
2012-2013,7,2012-10-06,West Brom,QPR,3,2,H,3,0,1,1,3,0,1,4,6,20,11,2,14,9,October,-0.8660254037844386,0.5,44,34,1,1,0,1.0,0.5,8,5,3,4,13,-9,"October, 2012"
2012-2013,7,2012-10-06,Man City,Sunderland,3,0,H,3,0,3,1,1,1,2,2,4,13,12,7,9,5,October,-0.8660254037844386,0.5,27,40,1,2,2,1.8,1.2,12,8,4,5,4,1,"October, 2012"
2012-2013,7,2012-10-06,Chelsea,Norwich,4,1,H,3,0,4,1,0,3,0,2,1,18,16,3,17,13,October,-0.8660254037844386,0.5,14,31,3,1,0,2.5,0.5,11,3,8,4,13,-9,"October, 2012"
2012-2013,7,2012-10-06,Swansea,Reading,2,2,D,1,1,1,1,3,1,1,3,11,19,7,2,8,5,October,-0.8660254037844386,0.5,41,35,0,0,0,0.0,0.0,10,9,1,6,11,-5,"October, 2012"
2012-2013,7,2012-10-07,Liverpool,Stoke,0,0,D,1,1,3,2,0,2,2,1,14,12,5,7,2,2,October,-0.8660254037844386,0.5,25,39,1,2,2,0.6,0.8,9,12,-3,6,5,1,"October, 2012"
2012-2013,7,2012-10-07,Newcastle,Man United,0,3,A,0,3,1,2,2,2,2,1,10,6,9,12,4,3,October,-0.8660254037844386,0.5,30,28,1,2,2,1.0,1.2,8,8,0,14,9,5,"October, 2012"
2012-2013,7,2012-10-07,Southampton,Fulham,2,2,D,1,1,0,3,2,1,0,4,18,9,3,9,9,6,October,-0.8660254037844386,0.5,38,19,0,3,2,1.0,1.6,10,18,-8,13,9,4,"October, 2012"
2012-2013,7,2012-10-07,Tottenham,Aston Villa,2,0,H,3,0,3,2,0,2,1,2,7,15,11,5,8,6,October,-0.8660254037844386,0.5,42,1,3,2,0,1.4,0.6,11,8,3,6,10,-4,"October, 2012"
2012-2013,8,2012-10-20,Tottenham,Chelsea,2,4,A,0,3,3,2,0,4,1,0,5,1,14,19,4,5,October,-0.8660254037844386,0.5,42,14,1,3,1,1.0,1.0,13,8,5,15,4,11,"October, 2012"
2012-2013,8,2012-10-20,West Brom,Man City,1,2,A,0,3,1,1,3,3,1,1,5,3,14,15,2,1,October,-0.8660254037844386,0.5,44,27,0,1,4,0.4,2.6,11,7,4,15,8,7,"October, 2012"
2012-2013,8,2012-10-20,Swansea,Wigan,2,1,H,3,0,1,1,3,1,2,2,12,16,8,5,4,3,October,-0.8660254037844386,0.5,41,46,1,1,0,1.0,0.0,12,11,1,7,13,-6,"October, 2012"
2012-2013,8,2012-10-20,West Ham,Southampton,4,1,H,3,0,2,1,2,0,3,2,10,18,11,4,8,7,October,-0.8660254037844386,0.5,45,38,2,1,2,1.2,0.8,8,8,0,12,20,-8,"October, 2012"
2012-2013,8,2012-10-20,Man United,Stoke,4,2,H,3,0,2,2,1,2,2,1,2,13,15,8,11,7,October,-0.8660254037844386,0.5,28,39,4,1,0,2.2,0.6,17,9,8,6,5,1,"October, 2012"
2012-2013,8,2012-10-20,Fulham,Aston Villa,1,0,H,3,0,1,0,4,2,1,2,9,16,10,5,7,5,October,-0.8660254037844386,0.5,19,1,0,3,2,0.6,1.2,15,11,4,6,12,-6,"October, 2012"
2012-2013,8,2012-10-20,Norwich,Arsenal,1,0,H,3,0,3,0,2,4,1,0,19,8,3,12,11,9,October,-0.8660254037844386,0.5,31,0,0,1,3,1.5,3.25,5,17,-12,13,5,8,"October, 2012"
2012-2013,8,2012-10-20,Liverpool,Reading,1,0,H,3,0,3,2,0,1,1,3,14,18,6,3,4,3,October,-0.8660254037844386,0.5,25,35,3,0,1,1.75,1.25,9,12,-3,8,13,-5,"October, 2012"
2012-2013,8,2012-10-21,QPR,Everton,1,1,D,1,1,0,1,4,2,1,2,20,4,2,14,16,12,October,-0.8660254037844386,0.5,34,18,2,1,1,1.25,1.0,6,16,-10,14,8,6,"October, 2012"
2012-2013,8,2012-10-21,Sunderland,Newcastle,1,1,D,1,1,1,2,2,1,2,2,14,12,7,9,2,2,October,-0.8660254037844386,0.5,40,30,0,3,2,0.8,1.8,5,7,-2,8,11,-3,"October, 2012"
2012-2013,9,2012-10-27,Wigan,West Ham,2,1,H,3,0,1,2,2,2,1,2,17,9,5,14,8,9,October,-0.8660254037844386,0.5,46,45,2,0,3,1.4,1.8,8,15,-7,12,9,3,"October, 2012"
2012-2013,9,2012-10-27,Arsenal,QPR,1,0,H,3,0,4,1,0,0,1,4,9,20,12,3,11,9,October,-0.8660254037844386,0.5,0,34,2,1,1,1.5,0.75,13,6,7,7,17,-10,"October, 2012"
2012-2013,9,2012-10-27,Aston Villa,Norwich,1,1,D,1,1,2,1,2,3,0,2,17,15,5,6,2,1,October,-0.8660254037844386,0.5,1,31,2,1,1,1.5,1.0,6,13,-7,6,17,-11,"October, 2012"
2012-2013,9,2012-10-27,Man City,Swansea,1,0,H,3,0,3,1,1,1,1,3,3,10,18,11,7,7,October,-0.8660254037844386,0.5,27,41,1,0,1,2.0,0.5,17,9,8,14,12,2,"October, 2012"
2012-2013,9,2012-10-27,Reading,Fulham,3,3,D,1,1,1,1,3,1,0,4,19,9,3,13,10,10,October,-0.8660254037844386,0.5,35,19,2,0,2,0.75,1.25,8,14,-6,16,11,5,"October, 2012"
2012-2013,9,2012-10-27,Stoke,Sunderland,0,0,D,1,1,2,2,1,1,2,2,13,14,8,8,1,0,October,-0.8660254037844386,0.5,39,40,1,1,3,0.6,1.8,8,9,-1,6,8,-2,"October, 2012"
2012-2013,9,2012-10-28,Southampton,Tottenham,1,2,A,0,3,0,3,2,3,2,0,19,7,4,14,12,10,October,-0.8660254037844386,0.5,38,42,4,0,1,1.4,1.2,13,24,-11,15,12,3,"October, 2012"
2012-2013,9,2012-10-28,Newcastle,West Brom,2,1,H,3,0,1,2,2,1,1,3,12,8,10,14,4,4,October,-0.8660254037844386,0.5,30,44,2,1,2,2.4,2.4,9,12,-3,12,9,3,"October, 2012"
2012-2013,9,2012-10-28,Everton,Liverpool,2,2,D,1,1,2,1,2,3,2,0,5,13,15,9,8,6,October,-0.8660254037844386,0.5,18,25,1,1,3,0.8,1.6,15,9,6,10,12,-2,"October, 2012"
2012-2013,9,2012-10-28,Chelsea,Man United,2,3,A,0,3,4,1,0,2,2,1,1,3,22,18,2,4,October,-0.8660254037844386,0.5,14,28,2,1,2,1.8,2.0,19,6,13,21,11,10,"October, 2012"
2012-2013,10,2012-11-03,West Ham,Man City,0,0,D,1,1,2,1,2,3,1,1,9,3,14,21,6,7,November,-0.5000000000000004,0.8660254037844384,45,27,1,1,3,1.0,1.8,13,11,2,18,9,9,"November, 2012"
2012-2013,10,2012-11-03,Fulham,Everton,2,2,D,1,1,1,0,4,2,1,2,7,5,14,16,2,2,November,-0.5000000000000004,0.8660254037844384,19,18,0,1,4,0.6,2.2,19,14,5,17,11,6,"November, 2012"
2012-2013,10,2012-11-03,Man United,Arsenal,2,1,H,3,0,2,2,1,4,1,0,2,6,21,15,4,6,November,-0.5000000000000004,0.8660254037844384,28,0,4,0,1,2.8,1.0,24,13,11,14,6,8,"November, 2012"
2012-2013,10,2012-11-03,Norwich,Stoke,1,0,H,3,0,3,0,2,2,2,1,16,13,7,9,3,2,November,-0.5000000000000004,0.8660254037844384,31,39,0,1,1,0.5,1.0,7,18,-11,8,9,-1,"November, 2012"
2012-2013,10,2012-11-03,Sunderland,Aston Villa,0,1,A,0,3,1,2,2,2,1,2,15,17,9,6,2,3,November,-0.5000000000000004,0.8660254037844384,40,1,2,3,0,1.0,0.6,6,8,-2,7,14,-7,"November, 2012"
2012-2013,10,2012-11-03,Swansea,Chelsea,1,1,D,1,1,1,1,3,4,1,0,11,2,11,22,9,11,November,-0.5000000000000004,0.8660254037844384,41,14,0,1,1,1.0,2.5,14,13,1,21,9,12,"November, 2012"
2012-2013,10,2012-11-03,Tottenham,Wigan,0,1,A,0,3,3,2,0,1,2,2,5,17,17,8,12,9,November,-0.5000000000000004,0.8660254037844384,42,46,3,1,1,1.6,0.6,17,13,4,10,16,-6,"November, 2012"
2012-2013,10,2012-11-04,QPR,Reading,1,1,D,1,1,0,1,4,1,1,3,20,18,3,4,2,1,November,-0.5000000000000004,0.8660254037844384,34,35,0,0,0,0.0,0.0,7,18,-11,11,17,-6,"November, 2012"
2012-2013,10,2012-11-04,Liverpool,Newcastle,1,1,D,1,1,3,2,0,1,2,2,13,10,10,13,3,3,November,-0.5000000000000004,0.8660254037844384,25,30,3,0,2,2.0,1.2,12,14,-2,11,13,-2,"November, 2012"
2012-2013,10,2012-11-05,West Brom,Southampton,2,0,H,3,0,1,1,3,0,3,2,9,20,14,4,11,10,November,-0.5000000000000004,0.8660254037844384,44,38,1,2,1,0.75,0.75,13,11,2,14,26,-12,"November, 2012"
2012-2013,11,2012-11-10,Arsenal,Fulham,3,3,D,1,1,4,1,0,1,0,4,7,8,15,15,1,0,November,-0.5000000000000004,0.8660254037844384,0,19,2,2,1,2.0,1.2,15,8,7,21,16,5,"November, 2012"
2012-2013,11,2012-11-10,Aston Villa,Man United,2,3,A,0,3,2,1,2,2,2,1,17,1,9,24,16,15,November,-0.5000000000000004,0.8660254037844384,1,28,0,2,3,0.8,2.2,8,14,-6,26,14,12,"November, 2012"
2012-2013,11,2012-11-10,Everton,Sunderland,2,1,H,3,0,2,1,2,1,2,2,4,16,17,9,12,8,November,-0.5000000000000004,0.8660254037844384,18,40,3,2,0,2.2,0.6,19,13,6,6,9,-3,"November, 2012"
2012-2013,11,2012-11-10,Reading,Norwich,0,0,D,1,1,1,1,3,3,0,2,18,14,5,10,4,5,November,-0.5000000000000004,0.8660254037844384,35,31,0,0,0,0.0,0.0,12,18,-6,8,18,-10,"November, 2012"
2012-2013,11,2012-11-10,Southampton,Swansea,1,1,D,1,1,0,3,2,1,1,3,20,11,4,12,9,8,November,-0.5000000000000004,0.8660254037844384,38,41,0,0,0,0.0,0.0,14,28,-14,15,14,1,"November, 2012"
2012-2013,11,2012-11-10,Stoke,QPR,1,0,H,3,0,2,2,1,0,1,4,15,20,9,4,5,5,November,-0.5000000000000004,0.8660254037844384,39,34,0,0,2,1.0,2.0,8,10,-2,8,19,-11,"November, 2012"
2012-2013,11,2012-11-10,Wigan,West Brom,1,2,A,0,3,1,2,2,1,1,3,14,5,11,17,9,6,November,-0.5000000000000004,0.8660254037844384,46,44,2,2,1,1.4,1.4,11,16,-5,15,11,4,"November, 2012"
2012-2013,11,2012-11-11,Chelsea,Liverpool,1,1,D,1,1,4,1,0,3,2,0,2,13,23,11,11,12,November,-0.5000000000000004,0.8660254037844384,14,25,1,0,4,0.8,1.8,22,10,12,13,15,-2,"November, 2012"
2012-2013,11,2012-11-11,Man City,Tottenham,2,1,H,3,0,3,1,1,3,2,0,3,6,22,17,3,5,November,-0.5000000000000004,0.8660254037844384,27,42,3,1,1,1.8,0.8,18,9,9,17,14,3,"November, 2012"
2012-2013,11,2012-11-11,Newcastle,West Ham,0,1,A,0,3,1,2,2,2,1,2,10,9,14,15,1,1,November,-0.5000000000000004,0.8660254037844384,30,45,2,2,1,2.4,1.6,12,14,-2,13,11,2,"November, 2012"
2012-2013,12,2012-11-17,West Brom,Chelsea,2,1,H,3,0,1,1,3,4,1,0,5,3,20,24,2,4,November,-0.5000000000000004,0.8660254037844384,44,14,1,0,4,0.6,2.6,17,12,5,23,11,12,"November, 2012"
2012-2013,12,2012-11-17,Reading,Everton,2,1,H,3,0,1,1,3,2,1,2,19,4,6,20,15,14,November,-0.5000000000000004,0.8660254037844384,35,18,1,1,2,0.5,1.0,12,18,-6,21,14,7,"November, 2012"
2012-2013,12,2012-11-17,QPR,Southampton,1,3,A,0,3,0,1,4,0,3,2,20,19,4,5,1,1,November,-0.5000000000000004,0.8660254037844384,34,38,1,0,1,1.5,1.0,8,20,-12,15,29,-14,"November, 2012"
2012-2013,12,2012-11-17,Norwich,Man United,1,0,H,3,0,3,0,2,2,2,1,15,2,11,27,13,16,November,-0.5000000000000004,0.8660254037844384,31,28,1,0,3,1.0,1.5,8,18,-10,29,16,13,"November, 2012"
2012-2013,12,2012-11-17,Arsenal,Tottenham,5,2,H,3,0,4,1,0,3,2,0,8,7,16,17,1,1,November,-0.5000000000000004,0.8660254037844384,0,42,1,1,3,2.4,2.4,18,11,7,18,16,2,"November, 2012"
2012-2013,12,2012-11-17,Man City,Aston Villa,5,0,H,3,0,3,1,1,2,1,2,2,17,25,9,15,16,November,-0.5000000000000004,0.8660254037844384,27,1,4,0,1,2.4,0.6,20,10,10,10,17,-7,"November, 2012"
2012-2013,12,2012-11-17,Liverpool,Wigan,3,0,H,3,0,3,2,0,1,2,2,13,14,12,11,1,1,November,-0.5000000000000004,0.8660254037844384,25,46,0,3,2,0.6,1.0,14,16,-2,12,18,-6,"November, 2012"
2012-2013,12,2012-11-17,Newcastle,Swansea,1,2,A,0,3,1,2,2,1,1,3,11,12,14,13,1,1,November,-0.5000000000000004,0.8660254037844384,30,41,1,1,0,1.0,0.0,12,15,-3,16,15,1,"November, 2012"
2012-2013,12,2012-11-18,Fulham,Sunderland,1,3,A,0,3,1,0,4,1,2,2,9,16,16,9,7,7,November,-0.5000000000000004,0.8660254037844384,19,40,2,3,0,1.0,0.2,24,19,5,7,11,-4,"November, 2012"
2012-2013,12,2012-11-19,West Ham,Stoke,1,1,D,1,1,2,1,2,2,2,1,7,14,18,12,7,6,November,-0.5000000000000004,0.8660254037844384,45,39,2,1,2,1.2,0.8,14,11,3,9,10,-1,"November, 2012"
2012-2013,13,2012-11-24,Wigan,Reading,3,2,H,3,0,1,2,2,1,1,3,16,18,11,9,2,2,November,-0.5000000000000004,0.8660254037844384,46,35,1,1,2,1.0,1.25,12,21,-9,14,19,-5,"November, 2012"
2012-2013,13,2012-11-24,Stoke,Fulham,1,0,H,3,0,2,2,1,1,0,4,14,9,13,16,5,3,November,-0.5000000000000004,0.8660254037844384,39,19,2,0,3,0.8,1.2,10,11,-1,25,22,3,"November, 2012"
2012-2013,13,2012-11-24,Sunderland,West Brom,2,4,A,0,3,1,2,2,1,1,3,15,4,12,23,11,11,November,-0.5000000000000004,0.8660254037844384,40,44,0,1,4,0.8,2.6,10,12,-2,19,13,6,"November, 2012"
2012-2013,13,2012-11-24,Everton,Norwich,1,1,D,1,1,2,1,2,3,0,2,6,13,20,14,7,6,November,-0.5000000000000004,0.8660254037844384,18,31,2,2,0,1.75,1.25,22,16,6,9,18,-9,"November, 2012"
2012-2013,13,2012-11-24,Aston Villa,Arsenal,0,0,D,1,1,2,1,2,4,1,0,18,6,9,19,12,10,November,-0.5000000000000004,0.8660254037844384,1,0,1,1,3,1.0,2.0,10,22,-12,23,13,10,"November, 2012"
2012-2013,13,2012-11-24,Man United,QPR,3,1,H,3,0,2,2,1,0,1,4,2,20,27,4,18,23,November,-0.5000000000000004,0.8660254037844384,28,34,3,1,0,1.75,0.5,29,17,12,9,23,-14,"November, 2012"
2012-2013,13,2012-11-25,Chelsea,Man City,0,0,D,1,1,4,1,0,3,1,1,4,2,24,28,2,4,November,-0.5000000000000004,0.8660254037844384,14,27,2,0,3,1.4,1.6,24,13,11,25,10,15,"November, 2012"
2012-2013,13,2012-11-25,Southampton,Newcastle,2,0,H,3,0,0,3,2,1,2,2,19,14,8,14,5,6,November,-0.5000000000000004,0.8660254037844384,38,30,0,2,3,1.2,1.8,18,30,-12,13,17,-4,"November, 2012"
2012-2013,13,2012-11-25,Swansea,Liverpool,0,0,D,1,1,1,1,3,3,2,0,10,12,16,15,2,1,November,-0.5000000000000004,0.8660254037844384,41,25,1,1,0,0.5,0.0,18,16,2,17,16,1,"November, 2012"
2012-2013,13,2012-11-25,Tottenham,West Ham,3,1,H,3,0,3,2,0,2,1,2,9,7,17,19,2,2,November,-0.5000000000000004,0.8660254037844384,42,45,3,1,1,1.0,0.4,20,21,-1,15,12,3,"November, 2012"
2012-2013,14,2012-11-27,Aston Villa,Reading,1,0,H,3,0,2,1,2,1,1,3,18,19,10,9,1,1,November,-0.5000000000000004,0.8660254037844384,1,35,3,0,1,1.75,1.25,10,22,-12,16,22,-6,"November, 2012"
2012-2013,14,2012-11-27,Sunderland,QPR,0,0,D,1,1,1,2,2,0,1,4,17,20,12,4,3,8,November,-0.5000000000000004,0.8660254037844384,40,34,2,0,0,3.0,1.5,12,16,-4,10,26,-16,"November, 2012"
2012-2013,14,2012-11-28,Wigan,Man City,0,2,A,0,3,1,2,2,3,1,1,15,2,14,29,13,15,November,-0.5000000000000004,0.8660254037844384,46,27,0,0,5,0.0,2.0,15,23,-8,25,10,15,"November, 2012"
2012-2013,14,2012-11-28,Tottenham,Liverpool,2,1,H,3,0,3,2,0,3,2,0,8,12,20,16,4,4,November,-0.5000000000000004,0.8660254037844384,42,25,3,1,1,1.6,0.6,23,22,1,17,16,1,"November, 2012"
2012-2013,14,2012-11-28,Swansea,West Brom,3,1,H,3,0,1,1,3,1,1,3,11,4,17,26,7,9,November,-0.5000000000000004,0.8660254037844384,41,44,2,0,0,2.5,0.5,18,16,2,23,15,8,"November, 2012"
2012-2013,14,2012-11-28,Stoke,Newcastle,2,1,H,3,0,2,2,1,1,2,2,12,14,16,14,2,2,November,-0.5000000000000004,0.8660254037844384,39,30,2,1,2,1.6,1.6,11,11,0,13,19,-6,"November, 2012"
2012-2013,14,2012-11-28,Man United,West Ham,1,0,H,3,0,2,2,1,2,1,2,1,8,30,19,7,11,November,-0.5000000000000004,0.8660254037844384,28,45,5,0,0,3.0,0.4,32,18,14,16,15,1,"November, 2012"
2012-2013,14,2012-11-28,Everton,Arsenal,1,1,D,1,1,2,1,2,4,1,0,5,6,21,20,1,1,November,-0.5000000000000004,0.8660254037844384,18,0,0,1,4,0.8,1.6,23,17,6,23,13,10,"November, 2012"
2012-2013,14,2012-11-28,Chelsea,Fulham,0,0,D,1,1,4,1,0,1,0,4,4,10,25,16,6,9,November,-0.5000000000000004,0.8660254037844384,14,19,2,3,0,1.0,0.6,24,13,11,25,23,2,"November, 2012"
2012-2013,14,2012-11-28,Southampton,Norwich,1,1,D,1,1,0,3,2,3,0,2,18,13,11,15,5,4,November,-0.5000000000000004,0.8660254037844384,38,31,1,0,1,2.5,2.5,20,30,-10,10,19,-9,"November, 2012"
2012-2013,15,2012-12-01,QPR,Aston Villa,1,1,D,1,1,0,1,4,2,1,2,20,17,5,13,3,8,December,-2.4492935982947064e-16,1.0,34,1,1,2,1,1.5,1.75,10,26,-16,11,22,-11,"December, 2012"
2012-2013,15,2012-12-01,West Ham,Chelsea,3,1,H,3,0,2,1,2,4,1,0,11,3,19,26,8,7,December,-2.4492935982947064e-16,1.0,45,14,0,1,4,0.6,2.4,16,16,0,24,13,11,"December, 2012"
2012-2013,15,2012-12-01,Man City,Everton,1,1,D,1,1,3,1,1,2,1,2,2,7,32,22,5,10,December,-2.4492935982947064e-16,1.0,27,18,1,0,4,0.8,1.4,27,10,17,24,18,6,"December, 2012"
2012-2013,15,2012-12-01,West Brom,Stoke,0,1,A,0,3,1,1,3,2,2,1,4,10,26,19,6,7,December,-2.4492935982947064e-16,1.0,44,39,1,1,3,0.6,1.6,24,18,6,13,12,1,"December, 2012"
2012-2013,15,2012-12-01,Fulham,Tottenham,0,3,A,0,3,1,0,4,3,2,0,11,6,17,23,5,6,December,-2.4492935982947064e-16,1.0,19,42,0,0,5,0.4,2.0,25,23,2,25,23,2,"December, 2012"
2012-2013,15,2012-12-01,Liverpool,Southampton,1,0,H,3,0,3,2,0,0,3,2,12,18,16,12,6,4,December,-2.4492935982947064e-16,1.0,25,38,2,0,3,0.6,1.2,18,18,0,21,31,-10,"December, 2012"
2012-2013,15,2012-12-01,Arsenal,Swansea,0,2,A,0,3,4,1,0,1,1,3,7,8,21,20,1,1,December,-2.4492935982947064e-16,1.0,0,41,1,0,1,1.5,1.5,24,14,10,21,17,4,"December, 2012"
2012-2013,15,2012-12-01,Reading,Man United,3,4,A,0,3,1,1,3,2,2,1,19,2,9,33,17,24,December,-2.4492935982947064e-16,1.0,35,28,0,2,2,0.75,1.5,16,23,-7,33,18,15,"December, 2012"
2012-2013,15,2012-12-02,Norwich,Sunderland,2,1,H,3,0,3,0,2,1,2,2,13,17,16,13,4,3,December,-2.4492935982947064e-16,1.0,31,40,1,0,1,1.0,2.0,11,20,-9,12,16,-4,"December, 2012"
2012-2013,15,2012-12-03,Newcastle,Wigan,3,0,H,3,0,1,2,2,1,2,2,14,15,14,14,1,0,December,-2.4492935982947064e-16,1.0,30,46,2,1,2,1.0,1.6,14,21,-7,15,25,-10,"December, 2012"
2012-2013,16,2012-12-08,Swansea,Norwich,3,4,A,0,3,1,1,3,3,0,2,8,12,23,19,4,4,December,-2.4492935982947064e-16,1.0,41,31,0,0,2,1.5,3.0,23,17,6,13,21,-8,"December, 2012"
2012-2013,16,2012-12-08,Sunderland,Chelsea,1,3,A,0,3,1,2,2,4,1,0,18,3,13,26,15,13,December,-2.4492935982947064e-16,1.0,40,14,1,0,4,1.6,2.8,13,18,-5,25,16,9,"December, 2012"
2012-2013,16,2012-12-08,Wigan,QPR,2,2,D,1,1,1,2,2,0,1,4,17,20,14,6,3,8,December,-2.4492935982947064e-16,1.0,46,34,1,0,1,1.5,1.5,15,28,-13,11,27,-16,"December, 2012"
2012-2013,16,2012-12-08,Aston Villa,Stoke,0,0,D,1,1,2,1,2,2,2,1,15,10,14,22,5,8,December,-2.4492935982947064e-16,1.0,1,39,0,4,1,0.6,0.8,12,23,-11,14,12,2,"December, 2012"
2012-2013,16,2012-12-08,Arsenal,West Brom,2,0,H,3,0,4,1,0,1,1,3,10,5,21,26,5,5,December,-2.4492935982947064e-16,1.0,0,44,3,1,1,2.6,1.6,24,16,8,24,19,5,"December, 2012"
2012-2013,16,2012-12-08,Southampton,Reading,1,0,H,3,0,0,3,2,1,1,3,18,19,12,9,1,3,December,-2.4492935982947064e-16,1.0,38,35,0,0,0,0.0,0.0,21,32,-11,19,27,-8,"December, 2012"
2012-2013,16,2012-12-09,Everton,Tottenham,2,1,H,3,0,2,1,2,3,2,0,7,4,23,26,3,3,December,-2.4492935982947064e-16,1.0,18,42,2,1,2,1.0,1.2,25,19,6,28,23,5,"December, 2012"
2012-2013,16,2012-12-09,West Ham,Liverpool,2,3,A,0,3,2,1,2,3,2,0,10,12,22,19,2,3,December,-2.4492935982947064e-16,1.0,45,25,1,0,4,1.0,2.6,19,17,2,19,18,1,"December, 2012"
2012-2013,16,2012-12-09,Man City,Man United,2,3,A,0,3,3,1,1,2,2,1,2,1,33,36,1,3,December,-2.4492935982947064e-16,1.0,27,28,2,1,2,1.6,0.8,28,11,17,37,21,16,"December, 2012"
2012-2013,16,2012-12-10,Fulham,Newcastle,2,1,H,3,0,1,0,4,1,2,2,13,14,17,17,1,0,December,-2.4492935982947064e-16,1.0,19,30,3,1,1,1.6,0.8,25,26,-1,17,21,-4,"December, 2012"
2012-2013,16,2012-12-11,Sunderland,Reading,3,0,H,3,0,1,2,2,1,1,3,18,19,13,9,1,4,December,-2.4492935982947064e-16,1.0,40,35,1,0,1,1.5,1.5,14,21,-7,19,28,-9,"December, 2012"
2012-2013,17,2012-12-15,Stoke,Everton,1,1,D,1,1,2,2,1,2,1,2,10,4,23,26,6,3,December,-2.4492935982947064e-16,1.0,39,18,2,2,1,0.8,0.4,14,12,2,27,20,7,"December, 2012"
2012-2013,17,2012-12-15,Liverpool,Aston Villa,1,3,A,0,3,3,2,0,2,1,2,10,17,22,15,7,7,December,-2.4492935982947064e-16,1.0,25,1,3,1,1,1.4,0.4,22,20,2,12,23,-11,"December, 2012"
2012-2013,17,2012-12-15,Man United,Sunderland,3,1,H,3,0,2,2,1,1,2,2,1,16,39,16,15,23,December,-2.4492935982947064e-16,1.0,28,40,4,1,0,1.0,0.0,40,23,17,17,21,-4,"December, 2012"
2012-2013,17,2012-12-15,Newcastle,Man City,1,3,A,0,3,1,2,2,3,1,1,15,2,17,33,13,16,December,-2.4492935982947064e-16,1.0,30,27,0,0,5,0.8,2.4,18,23,-5,30,14,16,"December, 2012"
2012-2013,17,2012-12-15,Norwich,Wigan,2,1,H,3,0,3,0,2,1,2,2,12,18,22,15,6,7,December,-2.4492935982947064e-16,1.0,31,46,0,2,0,1.0,1.0,17,24,-7,17,30,-13,"December, 2012"
2012-2013,17,2012-12-15,QPR,Fulham,2,1,H,3,0,0,1,4,1,0,4,20,13,7,20,7,13,December,-2.4492935982947064e-16,1.0,34,19,0,0,2,0.0,3.5,13,29,-16,27,27,0,"December, 2012"
2012-2013,17,2012-12-16,West Brom,West Ham,0,0,D,1,1,1,1,3,2,1,2,6,11,26,22,5,4,December,-2.4492935982947064e-16,1.0,44,45,1,3,1,1.6,1.6,24,21,3,21,20,1,"December, 2012"
2012-2013,17,2012-12-16,Tottenham,Swansea,1,0,H,3,0,3,2,0,1,1,3,5,10,26,23,5,3,December,-2.4492935982947064e-16,1.0,42,41,1,1,0,2.0,1.0,29,25,4,26,21,5,"December, 2012"
2012-2013,17,2012-12-17,Reading,Arsenal,2,5,A,0,3,1,1,3,4,1,0,20,8,9,24,12,15,December,-2.4492935982947064e-16,1.0,35,0,0,0,4,0.5,2.75,19,31,-12,26,16,10,"December, 2012"
2012-2013,18,2012-12-22,Liverpool,Fulham,4,0,H,3,0,3,2,0,1,0,4,12,13,22,20,1,2,December,-2.4492935982947064e-16,1.0,25,19,2,1,2,1.2,0.8,23,23,0,28,29,-1,"December, 2012"
2012-2013,18,2012-12-22,Man City,Reading,1,0,H,3,0,3,1,1,1,1,3,2,20,36,9,18,27,December,-2.4492935982947064e-16,1.0,27,35,1,0,3,0.5,1.5,33,15,18,21,36,-15,"December, 2012"
2012-2013,18,2012-12-22,Newcastle,QPR,1,0,H,3,0,1,2,2,0,1,4,15,19,17,10,4,7,December,-2.4492935982947064e-16,1.0,30,34,3,1,0,1.5,0.75,19,26,-7,15,30,-15,"December, 2012"
2012-2013,18,2012-12-22,Southampton,Sunderland,0,1,A,0,3,0,3,2,1,2,2,17,16,15,16,1,1,December,-2.4492935982947064e-16,1.0,38,40,3,1,1,1.2,0.6,22,32,-10,18,24,-6,"December, 2012"
2012-2013,18,2012-12-22,Tottenham,Stoke,0,0,D,1,1,3,2,0,2,2,1,4,10,29,24,6,5,December,-2.4492935982947064e-16,1.0,42,39,3,1,1,1.8,1.4,30,25,5,15,13,2,"December, 2012"
2012-2013,18,2012-12-22,West Brom,Norwich,2,1,H,3,0,1,1,3,3,0,2,7,10,27,25,3,2,December,-2.4492935982947064e-16,1.0,44,31,1,1,2,1.0,1.25,24,21,3,19,25,-6,"December, 2012"
2012-2013,18,2012-12-22,West Ham,Everton,1,2,A,0,3,2,1,2,2,1,2,12,7,23,27,5,4,December,-2.4492935982947064e-16,1.0,45,18,0,3,2,1.4,2.0,21,20,1,28,21,7,"December, 2012"
2012-2013,18,2012-12-22,Wigan,Arsenal,0,1,A,0,3,1,2,2,4,1,0,18,7,15,27,11,12,December,-2.4492935982947064e-16,1.0,46,0,2,1,2,1.4,2.4,18,32,-14,31,18,13,"December, 2012"
2012-2013,18,2012-12-23,Chelsea,Aston Villa,8,0,H,3,0,4,1,0,2,1,2,7,16,29,18,9,11,December,-2.4492935982947064e-16,1.0,14,1,2,2,1,3.0,1.8,28,17,11,15,24,-9,"December, 2012"
2012-2013,18,2012-12-23,Swansea,Man United,1,1,D,1,1,1,1,3,2,2,1,11,1,23,42,10,19,December,-2.4492935982947064e-16,1.0,41,28,0,0,2,0.0,1.5,26,22,4,43,24,19,"December, 2012"
2012-2013,19,2012-12-26,Sunderland,Man City,1,0,H,3,0,1,2,2,3,1,1,15,2,19,39,13,20,December,-2.4492935982947064e-16,1.0,40,27,2,1,2,1.0,2.2,19,24,-5,34,15,19,"December, 2012"
2012-2013,19,2012-12-26,Stoke,Liverpool,3,1,H,3,0,2,2,1,3,2,0,10,8,25,25,2,0,December,-2.4492935982947064e-16,1.0,39,25,2,2,1,0.6,0.4,15,13,2,27,23,4,"December, 2012"
2012-2013,19,2012-12-26,Reading,Swansea,0,0,D,1,1,1,1,3,1,1,3,20,11,9,24,9,15,December,-2.4492935982947064e-16,1.0,35,41,0,1,0,2.0,2.0,21,37,-16,27,23,4,"December, 2012"
2012-2013,19,2012-12-26,QPR,West Brom,1,2,A,0,3,0,1,4,1,1,3,19,7,10,30,12,20,December,-2.4492935982947064e-16,1.0,34,44,0,1,2,1.0,1.6666666666666667,15,31,-16,26,22,4,"December, 2012"
2012-2013,19,2012-12-26,Aston Villa,Tottenham,0,4,A,0,3,2,1,2,3,2,0,16,6,18,30,10,12,December,-2.4492935982947064e-16,1.0,1,42,0,1,4,0.6,1.8,15,32,-17,30,25,5,"December, 2012"
2012-2013,19,2012-12-26,Man United,Newcastle,4,3,H,3,0,2,2,1,1,2,2,1,14,43,20,13,23,December,-2.4492935982947064e-16,1.0,28,30,2,2,1,1.4,0.8,44,25,19,20,26,-6,"December, 2012"
2012-2013,19,2012-12-26,Fulham,Southampton,1,1,D,1,1,1,0,4,0,3,2,13,17,20,15,4,5,December,-2.4492935982947064e-16,1.0,19,38,2,3,0,1.6,1.0,28,33,-5,22,33,-11,"December, 2012"
2012-2013,19,2012-12-26,Everton,Wigan,2,1,H,3,0,2,1,2,1,2,2,6,18,30,15,12,15,December,-2.4492935982947064e-16,1.0,18,46,1,4,0,1.4,1.0,30,22,8,18,33,-15,"December, 2012"
2012-2013,19,2012-12-26,Norwich,Chelsea,0,1,A,0,3,3,0,2,4,1,0,10,5,25,32,5,7,December,-2.4492935982947064e-16,1.0,31,14,0,1,4,0.6,2.8,20,27,-7,36,17,19,"December, 2012"
2012-2013,20,2012-12-29,Reading,West Ham,1,0,H,3,0,1,1,3,2,1,2,19,12,10,23,7,13,December,-2.4492935982947064e-16,1.0,35,45,2,1,1,2.0,1.0,21,37,-16,22,22,0,"December, 2012"
2012-2013,20,2012-12-29,Sunderland,Tottenham,1,2,A,0,3,1,2,2,3,2,0,13,5,22,33,8,11,December,-2.4492935982947064e-16,1.0,40,42,1,2,2,1.0,1.0,20,24,-4,34,25,9,"December, 2012"
2012-2013,20,2012-12-29,Stoke,Southampton,3,3,D,1,1,2,2,1,0,3,2,9,18,28,16,9,12,December,-2.4492935982947064e-16,1.0,39,38,0,0,0,0.0,0.0,18,14,4,23,34,-11,"December, 2012"
2012-2013,20,2012-12-29,Norwich,Man City,3,4,A,0,3,3,0,2,3,1,1,11,2,25,39,9,14,December,-2.4492935982947064e-16,1.0,31,27,0,1,3,1.25,3.75,20,28,-8,34,16,18,"December, 2012"
2012-2013,20,2012-12-29,Aston Villa,Wigan,0,3,A,0,3,2,1,2,1,2,2,16,18,18,15,2,3,December,-2.4492935982947064e-16,1.0,1,46,3,2,0,1.4,0.6,15,36,-21,19,35,-16,"December, 2012"
2012-2013,20,2012-12-29,Fulham,Swansea,1,2,A,0,3,1,0,4,1,1,3,14,9,21,25,5,4,December,-2.4492935982947064e-16,1.0,19,41,0,0,2,0.0,2.5,29,34,-5,27,23,4,"December, 2012"
2012-2013,20,2012-12-29,Arsenal,Newcastle,7,3,H,3,0,4,1,0,1,2,2,7,15,30,20,8,10,December,-2.4492935982947064e-16,1.0,0,30,2,2,1,1.8,1.4,32,18,14,23,30,-7,"December, 2012"
2012-2013,20,2012-12-29,Man United,West Brom,2,0,H,3,0,2,2,1,1,1,3,1,7,46,33,6,13,December,-2.4492935982947064e-16,1.0,28,44,4,1,0,2.6,0.8,48,28,20,28,23,5,"December, 2012"
2012-2013,20,2012-12-30,Everton,Chelsea,1,2,A,0,3,2,1,2,4,1,0,6,4,33,35,2,2,December,-2.4492935982947064e-16,1.0,18,14,3,1,1,1.4,1.0,32,23,9,37,17,20,"December, 2012"
2012-2013,20,2012-12-30,QPR,Liverpool,0,3,A,0,3,0,1,4,3,2,0,20,10,10,25,10,15,December,-2.4492935982947064e-16,1.0,34,25,1,0,3,1.0,1.5,16,33,-17,28,26,2,"December, 2012"
2012-2013,21,2013-01-01,Wigan,Man United,0,4,A,0,3,1,2,2,2,2,1,18,1,18,49,17,31,January,0.4999999999999999,0.8660254037844387,46,28,1,0,4,0.2,3.0,22,35,-13,50,28,22,"January, 2013"
2012-2013,21,2013-01-01,West Ham,Norwich,2,1,H,3,0,2,1,2,3,0,2,13,11,23,25,2,2,January,0.4999999999999999,0.8660254037844387,45,31,0,1,0,0.0,0.0,22,23,-1,23,32,-9,"January, 2013"
2012-2013,21,2013-01-01,Tottenham,Reading,3,1,H,3,0,3,2,0,1,1,3,4,19,36,13,15,23,January,0.4999999999999999,0.8660254037844387,42,35,4,0,1,2.4,1.6,36,26,10,22,37,-15,"January, 2013"
2012-2013,21,2013-01-01,West Brom,Fulham,1,2,A,0,3,1,1,3,1,0,4,7,14,33,21,7,12,January,0.4999999999999999,0.8660254037844387,44,19,1,2,2,0.6,1.6,28,25,3,30,36,-6,"January, 2013"
2012-2013,21,2013-01-01,Southampton,Arsenal,1,1,D,1,1,0,3,2,4,1,0,18,5,17,33,13,16,January,0.4999999999999999,0.8660254037844387,38,0,0,2,3,0.8,2.4,26,37,-11,39,21,18,"January, 2013"
2012-2013,21,2013-01-01,Man City,Stoke,3,0,H,3,0,3,1,1,2,2,1,2,8,42,29,6,13,January,0.4999999999999999,0.8660254037844387,27,39,2,3,0,1.8,0.6,38,19,19,21,17,4,"January, 2013"
2012-2013,21,2013-01-01,Swansea,Aston Villa,2,2,D,1,1,1,1,3,2,1,2,10,18,28,18,8,10,January,0.4999999999999999,0.8660254037844387,41,1,1,1,1,0.6666666666666666,0.6666666666666666,29,24,5,15,39,-24,"January, 2013"
2012-2013,21,2013-01-02,Chelsea,QPR,0,1,A,0,3,4,1,0,0,1,4,4,20,38,10,16,28,January,0.4999999999999999,0.8660254037844387,14,34,2,2,1,1.8,0.8,39,18,21,16,36,-20,"January, 2013"
2012-2013,21,2013-01-02,Liverpool,Sunderland,3,0,H,3,0,3,2,0,1,2,2,10,14,28,22,4,6,January,0.4999999999999999,0.8660254037844387,25,40,1,3,1,1.2,1.0,31,26,5,21,26,-5,"January, 2013"
2012-2013,21,2013-01-02,Newcastle,Everton,1,2,A,0,3,1,2,2,2,1,2,15,6,20,33,9,13,January,0.4999999999999999,0.8660254037844387,30,18,2,1,2,1.4,1.6,26,37,-11,33,25,8,"January, 2013"
2012-2013,22,2013-01-12,Sunderland,West Ham,3,0,H,3,0,1,2,2,2,1,2,14,11,22,26,3,4,January,0.4999999999999999,0.8660254037844387,40,45,2,2,1,1.4,0.8,21,29,-8,24,24,0,"January, 2013"
2012-2013,22,2013-01-12,Stoke,Chelsea,0,4,A,0,3,2,2,1,4,1,0,10,4,29,38,6,9,January,0.4999999999999999,0.8660254037844387,39,14,0,2,3,0.2,1.0,21,20,1,39,19,20,"January, 2013"
2012-2013,22,2013-01-12,Reading,West Brom,3,2,H,3,0,1,1,3,1,1,3,20,7,13,33,13,20,January,0.4999999999999999,0.8660254037844387,35,44,0,0,1,0.0,1.0,23,40,-17,29,27,2,"January, 2013"
2012-2013,22,2013-01-12,QPR,Tottenham,0,0,D,1,1,0,1,4,3,2,0,20,3,13,39,17,26,January,0.4999999999999999,0.8660254037844387,34,42,1,0,4,1.0,1.8,17,36,-19,39,27,12,"January, 2013"
2012-2013,22,2013-01-12,Fulham,Wigan,1,1,D,1,1,1,0,4,1,2,2,13,18,24,18,5,6,January,0.4999999999999999,0.8660254037844387,19,46,4,1,0,1.8,0.6,32,37,-5,22,39,-17,"January, 2013"
2012-2013,22,2013-01-12,Everton,Swansea,0,0,D,1,1,2,1,2,1,1,3,5,9,36,29,4,7,January,0.4999999999999999,0.8660254037844387,18,41,3,0,0,2.0,0.0,35,26,9,31,26,5,"January, 2013"
2012-2013,22,2013-01-12,Aston Villa,Southampton,0,1,A,0,3,2,1,2,0,3,2,16,17,19,18,1,1,January,0.4999999999999999,0.8660254037844387,1,38,3,1,1,1.6,1.4,17,41,-24,27,38,-11,"January, 2013"
2012-2013,22,2013-01-12,Norwich,Newcastle,0,0,D,1,1,3,0,2,1,2,2,13,16,25,20,3,5,January,0.4999999999999999,0.8660254037844387,31,30,2,1,2,1.6,1.4,24,34,-10,27,39,-12,"January, 2013"
2012-2013,22,2013-01-13,Arsenal,Man City,0,2,A,0,3,4,1,0,3,1,1,6,2,34,45,4,11,January,0.4999999999999999,0.8660254037844387,0,27,2,2,1,1.0,0.4,40,22,18,41,19,22,"January, 2013"
2012-2013,22,2013-01-13,Man United,Liverpool,2,1,H,3,0,2,2,1,3,2,0,1,8,52,31,7,21,January,0.4999999999999999,0.8660254037844387,28,25,3,1,1,1.8,1.6,54,28,26,34,26,8,"January, 2013"
2012-2013,22,2013-01-16,Chelsea,Southampton,2,2,D,1,1,4,1,0,0,3,2,3,15,41,21,12,20,January,0.4999999999999999,0.8660254037844387,14,38,4,1,0,2.0,0.4,43,19,24,28,38,-10,"January, 2013"
2012-2013,23,2013-01-19,Wigan,Sunderland,2,3,A,0,3,1,2,2,1,2,2,19,13,19,25,6,6,January,0.4999999999999999,0.8660254037844387,46,40,1,1,3,1.2,2.2,23,40,-17,24,29,-5,"January, 2013"
2012-2013,23,2013-01-19,West Ham,QPR,1,1,D,1,1,2,1,2,0,1,4,11,20,26,14,9,12,January,0.4999999999999999,0.8660254037844387,45,34,2,0,1,1.0,1.3333333333333333,24,27,-3,17,36,-19,"January, 2013"
2012-2013,23,2013-01-19,West Brom,Aston Villa,2,2,D,1,1,1,1,3,2,1,2,9,19,33,19,10,14,January,0.4999999999999999,0.8660254037844387,44,1,2,2,1,1.2,1.0,31,30,1,17,42,-25,"January, 2013"
2012-2013,23,2013-01-19,Newcastle,Reading,1,2,A,0,3,1,2,2,1,1,3,16,19,21,16,3,5,January,0.4999999999999999,0.8660254037844387,30,35,2,1,2,1.8,1.4,27,39,-12,26,42,-16,"January, 2013"
2012-2013,23,2013-01-19,Man City,Fulham,2,0,H,3,0,3,1,1,1,0,4,2,13,48,25,11,23,January,0.4999999999999999,0.8660254037844387,27,19,3,2,0,2.4,1.0,43,19,24,33,38,-5,"January, 2013"
2012-2013,23,2013-01-19,Liverpool,Norwich,5,0,H,3,0,3,2,0,3,0,2,8,12,31,26,4,5,January,0.4999999999999999,0.8660254037844387,25,31,4,1,0,2.8,0.8,35,28,7,24,34,-10,"January, 2013"
2012-2013,23,2013-01-19,Swansea,Stoke,3,1,H,3,0,1,1,3,2,2,1,9,10,30,29,1,1,January,0.4999999999999999,0.8660254037844387,41,39,1,0,2,0.6666666666666666,1.3333333333333333,31,26,5,21,24,-3,"January, 2013"
2012-2013,23,2013-01-20,Chelsea,Arsenal,2,1,H,3,0,4,1,0,4,1,0,3,6,42,34,3,8,January,0.4999999999999999,0.8660254037844387,14,0,2,1,2,1.6,1.8,45,21,24,40,24,16,"January, 2013"
2012-2013,23,2013-01-20,Tottenham,Man United,1,1,D,1,1,3,2,0,2,2,1,4,1,40,55,3,15,January,0.4999999999999999,0.8660254037844387,42,28,1,1,3,0.8,2.0,39,27,12,56,29,27,"January, 2013"
2012-2013,23,2013-01-21,Southampton,Everton,0,0,D,1,1,0,3,2,2,1,2,15,5,22,37,10,15,January,0.4999999999999999,0.8660254037844387,38,18,0,3,2,1.2,1.8,30,40,-10,35,26,9,"January, 2013"
2012-2013,23,2013-01-23,Arsenal,West Ham,5,1,H,3,0,4,1,0,2,1,2,6,12,34,27,6,7,January,0.4999999999999999,0.8660254037844387,0,45,4,1,0,2.2,0.6,41,26,15,25,28,-3,"January, 2013"
2012-2013,24,2013-01-29,Sunderland,Swansea,0,0,D,1,1,1,2,2,1,1,3,11,9,28,33,2,5,January,0.4999999999999999,0.8660254037844387,40,41,1,2,0,1.3333333333333333,0.6666666666666666,27,31,-4,34,27,7,"January, 2013"
2012-2013,24,2013-01-29,Stoke,Wigan,2,2,D,1,1,2,2,1,1,2,2,10,19,29,19,9,10,January,0.4999999999999999,0.8660254037844387,39,46,0,3,2,1.2,1.8,22,27,-5,25,43,-18,"January, 2013"
2012-2013,24,2013-01-29,Aston Villa,Newcastle,1,2,A,0,3,2,1,2,1,2,2,17,16,20,21,1,1,January,0.4999999999999999,0.8660254037844387,1,30,1,2,2,0.8,2.0,19,44,-25,28,41,-13,"January, 2013"
2012-2013,24,2013-01-29,QPR,Man City,0,0,D,1,1,0,1,4,3,1,1,20,2,15,51,18,36,January,0.4999999999999999,0.8660254037844387,34,27,1,0,4,1.2,2.2,18,37,-19,45,19,26,"January, 2013"
2012-2013,24,2013-01-30,Arsenal,Liverpool,2,2,D,1,1,4,1,0,3,2,0,6,7,37,34,1,3,January,0.4999999999999999,0.8660254037844387,0,25,2,2,1,1.2,1.0,46,27,19,40,28,12,"January, 2013"
2012-2013,24,2013-01-30,Everton,West Brom,2,1,H,3,0,2,1,2,1,1,3,6,9,38,34,3,4,January,0.4999999999999999,0.8660254037844387,18,44,2,0,3,0.8,1.4,35,26,9,33,32,1,"January, 2013"
2012-2013,24,2013-01-30,Fulham,West Ham,3,1,H,3,0,1,0,4,2,1,2,14,12,25,27,2,2,January,0.4999999999999999,0.8660254037844387,19,45,1,2,2,1.4,2.2,33,40,-7,26,33,-7,"January, 2013"
2012-2013,24,2013-01-30,Man United,Southampton,2,1,H,3,0,2,2,1,0,3,2,1,16,56,23,15,33,January,0.4999999999999999,0.8660254037844387,28,38,4,0,1,2.2,1.2,57,30,27,30,40,-10,"January, 2013"
2012-2013,24,2013-01-30,Norwich,Tottenham,1,1,D,1,1,3,0,2,3,2,0,14,4,26,41,10,15,January,0.4999999999999999,0.8660254037844387,31,42,1,2,2,0.6,1.2,24,39,-15,40,28,12,"January, 2013"
2012-2013,24,2013-01-30,Reading,Chelsea,2,2,D,1,1,1,1,3,4,1,0,19,3,19,45,16,26,January,0.4999999999999999,0.8660254037844387,35,14,0,1,4,1.0,2.0,28,43,-15,47,22,25,"January, 2013"
2012-2013,25,2013-02-02,Fulham,Man United,0,1,A,0,3,1,0,4,2,2,1,12,1,28,59,11,31,February,0.8660254037844386,0.5000000000000001,19,28,0,1,4,0.8,2.6,36,41,-5,59,31,28,"February, 2013"
2012-2013,25,2013-02-02,Wigan,Southampton,2,2,D,1,1,1,2,2,0,3,2,19,16,20,23,3,3,February,0.8660254037844386,0.5000000000000001,46,38,1,0,0,2.0,0.0,27,45,-18,31,42,-11,"February, 2013"
2012-2013,25,2013-02-02,West Ham,Swansea,1,0,H,3,0,2,1,2,1,1,3,14,8,27,34,6,7,February,0.8660254037844386,0.5000000000000001,45,41,0,0,1,0.0,3.0,27,36,-9,34,27,7,"February, 2013"
2012-2013,25,2013-02-02,Reading,Sunderland,2,1,H,3,0,1,1,3,1,2,2,18,11,20,29,7,9,February,0.8660254037844386,0.5000000000000001,35,40,1,0,2,1.0,2.0,30,45,-15,27,31,-4,"February, 2013"
2012-2013,25,2013-02-02,Arsenal,Stoke,1,0,H,3,0,4,1,0,2,2,1,6,10,38,30,4,8,February,0.8660254037844386,0.5000000000000001,0,39,2,2,1,1.2,1.0,48,29,19,24,29,-5,"February, 2013"
2012-2013,25,2013-02-02,Newcastle,Chelsea,3,2,H,3,0,1,2,2,4,1,0,15,3,24,46,12,22,February,0.8660254037844386,0.5000000000000001,30,14,1,2,2,1.0,1.6,30,42,-12,49,24,25,"February, 2013"
2012-2013,25,2013-02-02,Everton,Aston Villa,3,3,D,1,1,2,1,2,2,1,2,6,19,41,20,13,21,February,0.8660254037844386,0.5000000000000001,18,1,1,3,1,1.6,1.4,37,27,10,20,46,-26,"February, 2013"
2012-2013,25,2013-02-02,QPR,Norwich,0,0,D,1,1,0,1,4,3,0,2,20,15,16,27,5,11,February,0.8660254037844386,0.5000000000000001,34,31,0,1,2,1.0,1.6666666666666667,18,37,-19,25,40,-15,"February, 2013"
2012-2013,25,2013-02-03,Man City,Liverpool,2,2,D,1,1,3,1,1,3,2,0,2,7,52,35,5,17,February,0.8660254037844386,0.5000000000000001,27,25,2,2,1,1.8,1.2,45,19,26,42,30,12,"February, 2013"
2012-2013,25,2013-02-03,West Brom,Tottenham,0,1,A,0,3,1,1,3,3,2,0,9,4,34,42,5,8,February,0.8660254037844386,0.5000000000000001,44,42,0,3,2,1.0,1.6,34,34,0,41,29,12,"February, 2013"
2012-2013,26,2013-02-09,Sunderland,Arsenal,0,1,A,0,3,1,2,2,4,1,0,12,6,29,41,6,12,February,0.8660254037844386,0.5000000000000001,40,0,0,3,2,0.6,1.0,28,33,-5,49,29,20,"February, 2013"
2012-2013,26,2013-02-09,Tottenham,Newcastle,2,1,H,3,0,3,2,0,1,2,2,4,16,45,27,12,18,February,0.8660254037844386,0.5000000000000001,42,30,2,2,1,2.2,1.0,42,29,13,33,44,-11,"February, 2013"
2012-2013,26,2013-02-09,Stoke,Reading,2,1,H,3,0,2,2,1,1,1,3,10,17,30,23,7,7,February,0.8660254037844386,0.5000000000000001,39,35,0,1,0,1.0,1.0,24,30,-6,32,46,-14,"February, 2013"
2012-2013,26,2013-02-09,Swansea,QPR,4,1,H,3,0,1,1,3,0,1,4,8,20,34,17,12,17,February,0.8660254037844386,0.5000000000000001,41,34,1,1,1,2.0,1.3333333333333333,34,28,6,18,37,-19,"February, 2013"
2012-2013,26,2013-02-09,Norwich,Fulham,0,0,D,1,1,3,0,2,1,0,4,14,13,28,28,1,0,February,0.8660254037844386,0.5000000000000001,31,19,0,1,4,0.4,3.0,25,40,-15,36,42,-6,"February, 2013"
2012-2013,26,2013-02-09,Chelsea,Wigan,4,1,H,3,0,4,1,0,1,2,2,3,18,46,21,15,25,February,0.8660254037844386,0.5000000000000001,14,46,4,1,0,2.4,0.4,51,27,24,29,47,-18,"February, 2013"
2012-2013,26,2013-02-09,Southampton,Man City,3,1,H,3,0,0,3,2,3,1,1,16,2,24,53,14,29,February,0.8660254037844386,0.5000000000000001,38,27,1,1,3,1.2,1.6,33,44,-11,47,21,26,"February, 2013"
2012-2013,26,2013-02-10,Aston Villa,West Ham,2,1,H,3,0,2,1,2,2,1,2,19,11,21,30,8,9,February,0.8660254037844386,0.5000000000000001,1,45,2,1,2,1.2,0.8,23,49,-26,28,36,-8,"February, 2013"
2012-2013,26,2013-02-10,Man United,Everton,2,0,H,3,0,2,2,1,2,1,2,1,6,62,42,5,20,February,0.8660254037844386,0.5000000000000001,28,18,2,2,1,1.8,1.6,60,31,29,40,30,10,"February, 2013"
2012-2013,26,2013-02-11,Liverpool,West Brom,0,2,A,0,3,3,2,0,1,1,3,8,9,36,34,1,2,February,0.8660254037844386,0.5000000000000001,25,44,2,0,3,0.8,1.2,44,32,12,34,35,-1,"February, 2013"
2012-2013,26,2013-02-17,Liverpool,Swansea,5,0,H,3,0,3,2,0,1,1,3,9,7,36,37,2,1,February,0.8660254037844386,0.5000000000000001,25,41,0,2,1,0.0,0.3333333333333333,44,34,10,38,29,9,"February, 2013"
2012-2013,27,2013-02-23,West Brom,Sunderland,2,1,H,3,0,1,1,3,1,2,2,9,14,37,29,5,8,February,0.8660254037844386,0.5000000000000001,44,40,4,1,0,2.8,1.2,36,35,1,28,34,-6,"February, 2013"
2012-2013,27,2013-02-23,Reading,Wigan,0,3,A,0,3,1,1,3,1,2,2,18,19,23,21,1,2,February,0.8660254037844386,0.5000000000000001,35,46,2,1,2,1.4,1.4,33,48,-15,30,51,-21,"February, 2013"
2012-2013,27,2013-02-23,QPR,Man United,0,2,A,0,3,0,1,4,2,2,1,20,1,17,65,19,48,February,0.8660254037844386,0.5000000000000001,34,28,0,1,4,0.6,2.0,19,41,-22,62,31,31,"February, 2013"
2012-2013,27,2013-02-23,Norwich,Everton,2,1,H,3,0,3,0,2,2,1,2,14,6,29,42,8,13,February,0.8660254037844386,0.5000000000000001,31,18,0,3,2,1.2,1.6,25,40,-15,40,32,8,"February, 2013"
2012-2013,27,2013-02-23,Fulham,Stoke,1,0,H,3,0,1,0,4,2,2,1,12,10,29,33,2,4,February,0.8660254037844386,0.5000000000000001,19,39,3,0,2,1.2,0.8,36,42,-6,26,31,-5,"February, 2013"
2012-2013,27,2013-02-23,Arsenal,Aston Villa,2,1,H,3,0,4,1,0,2,1,2,5,17,44,24,12,20,February,0.8660254037844386,0.5000000000000001,0,1,3,1,1,2.0,1.0,50,29,21,25,50,-25,"February, 2013"
2012-2013,27,2013-02-24,Man City,Chelsea,2,0,H,3,0,3,1,1,4,1,0,2,3,53,49,1,4,February,0.8660254037844386,0.5000000000000001,27,14,2,1,2,0.8,1.0,48,24,24,55,28,27,"February, 2013"
2012-2013,27,2013-02-24,Newcastle,Southampton,4,2,H,3,0,1,2,2,0,3,2,16,15,27,27,1,0,February,0.8660254037844386,0.5000000000000001,30,38,3,1,1,1.6,1.4,34,46,-12,36,45,-9,"February, 2013"
2012-2013,27,2013-02-25,West Ham,Tottenham,2,3,A,0,3,2,1,2,3,2,0,13,4,30,48,9,18,February,0.8660254037844386,0.5000000000000001,45,42,1,1,3,0.6,1.4,29,38,-9,44,30,14,"February, 2013"
2012-2013,28,2013-03-02,Wigan,Liverpool,0,4,A,0,3,1,2,2,3,2,0,17,9,24,39,8,15,March,1.0,6.123233995736766e-17,46,25,1,3,1,0.8,1.2,33,51,-18,49,34,15,"March, 2013"
2012-2013,28,2013-03-02,Sunderland,Fulham,2,2,D,1,1,1,2,2,1,0,4,15,12,29,32,3,3,March,1.0,6.123233995736766e-17,40,19,1,2,2,0.8,1.2,29,36,-7,37,42,-5,"March, 2013"
2012-2013,28,2013-03-02,Stoke,West Ham,0,1,A,0,3,2,2,1,2,1,2,10,14,33,30,4,3,March,1.0,6.123233995736766e-17,39,45,2,2,1,1.0,1.2,26,32,-6,31,41,-10,"March, 2013"
2012-2013,28,2013-03-02,Swansea,Newcastle,1,0,H,3,0,1,1,3,1,2,2,9,15,37,30,6,7,March,1.0,6.123233995736766e-17,41,30,1,1,1,0.6666666666666666,1.0,38,34,4,38,48,-10,"March, 2013"
2012-2013,28,2013-03-02,Man United,Norwich,4,0,H,3,0,2,2,1,3,0,2,1,12,68,32,11,36,March,1.0,6.123233995736766e-17,28,31,3,0,2,1.2,1.0,64,31,33,27,41,-14,"March, 2013"
2012-2013,28,2013-03-02,Everton,Reading,3,1,H,3,0,2,1,2,1,1,3,6,19,42,23,13,19,March,1.0,6.123233995736766e-17,18,35,2,1,2,1.0,0.8,41,34,7,33,51,-18,"March, 2013"
2012-2013,28,2013-03-02,Chelsea,West Brom,1,0,H,3,0,4,1,0,1,1,3,4,7,49,40,3,9,March,1.0,6.123233995736766e-17,14,44,3,0,2,2.4,1.0,55,30,25,38,36,2,"March, 2013"
2012-2013,28,2013-03-02,Southampton,QPR,1,2,A,0,3,0,3,2,0,1,4,16,20,27,17,4,10,March,1.0,6.123233995736766e-17,38,34,2,0,1,1.6666666666666667,1.3333333333333333,38,49,-11,19,43,-24,"March, 2013"
2012-2013,28,2013-03-03,Tottenham,Arsenal,2,1,H,3,0,3,2,0,4,1,0,4,5,51,47,1,4,March,1.0,6.123233995736766e-17,42,0,2,1,2,2.4,3.2,47,32,15,52,30,22,"March, 2013"
2012-2013,28,2013-03-04,Aston Villa,Man City,0,1,A,0,3,2,1,2,3,1,1,18,2,24,56,16,32,March,1.0,6.123233995736766e-17,1,27,1,0,4,0.4,2.8,26,52,-26,50,24,26,"March, 2013"
2012-2013,29,2013-03-09,Norwich,Southampton,0,0,D,1,1,3,0,2,0,3,2,13,16,32,27,3,5,March,1.0,6.123233995736766e-17,31,38,1,1,1,2.0,2.0,27,45,-18,39,51,-12,"March, 2013"
2012-2013,29,2013-03-09,QPR,Sunderland,3,1,H,3,0,0,1,4,1,2,2,20,14,20,30,6,10,March,1.0,6.123233995736766e-17,34,40,0,1,2,1.0,2.0,21,44,-23,31,38,-7,"March, 2013"
2012-2013,29,2013-03-09,Reading,Aston Villa,1,2,A,0,3,1,1,3,2,1,2,19,18,23,24,1,1,March,1.0,6.123233995736766e-17,35,1,1,0,4,1.0,1.6,34,54,-20,26,53,-27,"March, 2013"
2012-2013,29,2013-03-09,West Brom,Swansea,2,1,H,3,0,1,1,3,1,1,3,9,8,40,40,1,0,March,1.0,6.123233995736766e-17,44,41,0,0,3,0.6666666666666666,2.6666666666666665,38,37,1,39,34,5,"March, 2013"
2012-2013,29,2013-03-10,Liverpool,Tottenham,3,2,H,3,0,3,2,0,3,2,0,8,3,42,54,5,12,March,1.0,6.123233995736766e-17,25,42,0,1,4,0.4,2.0,53,34,19,49,33,16,"March, 2013"
2012-2013,29,2013-03-10,Newcastle,Stoke,2,1,H,3,0,1,2,2,2,2,1,15,11,30,33,4,3,March,1.0,6.123233995736766e-17,30,39,2,0,3,1.6,1.8,38,49,-11,26,33,-7,"March, 2013"
2012-2013,30,2013-03-16,Swansea,Arsenal,0,2,A,0,3,1,1,3,4,1,0,9,6,40,47,3,7,March,1.0,6.123233995736766e-17,41,0,2,0,1,1.6666666666666667,1.0,40,36,4,53,32,21,"March, 2013"
2012-2013,30,2013-03-16,Stoke,West Brom,0,0,D,1,1,2,2,1,1,1,3,11,8,33,43,3,10,March,1.0,6.123233995736766e-17,39,44,3,1,1,1.4,0.6,27,35,-8,40,38,2,"March, 2013"
2012-2013,30,2013-03-16,Southampton,Liverpool,3,1,H,3,0,0,3,2,3,2,0,17,7,28,45,10,17,March,1.0,6.123233995736766e-17,38,25,3,0,2,1.2,0.6,39,51,-12,56,36,20,"March, 2013"
2012-2013,30,2013-03-16,Aston Villa,QPR,3,2,H,3,0,2,1,2,0,1,4,17,20,27,23,3,4,March,1.0,6.123233995736766e-17,1,34,1,3,1,1.6,1.4,28,54,-26,24,45,-21,"March, 2013"
2012-2013,30,2013-03-16,Everton,Man City,2,0,H,3,0,2,1,2,3,1,1,7,2,45,59,5,14,March,1.0,6.123233995736766e-17,18,27,3,1,1,1.2,1.0,44,35,9,51,24,27,"March, 2013"
2012-2013,30,2013-03-16,Man United,Reading,1,0,H,3,0,2,2,1,1,1,3,1,19,71,23,18,48,March,1.0,6.123233995736766e-17,28,35,3,2,0,2.0,1.2,68,31,37,35,56,-21,"March, 2013"
2012-2013,30,2013-03-17,Chelsea,West Ham,2,0,H,3,0,4,1,0,2,1,2,4,12,52,33,8,19,March,1.0,6.123233995736766e-17,14,45,3,1,1,2.4,1.2,56,30,26,32,41,-9,"March, 2013"
2012-2013,30,2013-03-17,Sunderland,Norwich,1,1,D,1,1,1,2,2,3,0,2,16,14,30,33,2,3,March,1.0,6.123233995736766e-17,40,31,1,0,2,1.6666666666666667,1.3333333333333333,32,41,-9,27,45,-18,"March, 2013"
2012-2013,30,2013-03-17,Tottenham,Fulham,0,1,A,0,3,3,2,0,1,0,4,4,12,54,33,8,21,March,1.0,6.123233995736766e-17,42,19,5,0,0,2.2,0.4,51,36,15,39,44,-5,"March, 2013"
2012-2013,30,2013-03-17,Wigan,Newcastle,2,1,H,3,0,1,2,2,1,2,2,18,13,24,33,5,9,March,1.0,6.123233995736766e-17,46,30,1,1,3,1.2,1.4,33,55,-22,40,50,-10,"March, 2013"
2012-2013,31,2013-03-30,Swansea,Tottenham,1,2,A,0,3,1,1,3,3,2,0,9,4,40,54,5,14,March,1.0,6.123233995736766e-17,41,42,0,1,2,0.6666666666666666,1.6666666666666667,40,38,2,51,37,14,"March, 2013"
2012-2013,31,2013-03-30,Wigan,Norwich,1,0,H,3,0,1,2,2,3,0,2,18,14,27,34,4,7,March,1.0,6.123233995736766e-17,46,31,0,2,1,1.0,1.3333333333333333,35,56,-21,28,46,-18,"March, 2013"
2012-2013,31,2013-03-30,Sunderland,Man United,0,1,A,0,3,1,2,2,2,2,1,16,1,31,74,15,43,March,1.0,6.123233995736766e-17,40,28,0,1,4,0.2,1.4,33,42,-9,69,31,38,"March, 2013"
2012-2013,31,2013-03-30,West Ham,West Brom,3,1,H,3,0,2,1,2,1,1,3,14,8,33,44,6,11,March,1.0,6.123233995736766e-17,45,44,0,4,1,1.4,1.6,32,43,-11,40,38,2,"March, 2013"
2012-2013,31,2013-03-30,Man City,Newcastle,4,0,H,3,0,3,1,1,1,2,2,2,13,59,33,11,26,March,1.0,6.123233995736766e-17,27,30,5,0,0,2.6,0.8,51,26,25,41,52,-11,"March, 2013"
2012-2013,31,2013-03-30,Arsenal,Reading,4,1,H,3,0,4,1,0,1,1,3,5,19,50,23,14,27,March,1.0,6.123233995736766e-17,0,35,5,0,0,3.2,0.8,55,32,23,35,57,-22,"March, 2013"
2012-2013,31,2013-03-30,Southampton,Chelsea,2,1,H,3,0,0,3,2,4,1,0,16,3,31,55,13,24,March,1.0,6.123233995736766e-17,38,14,0,1,4,0.8,2.4,42,52,-10,58,30,28,"March, 2013"
2012-2013,31,2013-03-30,Everton,Stoke,1,0,H,3,0,2,1,2,2,2,1,6,11,48,34,5,14,March,1.0,6.123233995736766e-17,18,39,1,2,2,0.6,1.0,46,35,11,27,35,-8,"March, 2013"
2012-2013,31,2013-03-31,Aston Villa,Liverpool,1,2,A,0,3,2,1,2,3,2,0,18,7,30,45,11,15,March,1.0,6.123233995736766e-17,1,25,2,1,2,1.0,1.4,31,56,-25,57,39,18,"March, 2013"
2012-2013,31,2013-04-01,Fulham,QPR,3,2,H,3,0,1,0,4,0,1,4,10,19,36,23,9,13,April,0.8660254037844388,-0.4999999999999998,19,34,2,0,1,2.6666666666666665,0.6666666666666666,40,44,-4,26,48,-22,"April, 2013"
2012-2013,32,2013-04-06,Norwich,Swansea,2,2,D,1,1,3,0,2,1,1,3,14,9,34,40,5,6,April,0.8660254037844388,-0.4999999999999998,31,41,3,0,0,3.333333333333333,2.0,28,47,-19,41,40,1,"April, 2013"
2012-2013,32,2013-04-06,Reading,Southampton,0,2,A,0,3,1,1,3,0,3,2,20,13,23,34,7,11,April,0.8660254037844388,-0.4999999999999998,35,38,0,0,1,0.0,1.0,36,61,-25,44,53,-9,"April, 2013"
2012-2013,32,2013-04-06,Stoke,Aston Villa,1,3,A,0,3,2,2,1,2,1,2,14,18,34,30,4,4,April,0.8660254037844388,-0.4999999999999998,39,1,1,4,0,0.8,0.6,27,36,-9,32,58,-26,"April, 2013"
2012-2013,32,2013-04-06,West Brom,Arsenal,1,2,A,0,3,1,1,3,4,1,0,8,5,44,53,3,9,April,0.8660254037844388,-0.4999999999999998,44,0,1,1,3,1.4,2.4,41,41,0,59,33,26,"April, 2013"
2012-2013,32,2013-04-07,Tottenham,Everton,2,2,D,1,1,3,2,0,2,1,2,4,6,57,51,2,6,April,0.8660254037844388,-0.4999999999999998,42,18,1,1,3,1.0,1.2,53,38,15,47,35,12,"April, 2013"
2012-2013,32,2013-04-07,QPR,Wigan,1,1,D,1,1,0,1,4,1,2,2,19,18,23,30,1,7,April,0.8660254037844388,-0.4999999999999998,34,46,1,1,1,1.6666666666666667,1.6666666666666667,28,51,-23,36,56,-20,"April, 2013"
2012-2013,32,2013-04-07,Newcastle,Fulham,1,0,H,3,0,1,2,2,1,0,4,15,10,33,39,5,6,April,0.8660254037844388,-0.4999999999999998,30,19,1,1,3,1.0,1.8,41,56,-15,43,46,-3,"April, 2013"
2012-2013,32,2013-04-07,Liverpool,West Ham,0,0,D,1,1,3,2,0,2,1,2,7,12,48,36,5,12,April,0.8660254037844388,-0.4999999999999998,25,45,4,0,1,2.6,1.4,59,40,19,35,44,-9,"April, 2013"
2012-2013,32,2013-04-07,Chelsea,Sunderland,2,1,H,3,0,4,1,0,1,2,2,5,17,55,31,12,24,April,0.8660254037844388,-0.4999999999999998,14,40,4,0,1,2.0,1.4,59,32,27,33,43,-10,"April, 2013"
2012-2013,32,2013-04-08,Man United,Man City,1,2,A,0,3,2,2,1,3,1,1,1,2,77,62,1,15,April,0.8660254037844388,-0.4999999999999998,28,27,2,1,2,1.2,2.0,70,31,39,55,26,29,"April, 2013"
2012-2013,33,2013-04-13,Arsenal,Norwich,3,1,H,3,0,4,1,0,3,0,2,5,14,56,35,9,21,April,0.8660254037844388,-0.4999999999999998,0,31,3,1,1,2.6,1.4,61,34,27,30,49,-19,"April, 2013"
2012-2013,33,2013-04-13,Aston Villa,Fulham,1,1,D,1,1,2,1,2,1,0,4,16,10,33,39,6,6,April,0.8660254037844388,-0.4999999999999998,1,19,1,3,1,0.8,0.8,35,59,-24,43,47,-4,"April, 2013"
2012-2013,33,2013-04-13,Everton,QPR,2,0,H,3,0,2,1,2,0,1,4,6,19,52,24,13,28,April,0.8660254037844388,-0.4999999999999998,18,34,1,2,2,1.0,1.2,49,37,12,29,52,-23,"April, 2013"
2012-2013,33,2013-04-13,Reading,Liverpool,0,0,D,1,1,1,1,3,3,2,0,20,7,23,49,13,26,April,0.8660254037844388,-0.4999999999999998,35,25,1,0,4,1.0,1.6,36,63,-27,59,40,19,"April, 2013"
2012-2013,33,2013-04-13,Southampton,West Ham,1,1,D,1,1,0,3,2,2,1,2,11,12,37,37,1,0,April,0.8660254037844388,-0.4999999999999998,38,45,2,1,2,1.0,1.4,46,53,-7,35,44,-9,"April, 2013"
2012-2013,33,2013-04-14,Newcastle,Sunderland,0,3,A,0,3,1,2,2,1,2,2,13,17,36,31,4,5,April,0.8660254037844388,-0.4999999999999998,30,40,2,3,0,1.8,0.8,42,56,-14,34,45,-11,"April, 2013"
2012-2013,33,2013-04-14,Stoke,Man United,0,2,A,0,3,2,2,1,2,2,1,16,1,34,77,15,43,April,0.8660254037844388,-0.4999999999999998,39,28,0,1,4,1.0,2.2,28,39,-11,71,33,38,"April, 2013"
2012-2013,34,2013-04-16,Arsenal,Everton,0,0,D,1,1,4,1,0,2,1,2,3,6,59,55,3,4,April,0.8660254037844388,-0.4999999999999998,0,18,4,1,0,1.4,0.6,64,35,29,51,37,14,"April, 2013"
2012-2013,34,2013-04-17,Fulham,Chelsea,0,3,A,0,3,1,0,4,4,1,0,10,4,40,58,6,18,April,0.8660254037844388,-0.4999999999999998,19,14,0,4,1,0.4,0.6,44,48,-4,61,33,28,"April, 2013"
2012-2013,34,2013-04-17,Man City,Wigan,1,0,H,3,0,3,1,1,1,2,2,2,18,65,31,16,34,April,0.8660254037844388,-0.4999999999999998,27,46,5,0,0,1.8,0.0,57,27,30,37,57,-20,"April, 2013"
2012-2013,34,2013-04-17,West Ham,Man United,2,2,D,1,1,2,1,2,2,2,1,12,1,38,80,11,42,April,0.8660254037844388,-0.4999999999999998,45,28,0,0,5,0.4,3.0,36,45,-9,73,33,40,"April, 2013"
2012-2013,35,2013-04-20,West Brom,Newcastle,1,1,D,1,1,1,1,3,1,2,2,8,16,44,36,8,8,April,0.8660254037844388,-0.4999999999999998,44,30,2,1,2,2.2,2.2,42,43,-1,42,59,-17,"April, 2013"
2012-2013,35,2013-04-20,Swansea,Southampton,0,0,D,1,1,1,1,3,0,3,2,9,12,41,38,3,3,April,0.8660254037844388,-0.4999999999999998,41,38,0,1,0,1.0,1.0,43,42,1,47,54,-7,"April, 2013"
2012-2013,35,2013-04-20,Sunderland,Everton,1,0,H,3,0,1,2,2,2,1,2,16,6,34,56,10,22,April,0.8660254037844388,-0.4999999999999998,40,18,0,2,3,0.8,2.2,37,45,-8,51,37,14,"April, 2013"
2012-2013,35,2013-04-20,West Ham,Wigan,2,0,H,3,0,2,1,2,1,2,2,12,18,39,31,6,8,April,0.8660254037844388,-0.4999999999999998,45,46,2,0,3,1.8,1.8,38,47,-9,37,58,-21,"April, 2013"
2012-2013,35,2013-04-20,Norwich,Reading,2,1,H,3,0,3,0,2,1,1,3,14,20,35,24,6,11,April,0.8660254037844388,-0.4999999999999998,31,35,0,1,0,0.0,0.0,31,52,-21,36,63,-27,"April, 2013"
2012-2013,35,2013-04-20,Fulham,Arsenal,0,1,A,0,3,1,0,4,4,1,0,10,4,40,60,6,20,April,0.8660254037844388,-0.4999999999999998,19,0,1,3,1,1.8,1.8,44,51,-7,64,35,29,"April, 2013"
2012-2013,35,2013-04-20,QPR,Stoke,0,2,A,0,3,0,1,4,2,2,1,19,16,24,34,3,10,April,0.8660254037844388,-0.4999999999999998,34,39,2,0,1,1.3333333333333333,1.0,29,54,-25,28,41,-13,"April, 2013"
2012-2013,35,2013-04-21,Liverpool,Chelsea,2,2,D,1,1,3,2,0,4,1,0,7,4,50,61,3,11,April,0.8660254037844388,-0.4999999999999998,25,14,4,1,0,2.0,0.6,59,40,19,64,33,31,"April, 2013"
2012-2013,35,2013-04-21,Tottenham,Man City,3,1,H,3,0,3,2,0,3,1,1,5,2,58,68,3,10,April,0.8660254037844388,-0.4999999999999998,42,27,0,1,4,0.8,2.2,55,40,15,58,27,31,"April, 2013"
2012-2013,35,2013-04-22,Man United,Aston Villa,3,0,H,3,0,2,2,1,2,1,2,1,17,81,34,16,47,April,0.8660254037844388,-0.4999999999999998,28,1,4,1,0,2.6,1.0,75,35,40,36,60,-24,"April, 2013"
2012-2013,36,2013-04-27,Wigan,Tottenham,2,2,D,1,1,1,2,2,3,2,0,18,5,31,61,13,30,April,0.8660254037844388,-0.4999999999999998,46,42,2,1,2,0.8,1.0,37,60,-23,58,41,17,"April, 2013"
2012-2013,36,2013-04-27,Everton,Fulham,1,0,H,3,0,2,1,2,1,0,4,6,11,56,40,5,16,April,0.8660254037844388,-0.4999999999999998,18,19,3,2,0,2.2,0.8,51,38,13,44,52,-8,"April, 2013"
2012-2013,36,2013-04-27,Man City,West Ham,2,1,H,3,0,3,1,1,2,1,2,2,10,68,42,8,26,April,0.8660254037844388,-0.4999999999999998,27,45,3,2,0,1.8,0.8,59,30,29,40,47,-7,"April, 2013"
2012-2013,36,2013-04-27,Newcastle,Liverpool,0,6,A,0,3,1,2,2,3,2,0,16,7,37,51,9,14,April,0.8660254037844388,-0.4999999999999998,30,25,2,1,2,1.4,1.6,43,60,-17,61,42,19,"April, 2013"
2012-2013,36,2013-04-27,Southampton,West Brom,0,3,A,0,3,0,3,2,1,1,3,12,8,39,45,4,6,April,0.8660254037844388,-0.4999999999999998,38,44,1,2,2,0.6,1.0,47,54,-7,43,44,-1,"April, 2013"
2012-2013,36,2013-04-27,Stoke,Norwich,1,0,H,3,0,2,2,1,3,0,2,15,13,37,38,2,1,April,0.8660254037844388,-0.4999999999999998,39,31,1,1,1,0.6666666666666666,0.6666666666666666,30,41,-11,33,53,-20,"April, 2013"
2012-2013,36,2013-04-28,Chelsea,Swansea,2,0,H,3,0,4,1,0,1,1,3,4,9,62,42,5,20,April,0.8660254037844388,-0.4999999999999998,14,41,1,2,0,2.0,1.0,66,35,31,43,42,1,"April, 2013"
2012-2013,36,2013-04-28,Reading,QPR,0,0,D,1,1,1,1,3,0,1,4,20,19,24,24,1,0,April,0.8660254037844388,-0.4999999999999998,35,34,0,1,0,1.0,1.0,37,65,-28,29,56,-27,"April, 2013"
2012-2013,36,2013-04-28,Arsenal,Man United,1,1,D,1,1,4,1,0,2,2,1,3,1,63,84,2,21,April,0.8660254037844388,-0.4999999999999998,0,28,1,0,4,1.0,2.6,65,35,30,78,35,43,"April, 2013"
2012-2013,36,2013-04-29,Aston Villa,Sunderland,6,1,H,3,0,2,1,2,1,2,2,17,15,34,37,2,3,April,0.8660254037844388,-0.4999999999999998,1,40,1,2,2,0.6,0.8,36,63,-27,38,45,-7,"April, 2013"
2012-2013,37,2013-05-04,Fulham,Reading,2,4,A,0,3,1,0,4,1,1,3,11,20,40,25,9,15,May,0.4999999999999999,-0.8660254037844387,19,35,2,1,2,1.6,1.2,44,53,-9,37,65,-28,"May, 2013"
2012-2013,37,2013-05-04,Norwich,Aston Villa,1,2,A,0,3,3,0,2,2,1,2,14,16,38,37,2,1,May,0.4999999999999999,-0.8660254037844387,31,1,1,2,2,1.0,1.4,33,54,-21,42,64,-22,"May, 2013"
2012-2013,37,2013-05-04,QPR,Arsenal,0,1,A,0,3,0,1,4,4,1,0,20,4,25,64,16,39,May,0.4999999999999999,-0.8660254037844387,34,0,1,1,3,0.6,1.4,29,56,-27,66,36,30,"May, 2013"
2012-2013,37,2013-05-04,Swansea,Man City,0,0,D,1,1,1,1,3,3,1,1,9,2,42,71,7,29,May,0.4999999999999999,-0.8660254037844387,41,27,1,0,2,0.3333333333333333,1.6666666666666667,43,44,-1,61,31,30,"May, 2013"
2012-2013,37,2013-05-04,Tottenham,Southampton,1,0,H,3,0,3,2,0,0,3,2,5,14,62,39,9,23,May,0.4999999999999999,-0.8660254037844387,42,38,2,0,3,1.6,1.4,60,43,17,47,57,-10,"May, 2013"
2012-2013,37,2013-05-04,West Brom,Wigan,2,3,A,0,3,1,1,3,1,2,2,8,18,48,32,10,16,May,0.4999999999999999,-0.8660254037844387,44,46,1,2,2,1.2,1.4,46,44,2,39,62,-23,"May, 2013"
2012-2013,37,2013-05-04,West Ham,Newcastle,0,0,D,1,1,2,1,2,1,2,2,10,17,42,37,7,5,May,0.4999999999999999,-0.8660254037844387,45,30,2,1,2,1.4,2.0,41,49,-8,43,66,-23,"May, 2013"
2012-2013,37,2013-05-05,Liverpool,Everton,0,0,D,1,1,3,2,0,2,1,2,7,6,54,59,1,5,May,0.4999999999999999,-0.8660254037844387,25,18,2,2,1,1.8,1.2,67,42,25,52,38,14,"May, 2013"
2012-2013,37,2013-05-05,Man United,Chelsea,0,1,A,0,3,2,2,1,4,1,0,1,4,85,65,3,20,May,0.4999999999999999,-0.8660254037844387,28,14,3,1,1,2.4,1.8,79,36,43,68,35,33,"May, 2013"
2012-2013,37,2013-05-06,Sunderland,Stoke,1,1,D,1,1,1,2,2,2,2,1,17,11,37,40,6,3,May,0.4999999999999999,-0.8660254037844387,40,39,3,1,1,1.8,0.6,39,51,-12,31,41,-10,"May, 2013"
2012-2013,37,2013-05-07,Man City,West Brom,1,0,H,3,0,3,1,1,1,1,3,2,8,72,48,6,24,May,0.4999999999999999,-0.8660254037844387,27,44,4,1,0,2.2,0.2,61,31,30,48,47,1,"May, 2013"
2012-2013,37,2013-05-07,Wigan,Swansea,2,3,A,0,3,1,2,2,1,1,3,18,9,35,43,9,8,May,0.4999999999999999,-0.8660254037844387,46,41,0,1,2,0.3333333333333333,1.3333333333333333,42,64,-22,43,44,-1,"May, 2013"
2012-2013,37,2013-05-08,Chelsea,Tottenham,2,2,D,1,1,4,1,0,3,2,0,3,5,68,65,2,3,May,0.4999999999999999,-0.8660254037844387,14,42,2,3,0,1.6,1.0,69,35,34,61,43,18,"May, 2013"
2012-2013,38,2013-05-11,Aston Villa,Chelsea,1,2,A,0,3,2,1,2,4,1,0,13,3,40,69,10,29,May,0.4999999999999999,-0.8660254037844387,1,14,1,2,2,1.6,3.2,44,65,-21,71,37,34,"May, 2013"
2012-2013,38,2013-05-12,Stoke,Tottenham,1,2,A,0,3,2,2,1,3,2,0,11,5,41,66,6,25,May,0.4999999999999999,-0.8660254037844387,39,42,1,2,2,1.2,1.4,32,42,-10,63,45,18,"May, 2013"
2012-2013,38,2013-05-12,Sunderland,Southampton,1,1,D,1,1,1,2,2,0,3,2,17,16,38,39,1,1,May,0.4999999999999999,-0.8660254037844387,40,38,1,1,3,0.6,1.2,40,52,-12,47,58,-11,"May, 2013"
2012-2013,38,2013-05-12,Norwich,West Brom,4,0,H,3,0,3,0,2,1,1,3,16,8,38,48,8,10,May,0.4999999999999999,-0.8660254037844387,31,44,2,1,2,1.2,1.2,34,56,-22,48,48,0,"May, 2013"
2012-2013,38,2013-05-12,QPR,Newcastle,1,2,A,0,3,0,1,4,1,2,2,20,17,25,38,3,13,May,0.4999999999999999,-0.8660254037844387,34,30,0,1,4,0.6,1.4,29,57,-28,43,66,-23,"May, 2013"
2012-2013,38,2013-05-12,Fulham,Liverpool,1,3,A,0,3,1,0,4,3,2,0,12,7,40,55,5,15,May,0.4999999999999999,-0.8660254037844387,19,25,2,0,3,0.8,2.0,46,57,-11,67,42,25,"May, 2013"
2012-2013,38,2013-05-12,Everton,West Ham,2,0,H,3,0,2,1,2,2,1,2,6,10,60,43,4,17,May,0.4999999999999999,-0.8660254037844387,18,45,2,3,0,1.8,1.4,52,38,14,41,49,-8,"May, 2013"
2012-2013,38,2013-05-12,Man United,Swansea,2,1,H,3,0,2,2,1,1,1,3,1,9,85,46,8,39,May,0.4999999999999999,-0.8660254037844387,28,41,2,1,0,1.3333333333333333,0.3333333333333333,79,37,42,46,46,0,"May, 2013"
2012-2013,38,2013-05-14,Arsenal,Wigan,4,1,H,3,0,4,1,0,1,2,2,5,18,67,35,13,32,May,0.4999999999999999,-0.8660254037844387,0,46,3,1,1,2.2,0.8,67,36,31,44,67,-23,"May, 2013"
2012-2013,38,2013-05-14,Reading,Man City,0,2,A,0,3,1,1,3,3,1,1,19,2,28,75,17,47,May,0.4999999999999999,-0.8660254037844387,35,27,3,0,2,1.2,0.6,41,67,-26,62,31,31,"May, 2013"
2012-2013,39,2013-05-19,Swansea,Fulham,0,3,A,0,3,1,1,3,1,0,4,9,15,46,40,6,6,May,0.4999999999999999,-0.8660254037844387,41,19,3,0,0,2.333333333333333,0.3333333333333333,47,48,-1,47,60,-13,"May, 2013"
2012-2013,39,2013-05-19,Wigan,Aston Villa,2,2,D,1,1,1,2,2,2,1,2,18,16,35,40,2,5,May,0.4999999999999999,-0.8660254037844387,46,1,1,2,2,1.0,1.0,45,71,-26,45,67,-22,"May, 2013"
2012-2013,39,2013-05-19,West Ham,Reading,4,2,H,3,0,2,1,2,1,1,3,12,19,43,28,7,15,May,0.4999999999999999,-0.8660254037844387,45,35,1,1,3,0.8,1.8,41,51,-10,41,69,-28,"May, 2013"
2012-2013,39,2013-05-19,West Brom,Man United,5,5,D,1,1,1,1,3,2,2,1,8,1,48,88,7,40,May,0.4999999999999999,-0.8660254037844387,44,28,0,1,4,0.8,2.0,48,52,-4,81,38,43,"May, 2013"
2012-2013,39,2013-05-19,Tottenham,Sunderland,1,0,H,3,0,3,2,0,1,2,2,5,17,69,39,12,30,May,0.4999999999999999,-0.8660254037844387,42,40,3,2,0,1.2,0.6,65,46,19,41,53,-12,"May, 2013"
2012-2013,39,2013-05-19,Newcastle,Arsenal,0,1,A,0,3,1,2,2,4,1,0,13,4,41,70,9,29,May,0.4999999999999999,-0.8660254037844387,30,0,1,2,2,1.8,2.6,45,67,-22,71,37,34,"May, 2013"
2012-2013,39,2013-05-19,Man City,Norwich,2,3,A,0,3,3,1,1,3,0,2,2,12,78,41,10,37,May,0.4999999999999999,-0.8660254037844387,27,31,4,1,0,3.8,1.6,64,31,33,38,56,-18,"May, 2013"
2012-2013,39,2013-05-19,Liverpool,QPR,1,0,H,3,0,3,2,0,0,1,4,7,20,58,25,13,33,May,0.4999999999999999,-0.8660254037844387,25,34,4,0,1,1.8,0.8,70,43,27,30,59,-29,"May, 2013"
2012-2013,39,2013-05-19,Chelsea,Everton,2,1,H,3,0,4,1,0,2,1,2,3,6,72,63,3,9,May,0.4999999999999999,-0.8660254037844387,14,18,2,1,2,1.2,1.2,73,38,35,54,38,16,"May, 2013"
2012-2013,39,2013-05-19,Southampton,Stoke,1,1,D,1,1,0,3,2,2,2,1,14,12,40,41,2,1,May,0.4999999999999999,-0.8660254037844387,38,39,0,1,0,3.0,3.0,48,59,-11,33,44,-11,"May, 2013"
2013-2014,1,2013-08-17,Swansea,Man United,1,4,A,0,3,3,0,2,2,1,2,14,11,0,0,3,0,August,-0.8660254037844384,-0.5000000000000004,41,28,0,1,3,0.5,1.5,0,0,0,0,0,0,"August, 2013"
2013-2014,1,2013-08-17,Sunderland,Fulham,0,1,A,0,3,4,0,1,1,2,2,14,8,0,0,6,0,August,-0.8660254037844384,-0.5000000000000004,40,19,1,2,2,1.2,1.6,0,0,0,0,0,0,"August, 2013"
2013-2014,1,2013-08-17,West Brom,Southampton,0,1,A,0,3,1,0,4,2,2,1,15,13,0,0,2,0,August,-0.8660254037844384,-0.5000000000000004,44,38,2,2,1,1.4,0.6,0,0,0,0,0,0,"August, 2013"
2013-2014,1,2013-08-17,Liverpool,Stoke,1,0,H,3,0,3,1,1,3,1,1,8,14,0,0,6,0,August,-0.8660254037844384,-0.5000000000000004,25,39,1,2,2,0.6,0.8,0,0,0,0,0,0,"August, 2013"
2013-2014,1,2013-08-17,Arsenal,Aston Villa,1,3,A,0,3,5,0,0,1,1,3,1,2,0,0,1,0,August,-0.8660254037844384,-0.5000000000000004,0,1,3,1,1,1.6,0.8,0,0,0,0,0,0,"August, 2013"
2013-2014,1,2013-08-17,Norwich,Everton,2,2,D,1,1,0,1,4,2,0,3,12,6,0,0,6,0,August,-0.8660254037844384,-0.5000000000000004,31,18,1,3,1,1.2,1.2,0,0,0,0,0,0,"August, 2013"
2013-2014,1,2013-08-17,West Ham,Cardiff,2,0,H,3,0,1,0,4,1,1,3,15,8,0,0,7,0,August,-0.8660254037844384,-0.5000000000000004,45,12,0,0,0,0.0,0.0,0,0,0,0,0,0,"August, 2013"
2013-2014,1,2013-08-18,Chelsea,Hull,2,0,H,3,0,3,1,1,0,1,4,9,11,0,0,2,0,August,-0.8660254037844384,-0.5000000000000004,14,21,2,2,0,1.5,0.5,0,0,0,0,0,0,"August, 2013"
2013-2014,1,2013-08-18,Crystal Palace,Tottenham,0,1,A,0,3,2,2,1,3,1,1,10,13,0,0,3,0,August,-0.8660254037844384,-0.5000000000000004,16,42,2,1,1,1.5,1.0,0,0,0,0,0,0,"August, 2013"
2013-2014,1,2013-08-19,Man City,Newcastle,4,0,H,3,0,5,0,0,1,0,4,11,12,0,0,1,0,August,-0.8660254037844384,-0.5000000000000004,27,30,5,0,0,3.0,0.6,0,0,0,0,0,0,"August, 2013"
2013-2014,1,2013-08-21,Chelsea,Aston Villa,2,1,H,3,0,3,1,1,1,1,3,4,3,3,3,1,0,August,-0.8660254037844384,-0.5000000000000004,14,1,3,1,1,3.6,1.8,2,0,2,3,1,2,"August, 2013"
2013-2014,2,2013-08-24,Aston Villa,Liverpool,0,1,A,0,3,1,1,3,3,1,1,5,7,3,3,2,0,August,-0.8660254037844384,-0.5000000000000004,1,25,2,1,2,1.2,1.2,4,3,1,1,0,1,"August, 2013"
2013-2014,2,2013-08-24,Everton,West Brom,0,0,D,1,1,2,0,3,1,0,4,10,15,1,0,5,1,August,-0.8660254037844384,-0.5000000000000004,18,44,3,0,2,1.0,0.8,2,2,0,0,1,-1,"August, 2013"
2013-2014,2,2013-08-24,Fulham,Arsenal,1,3,A,0,3,1,2,2,5,0,0,6,16,3,0,10,3,August,-0.8660254037844384,-0.5000000000000004,19,0,1,3,1,1.6,1.6,1,0,1,1,3,-2,"August, 2013"
2013-2014,2,2013-08-24,Hull,Norwich,1,0,H,3,0,0,1,4,0,1,4,18,12,0,1,6,1,August,-0.8660254037844384,-0.5000000000000004,21,31,0,0,0,0.0,0.0,0,2,-2,2,2,0,"August, 2013"
2013-2014,2,2013-08-24,Newcastle,West Ham,0,0,D,1,1,1,0,4,1,0,4,20,5,0,3,15,3,August,-0.8660254037844384,-0.5000000000000004,30,45,2,2,1,1.8,0.8,0,4,-4,2,0,2,"August, 2013"
2013-2014,2,2013-08-24,Southampton,Sunderland,1,1,D,1,1,2,2,1,4,0,1,6,18,3,0,12,3,August,-0.8660254037844384,-0.5000000000000004,38,40,2,2,1,1.0,0.8,1,0,1,0,1,-1,"August, 2013"
2013-2014,2,2013-08-24,Stoke,Crystal Palace,2,1,H,3,0,3,1,1,2,2,1,18,17,0,0,1,0,August,-0.8660254037844384,-0.5000000000000004,39,16,0,0,0,0.0,0.0,0,1,-1,0,1,-1,"August, 2013"
2013-2014,2,2013-08-25,Cardiff,Man City,3,2,H,3,0,1,1,3,5,0,0,19,5,0,3,14,3,August,-0.8660254037844384,-0.5000000000000004,12,27,0,0,0,0.0,0.0,0,2,-2,4,0,4,"August, 2013"
2013-2014,2,2013-08-25,Tottenham,Swansea,1,0,H,3,0,3,1,1,3,0,2,7,20,3,0,13,3,August,-0.8660254037844384,-0.5000000000000004,42,41,3,1,0,1.75,0.75,1,0,1,1,4,-3,"August, 2013"
2013-2014,2,2013-08-26,Man United,Chelsea,0,0,D,1,1,2,1,2,3,1,1,7,1,3,6,6,3,August,-0.8660254037844384,-0.5000000000000004,28,14,3,1,1,2.2,1.6,4,1,3,4,1,3,"August, 2013"
2013-2014,3,2013-08-31,West Ham,Stoke,0,1,A,0,3,1,0,4,3,1,1,6,15,4,3,9,1,August,-0.8660254037844384,-0.5000000000000004,45,39,2,2,1,1.2,0.6,2,0,2,2,2,0,"August, 2013"
2013-2014,3,2013-08-31,Norwich,Southampton,1,0,H,3,0,0,1,4,2,2,1,17,7,1,4,10,3,August,-0.8660254037844384,-0.5000000000000004,31,38,1,2,1,1.5,1.5,2,3,-1,2,1,1,"August, 2013"
2013-2014,3,2013-08-31,Newcastle,Fulham,1,0,H,3,0,1,0,4,1,2,2,19,14,1,3,5,2,August,-0.8660254037844384,-0.5000000000000004,30,19,2,0,3,1.2,1.8,0,4,-4,2,3,-1,"August, 2013"
2013-2014,3,2013-08-31,Cardiff,Everton,0,0,D,1,1,1,1,3,2,0,3,11,14,3,2,3,1,August,-0.8660254037844384,-0.5000000000000004,12,18,0,0,0,0.0,0.0,3,4,-1,2,2,0,"August, 2013"
2013-2014,3,2013-08-31,Crystal Palace,Sunderland,3,1,H,3,0,2,2,1,4,0,1,19,16,0,1,3,1,August,-0.8660254037844384,-0.5000000000000004,16,40,0,0,0,0.0,0.0,1,3,-2,1,2,-1,"August, 2013"
2013-2014,3,2013-08-31,Man City,Hull,2,0,H,3,0,5,0,0,0,1,4,8,15,3,3,7,0,August,-0.8660254037844384,-0.5000000000000004,27,21,1,2,1,2.25,1.5,6,3,3,1,2,-1,"August, 2013"
2013-2014,3,2013-09-01,Arsenal,Tottenham,1,0,H,3,0,5,0,0,3,1,1,12,4,3,6,8,3,September,-1.0,-1.8369701987210287e-16,0,42,2,1,2,3.0,2.2,4,4,0,2,0,2,"September, 2013"
2013-2014,3,2013-09-01,Liverpool,Man United,1,0,H,3,0,3,1,1,2,1,2,3,7,6,4,4,2,September,-1.0,-1.8369701987210287e-16,25,28,1,1,3,1.4,1.6,2,0,2,4,1,3,"September, 2013"
2013-2014,3,2013-09-01,West Brom,Swansea,0,2,A,0,3,1,0,4,3,0,2,18,20,1,0,2,1,September,-1.0,-1.8369701987210287e-16,44,41,1,0,3,1.0,2.25,0,1,-1,1,5,-4,"September, 2013"
2013-2014,4,2013-09-14,Stoke,Man City,0,0,D,1,1,3,1,1,5,0,0,8,5,6,6,3,0,September,-1.0,-1.8369701987210287e-16,39,27,0,2,3,0.4,2.2,3,2,1,8,3,5,"September, 2013"
2013-2014,4,2013-09-14,Tottenham,Norwich,2,0,H,3,0,3,1,1,0,1,4,9,12,6,4,3,2,September,-1.0,-1.8369701987210287e-16,42,31,2,2,1,1.4,0.8,2,1,1,3,3,0,"September, 2013"
2013-2014,4,2013-09-14,Sunderland,Arsenal,1,3,A,0,3,4,0,1,5,0,0,20,7,1,6,13,5,September,-1.0,-1.8369701987210287e-16,40,0,0,2,3,0.4,1.0,2,5,-3,5,4,1,"September, 2013"
2013-2014,4,2013-09-14,Man United,Crystal Palace,2,0,H,3,0,2,1,2,2,2,1,10,16,4,3,6,1,September,-1.0,-1.8369701987210287e-16,28,16,3,1,0,2.5,0.5,4,2,2,4,4,0,"September, 2013"
2013-2014,4,2013-09-14,Everton,Chelsea,1,0,H,3,0,2,0,3,3,1,1,14,2,3,7,12,4,September,-1.0,-1.8369701987210287e-16,18,14,2,0,3,1.2,1.4,2,2,0,4,1,3,"September, 2013"
2013-2014,4,2013-09-14,Fulham,West Brom,1,1,D,1,1,1,2,2,1,0,4,17,20,3,1,3,2,September,-1.0,-1.8369701987210287e-16,19,44,3,2,0,1.8,0.4,2,4,-2,0,3,-3,"September, 2013"
2013-2014,4,2013-09-14,Aston Villa,Newcastle,1,2,A,0,3,1,1,3,1,0,4,13,12,3,4,1,1,September,-1.0,-1.8369701987210287e-16,1,30,1,2,2,1.0,1.2,4,4,0,1,4,-3,"September, 2013"
2013-2014,4,2013-09-14,Hull,Cardiff,1,1,D,1,1,0,1,4,1,1,3,18,13,3,4,5,1,September,-1.0,-1.8369701987210287e-16,21,12,0,0,0,0.0,0.0,1,4,-3,3,4,-1,"September, 2013"
2013-2014,4,2013-09-15,Southampton,West Ham,0,0,D,1,1,2,2,1,1,0,4,12,11,4,4,1,0,September,-1.0,-1.8369701987210287e-16,38,45,2,2,1,1.2,1.2,2,2,0,2,1,1,"September, 2013"
2013-2014,4,2013-09-16,Swansea,Liverpool,2,2,D,1,1,3,0,2,3,1,1,18,3,3,9,15,6,September,-1.0,-1.8369701987210287e-16,41,25,1,2,1,0.25,1.25,3,5,-2,3,0,3,"September, 2013"
2013-2014,5,2013-09-21,West Ham,Everton,2,3,A,0,3,1,0,4,2,0,3,13,11,5,6,2,1,September,-1.0,-1.8369701987210287e-16,45,18,0,3,2,1.2,1.8,2,1,1,3,2,1,"September, 2013"
2013-2014,5,2013-09-21,West Brom,Sunderland,3,0,H,3,0,1,0,4,4,0,1,19,20,2,1,1,1,September,-1.0,-1.8369701987210287e-16,44,40,4,1,0,3.0,1.4,1,4,-3,3,8,-5,"September, 2013"
2013-2014,5,2013-09-21,Norwich,Aston Villa,0,1,A,0,3,0,1,4,1,1,3,15,17,4,3,2,1,September,-1.0,-1.8369701987210287e-16,31,1,1,1,3,1.2,1.8,3,5,-2,5,6,-1,"September, 2013"
2013-2014,5,2013-09-21,Liverpool,Southampton,0,1,A,0,3,3,1,1,2,2,1,2,11,10,5,9,5,September,-1.0,-1.8369701987210287e-16,25,38,2,0,3,0.6,1.4,5,2,3,2,2,0,"September, 2013"
2013-2014,5,2013-09-21,Chelsea,Fulham,2,0,H,3,0,3,1,1,1,2,2,6,14,7,4,8,3,September,-1.0,-1.8369701987210287e-16,14,19,1,4,0,1.0,0.4,4,2,2,3,5,-2,"September, 2013"
2013-2014,5,2013-09-21,Newcastle,Hull,2,3,A,0,3,1,0,4,0,1,4,9,15,7,4,6,3,September,-1.0,-1.8369701987210287e-16,30,21,0,1,1,1.0,1.5,3,5,-2,2,5,-3,"September, 2013"
2013-2014,5,2013-09-22,Arsenal,Stoke,3,1,H,3,0,5,0,0,3,1,1,3,9,9,7,6,2,September,-1.0,-1.8369701987210287e-16,0,39,2,2,1,1.2,1.0,8,5,3,3,2,1,"September, 2013"
2013-2014,5,2013-09-22,Cardiff,Tottenham,0,1,A,0,3,1,1,3,3,1,1,15,4,5,9,11,4,September,-1.0,-1.8369701987210287e-16,12,42,0,0,0,0.0,0.0,4,5,-1,4,1,3,"September, 2013"
2013-2014,5,2013-09-22,Crystal Palace,Swansea,0,2,A,0,3,2,2,1,3,0,2,19,16,3,4,3,1,September,-1.0,-1.8369701987210287e-16,16,41,0,0,0,0.0,0.0,4,6,-2,5,7,-2,"September, 2013"
2013-2014,5,2013-09-22,Man City,Man United,4,1,H,3,0,5,0,0,2,1,2,7,8,7,7,1,0,September,-1.0,-1.8369701987210287e-16,27,28,3,0,2,2.4,1.4,8,3,5,6,2,4,"September, 2013"
2013-2014,6,2013-09-28,Swansea,Arsenal,1,2,A,0,3,3,0,2,5,0,0,13,1,7,12,12,5,September,-1.0,-1.8369701987210287e-16,41,0,2,0,2,1.25,1.25,7,7,0,11,6,5,"September, 2013"
2013-2014,6,2013-09-28,Tottenham,Chelsea,1,1,D,1,1,3,1,1,3,1,1,2,5,12,10,3,2,September,-1.0,-1.8369701987210287e-16,42,14,0,3,2,1.2,1.8,5,1,4,6,2,4,"September, 2013"
2013-2014,6,2013-09-28,Man United,West Brom,1,2,A,0,3,2,1,2,1,0,4,11,15,7,5,4,2,September,-1.0,-1.8369701987210287e-16,28,44,4,1,0,2.6,1.4,7,6,1,4,4,0,"September, 2013"
2013-2014,6,2013-09-28,Southampton,Crystal Palace,2,0,H,3,0,2,2,1,2,2,1,10,19,8,3,9,5,September,-1.0,-1.8369701987210287e-16,38,16,1,3,0,1.5,1.25,3,2,1,4,8,-4,"September, 2013"
2013-2014,6,2013-09-28,Fulham,Cardiff,1,2,A,0,3,1,2,2,1,1,3,18,16,4,5,2,1,September,-1.0,-1.8369701987210287e-16,19,12,0,0,0,0.0,0.0,3,7,-4,4,6,-2,"September, 2013"
2013-2014,6,2013-09-28,Aston Villa,Man City,3,2,H,3,0,1,1,3,5,0,0,13,3,6,10,10,4,September,-1.0,-1.8369701987210287e-16,1,27,1,0,4,0.4,2.2,6,6,0,12,4,8,"September, 2013"
2013-2014,6,2013-09-28,Hull,West Ham,1,0,H,3,0,0,1,4,1,0,4,13,16,7,5,3,2,September,-1.0,-1.8369701987210287e-16,21,45,1,1,2,1.0,2.0,5,7,-2,4,4,0,"September, 2013"
2013-2014,6,2013-09-29,Stoke,Norwich,0,1,A,0,3,3,1,1,0,1,4,14,17,7,4,3,3,September,-1.0,-1.8369701987210287e-16,39,31,2,1,1,0.75,0.5,4,5,-1,3,6,-3,"September, 2013"
2013-2014,6,2013-09-29,Sunderland,Liverpool,1,3,A,0,3,4,0,1,3,1,1,20,6,1,10,14,9,September,-1.0,-1.8369701987210287e-16,40,25,1,2,2,0.6,1.4,3,11,-8,5,3,2,"September, 2013"
2013-2014,6,2013-09-30,Everton,Newcastle,3,2,H,3,0,2,0,3,1,0,4,8,16,9,7,8,2,September,-1.0,-1.8369701987210287e-16,18,30,3,1,1,2.0,1.4,6,4,2,5,8,-3,"September, 2013"
2013-2014,7,2013-10-05,Liverpool,Crystal Palace,3,1,H,3,0,3,1,1,2,2,1,2,19,13,3,17,10,October,-0.8660254037844386,0.5,25,16,3,0,1,2.0,1.0,8,4,4,4,10,-6,"October, 2013"
2013-2014,7,2013-10-05,Cardiff,Newcastle,1,2,A,0,3,1,1,3,1,0,4,11,16,8,7,5,1,October,-0.8660254037844386,0.5,12,30,0,0,0,0.0,0.0,6,7,-1,7,11,-4,"October, 2013"
2013-2014,7,2013-10-05,Fulham,Stoke,1,0,H,3,0,1,2,2,3,1,1,18,16,4,7,2,3,October,-0.8660254037844386,0.5,19,39,3,0,2,1.0,0.8,4,9,-5,4,6,-2,"October, 2013"
2013-2014,7,2013-10-05,Hull,Aston Villa,0,0,D,1,1,0,1,4,1,1,3,8,10,10,9,2,1,October,-0.8660254037844386,0.5,21,1,0,0,4,0.0,1.75,6,7,-1,9,8,1,"October, 2013"
2013-2014,7,2013-10-05,Man City,Everton,3,1,H,3,0,5,0,0,2,0,3,8,4,10,12,4,2,October,-0.8660254037844386,0.5,27,18,1,1,3,0.8,1.2,14,7,7,9,6,3,"October, 2013"
2013-2014,7,2013-10-05,Sunderland,Man United,1,2,A,0,3,4,0,1,2,1,2,20,13,1,7,7,6,October,-0.8660254037844386,0.5,40,28,0,0,5,0.2,1.6,4,14,-10,8,8,0,"October, 2013"
2013-2014,7,2013-10-06,Norwich,Chelsea,1,3,A,0,3,0,1,4,3,1,1,15,6,7,11,9,4,October,-0.8660254037844386,0.5,31,14,0,1,4,0.6,2.2,4,6,-2,7,3,4,"October, 2013"
2013-2014,7,2013-10-06,Southampton,Swansea,2,0,H,3,0,2,2,1,3,0,2,7,14,11,7,7,4,October,-0.8660254037844386,0.5,38,41,0,2,0,0.5,0.5,5,2,3,8,9,-1,"October, 2013"
2013-2014,7,2013-10-06,Tottenham,West Ham,0,3,A,0,3,3,1,1,1,0,4,6,18,13,5,12,8,October,-0.8660254037844386,0.5,42,45,3,1,1,1.6,0.8,6,2,4,4,5,-1,"October, 2013"
2013-2014,7,2013-10-06,West Brom,Arsenal,1,1,D,1,1,1,0,4,5,0,0,13,2,8,15,11,7,October,-0.8660254037844386,0.5,44,0,0,1,4,1.0,2.4,6,5,1,13,7,6,"October, 2013"
2013-2014,8,2013-10-19,Swansea,Sunderland,4,0,H,3,0,3,0,2,4,0,1,16,20,7,1,4,6,October,-0.8660254037844386,0.5,41,40,0,3,1,0.5,1.0,8,11,-3,5,16,-11,"October, 2013"
2013-2014,8,2013-10-19,Stoke,West Brom,0,0,D,1,1,3,1,1,1,0,4,16,12,7,9,4,2,October,-0.8660254037844386,0.5,39,44,2,2,1,0.8,0.6,4,7,-3,7,6,1,"October, 2013"
2013-2014,8,2013-10-19,West Ham,Man City,1,3,A,0,3,1,0,4,5,0,0,14,6,8,13,8,5,October,-0.8660254037844386,0.5,45,27,0,2,3,0.8,1.6,7,5,2,17,8,9,"October, 2013"
2013-2014,8,2013-10-19,Newcastle,Liverpool,2,2,D,1,1,1,0,4,3,1,1,11,3,10,16,8,6,October,-0.8660254037844386,0.5,30,25,1,1,3,0.8,2.6,9,12,-3,11,5,6,"October, 2013"
2013-2014,8,2013-10-19,Man United,Southampton,1,1,D,1,1,2,1,2,2,2,1,9,5,10,14,4,4,October,-0.8660254037844386,0.5,28,38,5,0,0,2.6,1.2,10,9,1,7,2,5,"October, 2013"
2013-2014,8,2013-10-19,Everton,Hull,2,1,H,3,0,2,0,3,0,1,4,7,8,12,11,1,1,October,-0.8660254037844386,0.5,18,21,2,1,1,2.75,1.5,10,9,1,6,7,-1,"October, 2013"
2013-2014,8,2013-10-19,Chelsea,Cardiff,4,1,H,3,0,3,1,1,1,1,3,3,14,14,8,11,6,October,-0.8660254037844386,0.5,14,12,0,0,0,0.0,0.0,10,4,6,7,9,-2,"October, 2013"
2013-2014,8,2013-10-19,Arsenal,Norwich,4,1,H,3,0,5,0,0,0,1,4,1,18,16,7,17,9,October,-0.8660254037844386,0.5,0,31,3,1,1,2.4,1.4,14,8,6,5,9,-4,"October, 2013"
2013-2014,8,2013-10-20,Aston Villa,Tottenham,0,2,A,0,3,1,1,3,3,1,1,12,7,10,13,5,3,October,-0.8660254037844386,0.5,1,42,0,1,4,0.4,2.2,9,8,1,6,5,1,"October, 2013"
2013-2014,8,2013-10-21,Crystal Palace,Fulham,1,4,A,0,3,2,2,1,1,2,2,19,17,3,7,2,4,October,-0.8660254037844386,0.5,16,19,1,0,1,1.5,1.5,5,13,-8,5,9,-4,"October, 2013"
2013-2014,9,2013-10-26,Southampton,Fulham,2,0,H,3,0,2,2,1,1,2,2,7,12,15,10,5,5,October,-0.8660254037844386,0.5,38,19,0,4,1,1.2,1.4,8,3,5,9,10,-1,"October, 2013"
2013-2014,9,2013-10-26,Norwich,Cardiff,0,0,D,1,1,0,1,4,1,1,3,18,17,7,8,1,1,October,-0.8660254037844386,0.5,31,12,0,0,0,0.0,0.0,6,13,-7,8,13,-5,"October, 2013"
2013-2014,9,2013-10-26,Man United,Stoke,3,2,H,3,0,2,1,2,3,1,1,8,16,11,8,8,3,October,-0.8660254037844386,0.5,28,39,4,1,0,2.2,0.8,11,10,1,4,7,-3,"October, 2013"
2013-2014,9,2013-10-26,Crystal Palace,Arsenal,0,2,A,0,3,2,2,1,5,0,0,19,1,3,19,18,16,October,-0.8660254037844386,0.5,16,0,0,2,2,0.5,1.75,6,17,-11,18,9,9,"October, 2013"
2013-2014,9,2013-10-26,Aston Villa,Everton,0,2,A,0,3,1,1,3,2,0,3,13,7,10,15,6,5,October,-0.8660254037844386,0.5,1,18,0,4,1,1.8,2.2,9,10,-1,12,10,2,"October, 2013"
2013-2014,9,2013-10-26,Liverpool,West Brom,4,1,H,3,0,3,1,1,1,0,4,4,12,17,10,8,7,October,-0.8660254037844386,0.5,25,44,1,0,4,0.6,1.6,13,7,6,7,6,1,"October, 2013"
2013-2014,9,2013-10-27,Chelsea,Man City,2,1,H,3,0,3,1,1,5,0,0,5,6,17,16,1,1,October,-0.8660254037844386,0.5,14,27,2,1,2,1.0,1.0,14,5,9,20,9,11,"October, 2013"
2013-2014,9,2013-10-27,Sunderland,Newcastle,2,1,H,3,0,4,0,1,1,0,4,20,10,1,11,10,10,October,-0.8660254037844386,0.5,40,30,1,3,1,1.2,0.8,5,20,-15,11,14,-3,"October, 2013"
2013-2014,9,2013-10-27,Swansea,West Ham,0,0,D,1,1,3,0,2,1,0,4,11,16,10,8,5,2,October,-0.8660254037844386,0.5,41,45,1,0,1,1.5,0.5,12,11,1,8,8,0,"October, 2013"
2013-2014,9,2013-10-27,Tottenham,Hull,1,0,H,3,0,3,1,1,0,1,4,7,10,16,11,3,5,October,-0.8660254037844386,0.5,42,21,2,1,1,1.75,0.75,8,5,3,7,9,-2,"October, 2013"
2013-2014,10,2013-11-02,Stoke,Southampton,1,1,D,1,1,3,1,1,2,2,1,17,6,8,18,11,10,November,-0.5000000000000004,0.8660254037844384,39,38,0,2,0,2.0,2.0,6,10,-4,10,3,7,"November, 2013"
2013-2014,10,2013-11-02,West Brom,Crystal Palace,2,0,H,3,0,1,0,4,2,2,1,12,20,10,3,8,7,November,-0.5000000000000004,0.8660254037844384,44,16,0,1,1,1.0,2.5,8,10,-2,6,19,-13,"November, 2013"
2013-2014,10,2013-11-02,Newcastle,Chelsea,2,0,H,3,0,1,0,4,3,1,1,11,2,11,20,9,9,November,-0.5000000000000004,0.8660254037844384,30,14,2,1,2,1.4,1.8,12,16,-4,16,6,10,"November, 2013"
2013-2014,10,2013-11-02,West Ham,Aston Villa,0,0,D,1,1,1,0,4,1,1,3,15,13,9,10,2,1,November,-0.5000000000000004,0.8660254037844384,45,1,1,1,3,0.6,1.4,8,8,0,9,12,-3,"November, 2013"
2013-2014,10,2013-11-02,Hull,Sunderland,1,0,H,3,0,0,1,4,4,0,1,10,19,11,4,9,7,November,-0.5000000000000004,0.8660254037844384,21,40,0,0,4,0.5,2.5,7,10,-3,7,21,-14,"November, 2013"
2013-2014,10,2013-11-02,Fulham,Man United,1,3,A,0,3,1,2,2,2,1,2,14,8,10,14,6,4,November,-0.5000000000000004,0.8660254037844384,19,28,0,0,5,0.4,2.4,9,12,-3,14,12,2,"November, 2013"
2013-2014,10,2013-11-02,Arsenal,Liverpool,2,0,H,3,0,5,0,0,3,1,1,1,3,22,20,2,2,November,-0.5000000000000004,0.8660254037844384,0,25,2,2,1,1.4,1.2,20,9,11,17,8,9,"November, 2013"
2013-2014,10,2013-11-02,Man City,Norwich,7,0,H,3,0,5,0,0,0,1,4,8,18,16,8,10,8,November,-0.5000000000000004,0.8660254037844384,27,31,4,0,1,4.0,2.0,21,11,10,6,13,-7,"November, 2013"
2013-2014,10,2013-11-03,Everton,Tottenham,0,0,D,1,1,2,0,3,3,1,1,7,6,18,19,1,1,November,-0.5000000000000004,0.8660254037844384,18,42,3,1,1,1.4,1.2,14,10,4,9,5,4,"November, 2013"
2013-2014,10,2013-11-03,Cardiff,Swansea,1,0,H,3,0,1,1,3,3,0,2,17,12,9,11,5,2,November,-0.5000000000000004,0.8660254037844384,12,41,0,0,0,0.0,0.0,8,13,-5,12,11,1,"November, 2013"
2013-2014,11,2013-11-09,Aston Villa,Cardiff,2,0,H,3,0,1,1,3,1,1,3,14,12,11,12,2,1,November,-0.5000000000000004,0.8660254037844384,1,12,0,0,0,0.0,0.0,9,12,-3,9,13,-4,"November, 2013"
2013-2014,11,2013-11-09,Chelsea,West Brom,2,2,D,1,1,3,1,1,1,0,4,2,12,20,13,10,7,November,-0.5000000000000004,0.8660254037844384,14,44,3,0,2,1.4,1.0,16,8,8,10,10,0,"November, 2013"
2013-2014,11,2013-11-09,Crystal Palace,Everton,0,0,D,1,1,2,2,1,2,0,3,20,7,3,19,13,16,November,-0.5000000000000004,0.8660254037844384,16,18,1,0,3,1.0,2.75,6,21,-15,14,10,4,"November, 2013"
2013-2014,11,2013-11-09,Liverpool,Fulham,4,0,H,3,0,3,1,1,1,2,2,3,16,20,10,13,10,November,-0.5000000000000004,0.8660254037844384,25,19,3,0,2,2.4,1.0,17,10,7,10,15,-5,"November, 2013"
2013-2014,11,2013-11-09,Norwich,West Ham,3,1,H,3,0,0,1,4,1,0,4,18,15,8,10,3,2,November,-0.5000000000000004,0.8660254037844384,31,45,0,1,1,0.5,1.0,6,20,-14,8,8,0,"November, 2013"
2013-2014,11,2013-11-09,Southampton,Hull,4,1,H,3,0,2,2,1,0,1,4,7,12,19,14,5,5,November,-0.5000000000000004,0.8660254037844384,38,21,0,0,0,0.0,0.0,11,4,7,8,10,-2,"November, 2013"
2013-2014,11,2013-11-10,Man United,Arsenal,1,0,H,3,0,2,1,2,5,0,0,8,1,17,25,7,8,November,-0.5000000000000004,0.8660254037844384,28,0,3,1,1,2.6,1.2,17,13,4,22,9,13,"November, 2013"
2013-2014,11,2013-11-10,Sunderland,Man City,1,0,H,3,0,4,0,1,5,0,0,19,8,4,19,11,15,November,-0.5000000000000004,0.8660254037844384,40,27,2,1,2,1.0,2.2,7,22,-15,28,11,17,"November, 2013"
2013-2014,11,2013-11-10,Swansea,Stoke,3,3,D,1,1,3,0,2,3,1,1,14,18,11,9,4,2,November,-0.5000000000000004,0.8660254037844384,41,39,2,0,2,1.25,1.25,12,12,0,7,11,-4,"November, 2013"
2013-2014,11,2013-11-10,Tottenham,Newcastle,0,1,A,0,3,3,1,1,1,0,4,7,11,20,14,4,6,November,-0.5000000000000004,0.8660254037844384,42,30,2,2,1,2.2,1.2,9,5,4,14,16,-2,"November, 2013"
2013-2014,12,2013-11-23,West Ham,Chelsea,0,3,A,0,3,1,0,4,3,1,1,17,4,10,21,13,11,November,-0.5000000000000004,0.8660254037844384,45,14,1,0,4,1.0,2.6,9,11,-2,18,10,8,"November, 2013"
2013-2014,12,2013-11-23,Stoke,Sunderland,2,0,H,3,0,3,1,1,4,0,1,17,19,10,7,2,3,November,-0.5000000000000004,0.8660254037844384,39,40,1,2,2,0.8,1.6,10,14,-4,8,22,-14,"November, 2013"
2013-2014,12,2013-11-23,Newcastle,Norwich,2,1,H,3,0,1,0,4,0,1,4,9,15,17,11,6,6,November,-0.5000000000000004,0.8660254037844384,30,31,2,1,2,1.0,1.2,15,16,-1,9,21,-12,"November, 2013"
2013-2014,12,2013-11-23,Everton,Liverpool,3,3,D,1,1,2,0,3,3,1,1,6,2,20,23,4,3,November,-0.5000000000000004,0.8660254037844384,18,25,0,3,2,0.8,1.8,14,10,4,21,10,11,"November, 2013"
2013-2014,12,2013-11-23,Fulham,Swansea,1,2,A,0,3,1,2,2,3,0,2,18,13,10,12,5,2,November,-0.5000000000000004,0.8660254037844384,19,41,1,0,3,1.0,1.75,10,19,-9,15,15,0,"November, 2013"
2013-2014,12,2013-11-23,Arsenal,Southampton,2,0,H,3,0,5,0,0,2,2,1,1,3,25,22,2,3,November,-0.5000000000000004,0.8660254037844384,0,38,2,3,0,2.4,1.0,22,10,12,15,5,10,"November, 2013"
2013-2014,12,2013-11-23,Hull,Crystal Palace,0,1,A,0,3,0,1,4,2,2,1,13,20,14,4,7,10,November,-0.5000000000000004,0.8660254037844384,21,16,0,0,0,0.0,0.0,9,14,-5,6,21,-15,"November, 2013"
2013-2014,12,2013-11-24,Cardiff,Man United,2,2,D,1,1,1,1,3,2,1,2,15,6,12,20,9,8,November,-0.5000000000000004,0.8660254037844384,12,28,0,0,0,0.0,0.0,9,15,-6,18,13,5,"November, 2013"
2013-2014,12,2013-11-24,Man City,Tottenham,6,0,H,3,0,5,0,0,3,1,1,9,7,19,20,2,1,November,-0.5000000000000004,0.8660254037844384,27,42,4,0,1,2.4,1.4,28,12,16,9,6,3,"November, 2013"
2013-2014,12,2013-11-25,West Brom,Aston Villa,2,2,D,1,1,1,0,4,1,1,3,11,12,14,14,1,0,November,-0.5000000000000004,0.8660254037844384,44,1,2,3,0,1.4,1.0,12,12,0,11,12,-1,"November, 2013"
2013-2014,13,2013-11-30,Norwich,Crystal Palace,1,0,H,3,0,0,1,4,2,2,1,16,20,11,7,4,4,November,-0.5000000000000004,0.8660254037844384,31,16,0,2,0,2.0,2.0,10,23,-13,7,21,-14,"November, 2013"
2013-2014,13,2013-11-30,West Ham,Fulham,3,0,H,3,0,1,0,4,1,2,2,17,18,10,10,1,0,November,-0.5000000000000004,0.8660254037844384,45,19,2,1,2,2.0,1.6,9,14,-5,11,21,-10,"November, 2013"
2013-2014,13,2013-11-30,Newcastle,West Brom,2,1,H,3,0,1,0,4,1,0,4,8,12,20,15,4,5,November,-0.5000000000000004,0.8660254037844384,30,44,2,2,1,2.2,1.8,17,17,0,14,14,0,"November, 2013"
2013-2014,13,2013-11-30,Cardiff,Arsenal,0,3,A,0,3,1,1,3,5,0,0,15,1,13,28,14,15,November,-0.5000000000000004,0.8660254037844384,12,0,0,0,0,0.0,0.0,11,17,-6,24,10,14,"November, 2013"
2013-2014,13,2013-11-30,Aston Villa,Sunderland,0,0,D,1,1,1,1,3,4,0,1,12,20,15,7,8,8,November,-0.5000000000000004,0.8660254037844384,1,40,2,2,1,1.8,0.8,13,14,-1,8,24,-16,"November, 2013"
2013-2014,13,2013-11-30,Everton,Stoke,4,0,H,3,0,2,0,3,3,1,1,7,14,21,13,7,8,November,-0.5000000000000004,0.8660254037844384,18,39,1,2,2,0.6,1.0,17,13,4,12,14,-2,"November, 2013"
2013-2014,13,2013-12-01,Chelsea,Southampton,3,1,H,3,0,3,1,1,2,2,1,3,7,24,22,4,2,December,-2.4492935982947064e-16,1.0,14,38,3,1,1,2.4,1.2,21,10,11,15,7,8,"December, 2013"
2013-2014,13,2013-12-01,Hull,Liverpool,3,1,H,3,0,0,1,4,3,1,1,13,3,14,24,10,10,December,-2.4492935982947064e-16,1.0,21,25,0,2,2,1.0,2.75,9,15,-6,24,13,11,"December, 2013"
2013-2014,13,2013-12-01,Man City,Swansea,3,0,H,3,0,5,0,0,3,0,2,6,12,22,15,6,7,December,-2.4492935982947064e-16,1.0,27,41,2,1,1,1.25,0.25,34,12,22,17,16,1,"December, 2013"
2013-2014,13,2013-12-01,Tottenham,Man United,2,2,D,1,1,3,1,1,2,1,2,9,8,20,21,1,1,December,-2.4492935982947064e-16,1.0,42,28,1,2,2,1.0,1.8,9,12,-3,20,15,5,"December, 2013"
2013-2014,14,2013-12-03,Crystal Palace,West Ham,1,0,H,3,0,2,2,1,1,0,4,20,15,7,13,5,6,December,-2.4492935982947064e-16,1.0,16,45,0,1,1,2.0,3.5,7,22,-15,12,14,-2,"December, 2013"
2013-2014,14,2013-12-04,Liverpool,Norwich,5,1,H,3,0,3,1,1,0,1,4,4,14,24,14,10,10,December,-2.4492935982947064e-16,1.0,25,31,4,1,0,3.2,0.8,25,16,9,11,23,-12,"December, 2013"
2013-2014,14,2013-12-04,Arsenal,Hull,2,0,H,3,0,5,0,0,0,1,4,1,10,31,17,9,14,December,-2.4492935982947064e-16,1.0,0,21,3,0,1,2.25,1.0,27,10,17,12,16,-4,"December, 2013"
2013-2014,14,2013-12-04,Fulham,Tottenham,1,2,A,0,3,1,2,2,3,1,1,18,9,10,21,9,11,December,-2.4492935982947064e-16,1.0,19,42,1,0,4,0.4,1.8,11,24,-13,11,14,-3,"December, 2013"
2013-2014,14,2013-12-04,Man United,Everton,0,1,A,0,3,2,1,2,2,0,3,9,5,22,24,4,2,December,-2.4492935982947064e-16,1.0,28,18,3,1,1,1.6,1.0,22,17,5,21,13,8,"December, 2013"
2013-2014,14,2013-12-04,Southampton,Aston Villa,2,3,A,0,3,2,2,1,1,1,3,8,11,22,16,3,6,December,-2.4492935982947064e-16,1.0,38,1,2,1,2,1.6,1.4,16,10,6,13,14,-1,"December, 2013"
2013-2014,14,2013-12-04,Stoke,Cardiff,0,0,D,1,1,3,1,1,1,1,3,16,17,13,13,1,0,December,-2.4492935982947064e-16,1.0,39,12,0,0,0,0.0,0.0,12,18,-6,11,20,-9,"December, 2013"
2013-2014,14,2013-12-04,Sunderland,Chelsea,3,4,A,0,3,4,0,1,3,1,1,20,3,8,27,17,19,December,-2.4492935982947064e-16,1.0,40,14,0,0,5,1.0,2.4,8,24,-16,24,11,13,"December, 2013"
2013-2014,14,2013-12-04,Swansea,Newcastle,3,0,H,3,0,3,0,2,1,0,4,13,7,15,23,6,8,December,-2.4492935982947064e-16,1.0,41,30,2,1,1,0.75,0.75,17,19,-2,19,18,1,"December, 2013"
2013-2014,14,2013-12-04,West Brom,Man City,2,3,A,0,3,1,0,4,5,0,0,13,5,15,25,8,10,December,-2.4492935982947064e-16,1.0,44,27,0,1,4,0.2,2.0,15,16,-1,37,12,25,"December, 2013"
2013-2014,15,2013-12-07,Sunderland,Tottenham,1,2,A,0,3,4,0,1,3,1,1,20,7,8,24,13,16,December,-2.4492935982947064e-16,1.0,40,42,0,1,4,0.4,1.2,11,28,-17,13,15,-2,"December, 2013"
2013-2014,15,2013-12-07,West Brom,Norwich,0,2,A,0,3,1,0,4,0,1,4,14,16,15,14,2,1,December,-2.4492935982947064e-16,1.0,44,31,2,0,3,1.2,2.0,17,19,-2,12,28,-16,"December, 2013"
2013-2014,15,2013-12-07,Stoke,Chelsea,3,2,H,3,0,3,1,1,3,1,1,14,3,14,30,11,16,December,-2.4492935982947064e-16,1.0,39,14,0,2,3,0.2,1.4,12,18,-6,28,14,14,"December, 2013"
2013-2014,15,2013-12-07,Southampton,Man City,1,1,D,1,1,2,2,1,5,0,0,8,4,22,28,4,6,December,-2.4492935982947064e-16,1.0,38,27,2,1,2,1.8,1.4,18,13,5,40,14,26,"December, 2013"
2013-2014,15,2013-12-07,Man United,Newcastle,0,1,A,0,3,2,1,2,1,0,4,9,7,22,23,2,1,December,-2.4492935982947064e-16,1.0,28,30,2,2,1,1.6,1.4,22,18,4,19,21,-2,"December, 2013"
2013-2014,15,2013-12-07,Liverpool,West Ham,4,1,H,3,0,3,1,1,1,0,4,4,17,27,13,13,14,December,-2.4492935982947064e-16,1.0,25,45,3,1,1,2.0,1.0,30,17,13,12,15,-3,"December, 2013"
2013-2014,15,2013-12-07,Crystal Palace,Cardiff,2,0,H,3,0,2,2,1,1,1,3,19,15,10,14,4,4,December,-2.4492935982947064e-16,1.0,16,12,0,0,0,0.0,0.0,8,22,-14,11,20,-9,"December, 2013"
2013-2014,15,2013-12-08,Arsenal,Everton,1,1,D,1,1,5,0,0,2,0,3,1,5,34,27,4,7,December,-2.4492935982947064e-16,1.0,0,18,3,2,0,1.0,0.4,29,10,19,22,13,9,"December, 2013"
2013-2014,15,2013-12-08,Fulham,Aston Villa,2,0,H,3,0,1,2,2,1,1,3,19,10,10,19,9,9,December,-2.4492935982947064e-16,1.0,19,1,1,3,1,0.8,0.8,12,26,-14,16,16,0,"December, 2013"
2013-2014,15,2013-12-09,Swansea,Hull,1,1,D,1,1,3,0,2,0,1,4,11,13,18,17,2,1,December,-2.4492935982947064e-16,1.0,41,21,0,0,0,0.0,0.0,20,19,1,12,18,-6,"December, 2013"
2013-2014,16,2013-12-14,West Ham,Sunderland,0,0,D,1,1,1,0,4,4,0,1,17,20,13,8,3,5,December,-2.4492935982947064e-16,1.0,45,40,1,1,3,0.4,1.6,13,19,-6,12,30,-18,"December, 2013"
2013-2014,16,2013-12-14,Newcastle,Southampton,1,1,D,1,1,1,0,4,2,2,1,7,8,26,23,1,3,December,-2.4492935982947064e-16,1.0,30,38,3,1,1,2.2,1.8,20,21,-1,19,14,5,"December, 2013"
2013-2014,16,2013-12-14,Man City,Arsenal,6,3,H,3,0,5,0,0,5,0,0,5,1,29,35,4,6,December,-2.4492935982947064e-16,1.0,27,0,2,2,1,0.8,0.4,41,15,26,30,11,19,"December, 2013"
2013-2014,16,2013-12-14,Hull,Stoke,0,0,D,1,1,0,1,4,3,1,1,12,13,18,17,1,1,December,-2.4492935982947064e-16,1.0,21,39,1,1,2,1.0,1.5,13,19,-6,15,20,-5,"December, 2013"
2013-2014,16,2013-12-14,Everton,Fulham,4,1,H,3,0,2,0,3,1,2,2,5,18,28,13,13,15,December,-2.4492935982947064e-16,1.0,18,19,4,1,0,2.4,0.8,23,14,9,14,26,-12,"December, 2013"
2013-2014,16,2013-12-14,Chelsea,Crystal Palace,2,1,H,3,0,3,1,1,2,2,1,3,19,30,13,16,17,December,-2.4492935982947064e-16,1.0,14,16,4,0,0,3.75,0.75,30,17,13,10,22,-12,"December, 2013"
2013-2014,16,2013-12-14,Cardiff,West Brom,1,0,H,3,0,1,1,3,1,0,4,16,15,14,15,1,1,December,-2.4492935982947064e-16,1.0,12,44,0,0,0,0.0,0.0,11,22,-11,17,21,-4,"December, 2013"
2013-2014,16,2013-12-15,Aston Villa,Man United,0,3,A,0,3,1,1,3,2,1,2,11,9,19,22,2,3,December,-2.4492935982947064e-16,1.0,1,28,0,0,5,0.6,2.8,16,18,-2,22,19,3,"December, 2013"
2013-2014,16,2013-12-15,Norwich,Swansea,1,1,D,1,1,0,1,4,3,0,2,15,10,17,19,5,2,December,-2.4492935982947064e-16,1.0,31,41,3,1,0,3.0,2.0,14,28,-14,21,20,1,"December, 2013"
2013-2014,16,2013-12-15,Tottenham,Liverpool,0,5,A,0,3,3,1,1,3,1,1,7,5,27,30,2,3,December,-2.4492935982947064e-16,1.0,42,25,3,1,1,2.0,0.8,15,16,-1,34,18,16,"December, 2013"
2013-2014,17,2013-12-21,West Brom,Hull,1,1,D,1,1,1,0,4,0,1,4,16,13,15,19,3,4,December,-2.4492935982947064e-16,1.0,44,21,0,1,1,1.0,2.5,17,22,-5,13,19,-6,"December, 2013"
2013-2014,17,2013-12-21,Stoke,Aston Villa,2,1,H,3,0,3,1,1,1,1,3,13,11,18,19,2,1,December,-2.4492935982947064e-16,1.0,39,1,0,4,1,0.6,1.0,15,20,-5,16,21,-5,"December, 2013"
2013-2014,17,2013-12-21,Man United,West Ham,3,1,H,3,0,2,1,2,1,0,4,8,17,25,14,9,11,December,-2.4492935982947064e-16,1.0,28,45,4,1,0,2.6,0.8,25,19,6,13,19,-6,"December, 2013"
2013-2014,17,2013-12-21,Sunderland,Norwich,0,0,D,1,1,4,0,1,0,1,4,20,14,9,18,6,9,December,-2.4492935982947064e-16,1.0,40,31,1,1,2,1.5,1.25,12,30,-18,15,29,-14,"December, 2013"
2013-2014,17,2013-12-21,Fulham,Man City,2,4,A,0,3,1,2,2,5,0,0,18,4,13,32,14,19,December,-2.4492935982947064e-16,1.0,19,27,0,2,3,0.8,2.0,15,30,-15,47,18,29,"December, 2013"
2013-2014,17,2013-12-21,Crystal Palace,Newcastle,0,3,A,0,3,2,2,1,1,0,4,18,6,13,27,12,14,December,-2.4492935982947064e-16,1.0,16,30,1,1,2,0.75,1.25,11,24,-13,21,22,-1,"December, 2013"
2013-2014,17,2013-12-21,Liverpool,Cardiff,3,1,H,3,0,3,1,1,1,1,3,3,15,33,17,12,16,December,-2.4492935982947064e-16,1.0,25,12,0,0,0,0.0,0.0,39,18,21,12,22,-10,"December, 2013"
2013-2014,17,2013-12-22,Southampton,Tottenham,2,3,A,0,3,2,2,1,3,1,1,9,8,24,27,1,3,December,-2.4492935982947064e-16,1.0,38,42,2,0,3,0.8,1.6,20,15,5,15,21,-6,"December, 2013"
2013-2014,17,2013-12-22,Swansea,Everton,1,2,A,0,3,3,0,2,2,0,3,11,5,20,31,6,11,December,-2.4492935982947064e-16,1.0,41,18,0,1,3,0.0,1.5,22,21,1,27,15,12,"December, 2013"
2013-2014,17,2013-12-23,Arsenal,Chelsea,0,0,D,1,1,5,0,0,3,1,1,3,5,35,33,2,2,December,-2.4492935982947064e-16,1.0,0,14,2,1,2,2.0,1.6,33,17,16,32,18,14,"December, 2013"
2013-2014,18,2013-12-26,West Ham,Arsenal,1,3,A,0,3,1,0,4,5,0,0,19,4,14,36,15,22,December,-2.4492935982947064e-16,1.0,45,0,0,0,5,0.4,2.8,14,22,-8,33,17,16,"December, 2013"
2013-2014,18,2013-12-26,Tottenham,West Brom,1,1,D,1,1,3,1,1,1,0,4,8,16,30,16,8,14,December,-2.4492935982947064e-16,1.0,42,44,3,2,0,1.6,0.8,18,23,-5,18,23,-5,"December, 2013"
2013-2014,18,2013-12-26,Norwich,Fulham,1,2,A,0,3,0,1,4,1,2,2,14,19,19,13,5,6,December,-2.4492935982947064e-16,1.0,31,19,0,2,3,0.4,2.8,15,29,-14,17,34,-17,"December, 2013"
2013-2014,18,2013-12-26,Newcastle,Stoke,5,1,H,3,0,1,0,4,3,1,1,7,10,30,21,3,9,December,-2.4492935982947064e-16,1.0,30,39,3,0,2,1.8,1.6,24,22,2,17,21,-4,"December, 2013"
2013-2014,18,2013-12-26,Man City,Liverpool,2,1,H,3,0,5,0,0,3,1,1,4,2,35,36,2,1,December,-2.4492935982947064e-16,1.0,27,25,1,3,1,1.6,1.6,51,20,31,42,19,23,"December, 2013"
2013-2014,18,2013-12-26,Everton,Sunderland,0,1,A,0,3,2,0,3,4,0,1,5,20,34,10,15,24,December,-2.4492935982947064e-16,1.0,18,40,3,1,1,1.8,0.6,29,16,13,12,30,-18,"December, 2013"
2013-2014,18,2013-12-26,Chelsea,Swansea,1,0,H,3,0,3,1,1,3,0,2,4,11,34,20,7,14,December,-2.4492935982947064e-16,1.0,14,41,2,2,0,2.0,0.75,32,18,14,23,23,0,"December, 2013"
2013-2014,18,2013-12-26,Cardiff,Southampton,0,3,A,0,3,1,1,3,2,2,1,15,9,17,24,6,7,December,-2.4492935982947064e-16,1.0,12,38,0,0,0,0.0,0.0,13,25,-12,22,18,4,"December, 2013"
2013-2014,18,2013-12-26,Aston Villa,Crystal Palace,0,1,A,0,3,1,1,3,2,2,1,13,18,19,13,5,6,December,-2.4492935982947064e-16,1.0,1,16,1,2,1,1.25,1.25,17,23,-6,11,27,-16,"December, 2013"
2013-2014,18,2013-12-26,Hull,Man United,2,3,A,0,3,0,1,4,2,1,2,12,8,20,28,4,8,December,-2.4492935982947064e-16,1.0,21,28,0,0,4,1.0,3.0,14,20,-6,28,20,8,"December, 2013"
2013-2014,19,2013-12-28,West Ham,West Brom,3,3,D,1,1,1,0,4,1,0,4,19,16,14,17,3,3,December,-2.4492935982947064e-16,1.0,45,44,1,4,0,1.6,1.2,15,25,-10,19,24,-5,"December, 2013"
2013-2014,19,2013-12-28,Aston Villa,Swansea,1,1,D,1,1,1,1,3,3,0,2,13,11,19,20,2,1,December,-2.4492935982947064e-16,1.0,1,41,1,2,1,1.0,1.0,17,24,-7,23,24,-1,"December, 2013"
2013-2014,19,2013-12-28,Cardiff,Sunderland,2,2,D,1,1,1,1,3,4,0,1,16,20,17,13,4,4,December,-2.4492935982947064e-16,1.0,12,40,0,0,0,0.0,0.0,13,28,-15,13,30,-17,"December, 2013"
2013-2014,19,2013-12-28,Hull,Fulham,6,0,H,3,0,0,1,4,1,2,2,13,18,20,16,5,4,December,-2.4492935982947064e-16,1.0,21,19,3,0,1,1.25,0.75,16,23,-7,19,35,-16,"December, 2013"
2013-2014,19,2013-12-28,Man City,Crystal Palace,1,0,H,3,0,5,0,0,2,2,1,2,17,38,16,15,22,December,-2.4492935982947064e-16,1.0,27,16,2,0,0,2.5,1.0,53,21,32,12,27,-15,"December, 2013"
2013-2014,19,2013-12-28,Norwich,Man United,0,1,A,0,3,0,1,4,2,1,2,14,7,19,31,7,12,December,-2.4492935982947064e-16,1.0,31,28,2,0,3,0.8,1.6,16,31,-15,31,22,9,"December, 2013"
2013-2014,19,2013-12-29,Tottenham,Stoke,3,0,H,3,0,3,1,1,3,1,1,8,12,31,21,4,10,December,-2.4492935982947064e-16,1.0,42,39,2,2,1,1.4,1.2,19,24,-5,18,26,-8,"December, 2013"
2013-2014,19,2013-12-29,Newcastle,Arsenal,0,1,A,0,3,1,0,4,5,0,0,7,3,33,39,4,6,December,-2.4492935982947064e-16,1.0,30,0,0,2,3,1.6,2.8,29,23,6,36,18,18,"December, 2013"
2013-2014,19,2013-12-29,Chelsea,Liverpool,2,1,H,3,0,3,1,1,3,1,1,3,4,37,36,1,1,December,-2.4492935982947064e-16,1.0,14,25,0,2,3,1.0,2.0,33,18,15,43,21,22,"December, 2013"
2013-2014,19,2013-12-29,Everton,Southampton,2,1,H,3,0,2,0,3,2,2,1,5,9,34,27,4,7,December,-2.4492935982947064e-16,1.0,18,38,2,3,0,1.8,1.2,29,17,12,25,18,7,"December, 2013"
2013-2014,20,2014-01-01,Swansea,Man City,2,3,A,0,3,3,0,2,5,0,0,13,3,21,41,10,20,January,0.4999999999999999,0.8660254037844387,41,27,1,1,3,0.2,1.6,24,25,-1,54,21,33,"January, 2014"
2013-2014,20,2014-01-01,Arsenal,Cardiff,2,0,H,3,0,5,0,0,1,1,3,1,16,42,18,15,24,January,0.4999999999999999,0.8660254037844387,0,12,1,0,0,3.0,0.0,37,18,19,15,30,-15,"January, 2014"
2013-2014,20,2014-01-01,Crystal Palace,Norwich,1,1,D,1,1,2,2,1,0,1,4,17,14,16,19,3,3,January,0.4999999999999999,0.8660254037844387,16,31,0,2,1,1.3333333333333333,1.6666666666666667,12,28,-16,16,32,-16,"January, 2014"
2013-2014,20,2014-01-01,Fulham,West Ham,2,1,H,3,0,1,2,2,1,0,4,18,19,16,15,1,1,January,0.4999999999999999,0.8660254037844387,19,45,1,1,3,1.0,2.2,19,41,-22,18,28,-10,"January, 2014"
2013-2014,20,2014-01-01,Liverpool,Hull,2,0,H,3,0,3,1,1,0,1,4,5,10,36,23,5,13,January,0.4999999999999999,0.8660254037844387,25,21,2,2,1,2.4,1.4,44,23,21,22,23,-1,"January, 2014"
2013-2014,20,2014-01-01,Man United,Tottenham,1,2,A,0,3,2,1,2,3,1,1,6,7,34,34,1,0,January,0.4999999999999999,0.8660254037844387,28,42,2,2,1,2.2,1.4,32,22,10,22,24,-2,"January, 2014"
2013-2014,20,2014-01-01,Southampton,Chelsea,0,3,A,0,3,2,2,1,3,1,1,9,3,27,40,6,13,January,0.4999999999999999,0.8660254037844387,38,14,1,1,3,1.4,2.2,26,20,6,35,19,16,"January, 2014"
2013-2014,20,2014-01-01,Stoke,Everton,1,1,D,1,1,3,1,1,2,0,3,12,5,21,37,7,16,January,0.4999999999999999,0.8660254037844387,39,18,1,2,2,0.6,1.4,18,29,-11,31,18,13,"January, 2014"
2013-2014,20,2014-01-01,Sunderland,Aston Villa,0,1,A,0,3,4,0,1,1,1,3,20,13,14,20,7,6,January,0.4999999999999999,0.8660254037844387,40,1,0,3,2,0.6,1.8,15,32,-17,18,25,-7,"January, 2014"
2013-2014,20,2014-01-01,West Brom,Newcastle,1,0,H,3,0,1,0,4,1,0,4,16,8,18,33,8,15,January,0.4999999999999999,0.8660254037844387,44,30,1,1,3,1.4,2.0,22,27,-5,29,24,5,"January, 2014"
2013-2014,21,2014-01-11,Tottenham,Crystal Palace,2,0,H,3,0,3,1,1,2,2,1,7,20,37,17,13,20,January,0.4999999999999999,0.8660254037844387,42,16,2,1,2,1.0,1.2,24,25,-1,13,29,-16,"January, 2014"
2013-2014,21,2014-01-11,Southampton,West Brom,1,0,H,3,0,2,2,1,1,0,4,9,14,27,21,5,6,January,0.4999999999999999,0.8660254037844387,38,44,1,2,2,0.6,1.4,26,23,3,23,27,-4,"January, 2014"
2013-2014,21,2014-01-11,Man United,Swansea,2,0,H,3,0,2,1,2,3,0,2,7,13,34,21,6,13,January,0.4999999999999999,0.8660254037844387,28,41,4,1,0,2.0,0.6,33,24,9,26,28,-2,"January, 2014"
2013-2014,21,2014-01-11,Cardiff,West Ham,0,2,A,0,3,1,1,3,1,0,4,17,19,18,15,2,3,January,0.4999999999999999,0.8660254037844387,12,45,0,0,1,0.0,2.0,15,32,-17,19,30,-11,"January, 2014"
2013-2014,21,2014-01-11,Fulham,Sunderland,1,4,A,0,3,1,2,2,4,0,1,16,20,19,14,4,5,January,0.4999999999999999,0.8660254037844387,19,40,2,2,1,1.2,1.2,21,42,-21,15,33,-18,"January, 2014"
2013-2014,21,2014-01-11,Everton,Norwich,2,0,H,3,0,2,0,3,0,1,4,5,15,38,20,10,18,January,0.4999999999999999,0.8660254037844387,18,31,0,4,1,1.4,1.6,32,19,13,17,33,-16,"January, 2014"
2013-2014,21,2014-01-11,Hull,Chelsea,0,2,A,0,3,0,1,4,3,1,1,10,3,23,43,7,20,January,0.4999999999999999,0.8660254037844387,21,14,0,2,3,0.4,1.6,22,25,-3,38,19,19,"January, 2014"
2013-2014,21,2014-01-12,Newcastle,Man City,0,2,A,0,3,1,0,4,5,0,0,8,3,33,44,5,11,January,0.4999999999999999,0.8660254037844387,30,27,0,0,5,0.4,3.2,29,25,4,57,23,34,"January, 2014"
2013-2014,21,2014-01-12,Stoke,Liverpool,3,5,A,0,3,3,1,1,3,1,1,12,6,22,39,6,17,January,0.4999999999999999,0.8660254037844387,39,25,2,2,1,0.8,0.4,19,30,-11,46,23,23,"January, 2014"
2013-2014,21,2014-01-13,Aston Villa,Arsenal,1,2,A,0,3,1,1,3,5,0,0,11,3,23,45,8,22,January,0.4999999999999999,0.8660254037844387,1,0,1,1,3,1.0,1.6,19,25,-6,39,18,21,"January, 2014"
2013-2014,22,2014-01-18,Sunderland,Southampton,2,2,D,1,1,4,0,1,2,2,1,20,9,17,30,11,13,January,0.4999999999999999,0.8660254037844387,40,38,1,2,2,0.8,1.0,19,34,-15,27,23,4,"January, 2014"
2013-2014,22,2014-01-18,West Ham,Newcastle,1,3,A,0,3,1,0,4,1,0,4,18,8,18,33,10,15,January,0.4999999999999999,0.8660254037844387,45,30,1,2,2,0.4,1.4,21,30,-9,29,27,2,"January, 2014"
2013-2014,22,2014-01-18,Norwich,Hull,1,0,H,3,0,0,1,4,0,1,4,16,11,20,23,5,3,January,0.4999999999999999,0.8660254037844387,31,21,0,0,1,0.0,1.0,17,35,-18,22,27,-5,"January, 2014"
2013-2014,22,2014-01-18,Arsenal,Fulham,2,0,H,3,0,5,0,0,1,2,2,1,16,48,19,15,29,January,0.4999999999999999,0.8660254037844387,0,19,2,2,1,1.8,1.4,41,19,22,22,46,-24,"January, 2014"
2013-2014,22,2014-01-18,Liverpool,Aston Villa,2,2,D,1,1,3,1,1,1,1,3,4,11,42,23,7,19,January,0.4999999999999999,0.8660254037844387,25,1,3,1,1,1.4,1.0,51,26,25,20,27,-7,"January, 2014"
2013-2014,22,2014-01-18,Crystal Palace,Stoke,1,0,H,3,0,2,2,1,3,1,1,20,12,17,22,8,5,January,0.4999999999999999,0.8660254037844387,16,39,0,0,1,1.0,2.0,13,31,-18,22,35,-13,"January, 2014"
2013-2014,22,2014-01-18,Man City,Cardiff,4,2,H,3,0,5,0,0,1,1,3,2,19,47,18,17,29,January,0.4999999999999999,0.8660254037844387,27,12,0,0,1,2.0,3.0,59,23,36,15,34,-19,"January, 2014"
2013-2014,22,2014-01-19,Chelsea,Man United,3,1,H,3,0,3,1,1,2,1,2,3,7,46,37,4,9,January,0.4999999999999999,0.8660254037844387,14,28,1,2,2,1.4,1.8,40,19,21,35,24,11,"January, 2014"
2013-2014,22,2014-01-19,Swansea,Tottenham,1,3,A,0,3,3,0,2,3,1,1,14,6,21,40,8,19,January,0.4999999999999999,0.8660254037844387,41,42,0,1,4,0.6,1.6,26,30,-4,26,25,1,"January, 2014"
2013-2014,22,2014-01-20,West Brom,Everton,1,1,D,1,1,1,0,4,2,0,3,14,6,21,41,8,20,January,0.4999999999999999,0.8660254037844387,44,18,1,1,3,0.6,1.0,23,28,-5,34,19,15,"January, 2014"
2013-2014,23,2014-01-28,Swansea,Fulham,2,0,H,3,0,3,0,2,1,2,2,16,17,21,19,1,2,January,0.4999999999999999,0.8660254037844387,41,19,4,0,1,1.8,1.0,27,33,-6,22,48,-26,"January, 2014"
2013-2014,23,2014-01-28,Southampton,Arsenal,2,2,D,1,1,2,2,1,5,0,0,9,1,31,51,8,20,January,0.4999999999999999,0.8660254037844387,38,0,0,3,2,1.0,2.4,29,25,4,43,19,24,"January, 2014"
2013-2014,23,2014-01-28,Norwich,Newcastle,0,0,D,1,1,0,1,4,1,0,4,13,8,23,36,5,13,January,0.4999999999999999,0.8660254037844387,31,30,1,1,3,1.0,1.2,18,35,-17,32,28,4,"January, 2014"
2013-2014,23,2014-01-28,Man United,Cardiff,2,0,H,3,0,2,1,2,1,1,3,7,20,37,18,13,19,January,0.4999999999999999,0.8660254037844387,28,12,0,1,0,2.0,2.0,36,27,9,17,38,-21,"January, 2014"
2013-2014,23,2014-01-28,Crystal Palace,Hull,1,0,H,3,0,2,2,1,0,1,4,16,11,20,23,5,3,January,0.4999999999999999,0.8660254037844387,16,21,1,0,0,1.0,0.0,14,31,-17,22,28,-6,"January, 2014"
2013-2014,23,2014-01-28,Liverpool,Everton,4,0,H,3,0,3,1,1,2,0,3,4,6,43,42,2,1,January,0.4999999999999999,0.8660254037844387,25,18,2,3,0,2.0,1.0,53,28,25,35,20,15,"January, 2014"
2013-2014,23,2014-01-29,Tottenham,Man City,1,5,A,0,3,3,1,1,5,0,0,5,2,43,50,3,7,January,0.4999999999999999,0.8660254037844387,42,27,1,0,4,1.4,3.4,29,26,3,63,25,38,"January, 2014"
2013-2014,23,2014-01-29,Aston Villa,West Brom,4,3,H,3,0,1,1,3,1,0,4,11,15,24,22,4,2,January,0.4999999999999999,0.8660254037844387,1,44,0,4,1,1.2,1.4,22,29,-7,24,29,-5,"January, 2014"
2013-2014,23,2014-01-29,Chelsea,West Ham,0,0,D,1,1,3,1,1,1,0,4,3,18,49,18,15,31,January,0.4999999999999999,0.8660254037844387,14,45,4,0,1,2.4,0.8,43,20,23,22,33,-11,"January, 2014"
2013-2014,23,2014-01-29,Sunderland,Stoke,1,0,H,3,0,4,0,1,3,1,1,19,16,18,22,3,4,January,0.4999999999999999,0.8660254037844387,40,39,2,2,1,1.2,0.6,21,36,-15,22,36,-14,"January, 2014"
2013-2014,24,2014-02-01,Stoke,Man United,2,1,H,3,0,3,1,1,2,1,2,17,7,22,40,10,18,February,0.8660254037844386,0.5000000000000001,39,28,0,1,4,1.0,2.4,22,37,-15,38,27,11,"February, 2014"
2013-2014,24,2014-02-01,Fulham,Southampton,0,3,A,0,3,1,2,2,2,2,1,20,9,19,32,11,13,February,0.8660254037844386,0.5000000000000001,19,38,1,3,1,1.4,1.6,22,50,-28,31,27,4,"February, 2014"
2013-2014,24,2014-02-01,West Ham,Swansea,2,0,H,3,0,1,0,4,3,0,2,19,12,19,24,7,5,February,0.8660254037844386,0.5000000000000001,45,41,1,1,1,0.3333333333333333,1.0,22,33,-11,29,33,-4,"February, 2014"
2013-2014,24,2014-02-01,Newcastle,Sunderland,0,3,A,0,3,1,0,4,4,0,1,8,17,37,21,9,16,February,0.8660254037844386,0.5000000000000001,30,40,1,2,2,0.8,1.4,32,28,4,22,36,-14,"February, 2014"
2013-2014,24,2014-02-01,Everton,Aston Villa,2,1,H,3,0,2,0,3,1,1,3,6,10,42,27,4,15,February,0.8660254037844386,0.5000000000000001,18,1,2,3,0,2.2,1.4,35,24,11,26,32,-6,"February, 2014"
2013-2014,24,2014-02-01,Hull,Tottenham,1,1,D,1,1,0,1,4,3,1,1,13,6,23,43,7,20,February,0.8660254037844386,0.5000000000000001,21,42,1,1,3,0.6,1.6,22,29,-7,30,31,-1,"February, 2014"
2013-2014,24,2014-02-01,Cardiff,Norwich,2,1,H,3,0,1,1,3,0,1,4,20,12,18,24,8,6,February,0.8660254037844386,0.5000000000000001,12,31,0,1,0,0.0,0.0,17,40,-23,18,35,-17,"February, 2014"
2013-2014,24,2014-02-02,Arsenal,Crystal Palace,2,0,H,3,0,5,0,0,2,2,1,2,16,52,23,14,29,February,0.8660254037844386,0.5000000000000001,0,16,3,2,0,1.8,0.4,45,21,24,15,31,-16,"February, 2014"
2013-2014,24,2014-02-02,West Brom,Liverpool,1,1,D,1,1,1,0,4,3,1,1,17,4,22,46,13,24,February,0.8660254037844386,0.5000000000000001,44,25,3,0,2,1.4,1.2,27,33,-6,57,28,29,"February, 2014"
2013-2014,24,2014-02-03,Man City,Chelsea,0,1,A,0,3,5,0,0,3,1,1,2,3,53,50,1,3,February,0.8660254037844386,0.5000000000000001,27,14,2,1,2,1.2,1.0,68,26,42,43,20,23,"February, 2014"
2013-2014,25,2014-02-08,Swansea,Cardiff,3,0,H,3,0,3,0,2,1,1,3,16,19,24,21,3,3,February,0.8660254037844386,0.5000000000000001,41,12,0,0,1,0.0,1.0,29,35,-6,19,41,-22,"February, 2014"
2013-2014,25,2014-02-08,Sunderland,Hull,0,2,A,0,3,4,0,1,0,1,4,17,16,24,24,1,0,February,0.8660254037844386,0.5000000000000001,40,21,4,0,1,2.0,0.6,25,36,-11,23,30,-7,"February, 2014"
2013-2014,25,2014-02-08,Norwich,Man City,0,0,D,1,1,0,1,4,5,0,0,17,3,24,53,14,29,February,0.8660254037844386,0.5000000000000001,31,27,1,0,4,1.6,4.8,19,37,-18,68,27,41,"February, 2014"
2013-2014,25,2014-02-08,Southampton,Stoke,2,2,D,1,1,2,2,1,3,1,1,9,13,35,25,4,10,February,0.8660254037844386,0.5000000000000001,38,39,0,3,0,1.6666666666666667,1.6666666666666667,34,27,7,24,38,-14,"February, 2014"
2013-2014,25,2014-02-08,Crystal Palace,West Brom,3,1,H,3,0,2,2,1,1,0,4,18,17,23,23,1,0,February,0.8660254037844386,0.5000000000000001,16,44,1,1,1,1.6666666666666667,1.3333333333333333,15,33,-18,28,34,-6,"February, 2014"
2013-2014,25,2014-02-08,Chelsea,Newcastle,3,0,H,3,0,3,1,1,1,0,4,3,8,53,37,5,16,February,0.8660254037844386,0.5000000000000001,14,30,2,0,3,1.4,1.4,44,20,24,32,31,1,"February, 2014"
2013-2014,25,2014-02-08,Aston Villa,West Ham,0,2,A,0,3,1,1,3,1,0,4,10,18,27,22,8,5,February,0.8660254037844386,0.5000000000000001,1,45,3,1,1,1.4,0.6,27,34,-7,24,33,-9,"February, 2014"
2013-2014,25,2014-02-08,Liverpool,Arsenal,5,1,H,3,0,3,1,1,5,0,0,4,2,47,55,2,8,February,0.8660254037844386,0.5000000000000001,25,0,1,1,3,1.0,1.6,58,29,29,47,21,26,"February, 2014"
2013-2014,25,2014-02-09,Man United,Fulham,2,2,D,1,1,2,1,2,1,2,2,7,20,40,19,13,21,February,0.8660254037844386,0.5000000000000001,28,19,5,0,0,2.6,0.6,39,29,10,22,53,-31,"February, 2014"
2013-2014,25,2014-02-09,Tottenham,Everton,1,0,H,3,0,3,1,1,2,0,3,6,5,44,45,1,1,February,0.8660254037844386,0.5000000000000001,42,18,1,2,2,1.0,1.0,31,32,-1,37,25,12,"February, 2014"
2013-2014,26,2014-02-11,Cardiff,Aston Villa,0,0,D,1,1,1,1,3,1,1,3,19,12,21,27,7,6,February,0.8660254037844386,0.5000000000000001,12,1,0,0,1,0.0,2.0,19,44,-25,27,36,-9,"February, 2014"
2013-2014,26,2014-02-11,Hull,Southampton,0,1,A,0,3,0,1,4,2,2,1,12,9,27,36,3,9,February,0.8660254037844386,0.5000000000000001,21,38,0,0,1,1.0,4.0,25,30,-5,36,29,7,"February, 2014"
2013-2014,26,2014-02-11,West Brom,Chelsea,1,1,D,1,1,1,0,4,3,1,1,18,1,23,56,17,33,February,0.8660254037844386,0.5000000000000001,44,14,2,1,2,1.2,1.2,29,37,-8,47,20,27,"February, 2014"
2013-2014,26,2014-02-11,West Ham,Norwich,2,0,H,3,0,1,0,4,0,1,4,15,16,25,25,1,0,February,0.8660254037844386,0.5000000000000001,45,31,1,1,1,1.0,1.3333333333333333,26,33,-7,19,37,-18,"February, 2014"
2013-2014,26,2014-02-12,Newcastle,Tottenham,0,4,A,0,3,1,0,4,3,1,1,9,5,37,47,4,10,February,0.8660254037844386,0.5000000000000001,30,42,2,1,2,1.2,2.0,32,34,-2,32,32,0,"February, 2014"
2013-2014,26,2014-02-12,Stoke,Swansea,1,1,D,1,1,3,1,1,3,0,2,14,12,26,27,2,1,February,0.8660254037844386,0.5000000000000001,39,41,2,1,2,1.6,1.6,26,40,-14,32,35,-3,"February, 2014"
2013-2014,26,2014-02-12,Fulham,Liverpool,2,3,A,0,3,1,2,2,3,1,1,20,4,20,50,16,30,February,0.8660254037844386,0.5000000000000001,19,25,2,0,3,0.6,2.2,24,55,-31,63,30,33,"February, 2014"
2013-2014,26,2014-02-12,Arsenal,Man United,0,0,D,1,1,5,0,0,2,1,2,2,7,55,41,5,14,February,0.8660254037844386,0.5000000000000001,0,28,0,1,4,1.0,2.8,48,26,22,41,31,10,"February, 2014"
2013-2014,27,2014-02-22,Arsenal,Sunderland,4,1,H,3,0,5,0,0,4,0,1,2,18,56,24,16,32,February,0.8660254037844386,0.5000000000000001,0,40,4,1,0,1.6,0.6,48,26,22,25,38,-13,"February, 2014"
2013-2014,27,2014-02-22,Cardiff,Hull,0,4,A,0,3,1,1,3,0,1,4,19,13,22,27,6,5,February,0.8660254037844386,0.5000000000000001,12,21,0,1,0,1.0,1.0,19,44,-25,25,31,-6,"February, 2014"
2013-2014,27,2014-02-22,Chelsea,Everton,1,0,H,3,0,3,1,1,2,0,3,2,6,57,45,4,12,February,0.8660254037844386,0.5000000000000001,14,18,3,0,2,1.4,1.2,48,21,27,37,26,11,"February, 2014"
2013-2014,27,2014-02-22,Crystal Palace,Man United,0,2,A,0,3,2,2,1,2,1,2,15,7,26,42,8,16,February,0.8660254037844386,0.5000000000000001,16,28,0,1,4,0.4,2.4,18,34,-16,41,31,10,"February, 2014"
2013-2014,27,2014-02-22,Man City,Stoke,1,0,H,3,0,5,0,0,3,1,1,3,14,54,27,11,27,February,0.8660254037844386,0.5000000000000001,27,39,2,3,0,1.6,0.4,68,27,41,27,41,-14,"February, 2014"
2013-2014,27,2014-02-22,West Brom,Fulham,1,1,D,1,1,1,0,4,1,2,2,17,20,24,20,3,4,February,0.8660254037844386,0.5000000000000001,44,19,0,3,2,0.6,1.4,30,38,-8,26,58,-32,"February, 2014"
2013-2014,27,2014-02-22,West Ham,Southampton,3,1,H,3,0,1,0,4,2,2,1,12,8,28,39,4,11,February,0.8660254037844386,0.5000000000000001,45,38,1,3,1,1.2,0.8,28,33,-5,37,29,8,"February, 2014"
2013-2014,27,2014-02-23,Liverpool,Swansea,4,3,H,3,0,3,1,1,3,0,2,4,12,53,28,8,25,February,0.8660254037844386,0.5000000000000001,25,41,1,3,1,1.4,0.6,66,32,34,33,36,-3,"February, 2014"
2013-2014,27,2014-02-23,Newcastle,Aston Villa,1,0,H,3,0,1,0,4,1,1,3,9,13,37,28,4,9,February,0.8660254037844386,0.5000000000000001,30,1,3,2,0,1.6,1.0,32,38,-6,27,36,-9,"February, 2014"
2013-2014,27,2014-02-23,Norwich,Tottenham,1,0,H,3,0,0,1,4,3,1,1,17,5,25,50,12,25,February,0.8660254037844386,0.5000000000000001,31,42,1,2,2,0.8,1.4,19,39,-20,36,32,4,"February, 2014"
2013-2014,28,2014-03-01,Southampton,Liverpool,0,3,A,0,3,2,2,1,3,1,1,9,4,39,56,5,17,March,1.0,6.123233995736766e-17,38,25,3,0,2,1.2,0.6,38,32,6,70,35,35,"March, 2014"
2013-2014,28,2014-03-01,Everton,West Ham,1,0,H,3,0,2,0,3,1,0,4,7,10,45,31,3,14,March,1.0,6.123233995736766e-17,18,45,3,2,0,2.0,1.2,37,27,10,31,34,-3,"March, 2014"
2013-2014,28,2014-03-01,Fulham,Chelsea,1,3,A,0,3,1,2,2,3,1,1,20,1,21,60,19,39,March,1.0,6.123233995736766e-17,19,14,0,3,2,0.4,1.4,27,59,-32,49,21,28,"March, 2014"
2013-2014,28,2014-03-01,Hull,Newcastle,1,4,A,0,3,0,1,4,1,0,4,11,8,30,40,3,10,March,1.0,6.123233995736766e-17,21,30,2,1,0,2.0,1.3333333333333333,29,31,-2,33,38,-5,"March, 2014"
2013-2014,28,2014-03-01,Stoke,Arsenal,1,0,H,3,0,3,1,1,5,0,0,15,3,27,59,12,32,March,1.0,6.123233995736766e-17,39,0,0,2,3,0.6,1.6,27,42,-15,52,27,25,"March, 2014"
2013-2014,28,2014-03-02,Swansea,Crystal Palace,1,1,D,1,1,3,0,2,2,2,1,14,16,28,26,2,2,March,1.0,6.123233995736766e-17,41,16,1,0,0,2.0,0.0,36,40,-4,18,36,-18,"March, 2014"
2013-2014,28,2014-03-02,Aston Villa,Norwich,4,1,H,3,0,1,1,3,0,1,4,14,15,28,28,1,0,March,1.0,6.123233995736766e-17,1,31,3,1,1,1.4,1.2,27,37,-10,20,39,-19,"March, 2014"
2013-2014,28,2014-03-02,Tottenham,Cardiff,1,0,H,3,0,3,1,1,1,1,3,5,19,50,22,14,28,March,1.0,6.123233995736766e-17,42,12,1,0,0,1.0,0.0,36,33,3,19,48,-29,"March, 2014"
2013-2014,29,2014-03-08,West Brom,Man United,0,3,A,0,3,1,0,4,2,1,2,17,7,25,45,10,20,March,1.0,6.123233995736766e-17,44,28,1,1,3,1.6,2.4,31,39,-8,43,31,12,"March, 2014"
2013-2014,29,2014-03-08,Crystal Palace,Southampton,0,1,A,0,3,2,2,1,2,2,1,16,9,27,39,7,12,March,1.0,6.123233995736766e-17,16,38,0,3,2,1.0,1.6,19,37,-18,38,35,3,"March, 2014"
2013-2014,29,2014-03-08,Norwich,Stoke,1,1,D,1,1,0,1,4,3,1,1,15,13,28,30,2,2,March,1.0,6.123233995736766e-17,31,39,2,1,2,0.6,0.6,21,43,-22,28,42,-14,"March, 2014"
2013-2014,29,2014-03-08,Chelsea,Tottenham,4,0,H,3,0,3,1,1,3,1,1,1,5,63,53,4,10,March,1.0,6.123233995736766e-17,14,42,1,4,0,1.6,1.2,52,22,30,37,33,4,"March, 2014"
2013-2014,29,2014-03-08,Cardiff,Fulham,3,1,H,3,0,1,1,3,1,2,2,19,20,22,21,1,1,March,1.0,6.123233995736766e-17,12,19,1,0,0,2.0,1.0,19,49,-30,28,62,-34,"March, 2014"
2013-2014,30,2014-03-15,Aston Villa,Chelsea,1,0,H,3,0,1,1,3,3,1,1,11,1,31,66,10,35,March,1.0,6.123233995736766e-17,1,14,1,0,4,1.4,3.4,31,38,-7,56,22,34,"March, 2014"
2013-2014,30,2014-03-15,Everton,Cardiff,2,1,H,3,0,2,0,3,1,1,3,7,18,48,25,11,23,March,1.0,6.123233995736766e-17,18,12,0,1,0,0.0,0.0,38,27,11,22,50,-28,"March, 2014"
2013-2014,30,2014-03-15,Fulham,Newcastle,1,0,H,3,0,1,2,2,1,0,4,20,8,21,43,12,22,March,1.0,6.123233995736766e-17,19,30,2,0,3,1.6,1.4,29,65,-36,37,39,-2,"March, 2014"
2013-2014,30,2014-03-15,Hull,Man City,0,2,A,0,3,0,1,4,5,0,0,13,4,30,57,9,27,March,1.0,6.123233995736766e-17,21,27,1,2,2,1.2,2.2,30,35,-5,69,27,42,"March, 2014"
2013-2014,30,2014-03-15,Southampton,Norwich,4,2,H,3,0,2,2,1,0,1,4,9,15,42,29,6,13,March,1.0,6.123233995736766e-17,38,31,1,2,2,1.2,1.4,39,35,4,22,44,-22,"March, 2014"
2013-2014,30,2014-03-15,Stoke,West Ham,3,1,H,3,0,3,1,1,1,0,4,12,11,31,31,1,0,March,1.0,6.123233995736766e-17,39,45,1,2,2,0.6,1.2,29,43,-14,31,35,-4,"March, 2014"
2013-2014,30,2014-03-15,Sunderland,Crystal Palace,0,0,D,1,1,4,0,1,2,2,1,19,16,24,27,3,3,March,1.0,6.123233995736766e-17,40,16,0,0,1,1.0,3.0,26,42,-16,19,38,-19,"March, 2014"
2013-2014,30,2014-03-15,Swansea,West Brom,1,2,A,0,3,3,0,2,1,0,4,14,17,29,25,3,4,March,1.0,6.123233995736766e-17,41,44,4,0,1,2.2,0.8,37,41,-4,31,42,-11,"March, 2014"
2013-2014,30,2014-03-16,Man United,Liverpool,0,3,A,0,3,2,1,2,3,1,1,7,3,48,59,4,11,March,1.0,6.123233995736766e-17,28,25,3,1,1,1.4,1.0,46,31,15,73,35,38,"March, 2014"
2013-2014,30,2014-03-16,Tottenham,Arsenal,0,1,A,0,3,3,1,1,5,0,0,5,4,53,59,1,6,March,1.0,6.123233995736766e-17,42,0,2,0,3,1.6,2.6,37,37,0,52,28,24,"March, 2014"
2013-2014,31,2014-03-22,Norwich,Sunderland,2,0,H,3,0,0,1,4,4,0,1,15,18,29,25,3,4,March,1.0,6.123233995736766e-17,31,40,2,2,1,1.0,1.2,24,48,-24,26,42,-16,"March, 2014"
2013-2014,31,2014-03-22,Newcastle,Crystal Palace,1,0,H,3,0,1,0,4,2,2,1,9,17,43,28,8,15,March,1.0,6.123233995736766e-17,30,16,3,1,1,1.6,0.6,37,40,-3,19,38,-19,"March, 2014"
2013-2014,31,2014-03-22,Man City,Fulham,5,0,H,3,0,5,0,0,1,2,2,4,20,60,24,16,36,March,1.0,6.123233995736766e-17,27,19,4,1,0,2.6,1.0,71,27,44,30,65,-35,"March, 2014"
2013-2014,31,2014-03-22,West Ham,Man United,0,2,A,0,3,1,0,4,2,1,2,14,7,31,48,7,17,March,1.0,6.123233995736766e-17,45,28,0,1,4,1.0,2.6,32,38,-6,46,34,12,"March, 2014"
2013-2014,31,2014-03-22,Everton,Swansea,3,2,H,3,0,2,0,3,3,0,2,6,14,51,29,8,22,March,1.0,6.123233995736766e-17,18,41,4,1,0,1.6,0.2,40,28,12,38,43,-5,"March, 2014"
2013-2014,31,2014-03-22,Chelsea,Arsenal,6,0,H,3,0,3,1,1,5,0,0,1,3,66,62,2,4,March,1.0,6.123233995736766e-17,14,0,2,2,1,1.4,1.4,56,23,33,53,28,25,"March, 2014"
2013-2014,31,2014-03-22,Cardiff,Liverpool,3,6,A,0,3,1,1,3,3,1,1,19,2,25,62,17,37,March,1.0,6.123233995736766e-17,12,25,0,0,1,1.0,3.0,23,52,-29,76,35,41,"March, 2014"
2013-2014,31,2014-03-22,Hull,West Brom,2,0,H,3,0,0,1,4,1,0,4,13,16,30,28,3,2,March,1.0,6.123233995736766e-17,21,44,1,2,0,2.0,1.0,30,37,-7,33,43,-10,"March, 2014"
2013-2014,31,2014-03-23,Aston Villa,Stoke,1,4,A,0,3,1,1,3,3,1,1,10,11,34,34,1,0,March,1.0,6.123233995736766e-17,1,39,1,3,1,1.0,0.8,32,38,-6,32,44,-12,"March, 2014"
2013-2014,31,2014-03-23,Tottenham,Southampton,3,2,H,3,0,3,1,1,2,2,1,6,9,53,45,3,8,March,1.0,6.123233995736766e-17,42,38,4,0,1,2.2,1.0,37,38,-1,43,37,6,"March, 2014"
2013-2014,32,2014-03-25,Arsenal,Swansea,2,2,D,1,1,5,0,0,3,0,2,4,15,62,29,11,33,March,1.0,6.123233995736766e-17,0,41,3,0,2,1.4,1.2,53,34,19,40,46,-6,"March, 2014"
2013-2014,32,2014-03-25,Man United,Man City,0,3,A,0,3,2,1,2,5,0,0,7,3,51,63,4,12,March,1.0,6.123233995736766e-17,28,27,1,0,4,1.2,3.0,48,34,14,76,27,49,"March, 2014"
2013-2014,32,2014-03-25,Newcastle,Everton,0,3,A,0,3,1,0,4,2,0,3,8,6,46,54,2,8,March,1.0,6.123233995736766e-17,30,18,1,1,3,1.6,2.2,38,40,-2,43,30,13,"March, 2014"
2013-2014,32,2014-03-26,Liverpool,Sunderland,2,1,H,3,0,3,1,1,4,0,1,3,18,65,25,15,40,March,1.0,6.123233995736766e-17,25,40,2,2,1,1.6,0.8,82,38,44,26,44,-18,"March, 2014"
2013-2014,32,2014-03-26,West Ham,Hull,2,1,H,3,0,1,0,4,0,1,4,14,12,31,33,2,2,March,1.0,6.123233995736766e-17,45,21,2,1,2,1.6,1.0,32,40,-8,32,37,-5,"March, 2014"
2013-2014,33,2014-03-29,West Brom,Cardiff,3,3,D,1,1,1,0,4,1,1,3,17,19,28,25,2,3,March,1.0,6.123233995736766e-17,44,12,0,0,1,0.0,1.0,33,45,-12,26,58,-32,"March, 2014"
2013-2014,33,2014-03-29,Swansea,Norwich,3,0,H,3,0,3,0,2,0,1,4,16,14,30,32,2,2,March,1.0,6.123233995736766e-17,41,31,0,2,3,1.8,2.6,42,48,-6,26,48,-22,"March, 2014"
2013-2014,33,2014-03-29,Stoke,Hull,1,0,H,3,0,3,1,1,0,1,4,10,13,37,33,3,4,March,1.0,6.123233995736766e-17,39,21,2,2,1,1.2,0.8,36,45,-9,33,39,-6,"March, 2014"
2013-2014,33,2014-03-29,Arsenal,Man City,1,1,D,1,1,5,0,0,5,0,0,4,3,63,66,1,3,March,1.0,6.123233995736766e-17,0,27,1,1,3,1.0,2.0,55,36,19,79,27,52,"March, 2014"
2013-2014,33,2014-03-29,Man United,Aston Villa,4,1,H,3,0,2,1,2,1,1,3,7,12,51,34,5,17,March,1.0,6.123233995736766e-17,28,1,5,0,0,2.8,0.4,48,37,11,33,42,-9,"March, 2014"
2013-2014,33,2014-03-29,Crystal Palace,Chelsea,1,0,H,3,0,2,2,1,3,1,1,17,1,28,69,16,41,March,1.0,6.123233995736766e-17,16,14,0,0,5,0.8,3.4,19,39,-20,62,23,39,"March, 2014"
2013-2014,33,2014-03-29,Southampton,Newcastle,4,0,H,3,0,2,2,1,1,0,4,9,8,45,46,1,1,March,1.0,6.123233995736766e-17,38,30,1,1,3,1.4,1.8,45,40,5,38,43,-5,"March, 2014"
2013-2014,33,2014-03-30,Fulham,Everton,1,3,A,0,3,1,2,2,2,0,3,20,5,24,57,15,33,March,1.0,6.123233995736766e-17,19,18,0,1,4,0.8,2.8,30,70,-40,46,30,16,"March, 2014"
2013-2014,33,2014-03-30,Liverpool,Tottenham,4,0,H,3,0,3,1,1,3,1,1,2,6,68,56,4,12,March,1.0,6.123233995736766e-17,25,42,2,1,2,1.8,1.6,84,39,45,40,40,0,"March, 2014"
2013-2014,33,2014-03-31,Sunderland,West Ham,1,2,A,0,3,4,0,1,1,0,4,19,11,25,34,8,9,March,1.0,6.123233995736766e-17,40,45,3,2,0,1.6,0.2,27,46,-19,34,41,-7,"March, 2014"
2013-2014,34,2014-04-05,Man City,Southampton,4,1,H,3,0,5,0,0,2,2,1,3,8,67,48,5,19,April,0.8660254037844388,-0.4999999999999998,27,38,2,2,1,1.4,1.4,80,28,52,49,40,9,"April, 2014"
2013-2014,34,2014-04-05,Norwich,West Brom,0,1,A,0,3,0,1,4,1,0,4,16,17,32,29,1,3,April,0.8660254037844388,-0.4999999999999998,31,44,3,0,2,1.8,0.8,26,51,-25,36,48,-12,"April, 2014"
2013-2014,34,2014-04-05,Hull,Swansea,1,0,H,3,0,0,1,4,3,0,2,15,14,33,33,1,0,April,0.8660254037844388,-0.4999999999999998,21,41,0,1,0,1.0,1.0,33,40,-7,45,48,-3,"April, 2014"
2013-2014,34,2014-04-05,Newcastle,Man United,0,4,A,0,3,1,0,4,2,1,2,9,7,46,54,2,8,April,0.8660254037844388,-0.4999999999999998,30,28,2,1,2,1.6,1.6,38,47,-9,52,38,14,"April, 2014"
2013-2014,34,2014-04-05,Cardiff,Crystal Palace,0,3,A,0,3,1,1,3,2,2,1,19,16,26,31,3,5,April,0.8660254037844388,-0.4999999999999998,12,16,0,0,1,0.0,2.0,29,61,-32,20,39,-19,"April, 2014"
2013-2014,34,2014-04-05,Chelsea,Stoke,3,0,H,3,0,3,1,1,3,1,1,2,10,69,40,8,29,April,0.8660254037844388,-0.4999999999999998,14,39,3,1,1,1.6,0.6,62,24,38,37,45,-8,"April, 2014"
2013-2014,34,2014-04-05,Aston Villa,Fulham,1,2,A,0,3,1,1,3,1,2,2,12,20,34,24,8,10,April,0.8660254037844388,-0.4999999999999998,1,19,1,2,2,0.4,0.8,34,46,-12,31,73,-42,"April, 2014"
2013-2014,34,2014-04-06,Everton,Arsenal,3,0,H,3,0,2,0,3,5,0,0,5,4,60,64,1,4,April,0.8660254037844388,-0.4999999999999998,18,0,0,3,2,0.4,0.8,49,31,18,56,37,19,"April, 2014"
2013-2014,34,2014-04-06,West Ham,Liverpool,1,2,A,0,3,1,0,4,3,1,1,11,2,37,71,9,34,April,0.8660254037844388,-0.4999999999999998,45,25,1,1,3,1.2,2.2,36,42,-6,88,39,49,"April, 2014"
2013-2014,34,2014-04-07,Tottenham,Sunderland,5,1,H,3,0,3,1,1,4,0,1,7,20,56,25,13,31,April,0.8660254037844388,-0.4999999999999998,42,40,4,1,0,1.2,0.4,40,44,-4,28,48,-20,"April, 2014"
2013-2014,35,2014-04-12,West Brom,Tottenham,3,3,D,1,1,1,0,4,3,1,1,16,6,32,59,10,27,April,0.8660254037844388,-0.4999999999999998,44,42,0,2,3,0.6,1.4,37,48,-11,45,45,0,"April, 2014"
2013-2014,35,2014-04-12,Sunderland,Everton,0,1,A,0,3,4,0,1,2,0,3,20,5,25,63,15,38,April,0.8660254037844388,-0.4999999999999998,40,18,2,1,2,0.8,1.4,29,53,-24,52,31,21,"April, 2014"
2013-2014,35,2014-04-12,Stoke,Newcastle,1,0,H,3,0,3,1,1,1,0,4,10,9,40,46,1,6,April,0.8660254037844388,-0.4999999999999998,39,30,1,0,4,1.0,2.8,37,48,-11,38,51,-13,"April, 2014"
2013-2014,35,2014-04-12,Fulham,Norwich,1,0,H,3,0,1,2,2,0,1,4,18,17,27,32,1,5,April,0.8660254037844388,-0.4999999999999998,19,31,3,2,0,2.0,0.6,33,74,-41,26,52,-26,"April, 2014"
2013-2014,35,2014-04-12,Crystal Palace,Aston Villa,1,0,H,3,0,2,2,1,1,1,3,14,13,34,34,1,0,April,0.8660254037844388,-0.4999999999999998,16,1,2,2,1,1.2,1.0,23,39,-16,35,48,-13,"April, 2014"
2013-2014,35,2014-04-12,Southampton,Cardiff,0,1,A,0,3,2,2,1,1,1,3,8,19,48,26,11,22,April,0.8660254037844388,-0.4999999999999998,38,12,1,0,0,3.0,0.0,50,44,6,29,64,-35,"April, 2014"
2013-2014,35,2014-04-13,Liverpool,Man City,3,2,H,3,0,3,1,1,5,0,0,1,3,74,70,2,4,April,0.8660254037844388,-0.4999999999999998,25,27,0,3,2,1.2,2.0,90,40,50,84,29,55,"April, 2014"
2013-2014,35,2014-04-13,Swansea,Chelsea,0,1,A,0,3,3,0,2,3,1,1,15,2,33,72,13,39,April,0.8660254037844388,-0.4999999999999998,41,14,0,2,3,0.6,1.8,45,49,-4,65,24,41,"April, 2014"
2013-2014,36,2014-04-15,Arsenal,West Ham,3,1,H,3,0,5,0,0,1,0,4,5,11,64,37,6,27,April,0.8660254037844388,-0.4999999999999998,0,45,5,0,0,3.0,0.6,56,40,16,37,44,-7,"April, 2014"
2013-2014,36,2014-04-16,Everton,Crystal Palace,2,3,A,0,3,2,0,3,2,2,1,5,12,66,37,7,29,April,0.8660254037844388,-0.4999999999999998,18,16,3,1,1,2.2,0.8,53,31,22,24,39,-15,"April, 2014"
2013-2014,36,2014-04-16,Man City,Sunderland,2,2,D,1,1,5,0,0,4,0,1,3,20,70,25,17,45,April,0.8660254037844388,-0.4999999999999998,27,40,1,1,3,1.2,1.2,86,32,54,29,54,-25,"April, 2014"
2013-2014,37,2014-04-19,Tottenham,Fulham,3,1,H,3,0,3,1,1,1,2,2,6,19,60,30,13,30,April,0.8660254037844388,-0.4999999999999998,42,19,4,0,1,2.0,0.6,48,48,0,34,74,-40,"April, 2014"
2013-2014,37,2014-04-19,Newcastle,Swansea,1,2,A,0,3,1,0,4,3,0,2,9,15,46,33,6,13,April,0.8660254037844388,-0.4999999999999998,30,41,1,1,3,0.6,1.2,38,52,-14,45,50,-5,"April, 2014"
2013-2014,37,2014-04-19,West Ham,Crystal Palace,0,1,A,0,3,1,0,4,2,2,1,12,11,37,40,1,3,April,0.8660254037844388,-0.4999999999999998,45,16,1,1,1,2.333333333333333,1.6666666666666667,38,47,-9,27,41,-14,"April, 2014"
2013-2014,37,2014-04-19,Cardiff,Stoke,1,1,D,1,1,1,1,3,3,1,1,19,10,29,43,9,14,April,0.8660254037844388,-0.4999999999999998,12,39,0,1,0,0.0,0.0,30,64,-34,38,48,-10,"April, 2014"
2013-2014,37,2014-04-19,Aston Villa,Southampton,0,0,D,1,1,1,1,3,2,2,1,14,8,34,48,6,14,April,0.8660254037844388,-0.4999999999999998,1,38,3,0,2,1.8,1.8,35,49,-14,50,45,5,"April, 2014"
2013-2014,37,2014-04-19,Chelsea,Sunderland,1,2,A,0,3,3,1,1,4,0,1,2,20,75,26,18,49,April,0.8660254037844388,-0.4999999999999998,14,40,5,0,0,2.4,1.2,66,24,42,31,56,-25,"April, 2014"
2013-2014,37,2014-04-20,Everton,Man United,2,0,H,3,0,2,0,3,2,1,2,5,7,66,57,2,9,April,0.8660254037844388,-0.4999999999999998,18,28,2,1,2,1.2,1.4,55,34,21,56,38,18,"April, 2014"
2013-2014,37,2014-04-20,Hull,Arsenal,0,3,A,0,3,0,1,4,5,0,0,14,5,36,67,9,31,April,0.8660254037844388,-0.4999999999999998,21,0,1,0,4,0.8,2.2,34,40,-6,59,41,18,"April, 2014"
2013-2014,37,2014-04-20,Norwich,Liverpool,2,3,A,0,3,0,1,4,3,1,1,17,1,32,77,16,45,April,0.8660254037844388,-0.4999999999999998,31,25,0,1,4,0.8,3.8,26,53,-27,93,42,51,"April, 2014"
2013-2014,37,2014-04-21,Man City,West Brom,3,1,H,3,0,5,0,0,1,0,4,3,16,71,33,13,38,April,0.8660254037844388,-0.4999999999999998,27,44,4,1,0,2.0,0.6,88,34,54,40,51,-11,"April, 2014"
2013-2014,38,2014-04-26,Swansea,Aston Villa,4,1,H,3,0,3,0,2,1,1,3,14,15,36,35,1,1,April,0.8660254037844388,-0.4999999999999998,41,1,1,3,1,1.0,1.0,47,51,-4,35,49,-14,"April, 2014"
2013-2014,38,2014-04-26,Stoke,Tottenham,0,1,A,0,3,3,1,1,3,1,1,10,6,44,63,4,19,April,0.8660254037844388,-0.4999999999999998,39,42,1,2,2,0.8,1.4,39,49,-10,51,49,2,"April, 2014"
2013-2014,38,2014-04-26,West Brom,West Ham,1,0,H,3,0,1,0,4,1,0,4,16,14,33,37,2,4,April,0.8660254037844388,-0.4999999999999998,44,45,0,4,1,1.8,2.2,41,54,-13,38,48,-10,"April, 2014"
2013-2014,38,2014-04-26,Man United,Norwich,4,0,H,3,0,2,1,2,0,1,4,7,17,57,32,10,25,April,0.8660254037844388,-0.4999999999999998,28,31,4,0,1,1.8,0.4,56,40,16,28,56,-28,"April, 2014"
2013-2014,38,2014-04-26,Fulham,Hull,2,2,D,1,1,1,2,2,0,1,4,19,14,30,36,5,6,April,0.8660254037844388,-0.4999999999999998,19,21,1,0,4,0.6,2.2,35,77,-42,34,43,-9,"April, 2014"
2013-2014,38,2014-04-26,Southampton,Everton,2,0,H,3,0,2,2,1,2,0,3,8,5,49,69,3,20,April,0.8660254037844388,-0.4999999999999998,38,18,0,2,3,0.8,1.6,50,45,5,57,34,23,"April, 2014"
2013-2014,38,2014-04-27,Crystal Palace,Man City,0,2,A,0,3,2,2,1,5,0,0,11,3,43,74,8,31,April,0.8660254037844388,-0.4999999999999998,16,27,0,0,3,0.6666666666666666,2.0,28,41,-13,91,35,56,"April, 2014"
2013-2014,38,2014-04-27,Liverpool,Chelsea,0,2,A,0,3,3,1,1,3,1,1,1,3,80,75,2,5,April,0.8660254037844388,-0.4999999999999998,25,14,2,2,1,2.0,1.4,96,44,52,67,26,41,"April, 2014"
2013-2014,38,2014-04-27,Sunderland,Cardiff,4,0,H,3,0,4,0,1,1,1,3,20,19,29,30,1,1,April,0.8660254037844388,-0.4999999999999998,40,12,0,1,0,2.0,2.0,33,57,-24,31,65,-34,"April, 2014"
2013-2014,38,2014-04-28,Arsenal,Newcastle,3,0,H,3,0,5,0,0,1,0,4,4,9,70,46,5,24,April,0.8660254037844388,-0.4999999999999998,0,30,4,1,0,2.2,0.8,62,41,21,39,54,-15,"April, 2014"
2013-2014,39,2014-05-03,West Ham,Tottenham,2,0,H,3,0,1,0,4,3,1,1,14,6,37,66,8,29,May,0.4999999999999999,-0.8660254037844387,45,42,2,1,2,1.4,1.2,38,49,-11,52,49,3,"May, 2014"
2013-2014,39,2014-05-03,Aston Villa,Hull,3,1,H,3,0,1,1,3,0,1,4,16,13,35,37,3,2,May,0.4999999999999999,-0.8660254037844387,1,21,4,1,0,1.4,0.0,36,53,-17,36,45,-9,"May, 2014"
2013-2014,39,2014-05-03,Everton,Man City,2,3,A,0,3,2,0,3,5,0,0,5,3,69,77,2,8,May,0.4999999999999999,-0.8660254037844387,18,27,2,1,2,1.0,1.2,57,36,21,93,35,58,"May, 2014"
2013-2014,39,2014-05-03,Man United,Sunderland,0,1,A,0,3,2,1,2,4,0,1,7,17,60,32,10,28,May,0.4999999999999999,-0.8660254037844387,28,40,5,0,0,1.6,0.4,60,40,20,37,57,-20,"May, 2014"
2013-2014,39,2014-05-03,Newcastle,Cardiff,3,0,H,3,0,1,0,4,1,1,3,9,20,46,30,11,16,May,0.4999999999999999,-0.8660254037844387,30,12,1,0,0,2.0,1.0,39,57,-18,31,69,-38,"May, 2014"
2013-2014,39,2014-05-03,Stoke,Fulham,4,1,H,3,0,3,1,1,1,2,2,10,19,44,31,9,13,May,0.4999999999999999,-0.8660254037844387,39,19,2,0,3,0.8,0.8,39,50,-11,37,79,-42,"May, 2014"
2013-2014,39,2014-05-03,Swansea,Southampton,0,1,A,0,3,3,0,2,2,2,1,12,8,39,52,4,13,May,0.4999999999999999,-0.8660254037844387,41,38,0,2,1,0.3333333333333333,1.0,51,52,-1,52,45,7,"May, 2014"
2013-2014,39,2014-05-04,Chelsea,Norwich,0,0,D,1,1,3,1,1,0,1,4,3,18,78,32,15,46,May,0.4999999999999999,-0.8660254037844387,14,31,4,1,0,2.2,0.6,69,26,43,28,60,-32,"May, 2014"
2013-2014,39,2014-05-04,Arsenal,West Brom,1,0,H,3,0,5,0,0,1,0,4,4,16,73,36,12,37,May,0.4999999999999999,-0.8660254037844387,0,44,4,1,0,2.2,0.8,65,41,24,42,54,-12,"May, 2014"
2013-2014,39,2014-05-05,Crystal Palace,Liverpool,3,3,D,1,1,2,2,1,3,1,1,11,2,43,80,9,37,May,0.4999999999999999,-0.8660254037844387,16,25,1,0,4,1.0,2.2,28,43,-15,96,46,50,"May, 2014"
2013-2014,39,2014-05-06,Man United,Hull,3,1,H,3,0,2,1,2,0,1,4,7,15,60,37,8,23,May,0.4999999999999999,-0.8660254037844387,28,21,5,0,0,3.0,1.2,60,41,19,37,48,-11,"May, 2014"
2013-2014,39,2014-05-07,Man City,Aston Villa,4,0,H,3,0,5,0,0,1,1,3,2,14,80,38,12,42,May,0.4999999999999999,-0.8660254037844387,27,1,4,0,1,2.6,0.8,96,37,59,39,54,-15,"May, 2014"
2013-2014,39,2014-05-07,Sunderland,West Brom,2,0,H,3,0,4,0,1,1,0,4,17,16,35,36,1,1,May,0.4999999999999999,-0.8660254037844387,40,44,0,1,4,1.0,3.0,38,57,-19,42,55,-13,"May, 2014"
2013-2014,40,2014-05-11,West Brom,Stoke,1,2,A,0,3,1,0,4,3,1,1,17,10,36,47,7,11,May,0.4999999999999999,-0.8660254037844387,44,39,1,2,2,0.4,0.6,42,57,-15,43,51,-8,"May, 2014"
2013-2014,40,2014-05-11,Tottenham,Aston Villa,3,0,H,3,0,3,1,1,1,1,3,6,15,66,38,9,28,May,0.4999999999999999,-0.8660254037844387,42,1,4,1,0,2.2,0.2,52,51,1,39,58,-19,"May, 2014"
2013-2014,40,2014-05-11,Sunderland,Swansea,1,3,A,0,3,4,0,1,3,0,2,14,13,38,39,1,1,May,0.4999999999999999,-0.8660254037844387,40,41,1,3,1,0.8,1.2,40,57,-17,51,53,-2,"May, 2014"
2013-2014,40,2014-05-11,Southampton,Man United,1,1,D,1,1,2,2,1,2,1,2,8,7,55,63,1,8,May,0.4999999999999999,-0.8660254037844387,38,28,0,1,4,1.0,2.2,53,45,8,63,42,21,"May, 2014"
2013-2014,40,2014-05-11,Norwich,Arsenal,0,2,A,0,3,0,1,4,5,0,0,18,4,33,76,14,43,May,0.4999999999999999,-0.8660254037844387,31,0,1,1,3,1.4,2.4,28,60,-32,66,41,25,"May, 2014"
2013-2014,40,2014-05-11,Man City,West Ham,2,0,H,3,0,5,0,0,1,0,4,2,12,83,40,10,43,May,0.4999999999999999,-0.8660254037844387,27,45,4,1,0,2.0,0.8,100,37,63,40,49,-9,"May, 2014"
2013-2014,40,2014-05-11,Liverpool,Newcastle,2,1,H,3,0,3,1,1,1,0,4,3,9,81,49,6,32,May,0.4999999999999999,-0.8660254037844387,25,30,2,2,1,2.4,1.2,99,49,50,42,57,-15,"May, 2014"
2013-2014,40,2014-05-11,Hull,Everton,0,2,A,0,3,0,1,4,2,0,3,16,5,37,69,11,32,May,0.4999999999999999,-0.8660254037844387,21,18,1,1,3,1.4,2.6,38,51,-13,59,39,20,"May, 2014"
2013-2014,40,2014-05-11,Fulham,Crystal Palace,2,2,D,1,1,1,2,2,2,2,1,19,11,31,44,8,13,May,0.4999999999999999,-0.8660254037844387,19,16,2,0,1,2.333333333333333,1.3333333333333333,38,83,-45,31,46,-15,"May, 2014"
2013-2014,40,2014-05-11,Cardiff,Chelsea,1,2,A,0,3,1,1,3,3,1,1,20,3,30,79,17,49,May,0.4999999999999999,-0.8660254037844387,12,14,0,0,1,1.0,4.0,31,72,-41,69,26,43,"May, 2014"
2014-2015,1,2014-08-16,West Brom,Sunderland,2,2,D,1,1,2,2,1,2,2,1,15,13,0,0,2,0,August,-0.8660254037844384,-0.5000000000000004,44,40,4,0,1,2.6,1.0,0,0,0,0,0,0,"August, 2014"
2014-2015,1,2014-08-16,Stoke,Aston Villa,0,1,A,0,3,2,2,1,2,0,3,13,6,0,0,7,0,August,-0.8660254037844384,-0.5000000000000004,39,1,2,2,1,1.6,1.2,0,0,0,0,0,0,"August, 2014"
2014-2015,1,2014-08-16,QPR,Hull,0,1,A,0,3,1,1,3,1,1,3,12,8,0,0,4,0,August,-0.8660254037844384,-0.5000000000000004,34,21,0,0,0,0.0,0.0,0,0,0,0,0,0,"August, 2014"
2014-2015,1,2014-08-16,West Ham,Tottenham,0,1,A,0,3,1,1,3,2,1,2,16,15,0,0,1,0,August,-0.8660254037844384,-0.5000000000000004,45,42,2,1,2,1.6,1.2,0,0,0,0,0,0,"August, 2014"
2014-2015,1,2014-08-16,Leicester,Everton,2,2,D,1,1,3,1,1,2,0,3,7,5,0,0,2,0,August,-0.8660254037844384,-0.5000000000000004,24,18,0,3,2,1.2,1.6,0,0,0,0,0,0,"August, 2014"
2014-2015,1,2014-08-16,Arsenal,Crystal Palace,2,1,H,3,0,2,2,1,2,0,3,1,5,0,0,4,0,August,-0.8660254037844384,-0.5000000000000004,0,16,4,1,0,2.2,0.4,0,0,0,0,0,0,"August, 2014"
2014-2015,1,2014-08-16,Man United,Swansea,1,2,A,0,3,1,2,2,3,0,2,10,16,0,0,6,0,August,-0.8660254037844384,-0.5000000000000004,28,41,4,1,0,2.2,0.6,0,0,0,0,0,0,"August, 2014"
2014-2015,1,2014-08-17,Liverpool,Southampton,2,1,H,3,0,1,1,3,1,1,3,12,15,0,0,3,0,August,-0.8660254037844384,-0.5000000000000004,25,38,2,0,3,1.0,1.2,0,0,0,0,0,0,"August, 2014"
2014-2015,1,2014-08-17,Newcastle,Man City,0,2,A,0,3,1,1,3,5,0,0,14,13,0,0,1,0,August,-0.8660254037844384,-0.5000000000000004,30,27,0,0,5,0.2,3.0,0,0,0,0,0,0,"August, 2014"
2014-2015,1,2014-08-18,Burnley,Chelsea,1,3,A,0,3,2,1,2,3,1,1,12,13,0,0,1,0,August,-0.8660254037844384,-0.5000000000000004,11,14,0,0,2,0.5,2.5,0,0,0,0,0,0,"August, 2014"
2014-2015,2,2014-08-23,Southampton,West Brom,0,0,D,1,1,1,1,3,2,2,1,16,12,0,1,4,1,August,-0.8660254037844384,-0.5000000000000004,38,44,2,1,2,0.4,1.0,1,2,-1,2,2,0,"August, 2014"
2014-2015,2,2014-08-23,Everton,Arsenal,2,2,D,1,1,2,0,3,2,2,1,10,5,1,3,5,2,August,-0.8660254037844384,-0.5000000000000004,18,0,1,3,1,1.0,0.6,2,2,0,2,1,1,"August, 2014"
2014-2015,2,2014-08-23,Swansea,Burnley,1,0,H,3,0,3,0,2,2,1,2,7,19,3,0,12,3,August,-0.8660254037844384,-0.5000000000000004,41,11,0,0,0,0.0,0.0,2,1,1,1,3,-2,"August, 2014"
2014-2015,2,2014-08-23,Chelsea,Leicester,2,0,H,3,0,3,1,1,3,1,1,2,10,3,1,8,2,August,-0.8660254037844384,-0.5000000000000004,14,24,4,0,1,2.4,1.0,3,1,2,2,2,0,"August, 2014"
2014-2015,2,2014-08-23,Aston Villa,Newcastle,0,0,D,1,1,2,0,3,1,1,3,6,20,3,0,14,3,August,-0.8660254037844384,-0.5000000000000004,1,30,0,1,4,0.8,1.6,1,0,1,0,2,-2,"August, 2014"
2014-2015,2,2014-08-23,Crystal Palace,West Ham,1,3,A,0,3,2,0,3,1,1,3,14,19,0,0,5,0,August,-0.8660254037844384,-0.5000000000000004,16,45,2,1,1,1.5,1.75,1,2,-1,0,1,-1,"August, 2014"
2014-2015,2,2014-08-24,Hull,Stoke,1,1,D,1,1,1,1,3,2,2,1,8,18,3,0,10,3,August,-0.8660254037844384,-0.5000000000000004,21,39,1,1,3,0.6,1.2,1,0,1,0,1,-1,"August, 2014"
2014-2015,2,2014-08-24,Sunderland,Man United,1,1,D,1,1,2,2,1,1,2,2,12,17,1,0,5,1,August,-0.8660254037844384,-0.5000000000000004,40,28,1,0,4,0.6,1.4,2,2,0,1,2,-1,"August, 2014"
2014-2015,2,2014-08-24,Tottenham,QPR,4,0,H,3,0,2,1,2,1,1,3,9,18,3,0,9,3,August,-0.8660254037844384,-0.5000000000000004,42,34,3,1,1,1.2,0.6,1,0,1,0,1,-1,"August, 2014"
2014-2015,2,2014-08-25,Man City,Liverpool,3,1,H,3,0,5,0,0,1,1,3,7,9,3,3,2,0,August,-0.8660254037844384,-0.5000000000000004,27,25,2,2,1,2.2,1.6,2,0,2,2,1,1,"August, 2014"
2014-2015,3,2014-08-30,West Ham,Southampton,1,3,A,0,3,1,1,3,1,1,3,9,17,3,1,8,2,August,-0.8660254037844384,-0.5000000000000004,45,38,2,3,0,1.8,0.8,3,2,1,1,2,-1,"August, 2014"
2014-2015,3,2014-08-30,Burnley,Man United,0,0,D,1,1,2,1,2,1,2,2,19,13,0,1,6,1,August,-0.8660254037844384,-0.5000000000000004,11,28,1,0,1,0.5,1.5,1,4,-3,2,3,-1,"August, 2014"
2014-2015,3,2014-08-30,Everton,Chelsea,3,6,A,0,3,2,0,3,3,1,1,10,2,2,6,8,4,August,-0.8660254037844384,-0.5000000000000004,18,14,2,0,3,1.0,1.0,4,4,0,5,1,4,"August, 2014"
2014-2015,3,2014-08-30,Man City,Stoke,0,1,A,0,3,5,0,0,2,2,1,3,15,6,1,12,5,August,-0.8660254037844384,-0.5000000000000004,27,39,2,3,0,1.2,0.4,5,1,4,1,2,-1,"August, 2014"
2014-2015,3,2014-08-30,Newcastle,Crystal Palace,3,3,D,1,1,1,1,3,2,0,3,17,19,1,0,2,1,August,-0.8660254037844384,-0.5000000000000004,30,16,3,1,1,1.4,0.4,0,2,-2,2,5,-3,"August, 2014"
2014-2015,3,2014-08-30,QPR,Sunderland,1,0,H,3,0,1,1,3,2,2,1,20,11,0,2,9,2,August,-0.8660254037844384,-0.5000000000000004,34,40,1,1,2,1.5,1.75,0,5,-5,3,3,0,"August, 2014"
2014-2015,3,2014-08-30,Swansea,West Brom,3,0,H,3,0,3,0,2,2,2,1,4,12,6,2,8,4,August,-0.8660254037844384,-0.5000000000000004,41,44,3,0,2,1.8,1.2,3,1,2,2,2,0,"August, 2014"
2014-2015,3,2014-08-31,Tottenham,Liverpool,0,3,A,0,3,2,1,2,1,1,3,4,11,6,3,7,3,August,-0.8660254037844384,-0.5000000000000004,42,25,1,1,3,0.8,2.6,5,0,5,3,4,-1,"August, 2014"
2014-2015,3,2014-08-31,Aston Villa,Hull,2,1,H,3,0,2,0,3,1,1,3,8,7,4,4,1,0,August,-0.8660254037844384,-0.5000000000000004,1,21,4,1,0,1.8,0.2,1,0,1,2,1,1,"August, 2014"
2014-2015,3,2014-08-31,Leicester,Arsenal,1,1,D,1,1,3,1,1,2,2,1,18,6,1,4,12,3,August,-0.8660254037844384,-0.5000000000000004,24,0,0,2,3,0.6,2.0,2,4,-2,4,3,1,"August, 2014"
2014-2015,4,2014-09-13,West Brom,Everton,0,2,A,0,3,2,2,1,2,0,3,18,16,2,2,2,0,September,-1.0,-1.8369701987210287e-16,44,18,1,2,2,0.8,1.0,2,5,-3,7,10,-3,"September, 2014"
2014-2015,4,2014-09-13,Arsenal,Man City,2,2,D,1,1,2,2,1,5,0,0,7,4,5,6,3,1,September,-1.0,-1.8369701987210287e-16,0,27,1,2,2,1.2,2.0,5,4,1,5,2,3,"September, 2014"
2014-2015,4,2014-09-13,Chelsea,Swansea,4,2,H,3,0,3,1,1,3,0,2,1,2,9,9,1,0,September,-1.0,-1.8369701987210287e-16,14,41,3,2,0,1.2,0.4,11,4,7,6,1,5,"September, 2014"
2014-2015,4,2014-09-13,Crystal Palace,Burnley,0,0,D,1,1,2,0,3,2,1,2,19,20,1,1,1,0,September,-1.0,-1.8369701987210287e-16,16,11,0,0,0,0.0,0.0,5,8,-3,1,4,-3,"September, 2014"
2014-2015,4,2014-09-13,Liverpool,Aston Villa,0,1,A,0,3,1,1,3,2,0,3,5,4,6,7,1,1,September,-1.0,-1.8369701987210287e-16,25,1,2,2,1,1.4,1.4,6,4,2,3,1,2,"September, 2014"
2014-2015,4,2014-09-13,Southampton,Newcastle,4,0,H,3,0,1,1,3,1,1,3,8,16,4,2,8,2,September,-1.0,-1.8369701987210287e-16,38,30,2,1,2,2.0,1.4,4,3,1,3,5,-2,"September, 2014"
2014-2015,4,2014-09-13,Stoke,Leicester,0,1,A,0,3,2,2,1,3,1,1,10,15,4,2,5,2,September,-1.0,-1.8369701987210287e-16,39,24,0,0,0,0.0,0.0,2,2,0,3,5,-2,"September, 2014"
2014-2015,4,2014-09-13,Sunderland,Tottenham,2,2,D,1,1,2,2,1,2,1,2,14,6,2,6,8,4,September,-1.0,-1.8369701987210287e-16,40,42,0,1,4,0.6,2.0,3,4,-1,5,3,2,"September, 2014"
2014-2015,4,2014-09-14,Man United,QPR,4,0,H,3,0,1,2,2,1,1,3,16,15,2,3,1,1,September,-1.0,-1.8369701987210287e-16,28,34,4,1,0,2.0,0.4,2,3,-1,1,5,-4,"September, 2014"
2014-2015,4,2014-09-15,Hull,West Ham,2,2,D,1,1,1,1,3,1,1,3,12,15,4,3,3,1,September,-1.0,-1.8369701987210287e-16,21,45,1,1,3,1.0,2.0,3,3,0,4,5,-1,"September, 2014"
2014-2015,5,2014-09-20,Aston Villa,Arsenal,0,3,A,0,3,2,0,3,2,2,1,2,7,10,6,5,4,September,-1.0,-1.8369701987210287e-16,1,0,1,1,3,1.0,1.6,4,1,3,7,6,1,"September, 2014"
2014-2015,5,2014-09-20,Burnley,Sunderland,0,0,D,1,1,2,1,2,2,2,1,18,15,2,3,3,1,September,-1.0,-1.8369701987210287e-16,11,40,1,0,1,2.0,1.5,1,4,-3,5,6,-1,"September, 2014"
2014-2015,5,2014-09-20,Newcastle,Hull,2,2,D,1,1,1,1,3,1,1,3,20,10,2,5,10,3,September,-1.0,-1.8369701987210287e-16,30,21,1,1,2,2.0,1.75,3,9,-6,5,5,0,"September, 2014"
2014-2015,5,2014-09-20,QPR,Stoke,2,2,D,1,1,1,1,3,2,2,1,18,15,3,4,3,1,September,-1.0,-1.8369701987210287e-16,34,39,2,0,2,1.0,1.25,1,9,-8,2,3,-1,"September, 2014"
2014-2015,5,2014-09-20,Swansea,Southampton,0,1,A,0,3,3,0,2,1,1,3,4,5,9,7,1,2,September,-1.0,-1.8369701987210287e-16,41,38,0,2,2,0.25,1.0,8,5,3,8,3,5,"September, 2014"
2014-2015,5,2014-09-20,West Ham,Liverpool,3,1,H,3,0,1,1,3,1,1,3,14,8,4,6,6,2,September,-1.0,-1.8369701987210287e-16,45,25,1,1,3,1.4,2.0,6,7,-1,6,5,1,"September, 2014"
2014-2015,5,2014-09-21,Tottenham,West Brom,0,1,A,0,3,2,1,2,2,2,1,8,20,7,2,12,5,September,-1.0,-1.8369701987210287e-16,42,44,2,3,0,1.4,1.0,7,5,2,2,7,-5,"September, 2014"
2014-2015,5,2014-09-21,Man City,Chelsea,1,1,D,1,1,5,0,0,3,1,1,7,1,7,12,6,5,September,-1.0,-1.8369701987210287e-16,27,14,2,1,2,1.0,0.8,7,4,3,15,6,9,"September, 2014"
2014-2015,5,2014-09-21,Leicester,Man United,5,3,H,3,0,3,1,1,1,2,2,12,11,5,5,1,0,September,-1.0,-1.8369701987210287e-16,24,28,0,0,5,0.2,2.0,4,5,-1,6,3,3,"September, 2014"
2014-2015,5,2014-09-21,Everton,Crystal Palace,2,3,A,0,3,2,0,3,2,0,3,12,19,5,2,7,3,September,-1.0,-1.8369701987210287e-16,18,16,3,1,1,2.4,1.0,9,10,-1,5,8,-3,"September, 2014"
2014-2015,6,2014-09-27,Southampton,QPR,2,1,H,3,0,1,1,3,1,1,3,3,18,10,4,15,6,September,-1.0,-1.8369701987210287e-16,38,34,2,0,2,1.5,1.5,9,3,6,3,11,-8,"September, 2014"
2014-2015,6,2014-09-27,Man United,West Ham,2,1,H,3,0,1,2,2,1,1,3,14,10,5,7,4,2,September,-1.0,-1.8369701987210287e-16,28,45,4,1,0,2.4,1.0,9,8,1,9,8,1,"September, 2014"
2014-2015,6,2014-09-27,Liverpool,Everton,1,1,D,1,1,1,1,3,2,0,3,11,15,6,5,4,1,September,-1.0,-1.8369701987210287e-16,25,18,2,3,0,2.4,1.0,7,8,-1,11,13,-2,"September, 2014"
2014-2015,6,2014-09-27,Sunderland,Swansea,0,0,D,1,1,2,2,1,3,0,2,17,6,4,9,11,5,September,-1.0,-1.8369701987210287e-16,40,41,1,2,2,1.0,1.8,5,6,-1,8,6,2,"September, 2014"
2014-2015,6,2014-09-27,Crystal Palace,Leicester,2,0,H,3,0,2,0,3,3,1,1,15,7,5,8,8,3,September,-1.0,-1.8369701987210287e-16,16,24,0,1,1,0.5,2.0,8,10,-2,9,8,1,"September, 2014"
2014-2015,6,2014-09-27,Chelsea,Aston Villa,3,0,H,3,0,3,1,1,2,0,3,1,4,13,10,3,3,September,-1.0,-1.8369701987210287e-16,14,1,4,0,1,3.2,1.0,16,7,9,4,4,0,"September, 2014"
2014-2015,6,2014-09-27,Arsenal,Tottenham,1,1,D,1,1,2,2,1,2,1,2,4,9,9,7,5,2,September,-1.0,-1.8369701987210287e-16,0,42,4,0,1,2.6,1.2,10,6,4,7,6,1,"September, 2014"
2014-2015,6,2014-09-27,Hull,Man City,2,4,A,0,3,1,1,3,5,0,0,11,6,6,8,5,2,September,-1.0,-1.8369701987210287e-16,21,27,1,1,3,0.8,2.2,7,7,0,8,5,3,"September, 2014"
2014-2015,6,2014-09-28,West Brom,Burnley,4,0,H,3,0,2,2,1,2,1,2,17,19,5,3,2,2,September,-1.0,-1.8369701987210287e-16,44,11,0,0,0,0.0,0.0,3,7,-4,1,4,-3,"September, 2014"
2014-2015,6,2014-09-29,Stoke,Newcastle,1,0,H,3,0,2,2,1,1,1,3,17,19,5,3,2,2,September,-1.0,-1.8369701987210287e-16,39,30,2,0,3,1.0,2.2,4,5,-1,5,11,-6,"September, 2014"
2014-2015,7,2014-10-04,Swansea,Newcastle,2,2,D,1,1,3,0,2,1,1,3,5,20,10,3,15,7,October,-0.8660254037844386,0.5,41,30,4,0,1,1.6,0.8,8,6,2,5,12,-7,"October, 2014"
2014-2015,7,2014-10-04,Aston Villa,Man City,0,2,A,0,3,2,0,3,5,0,0,6,3,10,11,3,1,October,-0.8660254037844386,0.5,1,27,1,0,4,0.6,2.6,4,7,-3,12,7,5,"October, 2014"
2014-2015,7,2014-10-04,Hull,Crystal Palace,2,0,H,3,0,1,1,3,2,0,3,16,9,6,8,7,2,October,-0.8660254037844386,0.5,21,16,0,0,2,0.0,1.0,9,11,-2,10,10,0,"October, 2014"
2014-2015,7,2014-10-04,Leicester,Burnley,2,2,D,1,1,3,1,1,2,1,2,12,20,8,3,8,5,October,-0.8660254037844386,0.5,24,11,0,0,0,0.0,0.0,9,10,-1,1,8,-7,"October, 2014"
2014-2015,7,2014-10-04,Liverpool,West Brom,2,1,H,3,0,1,1,3,2,2,1,15,11,7,8,4,1,October,-0.8660254037844386,0.5,25,44,1,1,3,1.0,1.6,8,9,-1,7,7,0,"October, 2014"
2014-2015,7,2014-10-04,Sunderland,Stoke,3,1,H,3,0,2,2,1,2,2,1,17,12,5,8,5,3,October,-0.8660254037844386,0.5,40,39,2,2,1,0.6,0.6,5,6,-1,5,5,0,"October, 2014"
2014-2015,7,2014-10-05,Man United,Everton,2,1,H,3,0,1,2,2,2,0,3,10,17,8,6,7,2,October,-0.8660254037844386,0.5,28,18,1,1,3,1.2,1.6,11,9,2,12,14,-2,"October, 2014"
2014-2015,7,2014-10-05,Tottenham,Southampton,1,0,H,3,0,2,1,2,1,1,3,12,3,8,13,9,5,October,-0.8660254037844386,0.5,42,38,4,0,1,1.8,1.2,8,7,1,11,4,7,"October, 2014"
2014-2015,7,2014-10-05,Chelsea,Arsenal,2,0,H,3,0,3,1,1,2,2,1,1,5,16,10,4,6,October,-0.8660254037844386,0.5,14,0,3,2,0,2.0,0.4,19,7,12,11,7,4,"October, 2014"
2014-2015,7,2014-10-05,West Ham,QPR,2,0,H,3,0,1,1,3,1,1,3,16,20,7,4,4,3,October,-0.8660254037844386,0.5,45,34,2,1,1,1.0,1.25,10,10,0,4,13,-9,"October, 2014"
2014-2015,8,2014-10-18,Newcastle,Leicester,1,0,H,3,0,1,1,3,3,1,1,18,13,4,9,5,5,October,-0.8660254037844386,0.5,30,24,3,2,0,1.2,0.4,7,14,-7,11,12,-1,"October, 2014"
2014-2015,8,2014-10-18,Southampton,Sunderland,8,0,H,3,0,1,1,3,2,2,1,3,14,13,8,11,5,October,-0.8660254037844386,0.5,38,40,1,3,1,1.0,1.0,11,5,6,8,7,1,"October, 2014"
2014-2015,8,2014-10-18,Everton,Aston Villa,3,0,H,3,0,2,0,3,2,0,3,17,11,6,10,6,4,October,-0.8660254037844386,0.5,18,1,3,2,0,2.2,1.2,13,16,-3,4,9,-5,"October, 2014"
2014-2015,8,2014-10-18,Man City,Tottenham,4,1,H,3,0,5,0,0,2,1,2,2,8,14,11,6,3,October,-0.8660254037844386,0.5,27,42,4,0,1,3.4,1.4,14,7,7,9,7,2,"October, 2014"
2014-2015,8,2014-10-18,Crystal Palace,Chelsea,1,2,A,0,3,2,0,3,3,1,1,15,1,8,19,14,11,October,-0.8660254037844386,0.5,16,14,1,0,4,1.0,2.8,10,12,-2,21,7,14,"October, 2014"
2014-2015,8,2014-10-18,Burnley,West Ham,1,3,A,0,3,2,1,2,1,1,3,19,8,4,10,11,6,October,-0.8660254037844386,0.5,11,45,1,0,1,2.5,3.0,3,10,-7,12,10,2,"October, 2014"
2014-2015,8,2014-10-18,Arsenal,Hull,2,2,D,1,1,2,2,1,1,1,3,8,11,10,9,3,1,October,-0.8660254037844386,0.5,0,21,5,0,0,2.6,0.4,11,9,2,11,11,0,"October, 2014"
2014-2015,8,2014-10-19,QPR,Liverpool,2,3,A,0,3,1,1,3,1,1,3,20,10,4,10,10,6,October,-0.8660254037844386,0.5,34,25,1,0,4,0.8,1.8,4,15,-11,10,10,0,"October, 2014"
2014-2015,8,2014-10-19,Stoke,Swansea,2,1,H,3,0,2,2,1,3,0,2,15,8,8,11,7,3,October,-0.8660254037844386,0.5,39,41,2,2,1,1.8,1.4,6,8,-2,10,8,2,"October, 2014"
2014-2015,8,2014-10-20,West Brom,Man United,2,2,D,1,1,2,2,1,1,2,2,15,6,8,11,9,3,October,-0.8660254037844386,0.5,44,28,1,1,3,1.4,2.6,8,9,-1,13,10,3,"October, 2014"
2014-2015,9,2014-10-25,West Ham,Man City,2,1,H,3,0,1,1,3,5,0,0,7,3,13,17,4,4,October,-0.8660254037844386,0.5,45,27,0,1,4,0.6,1.8,15,11,4,18,8,10,"October, 2014"
2014-2015,9,2014-10-25,West Brom,Crystal Palace,2,2,D,1,1,2,2,1,2,0,3,14,16,9,8,2,1,October,-0.8660254037844386,0.5,44,16,1,1,2,1.25,2.0,10,11,-1,11,14,-3,"October, 2014"
2014-2015,9,2014-10-25,Swansea,Leicester,2,0,H,3,0,3,0,2,3,1,1,8,15,11,9,7,2,October,-0.8660254037844386,0.5,41,24,0,0,0,0.0,0.0,11,10,1,11,13,-2,"October, 2014"
2014-2015,9,2014-10-25,Southampton,Stoke,1,0,H,3,0,1,1,3,2,2,1,3,11,16,11,8,5,October,-0.8660254037844386,0.5,38,39,0,4,0,1.75,1.75,19,5,14,8,9,-1,"October, 2014"
2014-2015,9,2014-10-25,Liverpool,Hull,0,0,D,1,1,1,1,3,1,1,3,5,11,13,10,6,3,October,-0.8660254037844386,0.5,25,21,3,1,1,2.4,1.0,13,12,1,13,13,0,"October, 2014"
2014-2015,9,2014-10-25,Sunderland,Arsenal,0,2,A,0,3,2,2,1,2,2,1,17,7,8,11,10,3,October,-0.8660254037844386,0.5,40,0,0,1,4,0.6,2.0,8,15,-7,13,11,2,"October, 2014"
2014-2015,9,2014-10-26,Burnley,Everton,1,3,A,0,3,2,1,2,2,0,3,19,14,4,9,5,5,October,-0.8660254037844386,0.5,11,18,1,0,1,0.5,1.0,4,13,-9,16,16,0,"October, 2014"
2014-2015,9,2014-10-26,Man United,Chelsea,1,1,D,1,1,1,2,2,3,1,1,8,1,12,22,7,10,October,-0.8660254037844386,0.5,28,14,1,2,2,1.4,1.8,15,12,3,23,8,15,"October, 2014"
2014-2015,9,2014-10-26,Tottenham,Newcastle,1,2,A,0,3,2,1,2,1,1,3,11,18,11,7,7,4,October,-0.8660254037844386,0.5,42,30,3,0,2,2.4,0.8,10,11,-1,8,14,-6,"October, 2014"
2014-2015,9,2014-10-27,QPR,Aston Villa,2,0,H,3,0,1,1,3,2,0,3,20,15,4,10,5,6,October,-0.8660254037844386,0.5,34,1,0,3,2,1.6,2.2,6,18,-12,4,12,-8,"October, 2014"
2014-2015,10,2014-11-01,Leicester,West Brom,0,1,A,0,3,3,1,1,2,2,1,17,13,9,10,4,1,November,-0.5000000000000004,0.8660254037844384,24,44,0,0,0,0.0,0.0,11,15,-4,12,13,-1,"November, 2014"
2014-2015,10,2014-11-01,Stoke,West Ham,2,2,D,1,1,2,2,1,1,1,3,14,5,11,16,9,5,November,-0.5000000000000004,0.8660254037844384,39,45,2,1,2,1.0,1.2,8,10,-2,17,12,5,"November, 2014"
2014-2015,10,2014-11-01,Hull,Southampton,0,1,A,0,3,1,1,3,1,1,3,10,2,11,19,8,8,November,-0.5000000000000004,0.8660254037844384,21,38,0,0,2,0.5,2.5,13,13,0,20,5,15,"November, 2014"
2014-2015,10,2014-11-01,Newcastle,Liverpool,1,0,H,3,0,1,1,3,1,1,3,14,7,10,14,7,4,November,-0.5000000000000004,0.8660254037844384,30,25,1,2,2,1.2,2.2,10,15,-5,13,12,1,"November, 2014"
2014-2015,10,2014-11-01,Chelsea,QPR,2,1,H,3,0,3,1,1,1,1,3,1,19,23,7,18,16,November,-0.5000000000000004,0.8660254037844384,14,34,1,2,2,1.4,0.8,24,9,15,8,18,-10,"November, 2014"
2014-2015,10,2014-11-01,Everton,Swansea,0,0,D,1,1,2,0,3,3,0,2,9,6,12,14,3,2,November,-0.5000000000000004,0.8660254037844384,18,41,4,1,0,2.0,0.6,19,17,2,13,10,3,"November, 2014"
2014-2015,10,2014-11-01,Arsenal,Burnley,3,0,H,3,0,2,2,1,2,1,2,5,20,14,4,15,10,November,-0.5000000000000004,0.8660254037844384,0,11,1,1,0,2.0,1.0,15,11,4,5,16,-11,"November, 2014"
2014-2015,10,2014-11-02,Aston Villa,Tottenham,1,2,A,0,3,2,0,3,2,1,2,15,14,10,11,1,1,November,-0.5000000000000004,0.8660254037844384,1,42,0,1,4,0.2,2.4,4,14,-10,11,13,-2,"November, 2014"
2014-2015,10,2014-11-02,Man City,Man United,1,0,H,3,0,5,0,0,1,2,2,3,9,17,13,6,4,November,-0.5000000000000004,0.8660254037844384,27,28,4,0,1,2.4,1.0,19,10,9,16,13,3,"November, 2014"
2014-2015,10,2014-11-03,Crystal Palace,Sunderland,1,3,A,0,3,2,0,3,2,2,1,16,18,9,8,2,1,November,-0.5000000000000004,0.8660254037844384,16,40,1,1,0,1.5,0.5,13,16,-3,8,17,-9,"November, 2014"
2014-2015,11,2014-11-08,Southampton,Leicester,2,0,H,3,0,1,1,3,3,1,1,2,17,22,9,15,13,November,-0.5000000000000004,0.8660254037844384,38,24,2,3,0,1.8,0.8,21,5,16,11,16,-5,"November, 2014"
2014-2015,11,2014-11-08,QPR,Man City,2,2,D,1,1,1,1,3,5,0,0,19,3,7,20,16,13,November,-0.5000000000000004,0.8660254037844384,34,27,0,1,4,1.0,2.2,9,20,-11,20,10,10,"November, 2014"
2014-2015,11,2014-11-08,West Ham,Aston Villa,0,0,D,1,1,1,1,3,2,0,3,5,16,17,10,11,7,November,-0.5000000000000004,0.8660254037844384,45,1,2,1,2,1.0,0.8,19,14,5,5,16,-11,"November, 2014"
2014-2015,11,2014-11-08,Liverpool,Chelsea,1,2,A,0,3,1,1,3,3,1,1,7,1,14,26,6,12,November,-0.5000000000000004,0.8660254037844384,25,14,1,2,2,1.6,1.6,13,13,0,26,10,16,"November, 2014"
2014-2015,11,2014-11-08,Burnley,Hull,1,0,H,3,0,2,1,2,1,1,3,20,14,4,11,6,7,November,-0.5000000000000004,0.8660254037844384,11,21,2,0,0,3.0,0.5,5,19,-14,13,14,-1,"November, 2014"
2014-2015,11,2014-11-08,Man United,Crystal Palace,1,0,H,3,0,1,2,2,2,0,3,10,17,13,9,7,4,November,-0.5000000000000004,0.8660254037844384,28,16,4,1,0,2.4,0.4,16,14,2,14,19,-5,"November, 2014"
2014-2015,11,2014-11-09,Sunderland,Everton,1,1,D,1,1,2,2,1,2,0,3,15,10,11,13,5,2,November,-0.5000000000000004,0.8660254037844384,40,18,2,0,3,0.6,1.4,11,18,-7,19,17,2,"November, 2014"
2014-2015,11,2014-11-09,Swansea,Arsenal,2,1,H,3,0,3,0,2,2,2,1,7,5,15,17,2,2,November,-0.5000000000000004,0.8660254037844384,41,0,2,1,2,1.6,1.6,13,10,3,18,11,7,"November, 2014"
2014-2015,11,2014-11-09,Tottenham,Stoke,1,2,A,0,3,2,1,2,2,2,1,10,13,14,12,3,2,November,-0.5000000000000004,0.8660254037844384,42,39,3,2,0,1.4,0.4,13,14,-1,10,12,-2,"November, 2014"
2014-2015,11,2014-11-09,West Brom,Newcastle,0,2,A,0,3,2,2,1,1,1,3,12,13,13,13,1,0,November,-0.5000000000000004,0.8660254037844384,44,30,1,1,3,1.0,1.6,13,13,0,11,15,-4,"November, 2014"
2014-2015,12,2014-11-22,Newcastle,QPR,1,0,H,3,0,1,1,3,1,1,3,9,19,16,8,10,8,November,-0.5000000000000004,0.8660254037844384,30,34,4,1,0,1.2,0.4,13,15,-2,11,22,-11,"November, 2014"
2014-2015,12,2014-11-22,Arsenal,Man United,1,2,A,0,3,2,2,1,1,2,2,6,7,17,16,1,1,November,-0.5000000000000004,0.8660254037844384,0,28,0,2,3,0.6,1.2,19,13,6,17,14,3,"November, 2014"
2014-2015,12,2014-11-22,Chelsea,West Brom,2,0,H,3,0,3,1,1,2,2,1,1,13,29,13,12,16,November,-0.5000000000000004,0.8660254037844384,14,44,1,2,2,1.0,1.2,28,11,17,13,15,-2,"November, 2014"
2014-2015,12,2014-11-22,Everton,West Ham,2,1,H,3,0,2,0,3,1,1,3,10,5,14,18,5,4,November,-0.5000000000000004,0.8660254037844384,18,45,4,1,0,2.0,1.0,20,18,2,19,14,5,"November, 2014"
2014-2015,12,2014-11-22,Leicester,Sunderland,0,0,D,1,1,3,1,1,2,2,1,18,14,9,12,4,3,November,-0.5000000000000004,0.8660254037844384,24,40,3,1,1,1.8,0.8,11,18,-7,12,19,-7,"November, 2014"
2014-2015,12,2014-11-22,Man City,Swansea,2,1,H,3,0,5,0,0,3,0,2,3,6,21,18,3,3,November,-0.5000000000000004,0.8660254037844384,27,41,3,1,1,1.4,0.6,22,12,10,15,11,4,"November, 2014"
2014-2015,12,2014-11-22,Stoke,Burnley,1,2,A,0,3,2,2,1,2,1,2,10,20,15,7,10,8,November,-0.5000000000000004,0.8660254037844384,39,11,1,1,0,1.5,0.5,12,13,-1,6,19,-13,"November, 2014"
2014-2015,12,2014-11-23,Hull,Tottenham,1,2,A,0,3,1,1,3,2,1,2,16,11,11,14,5,3,November,-0.5000000000000004,0.8660254037844384,21,42,0,2,3,0.6,1.8,13,15,-2,14,16,-2,"November, 2014"
2014-2015,12,2014-11-23,Crystal Palace,Liverpool,3,1,H,3,0,2,0,3,1,1,3,19,11,9,14,8,5,November,-0.5000000000000004,0.8660254037844384,16,25,1,1,3,1.6,2.2,14,20,-6,14,15,-1,"November, 2014"
2014-2015,12,2014-11-24,Aston Villa,Southampton,1,1,D,1,1,2,0,3,1,1,3,17,2,11,25,15,14,November,-0.5000000000000004,0.8660254037844384,1,38,2,1,2,1.4,1.8,5,16,-11,23,5,18,"November, 2014"
2014-2015,13,2014-11-29,West Brom,Arsenal,0,1,A,0,3,2,2,1,2,2,1,15,8,13,17,7,4,November,-0.5000000000000004,0.8660254037844384,44,0,0,1,4,0.8,1.8,13,17,-4,20,15,5,"November, 2014"
2014-2015,13,2014-11-29,Swansea,Crystal Palace,1,1,D,1,1,3,0,2,2,0,3,7,16,18,12,9,6,November,-0.5000000000000004,0.8660254037844384,41,16,1,1,0,1.5,0.5,16,13,3,17,21,-4,"November, 2014"
2014-2015,13,2014-11-29,Sunderland,Chelsea,0,0,D,1,1,2,2,1,3,1,1,14,1,13,32,13,19,November,-0.5000000000000004,0.8660254037844384,40,14,1,0,4,1.4,2.2,12,19,-7,30,11,19,"November, 2014"
2014-2015,13,2014-11-29,West Ham,Newcastle,1,0,H,3,0,1,1,3,1,1,3,8,7,18,19,1,1,November,-0.5000000000000004,0.8660254037844384,45,30,1,2,2,0.4,1.6,20,16,4,14,15,-1,"November, 2014"
2014-2015,13,2014-11-29,Man United,Hull,3,0,H,3,0,1,2,2,1,1,3,4,17,19,11,13,8,November,-0.5000000000000004,0.8660254037844384,28,21,5,0,0,2.8,0.8,19,15,4,14,17,-3,"November, 2014"
2014-2015,13,2014-11-29,Liverpool,Stoke,1,0,H,3,0,1,1,3,2,2,1,12,11,14,15,1,1,November,-0.5000000000000004,0.8660254037844384,25,39,2,2,1,1.4,1.2,15,18,-3,13,15,-2,"November, 2014"
2014-2015,13,2014-11-29,Burnley,Aston Villa,1,1,D,1,1,2,1,2,2,0,3,19,16,10,12,3,2,November,-0.5000000000000004,0.8660254037844384,11,1,0,1,1,1.5,3.0,8,20,-12,6,17,-11,"November, 2014"
2014-2015,13,2014-11-29,QPR,Leicester,3,2,H,3,0,1,1,3,3,1,1,20,19,8,10,1,2,November,-0.5000000000000004,0.8660254037844384,34,24,0,0,0,0.0,0.0,11,23,-12,11,18,-7,"November, 2014"
2014-2015,13,2014-11-30,Southampton,Man City,0,3,A,0,3,1,1,3,5,0,0,2,3,26,24,1,2,November,-0.5000000000000004,0.8660254037844384,38,27,1,1,3,1.6,2.2,24,6,18,24,13,11,"November, 2014"
2014-2015,13,2014-11-30,Tottenham,Everton,2,1,H,3,0,2,1,2,2,0,3,10,9,17,17,1,0,November,-0.5000000000000004,0.8660254037844384,42,18,1,2,2,0.8,1.0,16,17,-1,22,19,3,"November, 2014"
2014-2015,14,2014-12-02,Burnley,Newcastle,1,1,D,1,1,2,1,2,1,1,3,19,9,11,19,10,8,December,-2.4492935982947064e-16,1.0,11,30,0,0,0,0.0,0.0,9,21,-12,14,16,-2,"December, 2014"
2014-2015,14,2014-12-02,Crystal Palace,Aston Villa,0,1,A,0,3,2,0,3,2,0,3,14,16,13,13,2,0,December,-2.4492935982947064e-16,1.0,16,1,3,1,1,1.2,0.8,18,22,-4,7,18,-11,"December, 2014"
2014-2015,14,2014-12-02,Leicester,Liverpool,1,3,A,0,3,3,1,1,1,1,3,20,11,10,17,9,7,December,-2.4492935982947064e-16,1.0,24,25,1,1,3,0.8,1.4,13,21,-8,16,18,-2,"December, 2014"
2014-2015,14,2014-12-02,Man United,Stoke,2,1,H,3,0,1,2,2,2,2,1,4,13,22,15,9,7,December,-2.4492935982947064e-16,1.0,28,39,4,0,1,2.4,1.2,22,15,7,13,16,-3,"December, 2014"
2014-2015,14,2014-12-02,Swansea,QPR,2,0,H,3,0,3,0,2,1,1,3,10,19,19,11,9,8,December,-2.4492935982947064e-16,1.0,41,34,2,1,1,2.5,1.25,17,14,3,14,25,-11,"December, 2014"
2014-2015,14,2014-12-02,West Brom,West Ham,1,2,A,0,3,2,2,1,1,1,3,16,6,13,21,10,8,December,-2.4492935982947064e-16,1.0,44,45,1,3,1,1.6,1.8,13,18,-5,21,16,5,"December, 2014"
2014-2015,14,2014-12-03,Sunderland,Man City,1,4,A,0,3,2,2,1,5,0,0,14,2,14,27,12,13,December,-2.4492935982947064e-16,1.0,40,27,2,2,1,1.4,1.6,12,19,-7,27,13,14,"December, 2014"
2014-2015,14,2014-12-03,Everton,Hull,1,1,D,1,1,2,0,3,1,1,3,11,18,17,11,7,6,December,-2.4492935982947064e-16,1.0,18,21,4,0,1,2.6,1.0,23,21,2,14,20,-6,"December, 2014"
2014-2015,14,2014-12-03,Chelsea,Tottenham,3,0,H,3,0,3,1,1,2,1,2,1,9,33,20,8,13,December,-2.4492935982947064e-16,1.0,14,42,2,3,0,2.2,1.0,30,11,19,18,18,0,"December, 2014"
2014-2015,14,2014-12-03,Arsenal,Southampton,1,0,H,3,0,2,2,1,1,1,3,7,3,20,26,4,6,December,-2.4492935982947064e-16,1.0,0,38,2,3,0,2.4,1.0,21,15,6,24,9,15,"December, 2014"
2014-2015,15,2014-12-06,Hull,West Brom,0,0,D,1,1,1,1,3,2,2,1,17,16,12,13,1,1,December,-2.4492935982947064e-16,1.0,21,44,2,2,0,2.0,0.75,15,21,-6,14,20,-6,"December, 2014"
2014-2015,15,2014-12-06,Liverpool,Sunderland,0,0,D,1,1,1,1,3,2,2,1,8,15,20,14,7,6,December,-2.4492935982947064e-16,1.0,25,40,3,1,1,1.8,0.8,19,19,0,13,23,-10,"December, 2014"
2014-2015,15,2014-12-06,Man City,Everton,1,0,H,3,0,5,0,0,2,0,3,2,11,30,18,9,12,December,-2.4492935982947064e-16,1.0,27,18,2,1,2,1.4,1.4,31,14,17,24,22,2,"December, 2014"
2014-2015,15,2014-12-06,Newcastle,Chelsea,2,1,H,3,0,1,1,3,3,1,1,9,1,20,36,8,16,December,-2.4492935982947064e-16,1.0,30,14,3,0,2,1.4,1.4,15,17,-2,33,11,22,"December, 2014"
2014-2015,15,2014-12-06,QPR,Burnley,2,0,H,3,0,1,1,3,2,1,2,19,18,11,12,1,1,December,-2.4492935982947064e-16,1.0,34,11,0,0,0,0.0,0.0,14,27,-13,10,22,-12,"December, 2014"
2014-2015,15,2014-12-06,Stoke,Arsenal,3,2,H,3,0,2,2,1,2,2,1,13,6,15,23,7,8,December,-2.4492935982947064e-16,1.0,39,0,1,2,2,0.6,1.0,14,18,-4,22,15,7,"December, 2014"
2014-2015,15,2014-12-06,Tottenham,Crystal Palace,0,0,D,1,1,2,1,2,2,0,3,10,17,20,13,7,7,December,-2.4492935982947064e-16,1.0,42,16,3,1,1,1.4,1.0,18,21,-3,18,23,-5,"December, 2014"
2014-2015,15,2014-12-07,West Ham,Swansea,3,1,H,3,0,1,1,3,3,0,2,5,8,24,22,3,2,December,-2.4492935982947064e-16,1.0,45,41,2,1,1,0.75,0.75,23,17,6,19,14,5,"December, 2014"
2014-2015,15,2014-12-07,Aston Villa,Leicester,2,1,H,3,0,2,0,3,3,1,1,13,20,16,10,7,6,December,-2.4492935982947064e-16,1.0,1,24,3,1,1,2.4,1.2,8,18,-10,14,24,-10,"December, 2014"
2014-2015,15,2014-12-08,Southampton,Man United,1,2,A,0,3,1,1,3,1,2,2,4,5,26,25,1,1,December,-2.4492935982947064e-16,1.0,38,28,0,2,3,1.2,1.8,24,10,14,24,16,8,"December, 2014"
2014-2015,16,2014-12-13,Arsenal,Newcastle,4,1,H,3,0,2,2,1,1,1,3,6,7,23,23,1,0,December,-2.4492935982947064e-16,1.0,0,30,5,0,0,2.8,0.8,24,18,6,17,18,-1,"December, 2014"
2014-2015,16,2014-12-13,Burnley,Southampton,1,0,H,3,0,2,1,2,1,1,3,19,5,12,26,14,14,December,-2.4492935982947064e-16,1.0,11,38,0,0,0,0.0,0.0,10,24,-14,25,12,13,"December, 2014"
2014-2015,16,2014-12-13,Chelsea,Hull,2,0,H,3,0,3,1,1,1,1,3,1,19,36,13,18,23,December,-2.4492935982947064e-16,1.0,14,21,3,2,0,1.4,0.4,34,13,21,15,21,-6,"December, 2014"
2014-2015,16,2014-12-13,Crystal Palace,Stoke,1,1,D,1,1,2,0,3,2,2,1,16,13,14,18,3,4,December,-2.4492935982947064e-16,1.0,16,39,1,0,1,1.0,1.0,18,23,-5,17,20,-3,"December, 2014"
2014-2015,16,2014-12-13,Leicester,Man City,0,1,A,0,3,3,1,1,5,0,0,20,2,10,33,18,23,December,-2.4492935982947064e-16,1.0,24,27,2,1,1,1.5,0.75,15,26,-11,32,14,18,"December, 2014"
2014-2015,16,2014-12-13,Sunderland,West Ham,1,1,D,1,1,2,2,1,1,1,3,15,4,15,27,11,12,December,-2.4492935982947064e-16,1.0,40,45,2,2,1,1.6,0.6,13,23,-10,26,18,8,"December, 2014"
2014-2015,16,2014-12-13,West Brom,Aston Villa,1,0,H,3,0,2,2,1,2,0,3,17,12,14,19,5,5,December,-2.4492935982947064e-16,1.0,44,1,0,4,1,1.6,1.8,14,20,-6,10,19,-9,"December, 2014"
2014-2015,16,2014-12-14,Man United,Liverpool,3,0,H,3,0,1,2,2,1,1,3,3,9,28,21,6,7,December,-2.4492935982947064e-16,1.0,28,25,3,0,2,1.2,1.4,26,17,9,19,19,0,"December, 2014"
2014-2015,16,2014-12-14,Swansea,Tottenham,1,2,A,0,3,3,0,2,2,1,2,8,10,22,21,2,1,December,-2.4492935982947064e-16,1.0,41,42,0,0,5,0.6,2.0,20,17,3,18,21,-3,"December, 2014"
2014-2015,16,2014-12-15,Everton,QPR,3,1,H,3,0,2,0,3,1,1,3,13,18,18,14,5,4,December,-2.4492935982947064e-16,1.0,18,34,1,2,2,1.0,1.2,24,23,1,16,27,-11,"December, 2014"
2014-2015,17,2014-12-20,Tottenham,Burnley,2,1,H,3,0,2,1,2,2,1,2,8,18,24,15,10,9,December,-2.4492935982947064e-16,1.0,42,11,1,0,1,3.5,2.0,20,22,-2,11,24,-13,"December, 2014"
2014-2015,17,2014-12-20,West Ham,Leicester,2,0,H,3,0,1,1,3,3,1,1,5,20,28,10,15,18,December,-2.4492935982947064e-16,1.0,45,24,2,1,2,1.2,1.0,27,19,8,15,27,-12,"December, 2014"
2014-2015,17,2014-12-20,Southampton,Everton,3,0,H,3,0,1,1,3,2,0,3,5,10,26,21,5,5,December,-2.4492935982947064e-16,1.0,38,18,1,2,2,1.2,1.4,25,13,12,27,24,3,"December, 2014"
2014-2015,17,2014-12-20,Hull,Swansea,0,1,A,0,3,1,1,3,3,0,2,19,9,13,22,10,9,December,-2.4492935982947064e-16,1.0,21,41,1,1,0,1.0,0.5,15,23,-8,21,19,2,"December, 2014"
2014-2015,17,2014-12-20,Man City,Crystal Palace,3,0,H,3,0,5,0,0,2,0,3,2,16,36,15,14,21,December,-2.4492935982947064e-16,1.0,27,16,4,0,0,2.0,0.5,33,14,19,19,24,-5,"December, 2014"
2014-2015,17,2014-12-20,QPR,West Brom,3,2,H,3,0,1,1,3,2,2,1,18,14,14,17,4,3,December,-2.4492935982947064e-16,1.0,34,44,0,1,3,1.0,1.75,17,30,-13,15,20,-5,"December, 2014"
2014-2015,17,2014-12-20,Aston Villa,Man United,1,1,D,1,1,2,0,3,1,2,2,13,3,19,31,10,12,December,-2.4492935982947064e-16,1.0,1,28,0,0,5,0.6,3.4,10,20,-10,29,17,12,"December, 2014"
2014-2015,17,2014-12-21,Liverpool,Arsenal,2,2,D,1,1,1,1,3,2,2,1,11,7,21,26,4,5,December,-2.4492935982947064e-16,1.0,25,0,1,1,3,1.6,1.8,19,22,-3,28,19,9,"December, 2014"
2014-2015,17,2014-12-21,Newcastle,Sunderland,0,1,A,0,3,1,1,3,2,2,1,9,16,23,16,7,7,December,-2.4492935982947064e-16,1.0,30,40,0,2,3,0.6,2.0,18,22,-4,14,24,-10,"December, 2014"
2014-2015,17,2014-12-22,Stoke,Chelsea,0,2,A,0,3,2,2,1,3,1,1,13,1,19,39,12,20,December,-2.4492935982947064e-16,1.0,39,14,1,0,4,0.6,2.2,18,21,-3,36,13,23,"December, 2014"
2014-2015,18,2014-12-26,West Brom,Man City,1,3,A,0,3,2,2,1,5,0,0,15,2,17,39,13,22,December,-2.4492935982947064e-16,1.0,44,27,0,0,5,0.8,2.6,17,23,-6,36,14,22,"December, 2014"
2014-2015,18,2014-12-26,Swansea,Aston Villa,1,0,H,3,0,3,0,2,2,0,3,8,13,25,20,5,5,December,-2.4492935982947064e-16,1.0,41,1,2,2,1,1.8,1.2,22,19,3,11,21,-10,"December, 2014"
2014-2015,18,2014-12-26,Sunderland,Hull,1,3,A,0,3,2,2,1,1,1,3,14,19,19,13,5,6,December,-2.4492935982947064e-16,1.0,40,21,3,0,2,1.2,0.8,15,24,-9,15,24,-9,"December, 2014"
2014-2015,18,2014-12-26,Man United,Newcastle,3,1,H,3,0,1,2,2,1,1,3,4,10,32,23,6,9,December,-2.4492935982947064e-16,1.0,28,30,3,0,2,2.2,1.4,30,18,12,18,23,-5,"December, 2014"
2014-2015,18,2014-12-26,Leicester,Tottenham,1,2,A,0,3,3,1,1,2,1,2,20,7,10,27,13,17,December,-2.4492935982947064e-16,1.0,24,42,2,1,2,2.4,2.2,15,29,-14,22,23,-1,"December, 2014"
2014-2015,18,2014-12-26,Crystal Palace,Southampton,1,3,A,0,3,2,0,3,1,1,3,17,6,15,29,11,14,December,-2.4492935982947064e-16,1.0,16,38,0,3,2,1.0,1.6,19,27,-8,28,13,15,"December, 2014"
2014-2015,18,2014-12-26,Chelsea,West Ham,2,0,H,3,0,3,1,1,1,1,3,1,4,42,31,3,11,December,-2.4492935982947064e-16,1.0,14,45,3,1,1,1.8,0.6,38,13,25,29,19,10,"December, 2014"
2014-2015,18,2014-12-26,Burnley,Liverpool,0,1,A,0,3,2,1,2,1,1,3,18,10,15,22,8,7,December,-2.4492935982947064e-16,1.0,11,25,0,0,2,0.0,4.0,12,26,-14,21,24,-3,"December, 2014"
2014-2015,18,2014-12-26,Arsenal,QPR,2,1,H,3,0,2,2,1,1,1,3,6,16,27,17,10,10,December,-2.4492935982947064e-16,1.0,0,34,3,1,1,1.0,0.6,30,21,9,20,32,-12,"December, 2014"
2014-2015,18,2014-12-26,Everton,Stoke,0,1,A,0,3,2,0,3,2,2,1,11,13,21,19,2,2,December,-2.4492935982947064e-16,1.0,18,39,2,3,0,1.6,0.6,27,27,0,18,23,-5,"December, 2014"
2014-2015,19,2014-12-28,Southampton,Chelsea,1,1,D,1,1,1,1,3,3,1,1,4,1,32,45,3,13,December,-2.4492935982947064e-16,1.0,38,14,1,1,3,1.2,2.4,31,14,17,40,13,27,"December, 2014"
2014-2015,19,2014-12-28,West Ham,Arsenal,1,2,A,0,3,1,1,3,2,2,1,5,7,31,30,2,1,December,-2.4492935982947064e-16,1.0,45,0,0,0,5,0.8,3.4,29,21,8,32,22,10,"December, 2014"
2014-2015,19,2014-12-28,Tottenham,Man United,0,0,D,1,1,2,1,2,1,2,2,7,3,30,35,4,5,December,-2.4492935982947064e-16,1.0,42,28,2,2,1,1.8,1.8,24,24,0,33,19,14,"December, 2014"
2014-2015,19,2014-12-28,Stoke,West Brom,2,0,H,3,0,2,2,1,2,2,1,11,16,22,17,5,5,December,-2.4492935982947064e-16,1.0,39,44,2,2,1,0.8,0.6,19,23,-4,18,26,-8,"December, 2014"
2014-2015,19,2014-12-28,QPR,Crystal Palace,0,0,D,1,1,1,1,3,2,0,3,16,19,17,15,3,2,December,-2.4492935982947064e-16,1.0,34,16,0,0,0,0.0,0.0,21,34,-13,20,30,-10,"December, 2014"
2014-2015,19,2014-12-28,Newcastle,Everton,3,2,H,3,0,1,1,3,2,0,3,10,12,23,21,2,2,December,-2.4492935982947064e-16,1.0,30,18,0,1,4,1.2,2.6,19,26,-7,27,28,-1,"December, 2014"
2014-2015,19,2014-12-28,Man City,Burnley,2,2,D,1,1,5,0,0,2,1,2,2,19,42,15,17,27,December,-2.4492935982947064e-16,1.0,27,11,1,1,0,4.5,2.0,39,15,24,12,27,-15,"December, 2014"
2014-2015,19,2014-12-28,Hull,Leicester,0,1,A,0,3,1,1,3,3,1,1,17,20,16,10,3,6,December,-2.4492935982947064e-16,1.0,21,24,0,0,0,0.0,0.0,18,25,-7,16,31,-15,"December, 2014"
2014-2015,19,2014-12-28,Aston Villa,Sunderland,0,0,D,1,1,2,0,3,2,2,1,13,14,20,19,1,1,December,-2.4492935982947064e-16,1.0,1,40,3,2,0,1.6,0.2,11,22,-11,16,27,-11,"December, 2014"
2014-2015,19,2014-12-29,Liverpool,Swansea,4,1,H,3,0,1,1,3,3,0,2,10,8,25,28,2,3,December,-2.4492935982947064e-16,1.0,25,41,2,2,1,2.2,1.2,22,24,-2,23,19,4,"December, 2014"
2014-2015,20,2015-01-01,West Ham,West Brom,1,1,D,1,1,1,1,3,2,2,1,7,18,31,17,11,14,January,0.4999999999999999,0.8660254037844387,45,44,2,2,1,1.6,1.2,30,23,7,18,28,-10,"January, 2015"
2014-2015,20,2015-01-01,Tottenham,Chelsea,5,3,H,3,0,2,1,2,3,1,1,7,1,31,46,6,15,January,0.4999999999999999,0.8660254037844387,42,14,0,2,3,1.0,2.8,24,24,0,41,14,27,"January, 2015"
2014-2015,20,2015-01-01,Stoke,Man United,1,1,D,1,1,2,2,1,1,2,2,11,4,25,36,7,11,January,0.4999999999999999,0.8660254037844387,39,28,1,0,4,1.4,2.4,21,23,-2,33,19,14,"January, 2015"
2014-2015,20,2015-01-01,Southampton,Arsenal,2,0,H,3,0,1,1,3,2,2,1,4,5,33,33,1,0,January,0.4999999999999999,0.8660254037844387,38,0,0,2,3,0.8,2.4,32,15,17,34,23,11,"January, 2015"
2014-2015,20,2015-01-01,QPR,Swansea,1,1,D,1,1,1,1,3,3,0,2,16,9,18,28,7,10,January,0.4999999999999999,0.8660254037844387,34,41,1,1,3,1.0,2.4,21,34,-13,24,23,1,"January, 2015"
2014-2015,20,2015-01-01,Newcastle,Burnley,3,3,D,1,1,1,1,3,2,1,2,10,19,26,16,9,10,January,0.4999999999999999,0.8660254037844387,30,11,0,1,0,1.0,1.0,22,28,-6,14,29,-15,"January, 2015"
2014-2015,20,2015-01-01,Man City,Sunderland,3,2,H,3,0,5,0,0,2,2,1,2,14,43,20,12,23,January,0.4999999999999999,0.8660254037844387,27,40,2,1,2,1.8,1.0,41,17,24,16,27,-11,"January, 2015"
2014-2015,20,2015-01-01,Liverpool,Leicester,2,2,D,1,1,1,1,3,3,1,1,8,20,28,13,12,15,January,0.4999999999999999,0.8660254037844387,25,24,4,1,0,2.0,0.6,26,25,1,17,31,-14,"January, 2015"
2014-2015,20,2015-01-01,Hull,Everton,2,0,H,3,0,1,1,3,2,0,3,18,13,16,21,5,5,January,0.4999999999999999,0.8660254037844387,21,18,1,1,3,1.2,2.4,18,26,-8,29,31,-2,"January, 2015"
2014-2015,20,2015-01-01,Aston Villa,Crystal Palace,0,0,D,1,1,2,0,3,2,0,3,13,18,21,16,5,5,January,0.4999999999999999,0.8660254037844387,1,16,1,1,3,0.4,1.0,11,22,-11,20,30,-10,"January, 2015"
2014-2015,21,2015-01-10,Swansea,West Ham,1,1,D,1,1,3,0,2,1,1,3,9,7,29,32,2,3,January,0.4999999999999999,0.8660254037844387,41,45,1,1,3,0.8,1.2,25,24,1,31,24,7,"January, 2015"
2014-2015,21,2015-01-10,Sunderland,Liverpool,0,1,A,0,3,2,2,1,1,1,3,15,8,20,29,7,9,January,0.4999999999999999,0.8660254037844387,40,25,0,2,3,0.6,1.8,18,30,-12,28,27,1,"January, 2015"
2014-2015,21,2015-01-10,West Brom,Hull,1,0,H,3,0,2,2,1,1,1,3,19,17,18,19,2,1,January,0.4999999999999999,0.8660254037844387,44,21,0,3,2,0.6,1.6,19,29,-10,20,26,-6,"January, 2015"
2014-2015,21,2015-01-10,Leicester,Aston Villa,1,0,H,3,0,3,1,1,2,0,3,20,13,14,22,7,8,January,0.4999999999999999,0.8660254037844387,24,1,1,1,3,1.2,2.4,19,33,-14,11,22,-11,"January, 2015"
2014-2015,21,2015-01-10,Crystal Palace,Tottenham,2,1,H,3,0,2,0,3,2,1,2,19,5,17,34,14,17,January,0.4999999999999999,0.8660254037844387,16,42,1,2,2,0.8,0.8,20,30,-10,29,27,2,"January, 2015"
2014-2015,21,2015-01-10,Burnley,QPR,2,1,H,3,0,2,1,2,1,1,3,19,16,17,19,3,2,January,0.4999999999999999,0.8660254037844387,11,34,0,0,1,0.0,2.0,17,32,-15,22,35,-13,"January, 2015"
2014-2015,21,2015-01-10,Everton,Man City,1,1,D,1,1,2,0,3,5,0,0,13,2,21,46,11,25,January,0.4999999999999999,0.8660254037844387,18,27,1,1,3,1.2,1.6,29,33,-4,44,19,25,"January, 2015"
2014-2015,21,2015-01-10,Chelsea,Newcastle,2,0,H,3,0,3,1,1,1,1,3,1,10,46,27,9,19,January,0.4999999999999999,0.8660254037844387,14,30,2,0,3,1.6,1.4,44,19,25,25,31,-6,"January, 2015"
2014-2015,21,2015-01-11,Arsenal,Stoke,3,0,H,3,0,2,2,1,2,2,1,6,11,33,26,5,7,January,0.4999999999999999,0.8660254037844387,0,39,2,1,2,1.2,1.0,34,25,9,22,24,-2,"January, 2015"
2014-2015,21,2015-01-11,Man United,Southampton,0,1,A,0,3,1,2,2,1,1,3,3,4,37,36,1,1,January,0.4999999999999999,0.8660254037844387,28,38,3,2,0,1.8,1.2,34,20,14,34,15,19,"January, 2015"
2014-2015,22,2015-01-17,Aston Villa,Liverpool,0,2,A,0,3,2,0,3,1,1,3,13,8,22,32,5,10,January,0.4999999999999999,0.8660254037844387,1,25,2,1,2,1.4,1.2,11,23,-12,29,27,2,"January, 2015"
2014-2015,22,2015-01-17,Burnley,Crystal Palace,2,3,A,0,3,2,1,2,2,0,3,17,15,20,20,2,0,January,0.4999999999999999,0.8660254037844387,11,16,0,1,0,0.0,0.0,19,33,-14,22,31,-9,"January, 2015"
2014-2015,22,2015-01-17,Leicester,Stoke,0,1,A,0,3,3,1,1,2,2,1,20,11,17,26,9,9,January,0.4999999999999999,0.8660254037844387,24,39,1,0,0,1.0,0.0,20,33,-13,22,27,-5,"January, 2015"
2014-2015,22,2015-01-17,QPR,Man United,0,2,A,0,3,1,1,3,1,2,2,19,4,19,37,15,18,January,0.4999999999999999,0.8660254037844387,34,28,0,0,5,0.2,2.6,23,37,-14,34,21,13,"January, 2015"
2014-2015,22,2015-01-17,Swansea,Chelsea,0,5,A,0,3,3,0,2,3,1,1,9,1,30,49,8,19,January,0.4999999999999999,0.8660254037844387,41,14,0,1,4,0.6,1.8,26,25,1,46,19,27,"January, 2015"
2014-2015,22,2015-01-17,Tottenham,Sunderland,2,1,H,3,0,2,1,2,2,2,1,7,16,34,20,9,14,January,0.4999999999999999,0.8660254037844387,42,40,4,1,0,2.4,1.0,30,29,1,18,31,-13,"January, 2015"
2014-2015,22,2015-01-17,Newcastle,Southampton,1,2,A,0,3,1,1,3,1,1,3,11,3,27,39,8,12,January,0.4999999999999999,0.8660254037844387,30,38,1,1,3,1.0,2.6,25,33,-8,35,15,20,"January, 2015"
2014-2015,22,2015-01-18,Man City,Arsenal,0,2,A,0,3,5,0,0,2,2,1,2,6,47,36,4,11,January,0.4999999999999999,0.8660254037844387,27,0,2,3,0,2.4,1.4,45,20,25,37,25,12,"January, 2015"
2014-2015,22,2015-01-18,West Ham,Hull,3,0,H,3,0,1,1,3,1,1,3,8,18,33,19,10,14,January,0.4999999999999999,0.8660254037844387,45,21,2,2,1,2.0,1.4,32,25,7,20,27,-7,"January, 2015"
2014-2015,22,2015-01-19,Everton,West Brom,0,0,D,1,1,2,0,3,2,2,1,13,15,22,21,2,1,January,0.4999999999999999,0.8660254037844387,18,44,2,2,1,1.0,0.8,30,34,-4,20,29,-9,"January, 2015"
2014-2015,23,2015-01-31,West Brom,Tottenham,0,3,A,0,3,2,2,1,2,1,2,15,7,22,37,8,15,January,0.4999999999999999,0.8660254037844387,44,42,1,3,1,1.2,1.2,20,29,-9,32,30,2,"January, 2015"
2014-2015,23,2015-01-31,Stoke,QPR,3,1,H,3,0,2,2,1,1,1,3,11,19,29,19,8,10,January,0.4999999999999999,0.8660254037844387,39,34,2,1,2,1.4,1.2,23,27,-4,23,39,-16,"January, 2015"
2014-2015,23,2015-01-31,Sunderland,Burnley,2,0,H,3,0,2,2,1,2,1,2,16,17,20,20,1,0,January,0.4999999999999999,0.8660254037844387,40,11,1,1,1,1.0,1.3333333333333333,19,33,-14,21,36,-15,"January, 2015"
2014-2015,23,2015-01-31,Man United,Leicester,3,1,H,3,0,1,2,2,3,1,1,4,20,40,17,16,23,January,0.4999999999999999,0.8660254037844387,28,24,4,0,1,2.2,1.2,36,21,15,20,34,-14,"January, 2015"
2014-2015,23,2015-01-31,Hull,Newcastle,0,3,A,0,3,1,1,3,1,1,3,18,11,19,27,7,8,January,0.4999999999999999,0.8660254037844387,21,30,2,2,1,1.8,2.0,20,30,-10,26,35,-9,"January, 2015"
2014-2015,23,2015-01-31,Crystal Palace,Everton,0,1,A,0,3,2,0,3,2,0,3,13,12,23,23,1,0,January,0.4999999999999999,0.8660254037844387,16,18,2,1,2,1.4,2.2,25,33,-8,30,34,-4,"January, 2015"
2014-2015,23,2015-01-31,Chelsea,Man City,1,1,D,1,1,3,1,1,5,0,0,1,2,52,47,1,5,January,0.4999999999999999,0.8660254037844387,14,27,2,2,1,0.8,0.8,51,19,32,45,22,23,"January, 2015"
2014-2015,23,2015-01-31,Liverpool,West Ham,2,0,H,3,0,1,1,3,1,1,3,8,7,35,36,1,1,January,0.4999999999999999,0.8660254037844387,25,45,3,1,1,2.0,1.4,31,27,4,35,25,10,"January, 2015"
2014-2015,23,2015-02-01,Arsenal,Aston Villa,5,0,H,3,0,2,2,1,2,0,3,6,16,39,22,10,17,February,0.8660254037844386,0.5000000000000001,0,1,3,1,1,1.6,1.0,39,25,14,11,25,-14,"February, 2015"
2014-2015,23,2015-02-01,Southampton,Swansea,0,1,A,0,3,1,1,3,3,0,2,4,10,42,30,6,12,February,0.8660254037844386,0.5000000000000001,38,41,3,2,0,1.0,0.2,37,16,21,26,30,-4,"February, 2015"
2014-2015,24,2015-02-07,Tottenham,Arsenal,2,1,H,3,0,2,1,2,2,2,1,6,5,40,42,1,2,February,0.8660254037844386,0.5000000000000001,42,0,1,1,3,1.0,1.8,35,30,5,44,25,19,"February, 2015"
2014-2015,24,2015-02-07,Swansea,Sunderland,1,1,D,1,1,3,0,2,2,2,1,9,14,33,23,5,10,February,0.8660254037844386,0.5000000000000001,41,40,2,3,0,1.8,0.6,27,30,-3,21,33,-12,"February, 2015"
2014-2015,24,2015-02-07,Man City,Hull,1,1,D,1,1,5,0,0,1,1,3,2,18,48,19,16,29,February,0.8660254037844386,0.5000000000000001,27,21,3,1,1,2.0,1.0,46,23,23,20,33,-13,"February, 2015"
2014-2015,24,2015-02-07,QPR,Southampton,0,1,A,0,3,1,1,3,1,1,3,19,4,19,42,15,23,February,0.8660254037844386,0.5000000000000001,34,38,2,0,3,1.4,1.6,24,42,-18,37,17,20,"February, 2015"
2014-2015,24,2015-02-07,Everton,Liverpool,0,0,D,1,1,2,0,3,1,1,3,12,7,26,38,5,12,February,0.8660254037844386,0.5000000000000001,18,25,0,4,1,1.2,2.0,31,34,-3,33,27,6,"February, 2015"
2014-2015,24,2015-02-07,Aston Villa,Chelsea,1,2,A,0,3,2,0,3,3,1,1,16,1,22,53,15,31,February,0.8660254037844386,0.5000000000000001,1,14,1,0,4,0.6,3.0,11,30,-19,52,20,32,"February, 2015"
2014-2015,24,2015-02-07,Leicester,Crystal Palace,0,1,A,0,3,3,1,1,2,0,3,20,13,17,23,7,6,February,0.8660254037844386,0.5000000000000001,24,16,1,1,1,1.3333333333333333,1.0,21,37,-16,25,34,-9,"February, 2015"
2014-2015,24,2015-02-08,Burnley,West Brom,2,2,D,1,1,2,1,2,2,2,1,18,15,20,22,3,2,February,0.8660254037844386,0.5000000000000001,11,44,0,0,1,0.0,4.0,21,38,-17,20,32,-12,"February, 2015"
2014-2015,24,2015-02-08,Newcastle,Stoke,1,1,D,1,1,1,1,3,2,2,1,11,10,30,32,1,2,February,0.8660254037844386,0.5000000000000001,30,39,2,0,3,1.6,1.2,29,35,-6,26,28,-2,"February, 2015"
2014-2015,24,2015-02-08,West Ham,Man United,1,1,D,1,1,1,1,3,1,2,2,8,4,36,43,4,7,February,0.8660254037844386,0.5000000000000001,45,28,0,1,4,0.8,2.0,35,27,8,39,22,17,"February, 2015"
2014-2015,25,2015-02-10,Arsenal,Leicester,2,1,H,3,0,2,2,1,3,1,1,6,20,42,17,14,25,February,0.8660254037844386,0.5000000000000001,0,24,3,2,0,2.2,0.8,45,27,18,21,38,-17,"February, 2015"
2014-2015,25,2015-02-10,Hull,Aston Villa,2,0,H,3,0,1,1,3,2,0,3,18,16,20,22,2,2,February,0.8660254037844386,0.5000000000000001,21,1,0,1,4,0.4,2.0,21,34,-13,12,32,-20,"February, 2015"
2014-2015,25,2015-02-10,Liverpool,Tottenham,3,2,H,3,0,1,1,3,2,1,2,7,6,39,43,1,4,February,0.8660254037844386,0.5000000000000001,25,42,4,0,1,3.2,0.8,33,27,6,37,31,6,"February, 2015"
2014-2015,25,2015-02-10,Sunderland,QPR,0,2,A,0,3,2,2,1,1,1,3,14,19,24,19,5,5,February,0.8660254037844386,0.5000000000000001,40,34,2,1,2,1.4,1.4,22,34,-12,24,43,-19,"February, 2015"
2014-2015,25,2015-02-11,Southampton,West Ham,0,0,D,1,1,1,1,3,1,1,3,4,8,45,37,4,8,February,0.8660254037844386,0.5000000000000001,38,45,1,2,2,1.2,1.8,38,17,21,36,28,8,"February, 2015"
2014-2015,25,2015-02-11,Man United,Burnley,3,1,H,3,0,1,2,2,2,1,2,5,19,44,21,14,23,February,0.8660254037844386,0.5000000000000001,28,11,1,1,1,1.0,0.3333333333333333,40,23,17,23,40,-17,"February, 2015"
2014-2015,25,2015-02-11,Stoke,Man City,1,4,A,0,3,2,2,1,5,0,0,10,2,33,49,8,16,February,0.8660254037844386,0.5000000000000001,39,27,1,2,2,0.4,1.0,27,29,-2,47,24,23,"February, 2015"
2014-2015,25,2015-02-11,Chelsea,Everton,1,0,H,3,0,3,1,1,2,0,3,1,12,56,27,11,29,February,0.8660254037844386,0.5000000000000001,14,18,4,0,1,2.2,1.2,54,21,33,31,34,-3,"February, 2015"
2014-2015,25,2015-02-11,Crystal Palace,Newcastle,1,1,D,1,1,2,0,3,1,1,3,13,11,26,31,2,5,February,0.8660254037844386,0.5000000000000001,16,30,0,2,3,0.6,1.8,26,34,-8,30,36,-6,"February, 2015"
2014-2015,25,2015-02-11,West Brom,Swansea,2,0,H,3,0,2,2,1,3,0,2,16,9,23,34,7,11,February,0.8660254037844386,0.5000000000000001,44,41,2,0,3,1.0,2.0,22,34,-12,28,31,-3,"February, 2015"
2014-2015,26,2015-02-21,Swansea,Man United,2,1,H,3,0,3,0,2,1,2,2,10,4,34,47,6,13,February,0.8660254037844386,0.5000000000000001,41,28,1,1,3,1.0,2.0,28,33,-5,43,24,19,"February, 2015"
2014-2015,26,2015-02-21,Sunderland,West Brom,0,0,D,1,1,2,2,1,2,2,1,16,15,24,26,1,2,February,0.8660254037844386,0.5000000000000001,40,44,1,1,3,1.4,2.2,22,36,-14,24,34,-10,"February, 2015"
2014-2015,26,2015-02-21,Hull,QPR,2,1,H,3,0,1,1,3,1,1,3,16,17,23,22,1,1,February,0.8660254037844386,0.5000000000000001,21,34,1,0,0,1.0,0.0,23,34,-11,26,43,-17,"February, 2015"
2014-2015,26,2015-02-21,Man City,Newcastle,5,0,H,3,0,5,0,0,1,1,3,2,11,52,32,9,20,February,0.8660254037844386,0.5000000000000001,27,30,5,0,0,3.0,0.2,51,25,26,31,37,-6,"February, 2015"
2014-2015,26,2015-02-21,Crystal Palace,Arsenal,1,2,A,0,3,2,0,3,2,2,1,13,5,27,45,8,18,February,0.8660254037844386,0.5000000000000001,16,0,0,1,4,0.6,2.4,27,35,-8,47,28,19,"February, 2015"
2014-2015,26,2015-02-21,Chelsea,Burnley,1,1,D,1,1,3,1,1,2,1,2,1,19,59,21,18,38,February,0.8660254037844386,0.5000000000000001,14,11,3,0,0,2.6666666666666665,0.6666666666666666,55,21,34,24,43,-19,"February, 2015"
2014-2015,26,2015-02-21,Aston Villa,Stoke,1,2,A,0,3,2,0,3,2,2,1,18,10,22,33,8,11,February,0.8660254037844386,0.5000000000000001,1,39,2,1,2,1.2,1.4,12,34,-22,28,33,-5,"February, 2015"
2014-2015,26,2015-02-22,Everton,Leicester,2,2,D,1,1,2,0,3,3,1,1,12,20,27,17,8,10,February,0.8660254037844386,0.5000000000000001,18,24,1,4,0,1.6,1.4,31,35,-4,22,40,-18,"February, 2015"
2014-2015,26,2015-02-22,Southampton,Liverpool,0,2,A,0,3,1,1,3,1,1,3,5,7,46,42,2,4,February,0.8660254037844386,0.5000000000000001,38,25,2,0,3,1.0,1.4,38,17,21,36,29,7,"February, 2015"
2014-2015,26,2015-02-22,Tottenham,West Ham,2,2,D,1,1,2,1,2,1,1,3,7,8,43,38,1,5,February,0.8660254037844386,0.5000000000000001,42,45,3,0,2,1.4,1.6,39,34,5,36,28,8,"February, 2015"
2014-2015,27,2015-02-28,West Ham,Crystal Palace,1,3,A,0,3,1,1,3,2,0,3,9,14,39,27,5,12,February,0.8660254037844386,0.5000000000000001,45,16,2,1,2,2.0,1.4,38,30,8,28,37,-9,"February, 2015"
2014-2015,27,2015-02-28,West Brom,Southampton,1,0,H,3,0,2,2,1,1,1,3,14,5,27,46,9,19,February,0.8660254037844386,0.5000000000000001,44,38,2,1,2,1.0,0.4,24,34,-10,38,19,19,"February, 2015"
2014-2015,27,2015-02-28,Stoke,Hull,1,0,H,3,0,2,2,1,1,1,3,10,15,36,26,5,10,February,0.8660254037844386,0.5000000000000001,39,21,2,2,1,1.0,0.6,30,34,-4,25,35,-10,"February, 2015"
2014-2015,27,2015-02-28,Man United,Sunderland,2,0,H,3,0,1,2,2,2,2,1,4,16,47,25,12,22,February,0.8660254037844386,0.5000000000000001,28,40,3,1,1,1.4,0.8,44,26,18,22,36,-14,"February, 2015"
2014-2015,27,2015-02-28,Burnley,Swansea,0,1,A,0,3,2,1,2,3,0,2,18,9,22,37,9,15,February,0.8660254037844386,0.5000000000000001,11,41,0,0,1,0.0,1.0,25,44,-19,30,34,-4,"February, 2015"
2014-2015,27,2015-02-28,Newcastle,Aston Villa,1,0,H,3,0,1,1,3,2,0,3,11,19,32,22,8,10,February,0.8660254037844386,0.5000000000000001,30,1,3,2,0,1.2,0.6,31,42,-11,13,36,-23,"February, 2015"
2014-2015,27,2015-03-01,Arsenal,Everton,2,0,H,3,0,2,2,1,2,0,3,4,14,48,28,10,20,March,1.0,6.123233995736766e-17,0,18,0,4,1,0.8,1.4,49,29,20,33,37,-4,"March, 2015"
2014-2015,27,2015-03-01,Liverpool,Man City,2,1,H,3,0,1,1,3,5,0,0,6,2,45,55,4,10,March,1.0,6.123233995736766e-17,25,27,1,2,2,1.8,2.2,38,29,9,56,25,31,"March, 2015"
2014-2015,28,2015-03-03,Aston Villa,West Brom,2,1,H,3,0,2,0,3,2,2,1,19,13,22,30,6,8,March,1.0,6.123233995736766e-17,1,44,1,3,1,1.8,1.8,13,37,-24,25,34,-9,"March, 2015"
2014-2015,28,2015-03-03,Hull,Sunderland,1,1,D,1,1,1,1,3,2,2,1,15,16,26,25,1,1,March,1.0,6.123233995736766e-17,21,40,3,0,2,1.4,1.2,25,36,-11,22,38,-16,"March, 2015"
2014-2015,28,2015-03-03,Southampton,Crystal Palace,1,0,H,3,0,1,1,3,2,0,3,6,12,46,30,6,16,March,1.0,6.123233995736766e-17,38,16,3,2,0,2.0,1.0,38,20,18,31,38,-7,"March, 2015"
2014-2015,28,2015-03-04,Tottenham,Swansea,3,2,H,3,0,2,1,2,3,0,2,7,9,44,40,2,4,March,1.0,6.123233995736766e-17,42,41,5,0,0,1.8,0.6,41,36,5,31,34,-3,"March, 2015"
2014-2015,28,2015-03-04,West Ham,Chelsea,0,1,A,0,3,1,1,3,3,1,1,10,1,39,60,9,21,March,1.0,6.123233995736766e-17,45,14,1,1,3,0.6,1.6,39,33,6,56,22,34,"March, 2015"
2014-2015,28,2015-03-04,QPR,Arsenal,1,2,A,0,3,1,1,3,2,2,1,18,4,22,51,14,29,March,1.0,6.123233995736766e-17,34,0,1,0,4,0.6,1.2,27,45,-18,51,29,22,"March, 2015"
2014-2015,28,2015-03-04,Stoke,Everton,2,0,H,3,0,2,2,1,2,0,3,10,14,39,28,4,11,March,1.0,6.123233995736766e-17,39,18,1,2,2,0.6,1.4,31,34,-3,33,39,-6,"March, 2015"
2014-2015,28,2015-03-04,Man City,Leicester,2,0,H,3,0,5,0,0,3,1,1,2,20,55,18,18,37,March,1.0,6.123233995736766e-17,27,24,2,1,2,0.8,1.2,57,27,30,24,42,-18,"March, 2015"
2014-2015,28,2015-03-04,Liverpool,Burnley,2,0,H,3,0,1,1,3,2,1,2,6,19,48,22,13,26,March,1.0,6.123233995736766e-17,25,11,3,0,0,3.0,0.0,40,30,10,25,45,-20,"March, 2015"
2014-2015,28,2015-03-04,Newcastle,Man United,0,1,A,0,3,1,1,3,1,2,2,11,5,35,50,6,15,March,1.0,6.123233995736766e-17,30,28,1,0,4,1.0,2.8,32,42,-10,46,26,20,"March, 2015"
2014-2015,28,2015-03-07,QPR,Tottenham,1,2,A,0,3,1,1,3,2,1,2,18,7,22,47,11,25,March,1.0,6.123233995736766e-17,34,42,1,1,3,0.6,1.8,28,47,-19,44,38,6,"March, 2015"
2014-2015,29,2015-03-14,Sunderland,Aston Villa,0,4,A,0,3,2,2,1,2,0,3,16,18,26,25,2,1,March,1.0,6.123233995736766e-17,40,1,0,2,3,0.2,1.6,23,39,-16,15,38,-23,"March, 2015"
2014-2015,29,2015-03-14,Arsenal,West Ham,3,0,H,3,0,2,2,1,1,1,3,3,10,54,39,7,15,March,1.0,6.123233995736766e-17,0,45,5,0,0,3.2,1.0,53,30,23,39,34,5,"March, 2015"
2014-2015,29,2015-03-14,Burnley,Man City,1,0,H,3,0,2,1,2,5,0,0,19,2,22,58,17,36,March,1.0,6.123233995736766e-17,11,27,0,2,1,2.0,3.6666666666666665,25,47,-22,59,27,32,"March, 2015"
2014-2015,29,2015-03-14,Crystal Palace,QPR,3,1,H,3,0,2,0,3,1,1,3,12,19,30,22,7,8,March,1.0,6.123233995736766e-17,16,34,0,1,0,0.0,0.0,31,39,-8,29,49,-20,"March, 2015"
2014-2015,29,2015-03-14,Leicester,Hull,0,0,D,1,1,3,1,1,1,1,3,20,15,18,27,5,9,March,1.0,6.123233995736766e-17,24,21,1,0,0,1.0,0.0,24,44,-20,26,37,-11,"March, 2015"
2014-2015,29,2015-03-14,West Brom,Stoke,1,0,H,3,0,2,2,1,2,2,1,13,8,30,42,5,12,March,1.0,6.123233995736766e-17,44,39,0,2,3,0.2,1.0,26,36,-10,33,34,-1,"March, 2015"
2014-2015,29,2015-03-15,Man United,Tottenham,3,0,H,3,0,1,2,2,2,1,2,4,7,53,50,3,3,March,1.0,6.123233995736766e-17,28,42,0,3,2,1.2,1.6,47,26,21,46,39,7,"March, 2015"
2014-2015,29,2015-03-15,Chelsea,Southampton,1,1,D,1,1,3,1,1,1,1,3,1,7,63,49,6,14,March,1.0,6.123233995736766e-17,14,38,2,2,1,2.0,1.2,57,22,35,39,20,19,"March, 2015"
2014-2015,29,2015-03-15,Everton,Newcastle,3,0,H,3,0,2,0,3,1,1,3,14,11,28,35,3,7,March,1.0,6.123233995736766e-17,18,30,3,1,1,2.4,1.6,33,41,-8,32,43,-11,"March, 2015"
2014-2015,29,2015-03-16,Swansea,Liverpool,0,1,A,0,3,3,0,2,1,1,3,9,5,40,51,4,11,March,1.0,6.123233995736766e-17,41,25,0,2,3,1.2,3.0,33,37,-4,42,30,12,"March, 2015"
2014-2015,30,2015-03-21,Stoke,Crystal Palace,1,2,A,0,3,2,2,1,2,0,3,9,12,42,33,3,9,March,1.0,6.123233995736766e-17,39,16,1,1,1,1.0,1.0,33,35,-2,34,40,-6,"March, 2015"
2014-2015,30,2015-03-21,Tottenham,Leicester,4,3,H,3,0,2,1,2,3,1,1,7,20,50,19,13,31,March,1.0,6.123233995736766e-17,42,24,3,1,1,2.2,1.8,46,42,4,24,44,-20,"March, 2015"
2014-2015,30,2015-03-21,Southampton,Burnley,2,0,H,3,0,1,1,3,2,1,2,6,18,50,25,12,25,March,1.0,6.123233995736766e-17,38,11,0,0,1,0.0,1.0,40,21,19,26,47,-21,"March, 2015"
2014-2015,30,2015-03-21,West Ham,Sunderland,1,0,H,3,0,1,1,3,2,2,1,10,17,39,26,7,13,March,1.0,6.123233995736766e-17,45,40,1,3,1,0.8,1.2,39,37,2,23,43,-20,"March, 2015"
2014-2015,30,2015-03-21,Man City,West Brom,3,0,H,3,0,5,0,0,2,2,1,2,13,58,33,11,25,March,1.0,6.123233995736766e-17,27,44,5,0,0,2.4,1.0,59,28,31,27,36,-9,"March, 2015"
2014-2015,30,2015-03-21,Aston Villa,Swansea,0,1,A,0,3,2,0,3,3,0,2,16,9,28,40,7,12,March,1.0,6.123233995736766e-17,1,41,1,2,2,1.2,1.6,19,38,-19,33,38,-5,"March, 2015"
2014-2015,30,2015-03-21,Newcastle,Arsenal,1,2,A,0,3,1,1,3,2,2,1,11,3,35,57,8,22,March,1.0,6.123233995736766e-17,30,0,0,0,5,0.8,3.2,32,46,-14,56,30,26,"March, 2015"
2014-2015,30,2015-03-22,QPR,Everton,1,2,A,0,3,1,1,3,2,0,3,19,14,22,31,5,9,March,1.0,6.123233995736766e-17,34,18,1,2,2,0.8,1.4,30,52,-22,36,41,-5,"March, 2015"
2014-2015,30,2015-03-22,Liverpool,Man United,1,2,A,0,3,1,1,3,1,2,2,5,4,54,56,1,2,March,1.0,6.123233995736766e-17,25,28,2,0,3,1.2,1.4,43,30,13,50,26,24,"March, 2015"
2014-2015,30,2015-03-22,Hull,Chelsea,2,3,A,0,3,1,1,3,3,1,1,15,1,28,64,14,36,March,1.0,6.123233995736766e-17,21,14,0,1,4,0.4,1.8,26,37,-11,58,23,35,"March, 2015"
2014-2015,31,2015-04-04,Arsenal,Liverpool,4,1,H,3,0,2,2,1,1,1,3,3,5,60,54,2,6,April,0.8660254037844388,-0.4999999999999998,0,25,2,2,1,1.8,1.8,58,31,27,44,32,12,"April, 2015"
2014-2015,31,2015-04-04,Chelsea,Stoke,2,1,H,3,0,3,1,1,2,2,1,1,10,67,42,9,25,April,0.8660254037844388,-0.4999999999999998,14,39,4,0,1,2.4,0.6,61,25,36,34,37,-3,"April, 2015"
2014-2015,31,2015-04-04,Everton,Southampton,1,0,H,3,0,2,0,3,1,1,3,13,6,34,53,7,19,April,0.8660254037844388,-0.4999999999999998,18,38,2,1,2,1.0,1.4,38,42,-4,42,21,21,"April, 2015"
2014-2015,31,2015-04-04,Leicester,West Ham,2,1,H,3,0,3,1,1,1,1,3,20,9,19,42,11,23,April,0.8660254037844388,-0.4999999999999998,24,45,2,1,2,0.8,1.0,27,48,-21,40,37,3,"April, 2015"
2014-2015,31,2015-04-04,Man United,Aston Villa,3,1,H,3,0,1,2,2,2,0,3,4,16,59,28,12,31,April,0.8660254037844388,-0.4999999999999998,28,1,4,1,0,2.8,0.8,52,27,25,19,39,-20,"April, 2015"
2014-2015,31,2015-04-04,Swansea,Hull,3,1,H,3,0,3,0,2,1,1,3,8,15,43,28,7,15,April,0.8660254037844388,-0.4999999999999998,41,21,1,1,1,0.6666666666666666,0.6666666666666666,34,38,-4,28,40,-12,"April, 2015"
2014-2015,31,2015-04-04,West Brom,QPR,1,4,A,0,3,2,2,1,1,1,3,14,20,33,22,6,11,April,0.8660254037844388,-0.4999999999999998,44,34,3,1,1,1.8,1.4,27,39,-12,31,54,-23,"April, 2015"
2014-2015,31,2015-04-05,Burnley,Tottenham,0,0,D,1,1,2,1,2,2,1,2,19,7,25,53,12,28,April,0.8660254037844388,-0.4999999999999998,11,42,1,0,2,1.6666666666666667,3.0,26,49,-23,50,45,5,"April, 2015"
2014-2015,31,2015-04-05,Sunderland,Newcastle,1,0,H,3,0,2,2,1,1,1,3,17,13,26,35,4,9,April,0.8660254037844388,-0.4999999999999998,40,30,4,1,0,2.0,0.4,23,44,-21,33,48,-15,"April, 2015"
2014-2015,31,2015-04-06,Crystal Palace,Man City,2,1,H,3,0,2,0,3,5,0,0,12,4,36,61,8,25,April,0.8660254037844388,-0.4999999999999998,16,27,0,0,5,0.4,2.2,36,41,-5,62,28,34,"April, 2015"
2014-2015,31,2015-04-07,Aston Villa,QPR,3,3,D,1,1,2,0,3,1,1,3,17,19,28,25,2,3,April,0.8660254037844388,-0.4999999999999998,1,34,1,3,1,1.4,1.6,20,42,-22,35,55,-20,"April, 2015"
2014-2015,32,2015-04-11,Burnley,Arsenal,0,1,A,0,3,2,1,2,2,2,1,19,2,26,63,17,37,April,0.8660254037844388,-0.4999999999999998,11,0,0,1,2,0.6666666666666666,2.333333333333333,26,49,-23,62,32,30,"April, 2015"
2014-2015,32,2015-04-11,Southampton,Hull,2,0,H,3,0,1,1,3,1,1,3,7,17,53,28,10,25,April,0.8660254037844388,-0.4999999999999998,38,21,3,0,0,2.0,0.3333333333333333,42,22,20,29,43,-14,"April, 2015"
2014-2015,32,2015-04-11,Sunderland,Crystal Palace,1,4,A,0,3,2,2,1,2,0,3,15,11,29,39,4,10,April,0.8660254037844388,-0.4999999999999998,40,16,1,1,1,1.3333333333333333,1.3333333333333333,24,44,-20,38,42,-4,"April, 2015"
2014-2015,32,2015-04-11,Swansea,Everton,1,1,D,1,1,3,0,2,2,0,3,8,12,46,37,4,9,April,0.8660254037844388,-0.4999999999999998,41,18,0,2,3,0.6,1.6,37,39,-2,39,42,-3,"April, 2015"
2014-2015,32,2015-04-11,Tottenham,Aston Villa,0,1,A,0,3,2,1,2,2,0,3,7,15,54,29,8,25,April,0.8660254037844388,-0.4999999999999998,42,1,5,0,0,2.6,0.2,50,45,5,23,45,-22,"April, 2015"
2014-2015,32,2015-04-11,West Brom,Leicester,2,3,A,0,3,2,2,1,3,1,1,14,20,33,22,6,11,April,0.8660254037844388,-0.4999999999999998,44,24,1,0,0,1.0,0.0,28,43,-15,29,49,-20,"April, 2015"
2014-2015,32,2015-04-11,West Ham,Stoke,1,1,D,1,1,1,1,3,2,2,1,9,11,42,42,2,0,April,0.8660254037844388,-0.4999999999999998,45,39,1,2,2,1.0,1.4,41,39,2,35,39,-4,"April, 2015"
2014-2015,32,2015-04-12,Man United,Man City,4,2,H,3,0,1,2,2,5,0,0,3,4,62,61,1,1,April,0.8660254037844388,-0.4999999999999998,28,27,1,0,4,1.0,2.4,55,28,27,63,30,33,"April, 2015"
2014-2015,32,2015-04-12,QPR,Chelsea,0,1,A,0,3,1,1,3,3,1,1,18,1,26,70,17,44,April,0.8660254037844388,-0.4999999999999998,34,14,2,1,2,0.8,1.6,38,58,-20,63,26,37,"April, 2015"
2014-2015,32,2015-04-13,Liverpool,Newcastle,2,0,H,3,0,1,1,3,1,1,3,6,13,54,35,7,19,April,0.8660254037844388,-0.4999999999999998,25,30,2,2,1,2.2,1.0,45,36,9,33,49,-16,"April, 2015"
2014-2015,33,2015-04-18,Chelsea,Man United,1,0,H,3,0,3,1,1,1,2,2,1,3,73,65,2,8,April,0.8660254037844388,-0.4999999999999998,14,28,2,2,1,1.4,1.0,64,26,38,59,30,29,"April, 2015"
2014-2015,33,2015-04-18,Crystal Palace,West Brom,0,2,A,0,3,2,0,3,2,2,1,11,14,42,33,3,9,April,0.8660254037844388,-0.4999999999999998,16,44,2,2,1,2.0,1.4,42,43,-1,30,46,-16,"April, 2015"
2014-2015,33,2015-04-18,Everton,Burnley,1,0,H,3,0,2,0,3,2,1,2,12,19,38,26,7,12,April,0.8660254037844388,-0.4999999999999998,18,11,2,0,1,1.6666666666666667,0.6666666666666666,40,43,-3,26,50,-24,"April, 2015"
2014-2015,33,2015-04-18,Leicester,Swansea,2,0,H,3,0,3,1,1,3,0,2,20,8,25,47,12,22,April,0.8660254037844388,-0.4999999999999998,24,41,0,0,1,0.0,2.0,32,51,-19,38,40,-2,"April, 2015"
2014-2015,33,2015-04-18,Stoke,Southampton,2,1,H,3,0,2,2,1,1,1,3,10,6,43,56,4,13,April,0.8660254037844388,-0.4999999999999998,39,38,0,4,1,1.4,1.6,36,40,-4,44,22,22,"April, 2015"
2014-2015,33,2015-04-19,Man City,West Ham,2,0,H,3,0,5,0,0,1,1,3,4,10,61,43,6,18,April,0.8660254037844388,-0.4999999999999998,27,45,3,1,1,1.6,0.8,65,34,31,42,40,2,"April, 2015"
2014-2015,33,2015-04-19,Newcastle,Tottenham,1,3,A,0,3,1,1,3,2,1,2,14,7,35,54,7,19,April,0.8660254037844388,-0.4999999999999998,30,42,3,0,2,1.2,1.6,33,51,-18,50,46,4,"April, 2015"
2014-2015,34,2015-04-25,West Brom,Liverpool,0,0,D,1,1,2,2,1,1,1,3,13,7,36,57,6,21,April,0.8660254037844388,-0.4999999999999998,44,25,2,1,2,1.6,1.4,32,46,-14,47,36,11,"April, 2015"
2014-2015,34,2015-04-25,Stoke,Sunderland,1,1,D,1,1,2,2,1,2,2,1,9,18,46,29,9,17,April,0.8660254037844388,-0.4999999999999998,39,40,1,2,2,0.8,1.0,38,41,-3,25,48,-23,"April, 2015"
2014-2015,34,2015-04-25,Southampton,Tottenham,2,2,D,1,1,1,1,3,2,1,2,7,6,56,57,1,1,April,0.8660254037844388,-0.4999999999999998,38,42,0,0,5,1.0,2.0,45,24,21,53,47,6,"April, 2015"
2014-2015,34,2015-04-25,QPR,West Ham,0,0,D,1,1,1,1,3,1,1,3,19,10,26,43,9,17,April,0.8660254037844388,-0.4999999999999998,34,45,1,1,3,1.0,1.2,38,59,-21,42,42,0,"April, 2015"
2014-2015,34,2015-04-25,Newcastle,Swansea,2,3,A,0,3,1,1,3,3,0,2,14,8,35,47,6,12,April,0.8660254037844388,-0.4999999999999998,30,41,0,1,4,0.8,2.0,34,54,-20,38,42,-4,"April, 2015"
2014-2015,34,2015-04-25,Man City,Aston Villa,3,2,H,3,0,5,0,0,2,0,3,4,15,64,32,11,32,April,0.8660254037844388,-0.4999999999999998,27,1,4,0,1,2.8,0.6,67,34,33,24,45,-21,"April, 2015"
2014-2015,34,2015-04-25,Crystal Palace,Hull,0,2,A,0,3,2,0,3,1,1,3,11,18,42,28,7,14,April,0.8660254037844388,-0.4999999999999998,16,21,2,0,1,0.6666666666666666,0.6666666666666666,42,45,-3,29,45,-16,"April, 2015"
2014-2015,34,2015-04-25,Burnley,Leicester,0,1,A,0,3,2,1,2,3,1,1,20,18,26,28,2,2,April,0.8660254037844388,-0.4999999999999998,11,24,0,1,0,2.0,2.0,26,51,-25,34,51,-17,"April, 2015"
2014-2015,34,2015-04-26,Arsenal,Chelsea,0,0,D,1,1,2,2,1,3,1,1,3,1,66,76,2,10,April,0.8660254037844388,-0.4999999999999998,0,14,0,1,4,0.4,2.4,63,32,31,65,26,39,"April, 2015"
2014-2015,34,2015-04-26,Everton,Man United,3,0,H,3,0,2,0,3,1,2,2,12,4,41,65,8,24,April,0.8660254037844388,-0.4999999999999998,18,28,3,0,2,1.0,0.8,41,43,-2,59,31,28,"April, 2015"
2014-2015,34,2015-04-28,Hull,Liverpool,1,0,H,3,0,1,1,3,1,1,3,16,5,31,58,11,27,April,0.8660254037844388,-0.4999999999999998,21,25,1,2,2,0.8,1.8,31,45,-14,47,36,11,"April, 2015"
2014-2015,34,2015-04-29,Leicester,Chelsea,1,3,A,0,3,3,1,1,3,1,1,17,1,31,77,16,46,April,0.8660254037844388,-0.4999999999999998,24,14,0,0,5,0.6,2.6,35,51,-16,65,26,39,"April, 2015"
2014-2015,35,2015-05-02,West Ham,Burnley,1,0,H,3,0,1,1,3,2,1,2,11,20,44,26,9,18,May,0.4999999999999999,-0.8660254037844387,45,11,2,0,1,3.0,2.0,42,42,0,26,52,-26,"May, 2015"
2014-2015,35,2015-05-02,Swansea,Stoke,2,0,H,3,0,3,0,2,2,2,1,8,9,50,47,1,3,May,0.4999999999999999,-0.8660254037844387,41,39,1,2,2,1.6,1.8,41,44,-3,39,42,-3,"May, 2015"
2014-2015,35,2015-05-02,Sunderland,Southampton,2,1,H,3,0,2,2,1,1,1,3,18,7,30,57,11,27,May,0.4999999999999999,-0.8660254037844387,40,38,1,3,1,1.0,2.4,26,49,-23,47,26,21,"May, 2015"
2014-2015,35,2015-05-02,Liverpool,QPR,2,1,H,3,0,1,1,3,1,1,3,5,19,58,27,14,31,May,0.4999999999999999,-0.8660254037844387,25,34,4,0,1,2.0,1.0,47,37,10,38,59,-21,"May, 2015"
2014-2015,35,2015-05-02,Man United,West Brom,0,1,A,0,3,1,2,2,2,2,1,4,13,65,37,9,28,May,0.4999999999999999,-0.8660254037844387,28,44,2,2,1,2.6,1.8,59,34,25,32,46,-14,"May, 2015"
2014-2015,35,2015-05-02,Leicester,Newcastle,3,0,H,3,0,3,1,1,1,1,3,17,14,31,35,3,4,May,0.4999999999999999,-0.8660254037844387,24,30,0,2,3,0.4,1.2,36,54,-18,36,57,-21,"May, 2015"
2014-2015,35,2015-05-02,Aston Villa,Everton,3,2,H,3,0,2,0,3,2,0,3,16,10,32,44,6,12,May,0.4999999999999999,-0.8660254037844387,1,18,0,1,4,1.0,2.6,26,48,-22,44,43,1,"May, 2015"
2014-2015,35,2015-05-03,Chelsea,Crystal Palace,1,0,H,3,0,3,1,1,2,0,3,1,12,80,42,11,38,May,0.4999999999999999,-0.8660254037844387,14,16,4,0,1,2.0,0.8,68,27,41,42,47,-5,"May, 2015"
2014-2015,35,2015-05-03,Tottenham,Man City,0,1,A,0,3,2,1,2,5,0,0,6,2,58,67,4,9,May,0.4999999999999999,-0.8660254037844387,42,27,1,0,4,1.2,3.6,55,49,6,70,36,34,"May, 2015"
2014-2015,35,2015-05-04,Hull,Arsenal,1,3,A,0,3,1,1,3,2,2,1,16,3,34,67,13,33,May,0.4999999999999999,-0.8660254037844387,21,0,0,1,4,0.6,2.4,32,45,-13,63,32,31,"May, 2015"
2014-2015,36,2015-05-09,Stoke,Tottenham,3,0,H,3,0,2,2,1,2,1,2,10,6,47,58,4,11,May,0.4999999999999999,-0.8660254037844387,39,42,1,1,3,0.6,1.4,39,44,-5,55,50,5,"May, 2015"
2014-2015,36,2015-05-09,Newcastle,West Brom,1,1,D,1,1,1,1,3,2,2,1,17,13,35,40,4,5,May,0.4999999999999999,-0.8660254037844387,30,44,3,1,1,1.4,0.8,36,60,-24,33,46,-13,"May, 2015"
2014-2015,36,2015-05-09,Leicester,Southampton,2,0,H,3,0,3,1,1,1,1,3,17,7,34,57,10,23,May,0.4999999999999999,-0.8660254037844387,24,38,0,3,2,0.8,2.0,39,54,-15,48,28,20,"May, 2015"
2014-2015,36,2015-05-09,Hull,Burnley,0,1,A,0,3,1,1,3,2,1,2,18,20,34,26,2,8,May,0.4999999999999999,-0.8660254037844387,21,11,0,0,3,0.3333333333333333,2.333333333333333,33,48,-15,26,53,-27,"May, 2015"
2014-2015,36,2015-05-09,Everton,Sunderland,0,2,A,0,3,2,0,3,2,2,1,11,18,44,33,7,11,May,0.4999999999999999,-0.8660254037844387,18,40,2,1,2,0.8,0.8,46,46,0,28,50,-22,"May, 2015"
2014-2015,36,2015-05-09,Crystal Palace,Man United,1,2,A,0,3,2,0,3,1,2,2,12,4,42,65,8,23,May,0.4999999999999999,-0.8660254037844387,16,28,0,1,4,0.4,2.0,42,48,-6,59,35,24,"May, 2015"
2014-2015,36,2015-05-09,Aston Villa,West Ham,1,0,H,3,0,2,0,3,1,1,3,14,9,35,47,5,12,May,0.4999999999999999,-0.8660254037844387,1,45,1,2,2,0.4,0.8,29,50,-21,43,42,1,"May, 2015"
2014-2015,36,2015-05-10,Chelsea,Liverpool,1,1,D,1,1,3,1,1,1,1,3,1,5,83,61,4,22,May,0.4999999999999999,-0.8660254037844387,14,25,3,2,0,1.8,1.0,69,27,42,49,38,11,"May, 2015"
2014-2015,36,2015-05-10,Man City,QPR,6,0,H,3,0,5,0,0,1,1,3,2,20,70,27,18,43,May,0.4999999999999999,-0.8660254037844387,27,34,3,2,0,2.2,1.4,71,36,35,39,61,-22,"May, 2015"
2014-2015,36,2015-05-11,Arsenal,Swansea,0,1,A,0,3,2,2,1,3,0,2,3,8,70,53,5,17,May,0.4999999999999999,-0.8660254037844387,0,41,2,1,2,1.4,1.4,66,33,33,43,44,-1,"May, 2015"
2014-2015,37,2015-05-16,West Ham,Everton,1,2,A,0,3,1,1,3,2,0,3,10,12,47,44,2,3,May,0.4999999999999999,-0.8660254037844387,45,18,0,0,5,0.8,2.0,43,43,0,46,48,-2,"May, 2015"
2014-2015,37,2015-05-16,Sunderland,Leicester,0,0,D,1,1,2,2,1,3,1,1,16,15,36,37,1,1,May,0.4999999999999999,-0.8660254037844387,40,24,1,2,2,0.4,0.8,30,50,-20,41,54,-13,"May, 2015"
2014-2015,37,2015-05-16,Southampton,Aston Villa,6,1,H,3,0,1,1,3,2,0,3,7,14,57,38,7,19,May,0.4999999999999999,-0.8660254037844387,38,1,2,2,1,1.6,1.0,48,30,18,30,50,-20,"May, 2015"
2014-2015,37,2015-05-16,Tottenham,Hull,2,0,H,3,0,2,1,2,1,1,3,7,18,58,34,11,24,May,0.4999999999999999,-0.8660254037844387,42,21,3,2,0,1.8,0.6,55,53,2,33,49,-16,"May, 2015"
2014-2015,37,2015-05-16,Liverpool,Crystal Palace,1,3,A,0,3,1,1,3,2,0,3,5,12,62,42,7,20,May,0.4999999999999999,-0.8660254037844387,25,16,2,1,2,2.0,2.0,50,39,11,43,50,-7,"May, 2015"
2014-2015,37,2015-05-16,Burnley,Stoke,0,0,D,1,1,2,1,2,2,2,1,19,9,29,50,10,21,May,0.4999999999999999,-0.8660254037844387,11,39,1,1,1,1.0,1.3333333333333333,27,53,-26,42,44,-2,"May, 2015"
2014-2015,37,2015-05-16,QPR,Newcastle,2,1,H,3,0,1,1,3,1,1,3,20,17,27,36,3,9,May,0.4999999999999999,-0.8660254037844387,34,30,0,1,4,0.2,1.0,39,67,-28,37,61,-24,"May, 2015"
2014-2015,37,2015-05-17,Man United,Arsenal,1,1,D,1,1,1,2,2,2,2,1,4,3,68,70,1,2,May,0.4999999999999999,-0.8660254037844387,28,0,3,2,0,1.2,0.6,61,36,25,66,34,32,"May, 2015"
2014-2015,37,2015-05-17,Swansea,Man City,2,4,A,0,3,3,0,2,5,0,0,8,2,56,73,6,17,May,0.4999999999999999,-0.8660254037844387,41,27,0,1,4,0.6,1.8,44,44,0,77,36,41,"May, 2015"
2014-2015,37,2015-05-18,West Brom,Chelsea,3,0,H,3,0,2,2,1,3,1,1,13,1,41,84,12,43,May,0.4999999999999999,-0.8660254037844387,44,14,1,2,2,1.0,1.4,34,47,-13,70,28,42,"May, 2015"
2014-2015,37,2015-05-20,Arsenal,Sunderland,0,0,D,1,1,2,2,1,2,2,1,3,16,71,37,13,34,May,0.4999999999999999,-0.8660254037844387,0,40,4,1,0,2.0,0.4,67,35,32,30,50,-20,"May, 2015"
2014-2015,38,2015-05-24,Stoke,Liverpool,6,1,H,3,0,2,2,1,1,1,3,9,6,51,62,3,11,May,0.4999999999999999,-0.8660254037844387,39,25,1,1,3,1.2,1.6,42,44,-2,51,42,9,"May, 2015"
2014-2015,38,2015-05-24,Newcastle,West Ham,2,0,H,3,0,1,1,3,1,1,3,17,11,36,47,6,11,May,0.4999999999999999,-0.8660254037844387,30,45,1,2,2,0.6,0.6,38,63,-25,44,45,-1,"May, 2015"
2014-2015,38,2015-05-24,Man City,Southampton,2,0,H,3,0,5,0,0,1,1,3,2,7,76,60,5,16,May,0.4999999999999999,-0.8660254037844387,27,38,3,1,1,2.4,1.4,81,38,43,54,31,23,"May, 2015"
2014-2015,38,2015-05-24,Leicester,QPR,5,1,H,3,0,3,1,1,1,1,3,14,20,38,30,6,8,May,0.4999999999999999,-0.8660254037844387,24,34,0,0,1,2.0,3.0,41,54,-13,41,68,-27,"May, 2015"
2014-2015,38,2015-05-24,Hull,Man United,0,0,D,1,1,1,1,3,1,2,2,18,4,34,69,14,35,May,0.4999999999999999,-0.8660254037844387,21,28,0,0,5,0.8,3.2,33,51,-18,62,37,25,"May, 2015"
2014-2015,38,2015-05-24,Everton,Tottenham,0,1,A,0,3,2,0,3,2,1,2,11,6,47,61,5,14,May,0.4999999999999999,-0.8660254037844387,18,42,1,2,2,1.0,1.2,48,49,-1,57,53,4,"May, 2015"
2014-2015,38,2015-05-24,Chelsea,Sunderland,3,1,H,3,0,3,1,1,2,2,1,1,15,84,38,14,46,May,0.4999999999999999,-0.8660254037844387,14,40,3,1,1,2.0,1.4,70,31,39,30,50,-20,"May, 2015"
2014-2015,38,2015-05-24,Aston Villa,Burnley,0,1,A,0,3,2,0,3,2,1,2,16,19,38,30,3,8,May,0.4999999999999999,-0.8660254037844387,1,11,1,2,0,2.333333333333333,1.3333333333333333,31,56,-25,27,53,-26,"May, 2015"
2014-2015,38,2015-05-24,Arsenal,West Brom,4,1,H,3,0,2,2,1,2,2,1,3,13,72,44,10,28,May,0.4999999999999999,-0.8660254037844387,0,44,4,1,0,1.4,0.4,67,35,32,37,47,-10,"May, 2015"
2014-2015,38,2015-05-24,Crystal Palace,Swansea,1,0,H,3,0,2,0,3,3,0,2,12,8,45,56,4,11,May,0.4999999999999999,-0.8660254037844387,16,41,0,2,1,0.6666666666666666,1.3333333333333333,46,51,-5,46,48,-2,"May, 2015"
2015-2016,1,2015-08-08,Norwich,Crystal Palace,1,3,A,0,3,1,0,4,1,1,3,13,9,0,0,4,0,August,-0.8660254037844384,-0.5000000000000004,31,16,1,3,0,1.5,1.25,0,0,0,0,0,0,"August, 2015"
2015-2016,1,2015-08-08,Bournemouth,Aston Villa,0,1,A,0,3,0,1,4,0,1,4,3,2,0,0,1,0,August,-0.8660254037844384,-0.5000000000000004,7,1,0,0,0,0.0,0.0,0,0,0,0,0,0,"August, 2015"
2015-2016,1,2015-08-08,Chelsea,Swansea,2,2,D,1,1,1,3,1,2,1,2,3,15,0,0,12,0,August,-0.8660254037844384,-0.5000000000000004,14,41,5,0,0,2.6,0.4,0,0,0,0,0,0,"August, 2015"
2015-2016,1,2015-08-08,Everton,Watford,2,2,D,1,1,2,0,3,1,1,3,6,17,0,0,11,0,August,-0.8660254037844384,-0.5000000000000004,18,43,4,0,0,3.0,1.0,0,0,0,0,0,0,"August, 2015"
2015-2016,1,2015-08-08,Leicester,Sunderland,4,2,H,3,0,2,3,0,2,3,0,8,16,0,0,8,0,August,-0.8660254037844384,-0.5000000000000004,24,40,2,2,1,0.8,0.4,0,0,0,0,0,0,"August, 2015"
2015-2016,1,2015-08-08,Man United,Tottenham,1,0,H,3,0,3,1,1,1,2,2,11,16,0,0,5,0,August,-0.8660254037844384,-0.5000000000000004,28,42,1,3,1,1.4,1.0,0,0,0,0,0,0,"August, 2015"
2015-2016,1,2015-08-09,Stoke,Liverpool,0,1,A,0,3,1,1,3,1,3,1,14,12,0,0,2,0,August,-0.8660254037844384,-0.5000000000000004,39,25,2,0,3,2.4,1.8,0,0,0,0,0,0,"August, 2015"
2015-2016,1,2015-08-09,Arsenal,West Ham,0,2,A,0,3,3,2,0,3,0,2,9,16,0,0,7,0,August,-0.8660254037844384,-0.5000000000000004,0,45,5,0,0,3.2,0.8,0,0,0,0,0,0,"August, 2015"
2015-2016,1,2015-08-09,Newcastle,Southampton,2,2,D,1,1,2,3,0,4,1,0,12,13,0,0,1,0,August,-0.8660254037844384,-0.5000000000000004,30,38,1,1,3,1.2,2.6,0,0,0,0,0,0,"August, 2015"
2015-2016,1,2015-08-10,West Brom,Man City,0,3,A,0,3,0,3,2,1,3,1,14,13,0,0,1,0,August,-0.8660254037844384,-0.5000000000000004,44,27,0,0,5,0.8,2.6,0,0,0,0,0,0,"August, 2015"
2015-2016,2,2015-08-14,Aston Villa,Man United,0,1,A,0,3,0,1,4,3,1,1,5,7,3,3,2,0,August,-0.8660254037844384,-0.5000000000000004,1,28,0,1,4,0.6,2.8,1,0,1,1,0,1,"August, 2015"
2015-2016,2,2015-08-15,Southampton,Everton,0,3,A,0,3,4,1,0,2,0,3,11,9,1,1,2,0,August,-0.8660254037844384,-0.5000000000000004,38,18,2,1,2,1.2,0.6,2,2,0,2,2,0,"August, 2015"
2015-2016,2,2015-08-15,Sunderland,Norwich,1,3,A,0,3,2,3,0,1,0,4,17,18,0,0,1,0,August,-0.8660254037844384,-0.5000000000000004,40,31,1,2,2,1.0,1.0,2,4,-2,1,3,-2,"August, 2015"
2015-2016,2,2015-08-15,Swansea,Newcastle,2,0,H,3,0,2,1,2,2,3,0,12,11,1,1,1,0,August,-0.8660254037844384,-0.5000000000000004,41,30,4,1,0,2.2,1.0,2,2,0,2,2,0,"August, 2015"
2015-2016,2,2015-08-15,Tottenham,Stoke,2,2,D,1,1,1,2,2,1,1,3,17,16,0,0,1,0,August,-0.8660254037844384,-0.5000000000000004,42,39,3,0,2,1.4,1.2,0,1,-1,0,1,-1,"August, 2015"
2015-2016,2,2015-08-15,Watford,West Brom,0,0,D,1,1,1,1,3,0,3,2,12,19,1,0,7,1,August,-0.8660254037844384,-0.5000000000000004,43,44,0,0,0,0.0,0.0,2,2,0,0,3,-3,"August, 2015"
2015-2016,2,2015-08-15,West Ham,Leicester,1,2,A,0,3,3,0,2,2,3,0,7,5,3,3,2,0,August,-0.8660254037844384,-0.5000000000000004,45,24,2,1,2,1.2,1.0,2,0,2,4,2,2,"August, 2015"
2015-2016,2,2015-08-16,Man City,Chelsea,3,0,H,3,0,1,3,1,1,3,1,5,13,3,1,8,2,August,-0.8660254037844384,-0.5000000000000004,27,14,1,2,2,1.0,1.0,3,0,3,2,2,0,"August, 2015"
2015-2016,2,2015-08-16,Crystal Palace,Arsenal,1,2,A,0,3,1,1,3,3,2,0,6,19,3,0,13,3,August,-0.8660254037844384,-0.5000000000000004,16,0,0,0,5,0.6,2.6,3,1,2,0,2,-2,"August, 2015"
2015-2016,2,2015-08-17,Liverpool,Bournemouth,1,0,H,3,0,1,3,1,0,1,4,8,19,3,0,11,3,August,-0.8660254037844384,-0.5000000000000004,25,7,0,0,0,0.0,0.0,1,0,1,0,1,-1,"August, 2015"
2015-2016,3,2015-08-22,Crystal Palace,Aston Villa,2,1,H,3,0,1,1,3,0,1,4,7,10,3,3,3,0,August,-0.8660254037844384,-0.5000000000000004,16,1,3,1,1,0.8,0.2,4,3,1,1,1,0,"August, 2015"
2015-2016,3,2015-08-22,Leicester,Tottenham,1,1,D,1,1,2,3,0,1,2,2,2,14,6,1,12,5,August,-0.8660254037844384,-0.5000000000000004,24,42,1,1,3,2.2,2.6,6,3,3,2,3,-1,"August, 2015"
2015-2016,3,2015-08-22,Man United,Newcastle,0,0,D,1,1,3,1,1,2,3,0,5,15,6,1,10,5,August,-0.8660254037844384,-0.5000000000000004,28,30,4,0,1,2.4,1.0,2,0,2,2,4,-2,"August, 2015"
2015-2016,3,2015-08-22,Norwich,Stoke,1,1,D,1,1,1,0,4,1,1,3,9,15,3,1,6,2,August,-0.8660254037844384,-0.5000000000000004,31,39,2,1,2,0.6,0.6,4,4,0,2,3,-1,"August, 2015"
2015-2016,3,2015-08-22,West Ham,Bournemouth,3,4,A,0,3,3,0,2,0,1,4,9,20,3,0,11,3,August,-0.8660254037844384,-0.5000000000000004,45,7,0,0,0,0.0,0.0,3,2,1,0,2,-2,"August, 2015"
2015-2016,3,2015-08-22,Sunderland,Swansea,1,1,D,1,1,2,3,0,2,1,2,20,7,0,4,13,4,August,-0.8660254037844384,-0.5000000000000004,40,41,0,3,2,0.4,1.6,3,7,-4,4,2,2,"August, 2015"
2015-2016,3,2015-08-23,West Brom,Chelsea,2,3,A,0,3,0,3,2,1,3,1,19,18,1,1,1,0,August,-0.8660254037844384,-0.5000000000000004,44,14,1,2,2,1.2,1.2,0,3,-3,2,5,-3,"August, 2015"
2015-2016,3,2015-08-23,Watford,Southampton,0,0,D,1,1,1,1,3,4,1,0,13,18,2,1,5,1,August,-0.8660254037844384,-0.5000000000000004,43,38,1,0,1,1.5,2.0,2,2,0,2,5,-3,"August, 2015"
2015-2016,3,2015-08-23,Everton,Man City,0,2,A,0,3,2,0,3,1,3,1,7,3,4,6,4,2,August,-0.8660254037844384,-0.5000000000000004,18,27,1,1,3,1.2,1.6,5,2,3,6,0,6,"August, 2015"
2015-2016,3,2015-08-24,Arsenal,Liverpool,0,0,D,1,1,3,2,0,1,3,1,13,5,3,6,8,3,August,-0.8660254037844384,-0.5000000000000004,0,25,2,2,1,2.2,2.0,2,3,-1,2,0,2,"August, 2015"
2015-2016,4,2015-08-29,Aston Villa,Sunderland,2,2,D,1,1,0,1,4,2,3,0,14,19,3,1,5,2,August,-0.8660254037844384,-0.5000000000000004,1,40,3,2,0,2.2,0.2,2,3,-1,4,8,-4,"August, 2015"
2015-2016,4,2015-08-29,Bournemouth,Leicester,1,1,D,1,1,0,1,4,2,3,0,14,2,3,7,12,4,August,-0.8660254037844384,-0.5000000000000004,7,24,0,0,0,0.0,0.0,4,5,-1,7,4,3,"August, 2015"
2015-2016,4,2015-08-29,Chelsea,Crystal Palace,1,2,A,0,3,1,3,1,1,1,3,12,5,4,6,7,2,August,-0.8660254037844384,-0.5000000000000004,14,16,4,0,1,1.8,0.8,5,7,-2,6,4,2,"August, 2015"
2015-2016,4,2015-08-29,Liverpool,West Ham,0,3,A,0,3,1,3,1,3,0,2,4,13,7,3,9,4,August,-0.8660254037844384,-0.5000000000000004,25,45,3,1,1,1.8,1.0,2,0,2,6,6,0,"August, 2015"
2015-2016,4,2015-08-29,Man City,Watford,2,0,H,3,0,1,3,1,1,1,3,1,14,9,3,13,6,August,-0.8660254037844384,-0.5000000000000004,27,43,0,2,0,0.5,0.5,8,0,8,2,2,0,"August, 2015"
2015-2016,4,2015-08-29,Newcastle,Arsenal,0,1,A,0,3,2,3,0,3,2,0,17,12,2,4,5,2,August,-0.8660254037844384,-0.5000000000000004,30,0,0,0,5,0.4,2.2,2,4,-2,2,3,-1,"August, 2015"
2015-2016,4,2015-08-29,Stoke,West Brom,0,1,A,0,3,1,1,3,0,3,2,15,20,2,1,5,1,August,-0.8660254037844384,-0.5000000000000004,39,44,2,2,1,0.8,0.4,3,4,-1,2,6,-4,"August, 2015"
2015-2016,4,2015-08-29,Tottenham,Everton,0,0,D,1,1,1,2,2,2,0,3,16,9,2,4,7,2,August,-0.8660254037844384,-0.5000000000000004,42,18,3,2,0,1.2,0.6,3,4,-1,5,4,1,"August, 2015"
2015-2016,4,2015-08-30,Southampton,Norwich,3,0,H,3,0,4,1,0,1,0,4,19,10,2,4,9,2,August,-0.8660254037844384,-0.5000000000000004,38,31,2,2,1,1.8,1.4,2,5,-3,5,5,0,"August, 2015"
2015-2016,4,2015-08-30,Swansea,Man United,2,1,H,3,0,2,1,2,3,1,1,8,4,5,7,4,2,August,-0.8660254037844384,-0.5000000000000004,41,28,2,0,3,1.2,2.0,5,3,2,2,0,2,"August, 2015"
2015-2016,5,2015-09-12,Norwich,Bournemouth,3,1,H,3,0,1,0,4,0,1,4,13,11,4,4,2,0,September,-1.0,-1.8369701987210287e-16,31,7,0,0,0,0.0,0.0,5,8,-3,5,6,-1,"September, 2015"
2015-2016,5,2015-09-12,Man United,Liverpool,3,1,H,3,0,3,1,1,1,3,1,7,8,7,7,1,0,September,-1.0,-1.8369701987210287e-16,28,25,3,0,2,1.4,1.2,3,2,1,2,3,-1,"September, 2015"
2015-2016,5,2015-09-12,Watford,Swansea,1,0,H,3,0,1,1,3,2,1,2,17,7,3,8,10,5,September,-1.0,-1.8369701987210287e-16,43,41,0,0,0,0.0,0.0,2,4,-2,7,4,3,"September, 2015"
2015-2016,5,2015-09-12,Crystal Palace,Man City,0,1,A,0,3,1,1,3,1,3,1,3,1,9,12,2,3,September,-1.0,-1.8369701987210287e-16,16,27,1,0,4,0.6,2.0,8,5,3,10,0,10,"September, 2015"
2015-2016,5,2015-09-12,Arsenal,Stoke,2,0,H,3,0,3,2,0,1,1,3,6,18,7,2,12,5,September,-1.0,-1.8369701987210287e-16,0,39,3,0,2,1.8,1.0,3,3,0,3,5,-2,"September, 2015"
2015-2016,5,2015-09-12,Everton,Chelsea,3,1,H,3,0,2,0,3,1,3,1,9,13,5,4,4,1,September,-1.0,-1.8369701987210287e-16,18,14,1,0,4,1.0,2.0,5,4,1,6,9,-3,"September, 2015"
2015-2016,5,2015-09-12,West Brom,Southampton,0,0,D,1,1,0,3,2,4,1,0,15,12,4,5,3,1,September,-1.0,-1.8369701987210287e-16,44,38,2,1,2,0.8,0.4,3,6,-3,5,5,0,"September, 2015"
2015-2016,5,2015-09-13,Sunderland,Tottenham,0,1,A,0,3,2,3,0,1,2,2,19,17,2,3,2,1,September,-1.0,-1.8369701987210287e-16,40,42,0,1,4,1.0,2.4,6,10,-4,3,4,-1,"September, 2015"
2015-2016,5,2015-09-13,Leicester,Aston Villa,3,2,H,3,0,2,3,0,0,1,4,6,14,8,4,8,4,September,-1.0,-1.8369701987210287e-16,24,1,1,1,3,1.0,2.4,8,5,3,4,5,-1,"September, 2015"
2015-2016,5,2015-09-14,West Ham,Newcastle,2,0,H,3,0,3,0,2,2,3,0,10,18,6,2,8,4,September,-1.0,-1.8369701987210287e-16,45,30,1,2,2,0.4,1.0,9,6,3,2,5,-3,"September, 2015"
2015-2016,6,2015-09-19,Bournemouth,Sunderland,2,0,H,3,0,0,1,4,2,3,0,16,19,4,2,3,2,September,-1.0,-1.8369701987210287e-16,7,40,0,0,0,0.0,0.0,6,9,-3,6,11,-5,"September, 2015"
2015-2016,6,2015-09-19,Stoke,Leicester,2,2,D,1,1,1,1,3,2,3,0,18,3,2,11,15,9,September,-1.0,-1.8369701987210287e-16,39,24,1,0,1,0.5,0.5,3,7,-4,11,7,4,"September, 2015"
2015-2016,6,2015-09-19,Swansea,Everton,0,0,D,1,1,2,1,2,2,0,3,9,8,8,8,1,0,September,-1.0,-1.8369701987210287e-16,41,18,0,3,2,0.8,1.2,7,5,2,8,5,3,"September, 2015"
2015-2016,6,2015-09-19,Newcastle,Watford,1,2,A,0,3,2,3,0,1,1,3,19,16,2,6,3,4,September,-1.0,-1.8369701987210287e-16,30,43,2,2,0,1.25,0.75,2,7,-5,3,4,-1,"September, 2015"
2015-2016,6,2015-09-19,Aston Villa,West Brom,0,1,A,0,3,0,1,4,0,3,2,15,14,4,5,1,1,September,-1.0,-1.8369701987210287e-16,1,44,2,2,1,2.0,1.8,6,8,-2,3,6,-3,"September, 2015"
2015-2016,6,2015-09-19,Chelsea,Arsenal,2,0,H,3,0,1,3,1,3,2,0,17,4,4,10,13,6,September,-1.0,-1.8369701987210287e-16,14,0,3,2,0,2.0,0.2,7,12,-5,5,3,2,"September, 2015"
2015-2016,6,2015-09-19,Man City,West Ham,1,2,A,0,3,1,3,1,3,0,2,1,5,15,9,4,6,September,-1.0,-1.8369701987210287e-16,27,45,4,0,1,2.0,0.8,11,0,11,11,6,5,"September, 2015"
2015-2016,6,2015-09-20,Liverpool,Norwich,1,1,D,1,1,1,3,1,1,0,4,14,12,7,7,2,0,September,-1.0,-1.8369701987210287e-16,25,31,5,0,0,4.2,1.0,3,6,-3,8,9,-1,"September, 2015"
2015-2016,6,2015-09-20,Southampton,Man United,2,3,A,0,3,4,1,0,3,1,1,15,4,6,10,11,4,September,-1.0,-1.8369701987210287e-16,38,28,1,2,2,1.0,1.2,5,5,0,6,3,3,"September, 2015"
2015-2016,6,2015-09-20,Tottenham,Crystal Palace,1,0,H,3,0,1,2,2,1,1,3,15,7,6,9,8,3,September,-1.0,-1.8369701987210287e-16,42,16,2,1,2,0.8,1.0,4,4,0,8,6,2,"September, 2015"
2015-2016,7,2015-09-26,West Ham,Norwich,2,2,D,1,1,3,0,2,1,0,4,4,13,12,8,9,4,September,-1.0,-1.8369701987210287e-16,45,31,2,1,1,1.25,1.0,13,7,6,9,10,-1,"September, 2015"
2015-2016,7,2015-09-26,Tottenham,Man City,4,1,H,3,0,1,2,2,1,3,1,10,2,9,15,8,6,September,-1.0,-1.8369701987210287e-16,42,27,1,0,4,1.0,3.4,5,4,1,12,2,10,"September, 2015"
2015-2016,7,2015-09-26,Stoke,Bournemouth,2,1,H,3,0,1,1,3,0,1,4,18,16,3,7,2,4,September,-1.0,-1.8369701987210287e-16,39,7,0,0,0,0.0,0.0,5,9,-4,8,9,-1,"September, 2015"
2015-2016,7,2015-09-26,Southampton,Swansea,3,1,H,3,0,4,1,0,2,1,2,16,8,6,9,8,3,September,-1.0,-1.8369701987210287e-16,38,41,3,1,1,0.8,0.2,7,8,-1,7,5,2,"September, 2015"
2015-2016,7,2015-09-26,Newcastle,Chelsea,2,2,D,1,1,2,3,0,1,3,1,19,15,2,7,4,5,September,-1.0,-1.8369701987210287e-16,30,14,3,0,2,1.4,1.6,3,9,-6,9,12,-3,"September, 2015"
2015-2016,7,2015-09-26,Man United,Sunderland,3,0,H,3,0,3,1,1,2,3,0,2,20,13,2,18,11,September,-1.0,-1.8369701987210287e-16,28,40,3,1,1,1.2,0.6,9,5,4,6,13,-7,"September, 2015"
2015-2016,7,2015-09-26,Liverpool,Aston Villa,3,2,H,3,0,1,3,1,0,1,4,13,17,8,4,4,4,September,-1.0,-1.8369701987210287e-16,25,1,3,1,1,1.4,0.8,4,7,-3,6,9,-3,"September, 2015"
2015-2016,7,2015-09-26,Leicester,Arsenal,2,5,A,0,3,2,3,0,3,2,0,4,5,12,10,1,2,September,-1.0,-1.8369701987210287e-16,24,0,0,2,3,1.0,1.8,13,9,4,5,5,0,"September, 2015"
2015-2016,7,2015-09-27,Watford,Crystal Palace,0,1,A,0,3,1,1,3,1,1,3,12,10,9,9,2,0,September,-1.0,-1.8369701987210287e-16,43,16,0,0,0,0.0,0.0,5,5,0,8,7,1,"September, 2015"
2015-2016,7,2015-09-28,West Brom,Everton,2,3,A,0,3,0,3,2,2,0,3,14,9,8,9,5,1,September,-1.0,-1.8369701987210287e-16,44,18,0,3,2,0.4,1.0,4,6,-2,8,5,3,"September, 2015"
2015-2016,8,2015-10-03,Sunderland,West Ham,2,2,D,1,1,2,3,0,3,0,2,20,5,2,13,15,11,October,-0.8660254037844386,0.5,40,45,1,2,2,1.0,0.8,6,16,-10,15,9,6,"October, 2015"
2015-2016,8,2015-10-03,Man City,Newcastle,6,1,H,3,0,1,3,1,2,3,0,2,19,15,3,17,12,October,-0.8660254037844386,0.5,27,30,5,0,0,3.4,0.0,13,6,7,5,11,-6,"October, 2015"
2015-2016,8,2015-10-03,Crystal Palace,West Brom,2,0,H,3,0,1,1,3,0,3,2,8,16,12,8,8,4,October,-0.8660254037844386,0.5,16,44,1,2,2,1.4,1.8,9,7,2,6,9,-3,"October, 2015"
2015-2016,8,2015-10-03,Norwich,Leicester,1,2,A,0,3,1,0,4,2,3,0,13,9,9,12,4,3,October,-0.8660254037844386,0.5,31,24,0,0,0,0.0,0.0,11,12,-1,15,14,1,"October, 2015"
2015-2016,8,2015-10-03,Bournemouth,Watford,1,1,D,1,1,0,1,4,1,1,3,17,13,7,9,4,2,October,-0.8660254037844386,0.5,7,43,0,0,0,0.0,0.0,9,11,-2,5,6,-1,"October, 2015"
2015-2016,8,2015-10-03,Aston Villa,Stoke,0,1,A,0,3,0,1,4,1,1,3,18,17,4,6,1,2,October,-0.8660254037844386,0.5,1,39,2,0,3,1.4,1.8,8,12,-4,7,10,-3,"October, 2015"
2015-2016,8,2015-10-03,Chelsea,Southampton,1,3,A,0,3,1,3,1,4,1,0,16,11,8,9,5,1,October,-0.8660254037844386,0.5,14,38,2,2,1,1.8,1.0,11,14,-3,10,9,1,"October, 2015"
2015-2016,8,2015-10-04,Arsenal,Man United,3,0,H,3,0,3,2,0,3,1,1,6,2,13,16,4,3,October,-0.8660254037844386,0.5,0,28,0,3,2,0.6,1.0,10,7,3,12,5,7,"October, 2015"
2015-2016,8,2015-10-04,Everton,Liverpool,1,1,D,1,1,2,0,3,1,3,1,7,10,12,11,3,1,October,-0.8660254037844386,0.5,18,25,0,4,1,0.8,1.6,11,7,4,7,9,-2,"October, 2015"
2015-2016,8,2015-10-04,Swansea,Tottenham,2,2,D,1,1,2,1,2,1,2,2,12,8,9,12,4,3,October,-0.8660254037844386,0.5,41,42,0,0,5,1.0,2.2,8,8,0,9,5,4,"October, 2015"
2015-2016,9,2015-10-17,West Brom,Sunderland,1,0,H,3,0,0,3,2,2,3,0,16,19,8,3,3,5,October,-0.8660254037844386,0.5,44,40,2,2,1,1.4,1.0,6,11,-5,8,18,-10,"October, 2015"
2015-2016,9,2015-10-17,Watford,Arsenal,0,3,A,0,3,1,1,3,3,2,0,13,4,10,16,9,6,October,-0.8660254037844386,0.5,43,0,0,0,4,0.75,2.25,6,7,-1,13,7,6,"October, 2015"
2015-2016,9,2015-10-17,Southampton,Leicester,2,2,D,1,1,4,1,0,2,3,0,9,5,12,15,4,3,October,-0.8660254037844386,0.5,38,24,1,3,1,1.2,1.2,13,10,3,17,15,2,"October, 2015"
2015-2016,9,2015-10-17,Tottenham,Liverpool,0,0,D,1,1,1,2,2,1,3,1,7,10,13,12,3,1,October,-0.8660254037844386,0.5,42,25,0,0,5,0.8,3.6,11,7,4,8,10,-2,"October, 2015"
2015-2016,9,2015-10-17,Everton,Man United,0,3,A,0,3,2,0,3,3,1,1,7,4,13,16,3,3,October,-0.8660254037844386,0.5,18,28,3,0,2,1.4,0.8,12,8,4,12,8,4,"October, 2015"
2015-2016,9,2015-10-17,Crystal Palace,West Ham,1,3,A,0,3,1,1,3,3,0,2,4,6,15,14,2,1,October,-0.8660254037844386,0.5,16,45,3,1,1,1.8,1.4,11,7,4,17,11,6,"October, 2015"
2015-2016,9,2015-10-17,Chelsea,Aston Villa,2,0,H,3,0,1,3,1,0,1,4,16,18,8,4,2,4,October,-0.8660254037844386,0.5,14,1,4,0,1,1.8,0.8,12,17,-5,8,13,-5,"October, 2015"
2015-2016,9,2015-10-17,Man City,Bournemouth,5,1,H,3,0,1,3,1,0,1,4,2,16,18,8,14,10,October,-0.8660254037844386,0.5,27,7,0,0,0,0.0,0.0,19,7,12,10,12,-2,"October, 2015"
2015-2016,9,2015-10-18,Newcastle,Norwich,6,2,H,3,0,2,3,0,1,0,4,20,15,3,9,5,6,October,-0.8660254037844386,0.5,30,31,3,2,0,0.8,0.2,6,17,-11,12,14,-2,"October, 2015"
2015-2016,9,2015-10-19,Swansea,Stoke,0,1,A,0,3,2,1,2,1,1,3,13,15,10,9,2,1,October,-0.8660254037844386,0.5,41,39,2,2,1,2.0,1.4,10,10,0,8,10,-2,"October, 2015"
2015-2016,10,2015-10-24,West Ham,Chelsea,2,1,H,3,0,3,0,2,1,3,1,5,15,17,11,10,6,October,-0.8660254037844386,0.5,45,14,0,1,4,0.0,1.6,20,12,8,14,17,-3,"October, 2015"
2015-2016,10,2015-10-24,Arsenal,Everton,2,1,H,3,0,3,2,0,2,0,3,2,9,19,13,7,6,October,-0.8660254037844386,0.5,0,18,1,3,1,1.0,1.2,16,7,9,12,11,1,"October, 2015"
2015-2016,10,2015-10-24,Aston Villa,Swansea,1,2,A,0,3,0,1,4,2,1,2,19,14,4,10,5,6,October,-0.8660254037844386,0.5,1,41,0,2,3,0.8,1.8,8,15,-7,10,11,-1,"October, 2015"
2015-2016,10,2015-10-24,Leicester,Crystal Palace,1,0,H,3,0,2,3,0,1,1,3,5,6,16,15,1,1,October,-0.8660254037844386,0.5,24,16,1,1,2,1.0,1.0,19,17,2,12,10,2,"October, 2015"
2015-2016,10,2015-10-24,Norwich,West Brom,0,1,A,0,3,1,0,4,0,3,2,16,14,9,11,2,2,October,-0.8660254037844386,0.5,31,44,3,0,2,1.8,0.8,14,20,-6,7,11,-4,"October, 2015"
2015-2016,10,2015-10-24,Stoke,Watford,0,2,A,0,3,1,1,3,1,1,3,13,15,12,10,2,2,October,-0.8660254037844386,0.5,39,43,0,0,0,0.0,0.0,9,10,-1,6,10,-4,"October, 2015"
2015-2016,10,2015-10-25,Man United,Man City,0,0,D,1,1,3,1,1,1,3,1,4,2,19,21,2,2,October,-0.8660254037844386,0.5,28,27,1,0,4,1.2,2.4,15,8,7,24,8,16,"October, 2015"
2015-2016,10,2015-10-25,Sunderland,Newcastle,3,0,H,3,0,2,3,0,2,3,0,20,18,3,6,2,3,October,-0.8660254037844386,0.5,40,30,5,0,0,2.0,0.2,8,19,-11,12,19,-7,"October, 2015"
2015-2016,10,2015-10-25,Bournemouth,Tottenham,1,5,A,0,3,0,1,4,1,2,2,17,7,8,14,10,6,October,-0.8660254037844386,0.5,7,42,0,0,0,0.0,0.0,11,17,-6,11,7,4,"October, 2015"
2015-2016,10,2015-10-25,Liverpool,Southampton,1,1,D,1,1,1,3,1,4,1,0,12,9,13,13,3,0,October,-0.8660254037844386,0.5,25,38,3,0,2,1.6,1.0,8,10,-2,15,12,3,"October, 2015"
2015-2016,11,2015-10-31,Chelsea,Liverpool,1,3,A,0,3,1,3,1,1,3,1,15,9,11,14,6,3,October,-0.8660254037844386,0.5,14,25,3,2,0,1.8,1.0,15,19,-4,9,11,-2,"October, 2015"
2015-2016,11,2015-10-31,Crystal Palace,Man United,0,0,D,1,1,1,1,3,3,1,1,8,4,15,20,4,5,October,-0.8660254037844386,0.5,16,28,0,1,4,0.2,1.4,12,11,1,15,8,7,"October, 2015"
2015-2016,11,2015-10-31,Man City,Norwich,2,1,H,3,0,1,3,1,1,0,4,1,16,22,9,15,13,October,-0.8660254037844386,0.5,27,31,3,1,1,3.8,1.4,24,8,16,14,21,-7,"October, 2015"
2015-2016,11,2015-10-31,Newcastle,Stoke,0,0,D,1,1,2,3,0,1,1,3,19,14,6,12,5,6,October,-0.8660254037844386,0.5,30,39,2,1,2,1.6,1.0,12,22,-10,9,12,-3,"October, 2015"
2015-2016,11,2015-10-31,Swansea,Arsenal,0,3,A,0,3,2,1,2,3,2,0,12,2,13,22,10,9,October,-0.8660254037844386,0.5,41,0,2,1,2,1.2,1.4,12,12,0,18,8,10,"October, 2015"
2015-2016,11,2015-10-31,Watford,West Ham,2,0,H,3,0,1,1,3,3,0,2,12,4,13,20,8,7,October,-0.8660254037844386,0.5,43,45,1,1,2,0.75,1.0,8,10,-2,22,13,9,"October, 2015"
2015-2016,11,2015-10-31,West Brom,Leicester,2,3,A,0,3,0,3,2,2,3,0,11,5,14,19,6,5,October,-0.8660254037844386,0.5,44,24,1,0,1,1.5,1.5,8,11,-3,20,17,3,"October, 2015"
2015-2016,11,2015-11-01,Everton,Sunderland,6,2,H,3,0,2,0,3,2,3,0,12,19,13,6,7,7,November,-0.5000000000000004,0.8660254037844384,18,40,1,1,3,0.4,1.0,13,13,0,11,19,-8,"November, 2015"
2015-2016,11,2015-11-01,Southampton,Bournemouth,2,0,H,3,0,4,1,0,0,1,4,11,17,14,8,6,6,November,-0.5000000000000004,0.8660254037844384,38,7,0,0,0,0.0,0.0,16,13,3,12,22,-10,"November, 2015"
2015-2016,11,2015-11-02,Tottenham,Aston Villa,3,1,H,3,0,1,2,2,0,1,4,6,20,17,4,14,13,November,-0.5000000000000004,0.8660254037844384,42,1,4,0,1,2.2,0.4,16,8,8,9,17,-8,"November, 2015"
2015-2016,12,2015-11-07,West Ham,Everton,1,1,D,1,1,3,0,2,2,0,3,6,9,20,16,3,4,November,-0.5000000000000004,0.8660254037844384,45,18,0,0,5,0.8,2.0,22,15,7,19,15,4,"November, 2015"
2015-2016,12,2015-11-07,Sunderland,Southampton,0,1,A,0,3,2,3,0,4,1,0,19,7,6,17,12,11,November,-0.5000000000000004,0.8660254037844384,40,38,1,3,1,1.2,2.6,13,25,-12,18,13,5,"November, 2015"
2015-2016,12,2015-11-07,Stoke,Chelsea,1,0,H,3,0,1,1,3,1,3,1,13,16,13,11,3,2,November,-0.5000000000000004,0.8660254037844384,39,14,1,0,4,0.8,2.6,9,12,-3,16,22,-6,"November, 2015"
2015-2016,12,2015-11-07,Bournemouth,Newcastle,0,1,A,0,3,0,1,4,2,3,0,17,18,8,7,1,1,November,-0.5000000000000004,0.8660254037844384,7,30,0,0,0,0.0,0.0,12,24,-12,12,22,-10,"November, 2015"
2015-2016,12,2015-11-07,Man United,West Brom,2,0,H,3,0,3,1,1,0,3,2,4,12,21,14,8,7,November,-0.5000000000000004,0.8660254037844384,28,44,1,2,2,2.2,2.0,15,8,7,10,14,-4,"November, 2015"
2015-2016,12,2015-11-07,Leicester,Watford,2,1,H,3,0,2,3,0,1,1,3,3,11,22,16,8,6,November,-0.5000000000000004,0.8660254037844384,24,43,1,1,0,1.0,0.5,23,19,4,10,10,0,"November, 2015"
2015-2016,12,2015-11-07,Norwich,Swansea,1,0,H,3,0,1,0,4,2,1,2,17,13,9,13,4,4,November,-0.5000000000000004,0.8660254037844384,31,41,2,2,1,2.0,2.2,15,23,-8,12,15,-3,"November, 2015"
2015-2016,12,2015-11-08,Arsenal,Tottenham,1,1,D,1,1,3,2,0,1,2,2,2,6,25,20,4,5,November,-0.5000000000000004,0.8660254037844384,0,42,2,1,2,1.0,1.0,21,8,13,19,9,10,"November, 2015"
2015-2016,12,2015-11-08,Aston Villa,Man City,0,0,D,1,1,0,1,4,1,3,1,20,2,4,25,18,21,November,-0.5000000000000004,0.8660254037844384,1,27,1,0,4,1.0,2.4,10,20,-10,26,9,17,"November, 2015"
2015-2016,12,2015-11-08,Liverpool,Crystal Palace,1,2,A,0,3,1,3,1,1,1,3,9,10,17,16,1,1,November,-0.5000000000000004,0.8660254037844384,25,16,1,1,3,1.6,2.2,12,12,0,12,11,1,"November, 2015"
2015-2016,13,2015-11-21,Swansea,Bournemouth,2,2,D,1,1,2,1,2,0,1,4,15,18,13,8,3,5,November,-0.5000000000000004,0.8660254037844384,41,7,0,0,0,0.0,0.0,12,16,-4,12,25,-13,"November, 2015"
2015-2016,13,2015-11-21,West Brom,Arsenal,2,1,H,3,0,0,3,2,3,2,0,15,4,14,26,11,12,November,-0.5000000000000004,0.8660254037844384,44,0,0,1,4,0.6,1.8,10,16,-6,22,9,13,"November, 2015"
2015-2016,13,2015-11-21,Watford,Man United,1,2,A,0,3,1,1,3,3,1,1,12,4,16,24,8,8,November,-0.5000000000000004,0.8660254037844384,43,28,0,0,4,1.0,3.25,11,12,-1,17,8,9,"November, 2015"
2015-2016,13,2015-11-21,Southampton,Stoke,0,1,A,0,3,4,1,0,1,1,3,8,12,20,16,4,4,November,-0.5000000000000004,0.8660254037844384,38,39,1,3,1,1.2,1.2,19,13,6,10,12,-2,"November, 2015"
2015-2016,13,2015-11-21,Chelsea,Norwich,1,0,H,3,0,1,3,1,1,0,4,16,15,11,12,1,1,November,-0.5000000000000004,0.8660254037844384,14,31,3,2,0,1.6,0.4,16,23,-7,16,23,-7,"November, 2015"
2015-2016,13,2015-11-21,Man City,Liverpool,1,4,A,0,3,1,3,1,1,3,1,1,10,26,17,9,9,November,-0.5000000000000004,0.8660254037844384,27,25,2,1,2,2.0,1.8,26,9,17,13,14,-1,"November, 2015"
2015-2016,13,2015-11-21,Everton,Aston Villa,4,0,H,3,0,2,0,3,0,1,4,9,20,17,5,11,12,November,-0.5000000000000004,0.8660254037844384,18,1,3,1,1,2.4,1.4,20,16,4,10,20,-10,"November, 2015"
2015-2016,13,2015-11-21,Newcastle,Leicester,0,3,A,0,3,2,3,0,2,3,0,17,3,10,25,14,15,November,-0.5000000000000004,0.8660254037844384,30,24,2,2,1,1.0,1.0,13,22,-9,25,20,5,"November, 2015"
2015-2016,13,2015-11-22,Tottenham,West Ham,4,1,H,3,0,1,2,2,3,0,2,5,6,21,21,1,0,November,-0.5000000000000004,0.8660254037844384,42,45,2,1,2,1.2,1.8,20,10,10,23,16,7,"November, 2015"
2015-2016,13,2015-11-23,Crystal Palace,Sunderland,0,1,A,0,3,1,1,3,2,3,0,10,19,19,6,9,13,November,-0.5000000000000004,0.8660254037844384,16,40,2,1,1,2.0,1.25,14,12,2,13,26,-13,"November, 2015"
2015-2016,14,2015-11-28,Sunderland,Stoke,2,0,H,3,0,2,3,0,1,1,3,19,12,9,19,7,10,November,-0.5000000000000004,0.8660254037844384,40,39,2,2,1,1.2,1.0,14,26,-12,11,12,-1,"November, 2015"
2015-2016,14,2015-11-28,Leicester,Man United,1,1,D,1,1,2,3,0,3,1,1,1,2,28,27,1,1,November,-0.5000000000000004,0.8660254037844384,24,28,1,0,4,1.4,2.4,28,20,8,19,9,10,"November, 2015"
2015-2016,14,2015-11-28,Man City,Southampton,3,1,H,3,0,1,3,1,4,1,0,3,9,26,20,6,6,November,-0.5000000000000004,0.8660254037844384,27,38,3,1,1,2.2,1.0,27,13,14,19,14,5,"November, 2015"
2015-2016,14,2015-11-28,Bournemouth,Everton,3,3,D,1,1,0,1,4,2,0,3,19,7,9,20,12,11,November,-0.5000000000000004,0.8660254037844384,7,18,0,0,0,0.0,0.0,14,27,-13,24,16,8,"November, 2015"
2015-2016,14,2015-11-28,Aston Villa,Watford,2,3,A,0,3,0,1,4,1,1,3,20,13,5,16,7,11,November,-0.5000000000000004,0.8660254037844384,1,43,3,1,0,1.75,0.0,10,24,-14,12,14,-2,"November, 2015"
2015-2016,14,2015-11-28,Crystal Palace,Newcastle,5,1,H,3,0,1,1,3,2,3,0,10,17,19,10,7,9,November,-0.5000000000000004,0.8660254037844384,16,30,0,3,2,0.8,1.6,14,13,1,13,25,-12,"November, 2015"
2015-2016,14,2015-11-29,Liverpool,Swansea,1,0,H,3,0,1,3,1,2,1,2,10,14,20,14,4,6,November,-0.5000000000000004,0.8660254037844384,25,41,4,1,0,3.2,1.2,17,15,2,14,18,-4,"November, 2015"
2015-2016,14,2015-11-29,Norwich,Arsenal,1,1,D,1,1,1,0,4,3,2,0,16,4,12,26,12,14,November,-0.5000000000000004,0.8660254037844384,31,0,1,1,3,1.2,2.4,16,24,-8,23,11,12,"November, 2015"
2015-2016,14,2015-11-29,Tottenham,Chelsea,0,0,D,1,1,1,2,2,1,3,1,5,15,24,14,10,10,November,-0.5000000000000004,0.8660254037844384,42,14,1,2,2,1.6,2.6,24,11,13,17,23,-6,"November, 2015"
2015-2016,14,2015-11-29,West Ham,West Brom,1,1,D,1,1,3,0,2,0,3,2,9,13,21,17,4,4,November,-0.5000000000000004,0.8660254037844384,45,44,2,2,1,1.8,1.4,24,20,4,12,17,-5,"November, 2015"
2015-2016,15,2015-12-05,Swansea,Leicester,0,3,A,0,3,2,1,2,2,3,0,15,4,14,29,11,15,December,-2.4492935982947064e-16,1.0,41,24,1,0,1,1.0,1.0,14,19,-5,29,21,8,"December, 2015"
2015-2016,15,2015-12-05,Watford,Norwich,2,0,H,3,0,1,1,3,1,0,4,12,16,19,13,4,6,December,-2.4492935982947064e-16,1.0,43,31,0,0,0,0.0,0.0,15,16,-1,17,25,-8,"December, 2015"
2015-2016,15,2015-12-05,West Brom,Tottenham,1,1,D,1,1,0,3,2,1,2,2,13,5,18,25,8,7,December,-2.4492935982947064e-16,1.0,44,42,1,2,2,1.0,1.6,13,18,-5,24,11,13,"December, 2015"
2015-2016,15,2015-12-05,Stoke,Man City,2,0,H,3,0,1,1,3,1,3,1,12,2,19,29,10,10,December,-2.4492935982947064e-16,1.0,39,27,1,1,3,0.4,1.6,11,14,-3,30,14,16,"December, 2015"
2015-2016,15,2015-12-05,Chelsea,Bournemouth,0,1,A,0,3,1,3,1,0,1,4,14,18,15,10,4,5,December,-2.4492935982947064e-16,1.0,14,7,0,0,0,0.0,0.0,17,23,-6,17,30,-13,"December, 2015"
2015-2016,15,2015-12-05,Man United,West Ham,0,0,D,1,1,3,1,1,3,0,2,4,8,28,22,4,6,December,-2.4492935982947064e-16,1.0,28,45,3,2,0,2.0,1.0,20,10,10,25,21,4,"December, 2015"
2015-2016,15,2015-12-05,Arsenal,Sunderland,3,1,H,3,0,3,2,0,2,3,0,4,17,27,12,13,15,December,-2.4492935982947064e-16,1.0,0,40,4,1,0,2.0,0.4,24,12,12,16,26,-10,"December, 2015"
2015-2016,15,2015-12-05,Southampton,Aston Villa,1,1,D,1,1,4,1,0,0,1,4,10,20,20,5,10,15,December,-2.4492935982947064e-16,1.0,38,1,2,2,1,2.0,1.0,20,17,3,12,27,-15,"December, 2015"
2015-2016,15,2015-12-06,Newcastle,Liverpool,2,0,H,3,0,2,3,0,1,3,1,19,7,10,23,12,13,December,-2.4492935982947064e-16,1.0,30,25,1,1,3,0.8,2.4,14,30,-16,18,15,3,"December, 2015"
2015-2016,15,2015-12-07,Everton,Crystal Palace,1,1,D,1,1,2,0,3,1,1,3,11,8,21,22,3,1,December,-2.4492935982947064e-16,1.0,18,16,2,1,2,1.8,1.2,27,19,8,19,14,5,"December, 2015"
2015-2016,16,2015-12-12,West Ham,Stoke,0,0,D,1,1,3,0,2,1,1,3,9,11,23,22,2,1,December,-2.4492935982947064e-16,1.0,45,39,1,2,2,1.0,1.4,25,21,4,13,14,-1,"December, 2015"
2015-2016,16,2015-12-12,Sunderland,Watford,0,1,A,0,3,2,3,0,1,1,3,19,10,12,22,9,10,December,-2.4492935982947064e-16,1.0,40,43,2,0,0,2.5,1.0,17,29,-12,17,16,1,"December, 2015"
2015-2016,16,2015-12-12,Norwich,Everton,1,1,D,1,1,1,0,4,2,0,3,17,9,13,22,8,9,December,-2.4492935982947064e-16,1.0,31,18,1,3,1,1.4,1.6,17,27,-10,28,20,8,"December, 2015"
2015-2016,16,2015-12-12,Crystal Palace,Southampton,1,0,H,3,0,1,1,3,4,1,0,6,12,23,21,6,2,December,-2.4492935982947064e-16,1.0,16,38,0,1,4,0.6,1.8,20,15,5,21,18,3,"December, 2015"
2015-2016,16,2015-12-12,Bournemouth,Man United,2,1,H,3,0,0,1,4,3,1,1,17,4,13,29,13,16,December,-2.4492935982947064e-16,1.0,7,28,0,0,0,0.0,0.0,18,30,-12,20,10,10,"December, 2015"
2015-2016,16,2015-12-12,Man City,Swansea,2,1,H,3,0,1,3,1,2,1,2,3,16,29,14,13,15,December,-2.4492935982947064e-16,1.0,27,41,4,1,0,2.4,1.0,30,16,14,14,22,-8,"December, 2015"
2015-2016,16,2015-12-13,Aston Villa,Arsenal,0,2,A,0,3,0,1,4,3,2,0,20,3,6,30,17,24,December,-2.4492935982947064e-16,1.0,1,0,1,0,4,1.0,2.6,13,28,-15,27,13,14,"December, 2015"
2015-2016,16,2015-12-13,Liverpool,West Brom,2,2,D,1,1,1,3,1,0,3,2,10,13,23,19,3,4,December,-2.4492935982947064e-16,1.0,25,44,2,2,1,1.4,1.0,18,17,1,14,19,-5,"December, 2015"
2015-2016,16,2015-12-13,Tottenham,Newcastle,1,2,A,0,3,1,2,2,2,3,0,5,18,26,13,13,13,December,-2.4492935982947064e-16,1.0,42,30,3,0,2,2.0,1.0,25,12,13,16,30,-14,"December, 2015"
2015-2016,16,2015-12-14,Leicester,Chelsea,2,1,H,3,0,2,3,0,1,3,1,3,16,32,15,13,17,December,-2.4492935982947064e-16,1.0,24,14,0,0,5,0.8,2.8,32,21,11,17,24,-7,"December, 2015"
2015-2016,17,2015-12-19,Stoke,Crystal Palace,1,2,A,0,3,1,1,3,1,1,3,11,6,23,26,5,3,December,-2.4492935982947064e-16,1.0,39,16,1,1,2,1.0,1.25,13,14,-1,21,15,6,"December, 2015"
2015-2016,17,2015-12-19,West Brom,Bournemouth,1,2,A,0,3,0,3,2,0,1,4,13,17,20,16,4,4,December,-2.4492935982947064e-16,1.0,44,7,0,0,0,0.0,0.0,16,21,-5,20,31,-11,"December, 2015"
2015-2016,17,2015-12-19,Southampton,Tottenham,0,2,A,0,3,4,1,0,1,2,2,12,5,21,26,7,5,December,-2.4492935982947064e-16,1.0,38,42,0,1,4,1.2,2.0,21,19,2,26,14,12,"December, 2015"
2015-2016,17,2015-12-19,Newcastle,Aston Villa,1,1,D,1,1,2,3,0,0,1,4,17,20,16,6,3,10,December,-2.4492935982947064e-16,1.0,30,1,4,1,0,1.2,0.4,18,31,-13,13,30,-17,"December, 2015"
2015-2016,17,2015-12-19,Man United,Norwich,1,2,A,0,3,3,1,1,1,0,4,4,18,29,14,14,15,December,-2.4492935982947064e-16,1.0,28,31,4,0,1,2.2,0.4,21,12,9,18,28,-10,"December, 2015"
2015-2016,17,2015-12-19,Everton,Leicester,2,3,A,0,3,2,0,3,2,3,0,10,1,23,35,9,12,December,-2.4492935982947064e-16,1.0,18,24,1,4,0,2.0,1.8,29,21,8,34,22,12,"December, 2015"
2015-2016,17,2015-12-19,Chelsea,Sunderland,3,1,H,3,0,1,3,1,2,3,0,16,19,15,12,3,3,December,-2.4492935982947064e-16,1.0,14,40,3,1,1,2.0,1.4,18,26,-8,17,30,-13,"December, 2015"
2015-2016,17,2015-12-20,Swansea,West Ham,0,0,D,1,1,2,1,2,3,0,2,18,8,14,24,10,10,December,-2.4492935982947064e-16,1.0,41,45,0,2,3,0.4,1.4,15,24,-9,25,21,4,"December, 2015"
2015-2016,17,2015-12-20,Watford,Liverpool,3,0,H,3,0,1,1,3,1,3,1,8,9,25,24,1,1,December,-2.4492935982947064e-16,1.0,43,25,1,0,3,0.75,2.0,18,16,2,20,19,1,"December, 2015"
2015-2016,17,2015-12-21,Arsenal,Man City,2,1,H,3,0,3,2,0,1,3,1,2,3,33,32,1,1,December,-2.4492935982947064e-16,1.0,0,27,1,2,2,1.6,2.2,29,13,16,32,17,15,"December, 2015"
2015-2016,18,2015-12-26,Tottenham,Norwich,3,0,H,3,0,1,2,2,1,0,4,5,17,29,17,12,12,December,-2.4492935982947064e-16,1.0,42,31,1,2,2,1.0,1.0,28,14,14,20,29,-9,"December, 2015"
2015-2016,18,2015-12-26,Swansea,West Brom,1,0,H,3,0,2,1,2,0,3,2,18,13,15,20,5,5,December,-2.4492935982947064e-16,1.0,41,44,2,0,3,1.4,1.2,15,24,-9,17,23,-6,"December, 2015"
2015-2016,18,2015-12-26,Stoke,Man United,2,0,H,3,0,1,1,3,3,1,1,12,6,23,29,6,6,December,-2.4492935982947064e-16,1.0,39,28,1,1,3,1.2,1.8,14,16,-2,22,14,8,"December, 2015"
2015-2016,18,2015-12-26,Southampton,Arsenal,4,0,H,3,0,4,1,0,3,2,0,12,2,21,36,10,15,December,-2.4492935982947064e-16,1.0,38,0,1,2,2,1.0,1.2,21,21,0,31,14,17,"December, 2015"
2015-2016,18,2015-12-26,Newcastle,Everton,0,1,A,0,3,2,3,0,2,0,3,17,10,17,23,7,6,December,-2.4492935982947064e-16,1.0,30,18,1,0,4,1.2,2.6,19,32,-13,31,24,7,"December, 2015"
2015-2016,18,2015-12-26,Liverpool,Leicester,1,0,H,3,0,1,3,1,2,3,0,9,1,24,38,8,14,December,-2.4492935982947064e-16,1.0,25,24,3,2,0,1.6,0.8,20,22,-2,37,24,13,"December, 2015"
2015-2016,18,2015-12-26,Chelsea,Watford,2,2,D,1,1,1,3,1,1,1,3,15,7,18,28,8,10,December,-2.4492935982947064e-16,1.0,14,43,3,0,1,1.75,0.5,21,27,-6,21,16,5,"December, 2015"
2015-2016,18,2015-12-26,Bournemouth,Crystal Palace,0,0,D,1,1,0,1,4,1,1,3,14,6,19,29,8,10,December,-2.4492935982947064e-16,1.0,7,16,0,0,0,0.0,0.0,22,32,-10,23,16,7,"December, 2015"
2015-2016,18,2015-12-26,Aston Villa,West Ham,1,1,D,1,1,0,1,4,3,0,2,20,8,7,25,12,18,December,-2.4492935982947064e-16,1.0,1,45,2,2,1,0.6,0.6,14,31,-17,25,21,4,"December, 2015"
2015-2016,18,2015-12-26,Man City,Sunderland,4,1,H,3,0,1,3,1,2,3,0,3,19,32,12,16,20,December,-2.4492935982947064e-16,1.0,27,40,2,1,2,1.8,1.4,33,19,14,18,33,-15,"December, 2015"
2015-2016,19,2015-12-28,Watford,Tottenham,1,2,A,0,3,1,1,3,1,2,2,7,4,29,32,3,3,December,-2.4492935982947064e-16,1.0,43,42,0,2,2,0.5,2.0,23,18,5,31,14,17,"December, 2015"
2015-2016,19,2015-12-28,West Ham,Southampton,2,1,H,3,0,3,0,2,4,1,0,11,12,26,24,1,2,December,-2.4492935982947064e-16,1.0,45,38,1,3,1,1.0,1.0,26,22,4,25,21,4,"December, 2015"
2015-2016,19,2015-12-28,Norwich,Aston Villa,2,0,H,3,0,1,0,4,0,1,4,17,20,17,8,3,9,December,-2.4492935982947064e-16,1.0,31,1,1,1,3,1.0,1.6,20,32,-12,15,32,-17,"December, 2015"
2015-2016,19,2015-12-28,West Brom,Newcastle,1,0,H,3,0,0,3,2,2,3,0,14,18,20,17,4,3,December,-2.4492935982947064e-16,1.0,44,30,1,2,2,0.8,1.2,17,24,-7,19,33,-14,"December, 2015"
2015-2016,19,2015-12-28,Everton,Stoke,3,4,A,0,3,2,0,3,1,1,3,9,11,26,26,2,0,December,-2.4492935982947064e-16,1.0,18,39,2,1,2,1.2,0.8,32,24,8,16,16,0,"December, 2015"
2015-2016,19,2015-12-28,Arsenal,Bournemouth,2,0,H,3,0,3,2,0,0,1,4,2,14,36,20,12,16,December,-2.4492935982947064e-16,1.0,0,7,0,0,0,0.0,0.0,31,18,13,22,32,-10,"December, 2015"
2015-2016,19,2015-12-28,Man United,Chelsea,0,0,D,1,1,3,1,1,1,3,1,6,15,29,19,9,10,December,-2.4492935982947064e-16,1.0,28,14,0,2,3,0.4,1.2,22,16,6,23,29,-6,"December, 2015"
2015-2016,19,2015-12-28,Crystal Palace,Swansea,0,0,D,1,1,1,1,3,2,1,2,5,16,30,18,11,12,December,-2.4492935982947064e-16,1.0,16,41,1,2,1,0.75,1.0,23,16,7,16,24,-8,"December, 2015"
2015-2016,19,2015-12-29,Leicester,Man City,0,0,D,1,1,2,3,0,1,3,1,2,4,38,35,2,3,December,-2.4492935982947064e-16,1.0,24,27,1,1,3,1.0,1.2,37,25,12,37,20,17,"December, 2015"
2015-2016,19,2015-12-30,Sunderland,Liverpool,0,1,A,0,3,2,3,0,1,3,1,19,10,12,27,9,15,December,-2.4492935982947064e-16,1.0,40,25,0,1,4,0.4,1.8,19,37,-18,21,22,-1,"December, 2015"
2015-2016,20,2016-01-02,West Brom,Stoke,2,1,H,3,0,0,3,2,1,1,3,13,10,23,29,3,6,January,0.4999999999999999,0.8660254037844387,44,39,2,1,2,0.6,0.8,18,24,-6,20,19,1,"January, 2016"
2015-2016,20,2016-01-02,West Ham,Liverpool,2,0,H,3,0,3,0,2,1,3,1,8,7,29,30,1,1,January,0.4999999999999999,0.8660254037844387,45,25,2,0,3,1.6,1.8,28,23,5,22,22,0,"January, 2016"
2015-2016,20,2016-01-02,Watford,Man City,1,2,A,0,3,1,1,3,1,3,1,9,3,29,36,6,7,January,0.4999999999999999,0.8660254037844387,43,27,0,2,1,0.3333333333333333,1.0,24,20,4,37,20,17,"January, 2016"
2015-2016,20,2016-01-02,Sunderland,Aston Villa,3,1,H,3,0,2,3,0,0,1,4,19,20,12,8,1,4,January,0.4999999999999999,0.8660254037844387,40,1,0,3,2,0.4,1.4,19,38,-19,15,34,-19,"January, 2016"
2015-2016,20,2016-01-02,Man United,Swansea,2,1,H,3,0,3,1,1,2,1,2,6,17,30,19,11,11,January,0.4999999999999999,0.8660254037844387,28,41,2,0,3,1.8,1.4,22,16,6,16,24,-8,"January, 2016"
2015-2016,20,2016-01-02,Leicester,Bournemouth,0,0,D,1,1,2,3,0,0,1,4,2,16,39,20,14,19,January,0.4999999999999999,0.8660254037844387,24,7,0,1,0,1.0,1.0,37,25,12,22,34,-12,"January, 2016"
2015-2016,20,2016-01-02,Arsenal,Newcastle,1,0,H,3,0,3,2,0,2,3,0,1,18,39,17,17,22,January,0.4999999999999999,0.8660254037844387,0,30,5,0,0,2.2,0.4,33,18,15,19,34,-15,"January, 2016"
2015-2016,20,2016-01-02,Norwich,Southampton,1,0,H,3,0,1,0,4,4,1,0,16,12,20,24,4,4,January,0.4999999999999999,0.8660254037844387,31,38,1,2,2,0.8,1.6,22,32,-10,26,23,3,"January, 2016"
2015-2016,20,2016-01-03,Crystal Palace,Chelsea,0,3,A,0,3,1,1,3,1,3,1,7,16,31,20,9,11,January,0.4999999999999999,0.8660254037844387,16,14,2,0,3,1.0,1.2,23,16,7,23,29,-6,"January, 2016"
2015-2016,20,2016-01-03,Everton,Tottenham,1,1,D,1,1,2,0,3,1,2,2,11,4,26,35,7,9,January,0.4999999999999999,0.8660254037844387,18,42,0,2,3,0.2,0.8,35,28,7,33,15,18,"January, 2016"
2015-2016,21,2016-01-12,Aston Villa,Crystal Palace,1,0,H,3,0,0,1,4,1,1,3,20,7,8,31,13,23,January,0.4999999999999999,0.8660254037844387,1,16,1,1,3,0.4,0.8,16,37,-21,23,19,4,"January, 2016"
2015-2016,21,2016-01-12,Bournemouth,West Ham,1,3,A,0,3,0,1,4,3,0,2,16,6,21,32,10,11,January,0.4999999999999999,0.8660254037844387,7,45,1,0,0,4.0,3.0,22,34,-12,30,23,7,"January, 2016"
2015-2016,21,2016-01-12,Newcastle,Man United,3,3,D,1,1,2,3,0,3,1,1,18,6,17,33,12,16,January,0.4999999999999999,0.8660254037844387,30,28,1,1,3,0.4,1.6,19,35,-16,24,17,7,"January, 2016"
2015-2016,21,2016-01-13,Stoke,Norwich,3,1,H,3,0,1,1,3,1,0,4,10,15,29,23,5,6,January,0.4999999999999999,0.8660254037844387,39,31,1,2,2,0.6,0.8,21,21,0,23,32,-9,"January, 2016"
2015-2016,21,2016-01-13,Swansea,Sunderland,2,4,A,0,3,2,1,2,2,3,0,17,19,19,15,2,4,January,0.4999999999999999,0.8660254037844387,41,40,2,3,0,1.8,0.6,17,26,-9,22,39,-17,"January, 2016"
2015-2016,21,2016-01-13,Tottenham,Leicester,0,1,A,0,3,1,2,2,2,3,0,4,3,36,40,1,4,January,0.4999999999999999,0.8660254037844387,42,24,3,2,0,2.6,2.0,34,16,18,37,25,12,"January, 2016"
2015-2016,21,2016-01-13,Man City,Everton,0,0,D,1,1,1,3,1,2,0,3,3,11,39,27,8,12,January,0.4999999999999999,0.8660254037844387,27,18,4,1,0,2.0,0.8,39,21,18,36,29,7,"January, 2016"
2015-2016,21,2016-01-13,Liverpool,Arsenal,3,3,D,1,1,1,3,1,3,2,0,8,1,30,42,7,12,January,0.4999999999999999,0.8660254037844387,25,0,1,2,2,1.6,1.8,22,24,-2,34,18,16,"January, 2016"
2015-2016,21,2016-01-13,Chelsea,West Brom,2,2,D,1,1,1,3,1,0,3,2,14,12,23,26,2,3,January,0.4999999999999999,0.8660254037844387,14,44,2,2,1,1.6,1.6,26,29,-3,20,25,-5,"January, 2016"
2015-2016,21,2016-01-13,Southampton,Watford,2,0,H,3,0,4,1,0,1,1,3,13,9,24,29,4,5,January,0.4999999999999999,0.8660254037844387,38,43,1,1,1,1.3333333333333333,1.0,26,24,2,25,22,3,"January, 2016"
2015-2016,22,2016-01-16,Aston Villa,Leicester,1,1,D,1,1,0,1,4,2,3,0,20,2,11,43,18,32,January,0.4999999999999999,0.8660254037844387,1,24,3,0,2,2.4,1.2,17,37,-20,38,25,13,"January, 2016"
2015-2016,22,2016-01-16,Bournemouth,Norwich,3,0,H,3,0,0,1,4,1,0,4,16,15,21,23,1,2,January,0.4999999999999999,0.8660254037844387,7,31,0,0,1,1.0,3.0,23,37,-14,24,35,-11,"January, 2016"
2015-2016,22,2016-01-16,Chelsea,Everton,3,3,D,1,1,1,3,1,2,0,3,14,11,24,28,3,4,January,0.4999999999999999,0.8660254037844387,14,18,3,0,2,1.8,1.4,28,31,-3,36,29,7,"January, 2016"
2015-2016,22,2016-01-16,Man City,Crystal Palace,4,0,H,3,0,1,3,1,1,1,3,3,8,40,31,5,9,January,0.4999999999999999,0.8660254037844387,27,16,4,0,1,1.6,0.4,39,21,18,23,20,3,"January, 2016"
2015-2016,22,2016-01-16,Newcastle,West Ham,2,1,H,3,0,2,3,0,3,0,2,19,5,18,35,14,17,January,0.4999999999999999,0.8660254037844387,30,45,2,1,2,1.0,0.8,22,38,-16,33,24,9,"January, 2016"
2015-2016,22,2016-01-16,Southampton,West Brom,3,0,H,3,0,4,1,0,0,3,2,12,13,27,27,1,0,January,0.4999999999999999,0.8660254037844387,38,44,2,2,1,0.4,0.2,28,24,4,22,27,-5,"January, 2016"
2015-2016,22,2016-01-16,Tottenham,Sunderland,4,1,H,3,0,1,2,2,2,3,0,4,19,36,18,15,18,January,0.4999999999999999,0.8660254037844387,42,40,4,1,0,2.4,1.0,34,17,17,26,41,-15,"January, 2016"
2015-2016,22,2016-01-17,Stoke,Arsenal,0,0,D,1,1,1,1,3,3,2,0,7,3,32,43,4,11,January,0.4999999999999999,0.8660254037844387,39,0,2,0,3,1.0,2.0,24,22,2,37,21,16,"January, 2016"
2015-2016,22,2016-01-17,Liverpool,Man United,0,1,A,0,3,1,3,1,3,1,1,9,6,31,34,3,3,January,0.4999999999999999,0.8660254037844387,25,28,2,0,3,1.2,1.6,25,27,-2,27,20,7,"January, 2016"
2015-2016,22,2016-01-18,Swansea,Watford,1,0,H,3,0,2,1,2,1,1,3,18,12,19,29,6,10,January,0.4999999999999999,0.8660254037844387,41,43,0,0,1,0.0,1.0,19,30,-11,25,24,1,"January, 2016"
2015-2016,23,2016-01-23,Crystal Palace,Tottenham,1,3,A,0,3,1,1,3,1,2,2,8,4,31,39,4,8,January,0.4999999999999999,0.8660254037844387,16,42,1,1,3,0.4,1.0,23,24,-1,38,18,20,"January, 2016"
2015-2016,23,2016-01-23,Leicester,Stoke,3,0,H,3,0,2,3,0,1,1,3,2,7,44,33,5,11,January,0.4999999999999999,0.8660254037844387,24,39,1,1,1,1.0,1.0,39,26,13,24,22,2,"January, 2016"
2015-2016,23,2016-01-23,Man United,Southampton,0,1,A,0,3,3,1,1,4,1,0,5,10,37,30,5,7,January,0.4999999999999999,0.8660254037844387,28,38,2,2,1,1.4,1.2,28,20,8,31,24,7,"January, 2016"
2015-2016,23,2016-01-23,Norwich,Liverpool,4,5,A,0,3,1,0,4,1,3,1,16,9,23,31,7,8,January,0.4999999999999999,0.8660254037844387,31,25,0,1,4,1.2,3.8,24,38,-14,25,28,-3,"January, 2016"
2015-2016,23,2016-01-23,Sunderland,Bournemouth,1,1,D,1,1,2,3,0,0,1,4,19,15,18,24,4,6,January,0.4999999999999999,0.8660254037844387,40,7,0,0,1,0.0,2.0,27,45,-18,26,37,-11,"January, 2016"
2015-2016,23,2016-01-23,Watford,Newcastle,2,1,H,3,0,1,1,3,2,3,0,12,18,29,21,6,8,January,0.4999999999999999,0.8660254037844387,43,30,1,2,2,1.0,1.2,25,25,0,24,39,-15,"January, 2016"
2015-2016,23,2016-01-23,West Brom,Aston Villa,0,0,D,1,1,0,3,2,0,1,4,13,20,27,12,7,15,January,0.4999999999999999,0.8660254037844387,44,1,2,1,2,1.6,1.6,22,30,-8,18,38,-20,"January, 2016"
2015-2016,23,2016-01-23,West Ham,Man City,2,2,D,1,1,3,0,2,1,3,1,6,3,35,43,3,8,January,0.4999999999999999,0.8660254037844387,45,27,2,0,3,1.0,1.8,34,26,8,43,21,22,"January, 2016"
2015-2016,23,2016-01-24,Arsenal,Chelsea,0,1,A,0,3,3,2,0,1,3,1,3,14,44,25,11,19,January,0.4999999999999999,0.8660254037844387,0,14,0,2,3,0.0,2.0,37,21,16,31,34,-3,"January, 2016"
2015-2016,23,2016-01-24,Everton,Swansea,1,2,A,0,3,2,0,3,2,1,2,12,17,29,22,5,7,January,0.4999999999999999,0.8660254037844387,18,41,2,3,0,1.2,0.8,39,32,7,20,30,-10,"January, 2016"
2015-2016,24,2016-02-02,Crystal Palace,Bournemouth,1,2,A,0,3,1,1,3,0,1,4,11,16,31,25,5,6,February,0.8660254037844386,0.5000000000000001,16,7,0,1,0,0.0,0.0,24,27,-3,27,38,-11,"February, 2016"
2015-2016,24,2016-02-02,West Brom,Swansea,1,1,D,1,1,0,3,2,2,1,2,14,16,28,25,2,3,February,0.8660254037844386,0.5000000000000001,44,41,2,0,3,0.8,1.4,22,30,-8,22,31,-9,"February, 2016"
2015-2016,24,2016-02-02,West Ham,Aston Villa,2,0,H,3,0,3,0,2,0,1,4,6,20,36,13,14,23,February,0.8660254037844386,0.5000000000000001,45,1,1,3,1,0.6,0.4,36,28,8,18,38,-20,"February, 2016"
2015-2016,24,2016-02-02,Sunderland,Man City,0,1,A,0,3,2,3,0,1,3,1,19,4,19,44,15,25,February,0.8660254037844386,0.5000000000000001,40,27,1,1,3,1.4,2.6,28,46,-18,45,23,22,"February, 2016"
2015-2016,24,2016-02-02,Arsenal,Southampton,0,0,D,1,1,3,2,0,4,1,0,3,8,44,33,5,11,February,0.8660254037844386,0.5000000000000001,0,38,2,1,2,1.0,1.6,37,22,15,32,24,8,"February, 2016"
2015-2016,24,2016-02-02,Man United,Stoke,3,0,H,3,0,3,1,1,1,1,3,5,9,37,33,4,4,February,0.8660254037844386,0.5000000000000001,28,39,2,1,2,1.4,1.6,28,21,7,24,25,-1,"February, 2016"
2015-2016,24,2016-02-02,Norwich,Tottenham,0,3,A,0,3,1,0,4,1,2,2,17,4,23,42,13,19,February,0.8660254037844386,0.5000000000000001,31,42,1,2,2,0.6,1.4,28,43,-15,41,19,22,"February, 2016"
2015-2016,24,2016-02-02,Leicester,Liverpool,2,0,H,3,0,2,3,0,1,3,1,1,8,47,34,7,13,February,0.8660254037844386,0.5000000000000001,24,25,0,2,3,0.8,1.6,42,26,16,30,32,-2,"February, 2016"
2015-2016,24,2016-02-03,Everton,Newcastle,3,0,H,3,0,2,0,3,2,3,0,12,18,29,21,6,8,February,0.8660254037844386,0.5000000000000001,18,30,4,0,1,2.4,1.0,40,34,6,25,41,-16,"February, 2016"
2015-2016,24,2016-02-03,Watford,Chelsea,0,0,D,1,1,1,1,3,1,3,1,11,14,32,28,3,4,February,0.8660254037844386,0.5000000000000001,43,14,1,1,3,0.8,1.8,27,26,1,32,34,-2,"February, 2016"
2015-2016,25,2016-02-06,Swansea,Crystal Palace,1,1,D,1,1,2,1,2,1,1,3,16,12,26,31,4,5,February,0.8660254037844386,0.5000000000000001,41,16,1,3,1,0.8,0.6,23,32,-9,25,29,-4,"February, 2016"
2015-2016,25,2016-02-06,Stoke,Everton,0,3,A,0,3,1,1,3,2,0,3,10,11,33,32,1,1,February,0.8660254037844386,0.5000000000000001,39,18,3,1,1,1.6,1.6,24,28,-4,43,34,9,"February, 2016"
2015-2016,25,2016-02-06,Southampton,West Ham,1,0,H,3,0,4,1,0,3,0,2,8,6,34,39,2,5,February,0.8660254037844386,0.5000000000000001,38,45,1,2,2,1.0,1.2,32,24,8,38,28,10,"February, 2016"
2015-2016,25,2016-02-06,Tottenham,Watford,1,0,H,3,0,1,2,2,1,1,3,3,10,45,33,7,12,February,0.8660254037844386,0.5000000000000001,42,43,3,2,0,2.0,0.6,44,19,25,27,26,1,"February, 2016"
2015-2016,25,2016-02-06,Man City,Leicester,1,3,A,0,3,1,3,1,2,3,0,2,1,47,50,1,3,February,0.8660254037844386,0.5000000000000001,27,24,2,2,1,0.8,0.8,46,23,23,44,26,18,"February, 2016"
2015-2016,25,2016-02-06,Liverpool,Sunderland,2,2,D,1,1,1,3,1,2,3,0,8,19,34,19,11,15,February,0.8660254037844386,0.5000000000000001,25,40,4,1,0,1.4,0.4,30,34,-4,28,47,-19,"February, 2016"
2015-2016,25,2016-02-06,Aston Villa,Norwich,2,0,H,3,0,0,1,4,1,0,4,20,17,13,23,3,10,February,0.8660254037844386,0.5000000000000001,1,31,3,1,1,1.6,1.0,18,40,-22,28,46,-18,"February, 2016"
2015-2016,25,2016-02-06,Newcastle,West Brom,1,0,H,3,0,2,3,0,0,3,2,18,14,21,29,4,8,February,0.8660254037844386,0.5000000000000001,30,44,2,1,2,1.0,0.8,25,44,-19,23,31,-8,"February, 2016"
2015-2016,25,2016-02-07,Bournemouth,Arsenal,0,2,A,0,3,0,1,4,3,2,0,15,4,28,45,11,17,February,0.8660254037844386,0.5000000000000001,7,0,0,0,1,0.0,2.0,29,39,-10,37,22,15,"February, 2016"
2015-2016,25,2016-02-07,Chelsea,Man United,1,1,D,1,1,1,3,1,3,1,1,13,5,29,40,8,11,February,0.8660254037844386,0.5000000000000001,14,28,2,3,0,1.0,0.4,32,34,-2,31,21,10,"February, 2016"
2015-2016,26,2016-02-13,Swansea,Southampton,0,1,A,0,3,2,1,2,4,1,0,16,7,27,37,9,10,February,0.8660254037844386,0.5000000000000001,41,38,1,0,4,0.4,1.4,24,33,-9,33,24,9,"February, 2016"
2015-2016,26,2016-02-13,Bournemouth,Stoke,1,3,A,0,3,0,1,4,1,1,3,15,11,28,33,4,5,February,0.8660254037844386,0.5000000000000001,7,39,0,0,1,1.0,2.0,29,41,-12,24,31,-7,"February, 2016"
2015-2016,26,2016-02-13,Chelsea,Newcastle,5,1,H,3,0,1,3,1,2,3,0,13,17,30,24,4,6,February,0.8660254037844386,0.5000000000000001,14,30,2,1,2,1.6,1.2,33,35,-2,26,44,-18,"February, 2016"
2015-2016,26,2016-02-13,Crystal Palace,Watford,1,2,A,0,3,1,1,3,1,1,3,13,12,32,33,1,1,February,0.8660254037844386,0.5000000000000001,16,43,1,0,0,1.0,0.0,26,30,-4,27,27,0,"February, 2016"
2015-2016,26,2016-02-13,Everton,West Brom,0,1,A,0,3,2,0,3,0,3,2,10,14,35,29,4,6,February,0.8660254037844386,0.5000000000000001,18,44,2,3,0,1.2,0.6,46,34,12,23,32,-9,"February, 2016"
2015-2016,26,2016-02-13,Norwich,West Ham,2,2,D,1,1,1,0,4,3,0,2,18,6,23,39,12,16,February,0.8660254037844386,0.5000000000000001,31,45,1,2,2,1.2,1.4,28,48,-20,38,29,9,"February, 2016"
2015-2016,26,2016-02-13,Sunderland,Man United,2,1,H,3,0,2,3,0,3,1,1,19,5,20,41,14,21,February,0.8660254037844386,0.5000000000000001,40,28,1,1,3,0.6,1.6,30,49,-19,32,22,10,"February, 2016"
2015-2016,26,2016-02-14,Aston Villa,Liverpool,0,6,A,0,3,0,1,4,1,3,1,20,11,16,35,9,19,February,0.8660254037844386,0.5000000000000001,1,25,1,1,3,1.0,1.6,20,40,-20,32,36,-4,"February, 2016"
2015-2016,26,2016-02-14,Man City,Tottenham,1,2,A,0,3,1,3,1,1,2,2,4,3,47,48,1,1,February,0.8660254037844386,0.5000000000000001,27,42,4,0,1,3.4,1.2,47,26,21,45,19,26,"February, 2016"
2015-2016,26,2016-02-14,Arsenal,Leicester,2,1,H,3,0,3,2,0,2,3,0,3,1,48,53,2,5,February,0.8660254037844386,0.5000000000000001,0,24,3,2,0,2.2,1.2,39,22,17,47,27,20,"February, 2016"
2015-2016,27,2016-02-27,Leicester,Norwich,1,0,H,3,0,2,3,0,1,0,4,1,17,53,24,16,29,February,0.8660254037844386,0.5000000000000001,24,31,1,0,0,2.0,1.0,48,29,19,30,50,-20,"February, 2016"
2015-2016,27,2016-02-27,Southampton,Chelsea,1,2,A,0,3,4,1,0,1,3,1,6,12,40,33,6,7,February,0.8660254037844386,0.5000000000000001,38,14,1,2,2,1.2,1.8,34,24,10,38,36,2,"February, 2016"
2015-2016,27,2016-02-27,Stoke,Aston Villa,2,1,H,3,0,1,1,3,0,1,4,11,20,36,16,9,20,February,0.8660254037844386,0.5000000000000001,39,1,4,0,1,1.8,0.8,27,32,-5,20,46,-26,"February, 2016"
2015-2016,27,2016-02-27,Watford,Bournemouth,0,0,D,1,1,1,1,3,0,1,4,11,15,36,28,4,8,February,0.8660254037844386,0.5000000000000001,43,7,0,1,0,1.0,1.0,29,28,1,30,44,-14,"February, 2016"
2015-2016,27,2016-02-27,West Brom,Crystal Palace,3,2,H,3,0,0,3,2,1,1,3,14,13,32,32,1,0,February,0.8660254037844386,0.5000000000000001,44,16,2,1,2,1.4,1.4,24,32,-8,27,32,-5,"February, 2016"
2015-2016,27,2016-02-27,West Ham,Sunderland,1,0,H,3,0,3,0,2,2,3,0,6,19,40,23,13,17,February,0.8660254037844386,0.5000000000000001,45,40,2,3,0,1.2,0.8,40,31,9,32,50,-18,"February, 2016"
2015-2016,27,2016-02-28,Tottenham,Swansea,2,1,H,3,0,1,2,2,2,1,2,2,16,51,27,14,24,February,0.8660254037844386,0.5000000000000001,42,41,4,1,0,2.2,1.2,47,20,27,24,34,-10,"February, 2016"
2015-2016,27,2016-02-28,Man United,Arsenal,3,2,H,3,0,3,1,1,3,2,0,6,3,41,51,3,10,February,0.8660254037844386,0.5000000000000001,28,0,2,2,1,0.8,1.0,33,24,9,41,23,18,"February, 2016"
2015-2016,28,2016-03-01,Leicester,West Brom,2,2,D,1,1,2,3,0,0,3,2,1,13,56,35,12,21,March,1.0,6.123233995736766e-17,24,44,2,0,1,2.0,1.6666666666666667,49,29,20,27,34,-7,"March, 2016"
2015-2016,28,2016-03-01,Sunderland,Crystal Palace,2,2,D,1,1,2,3,0,1,1,3,19,14,23,32,5,9,March,1.0,6.123233995736766e-17,40,16,2,1,2,1.2,1.6,32,51,-19,29,35,-6,"March, 2016"
2015-2016,28,2016-03-01,Norwich,Chelsea,1,2,A,0,3,1,0,4,1,3,1,17,12,24,36,5,12,March,1.0,6.123233995736766e-17,31,14,0,1,4,0.4,1.8,30,51,-21,40,37,3,"March, 2016"
2015-2016,28,2016-03-01,Aston Villa,Everton,1,3,A,0,3,0,1,4,2,0,3,20,12,16,35,8,19,March,1.0,6.123233995736766e-17,1,18,1,0,4,0.8,2.6,21,48,-27,46,35,11,"March, 2016"
2015-2016,28,2016-03-01,Bournemouth,Southampton,2,0,H,3,0,0,1,4,4,1,0,15,7,29,40,8,11,March,1.0,6.123233995736766e-17,7,38,0,0,1,0.0,2.0,30,44,-14,35,26,9,"March, 2016"
2015-2016,28,2016-03-02,West Ham,Tottenham,1,0,H,3,0,3,0,2,1,2,2,6,2,43,54,4,11,March,1.0,6.123233995736766e-17,45,42,2,1,2,1.6,1.4,41,31,10,49,21,28,"March, 2016"
2015-2016,28,2016-03-02,Arsenal,Swansea,1,2,A,0,3,3,2,0,2,1,2,3,16,51,27,13,24,March,1.0,6.123233995736766e-17,0,41,2,1,2,1.6,1.2,43,26,17,25,36,-11,"March, 2016"
2015-2016,28,2016-03-02,Liverpool,Man City,3,0,H,3,0,1,3,1,1,3,1,11,4,38,47,7,9,March,1.0,6.123233995736766e-17,25,27,3,0,2,2.2,1.8,38,36,2,48,28,20,"March, 2016"
2015-2016,28,2016-03-02,Man United,Watford,1,0,H,3,0,3,1,1,1,1,3,5,12,44,37,7,7,March,1.0,6.123233995736766e-17,28,43,5,0,0,3.0,1.0,36,26,10,29,28,1,"March, 2016"
2015-2016,28,2016-03-02,Stoke,Newcastle,1,0,H,3,0,1,1,3,2,3,0,10,19,39,24,9,15,March,1.0,6.123233995736766e-17,39,30,2,2,1,0.8,1.2,29,33,-4,27,49,-22,"March, 2016"
2015-2016,29,2016-03-05,Tottenham,Arsenal,2,2,D,1,1,1,2,2,3,2,0,2,3,54,51,1,3,March,1.0,6.123233995736766e-17,42,0,1,2,2,0.8,1.0,49,22,27,44,28,16,"March, 2016"
2015-2016,29,2016-03-05,Swansea,Norwich,1,0,H,3,0,2,1,2,1,0,4,16,18,30,24,2,6,March,1.0,6.123233995736766e-17,41,31,1,2,2,1.8,1.6,27,37,-10,31,53,-22,"March, 2016"
2015-2016,29,2016-03-05,Watford,Leicester,0,1,A,0,3,1,1,3,2,3,0,12,1,37,57,11,20,March,1.0,6.123233995736766e-17,43,24,0,1,2,0.6666666666666666,1.3333333333333333,29,29,0,51,31,20,"March, 2016"
2015-2016,29,2016-03-05,Newcastle,Bournemouth,1,3,A,0,3,2,3,0,0,1,4,19,15,24,32,4,8,March,1.0,6.123233995736766e-17,30,7,1,0,0,1.0,0.0,27,50,-23,32,44,-12,"March, 2016"
2015-2016,29,2016-03-05,Everton,West Ham,2,3,A,0,3,2,0,3,3,0,2,11,6,38,46,5,8,March,1.0,6.123233995736766e-17,18,45,4,1,0,1.8,1.0,49,36,13,42,31,11,"March, 2016"
2015-2016,29,2016-03-05,Man City,Aston Villa,4,0,H,3,0,1,3,1,0,1,4,5,20,47,16,15,31,March,1.0,6.123233995736766e-17,27,1,3,1,1,2.2,1.0,48,31,17,22,51,-29,"March, 2016"
2015-2016,29,2016-03-05,Southampton,Sunderland,1,1,D,1,1,4,1,0,2,3,0,9,17,40,24,8,16,March,1.0,6.123233995736766e-17,38,40,2,2,1,2.6,1.0,35,28,7,34,53,-19,"March, 2016"
2015-2016,29,2016-03-05,Chelsea,Stoke,1,1,D,1,1,1,3,1,1,1,3,10,7,39,42,3,3,March,1.0,6.123233995736766e-17,14,39,3,0,2,1.8,1.0,42,38,4,30,33,-3,"March, 2016"
2015-2016,29,2016-03-06,Crystal Palace,Liverpool,1,2,A,0,3,1,1,3,1,3,1,15,9,33,41,6,8,March,1.0,6.123233995736766e-17,16,25,3,1,1,2.4,1.8,31,37,-6,41,36,5,"March, 2016"
2015-2016,29,2016-03-06,West Brom,Man United,1,0,H,3,0,0,3,2,3,1,1,13,6,36,47,7,11,March,1.0,6.123233995736766e-17,44,28,2,1,2,1.0,1.6,29,36,-7,37,26,11,"March, 2016"
2015-2016,30,2016-03-12,Bournemouth,Swansea,3,2,H,3,0,0,1,4,2,1,2,14,16,35,33,2,2,March,1.0,6.123233995736766e-17,7,41,0,1,0,2.0,2.0,35,45,-10,28,37,-9,"March, 2016"
2015-2016,30,2016-03-12,Norwich,Man City,0,0,D,1,1,1,0,4,1,3,1,18,4,24,50,14,26,March,1.0,6.123233995736766e-17,31,27,1,1,3,1.4,3.0,31,54,-23,52,31,21,"March, 2016"
2015-2016,30,2016-03-12,Stoke,Southampton,1,2,A,0,3,1,1,3,4,1,0,8,9,43,41,1,2,March,1.0,6.123233995736766e-17,39,38,2,2,1,1.2,1.0,31,34,-3,36,29,7,"March, 2016"
2015-2016,30,2016-03-13,Aston Villa,Tottenham,0,2,A,0,3,0,1,4,1,2,2,20,2,16,55,18,39,March,1.0,6.123233995736766e-17,1,42,1,0,4,0.6,2.0,22,55,-33,51,24,27,"March, 2016"
2015-2016,30,2016-03-14,Leicester,Newcastle,1,0,H,3,0,2,3,0,2,3,0,1,19,60,24,18,36,March,1.0,6.123233995736766e-17,24,30,2,1,2,1.6,1.0,52,31,21,28,53,-25,"March, 2016"
2015-2016,31,2016-03-19,Chelsea,West Ham,2,2,D,1,1,1,3,1,3,0,2,10,5,40,49,5,9,March,1.0,6.123233995736766e-17,14,45,3,1,1,1.4,0.4,43,39,4,45,33,12,"March, 2016"
2015-2016,31,2016-03-19,Crystal Palace,Leicester,0,1,A,0,3,1,1,3,2,3,0,15,1,33,63,14,30,March,1.0,6.123233995736766e-17,16,24,2,1,2,0.8,1.0,32,39,-7,53,31,22,"March, 2016"
2015-2016,31,2016-03-19,Everton,Arsenal,0,2,A,0,3,2,0,3,3,2,0,12,3,38,52,9,14,March,1.0,6.123233995736766e-17,18,0,1,2,2,1.4,1.4,51,39,12,46,30,16,"March, 2016"
2015-2016,31,2016-03-19,Swansea,Aston Villa,1,0,H,3,0,2,1,2,0,1,4,16,20,33,16,4,17,March,1.0,6.123233995736766e-17,41,1,4,1,0,1.8,0.6,30,40,-10,22,57,-35,"March, 2016"
2015-2016,31,2016-03-19,Watford,Stoke,1,2,A,0,3,1,1,3,1,1,3,14,9,37,43,5,6,March,1.0,6.123233995736766e-17,43,39,1,0,0,2.0,0.0,29,30,-1,32,36,-4,"March, 2016"
2015-2016,31,2016-03-19,West Brom,Norwich,0,1,A,0,3,0,3,2,1,0,4,11,18,39,25,7,14,March,1.0,6.123233995736766e-17,44,31,3,0,2,0.8,1.4,30,36,-6,31,54,-23,"March, 2016"
2015-2016,31,2016-03-20,Southampton,Liverpool,3,2,H,3,0,4,1,0,1,3,1,8,9,44,44,1,0,March,1.0,6.123233995736766e-17,38,25,1,1,3,0.6,1.6,38,30,8,43,37,6,"March, 2016"
2015-2016,31,2016-03-20,Tottenham,Bournemouth,3,0,H,3,0,1,2,2,0,1,4,2,13,58,38,11,20,March,1.0,6.123233995736766e-17,42,7,1,0,0,5.0,1.0,53,24,29,38,47,-9,"March, 2016"
2015-2016,31,2016-03-20,Man City,Man United,0,1,A,0,3,1,3,1,3,1,1,4,6,51,47,2,4,March,1.0,6.123233995736766e-17,27,28,3,1,1,2.0,1.0,52,31,21,37,27,10,"March, 2016"
2015-2016,31,2016-03-20,Newcastle,Sunderland,1,1,D,1,1,2,3,0,2,3,0,19,18,24,25,1,1,March,1.0,6.123233995736766e-17,30,40,0,0,5,0.2,2.0,28,54,-26,35,54,-19,"March, 2016"
2015-2016,32,2016-04-02,Arsenal,Watford,4,0,H,3,0,3,2,0,1,1,3,3,14,55,37,11,18,April,0.8660254037844388,-0.4999999999999998,0,43,5,0,0,2.4,0.6,48,30,18,30,32,-2,"April, 2016"
2015-2016,32,2016-04-02,Aston Villa,Chelsea,0,4,A,0,3,0,1,4,1,3,1,20,10,16,41,10,25,April,0.8660254037844388,-0.4999999999999998,1,14,1,0,4,0.6,1.8,22,58,-36,45,41,4,"April, 2016"
2015-2016,32,2016-04-02,Bournemouth,Man City,0,4,A,0,3,0,1,4,1,3,1,13,4,38,51,9,13,April,0.8660254037844388,-0.4999999999999998,7,27,0,0,1,1.0,5.0,38,50,-12,52,32,20,"April, 2016"
2015-2016,32,2016-04-02,Liverpool,Tottenham,1,1,D,1,1,1,3,1,1,2,2,10,2,44,61,8,17,April,0.8660254037844388,-0.4999999999999998,25,42,4,1,0,3.0,0.4,45,40,5,56,24,32,"April, 2016"
2015-2016,32,2016-04-02,Norwich,Newcastle,3,2,H,3,0,1,0,4,2,3,0,17,19,28,25,2,3,April,0.8660254037844388,-0.4999999999999998,31,30,0,2,3,0.6,1.8,32,54,-22,29,55,-26,"April, 2016"
2015-2016,32,2016-04-02,Stoke,Swansea,2,2,D,1,1,1,1,3,2,1,2,8,15,46,36,7,10,April,0.8660254037844388,-0.4999999999999998,39,41,2,2,1,1.4,1.4,34,37,-3,31,40,-9,"April, 2016"
2015-2016,32,2016-04-02,Sunderland,West Brom,0,0,D,1,1,2,3,0,0,3,2,18,11,26,39,7,13,April,0.8660254037844388,-0.4999999999999998,40,44,1,2,2,0.8,1.2,36,55,-19,30,37,-7,"April, 2016"
2015-2016,32,2016-04-02,West Ham,Crystal Palace,2,2,D,1,1,3,0,2,1,1,3,5,16,50,33,11,17,April,0.8660254037844388,-0.4999999999999998,45,16,2,0,3,1.4,1.4,47,35,12,32,40,-8,"April, 2016"
2015-2016,32,2016-04-03,Man United,Everton,1,0,H,3,0,3,1,1,2,0,3,6,12,50,38,6,12,April,0.8660254037844388,-0.4999999999999998,28,18,2,0,3,1.0,1.4,38,27,11,51,41,10,"April, 2016"
2015-2016,32,2016-04-03,Leicester,Southampton,1,0,H,3,0,2,3,0,4,1,0,1,7,66,47,6,19,April,0.8660254037844388,-0.4999999999999998,24,38,1,3,1,1.2,1.2,54,31,23,41,32,9,"April, 2016"
2015-2016,33,2016-04-09,Aston Villa,Bournemouth,1,2,A,0,3,0,1,4,0,1,4,20,13,16,38,7,22,April,0.8660254037844388,-0.4999999999999998,1,7,1,0,0,1.0,0.0,22,62,-40,38,54,-16,"April, 2016"
2015-2016,33,2016-04-09,Crystal Palace,Norwich,1,0,H,3,0,1,1,3,1,0,4,16,17,34,31,1,3,April,0.8660254037844388,-0.4999999999999998,16,31,1,3,1,1.6,1.4,34,42,-8,35,56,-21,"April, 2016"
2015-2016,33,2016-04-09,Man City,West Brom,2,1,H,3,0,1,3,1,0,3,2,4,12,54,40,8,14,April,0.8660254037844388,-0.4999999999999998,27,44,5,0,0,3.0,0.8,56,32,24,30,37,-7,"April, 2016"
2015-2016,33,2016-04-09,Southampton,Newcastle,3,1,H,3,0,4,1,0,2,3,0,7,19,47,25,12,22,April,0.8660254037844388,-0.4999999999999998,38,30,3,2,0,2.6,0.8,41,33,8,31,58,-27,"April, 2016"
2015-2016,33,2016-04-09,Swansea,Chelsea,1,0,H,3,0,2,1,2,1,3,1,16,10,37,44,6,7,April,0.8660254037844388,-0.4999999999999998,41,14,0,1,4,0.8,2.6,33,42,-9,49,41,8,"April, 2016"
2015-2016,33,2016-04-09,Watford,Everton,1,1,D,1,1,1,1,3,2,0,3,15,14,37,38,1,1,April,0.8660254037844388,-0.4999999999999998,43,18,0,1,4,1.2,2.8,30,36,-6,51,42,9,"April, 2016"
2015-2016,33,2016-04-09,West Ham,Arsenal,3,3,D,1,1,3,0,2,3,2,0,6,3,51,58,3,7,April,0.8660254037844388,-0.4999999999999998,45,0,1,0,4,1.0,2.2,49,37,12,52,30,22,"April, 2016"
2015-2016,33,2016-04-10,Liverpool,Stoke,4,1,H,3,0,1,3,1,1,1,3,9,8,45,47,1,2,April,0.8660254037844388,-0.4999999999999998,25,39,4,0,1,1.8,1.8,46,41,5,36,39,-3,"April, 2016"
2015-2016,33,2016-04-10,Sunderland,Leicester,0,2,A,0,3,2,3,0,2,3,0,18,1,27,69,17,42,April,0.8660254037844388,-0.4999999999999998,40,24,1,2,2,0.8,1.2,36,55,-19,55,31,24,"April, 2016"
2015-2016,33,2016-04-10,Tottenham,Man United,3,0,H,3,0,1,2,2,3,1,1,2,5,62,53,3,9,April,0.8660254037844388,-0.4999999999999998,42,28,1,2,2,0.8,1.4,57,25,32,39,27,12,"April, 2016"
2015-2016,33,2016-04-13,Crystal Palace,Everton,0,0,D,1,1,1,1,3,2,0,3,16,14,37,39,2,2,April,0.8660254037844388,-0.4999999999999998,16,18,2,2,1,1.4,1.2,35,42,-7,52,43,9,"April, 2016"
2015-2016,34,2016-04-16,Norwich,Sunderland,0,3,A,0,3,1,0,4,2,3,0,17,19,31,27,2,4,April,0.8660254037844388,-0.4999999999999998,31,40,3,2,0,1.6,0.6,35,57,-22,36,57,-21,"April, 2016"
2015-2016,34,2016-04-16,West Brom,Watford,0,1,A,0,3,0,3,2,1,1,3,13,15,40,38,2,2,April,0.8660254037844388,-0.4999999999999998,44,43,0,1,0,0.0,0.0,31,39,-8,31,37,-6,"April, 2016"
2015-2016,34,2016-04-16,Newcastle,Swansea,3,0,H,3,0,2,3,0,2,1,2,19,13,25,40,6,15,April,0.8660254037844388,-0.4999999999999998,30,41,0,1,4,1.0,2.4,32,61,-29,34,42,-8,"April, 2016"
2015-2016,34,2016-04-16,Everton,Southampton,1,1,D,1,1,2,0,3,4,1,0,12,7,40,50,5,10,April,0.8660254037844388,-0.4999999999999998,18,38,3,0,2,1.2,1.2,52,43,9,44,34,10,"April, 2016"
2015-2016,34,2016-04-16,Chelsea,Man City,0,3,A,0,3,1,3,1,1,3,1,10,4,44,57,6,13,April,0.8660254037844388,-0.4999999999999998,14,27,2,2,1,1.0,1.2,49,42,7,58,33,25,"April, 2016"
2015-2016,34,2016-04-16,Man United,Aston Villa,1,0,H,3,0,3,1,1,0,1,4,5,20,53,16,15,37,April,0.8660254037844388,-0.4999999999999998,28,1,4,1,0,2.4,0.6,39,30,9,23,64,-41,"April, 2016"
2015-2016,34,2016-04-17,Arsenal,Crystal Palace,1,1,D,1,1,3,2,0,1,1,3,4,16,59,38,12,21,April,0.8660254037844388,-0.4999999999999998,0,16,5,0,0,2.0,0.6,55,33,22,35,42,-7,"April, 2016"
2015-2016,34,2016-04-17,Bournemouth,Liverpool,1,2,A,0,3,0,1,4,1,3,1,13,8,41,48,5,7,April,0.8660254037844388,-0.4999999999999998,7,25,0,0,1,0.0,1.0,40,55,-15,50,42,8,"April, 2016"
2015-2016,34,2016-04-17,Leicester,West Ham,2,2,D,1,1,2,3,0,3,0,2,1,6,72,52,5,20,April,0.8660254037844388,-0.4999999999999998,24,45,2,1,2,1.0,1.2,57,31,26,52,40,12,"April, 2016"
2015-2016,34,2016-04-18,Stoke,Tottenham,0,4,A,0,3,1,1,3,1,2,2,9,2,47,65,7,18,April,0.8660254037844388,-0.4999999999999998,39,42,2,1,2,1.4,1.4,37,43,-6,60,25,35,"April, 2016"
2015-2016,34,2016-04-19,Newcastle,Man City,1,1,D,1,1,2,3,0,1,3,1,19,3,28,60,16,32,April,0.8660254037844388,-0.4999999999999998,30,27,0,0,5,0.2,3.8,35,61,-26,61,33,28,"April, 2016"
2015-2016,34,2016-04-20,Liverpool,Everton,4,0,H,3,0,1,3,1,2,0,3,8,11,51,41,3,10,April,0.8660254037844388,-0.4999999999999998,25,18,1,4,0,1.8,1.0,52,43,9,53,44,9,"April, 2016"
2015-2016,34,2016-04-20,Man United,Crystal Palace,2,0,H,3,0,3,1,1,1,1,3,5,16,56,39,11,17,April,0.8660254037844388,-0.4999999999999998,28,16,4,1,0,1.4,0.2,40,30,10,36,43,-7,"April, 2016"
2015-2016,34,2016-04-20,West Ham,Watford,3,1,H,3,0,3,0,2,1,1,3,7,12,53,41,5,12,April,0.8660254037844388,-0.4999999999999998,45,43,2,1,2,0.8,1.0,54,42,12,32,37,-5,"April, 2016"
2015-2016,34,2016-04-21,Arsenal,West Brom,2,0,H,3,0,3,2,0,0,3,2,4,14,60,40,10,20,April,0.8660254037844388,-0.4999999999999998,0,44,3,1,1,1.6,0.8,56,34,22,31,40,-9,"April, 2016"
2015-2016,35,2016-04-23,Aston Villa,Southampton,2,4,A,0,3,0,1,4,4,1,0,20,8,16,51,12,35,April,0.8660254037844388,-0.4999999999999998,1,38,1,3,1,1.2,2.0,23,65,-42,45,35,10,"April, 2016"
2015-2016,35,2016-04-23,Bournemouth,Chelsea,1,4,A,0,3,0,1,4,1,3,1,13,10,41,44,3,3,April,0.8660254037844388,-0.4999999999999998,7,14,1,0,0,1.0,0.0,41,57,-16,49,45,4,"April, 2016"
2015-2016,35,2016-04-23,Liverpool,Newcastle,2,2,D,1,1,1,3,1,2,3,0,7,19,54,29,12,25,April,0.8660254037844388,-0.4999999999999998,25,30,2,1,2,1.2,1.2,56,43,13,36,62,-26,"April, 2016"
2015-2016,35,2016-04-23,Man City,Stoke,4,0,H,3,0,1,3,1,1,1,3,4,10,61,47,6,14,April,0.8660254037844388,-0.4999999999999998,27,39,2,1,2,1.0,0.8,62,34,28,37,47,-10,"April, 2016"
2015-2016,35,2016-04-24,Leicester,Swansea,4,0,H,3,0,2,3,0,2,1,2,1,14,73,40,13,33,April,0.8660254037844388,-0.4999999999999998,24,41,2,0,1,1.6666666666666667,0.6666666666666666,59,33,26,34,45,-11,"April, 2016"
2015-2016,35,2016-04-24,Sunderland,Arsenal,0,0,D,1,1,2,3,0,3,2,0,18,4,30,63,14,33,April,0.8660254037844388,-0.4999999999999998,40,0,0,1,4,0.6,2.4,39,57,-18,58,34,24,"April, 2016"
2015-2016,35,2016-04-25,Tottenham,West Brom,1,1,D,1,1,1,2,2,0,3,2,2,14,68,40,12,28,April,0.8660254037844388,-0.4999999999999998,42,44,1,3,1,1.6,1.2,64,25,39,31,42,-11,"April, 2016"
2015-2016,36,2016-04-30,West Brom,West Ham,0,3,A,0,3,0,3,2,3,0,2,13,6,41,56,7,15,April,0.8660254037844388,-0.4999999999999998,44,45,1,3,1,1.4,1.4,32,43,-11,57,43,14,"April, 2016"
2015-2016,36,2016-04-30,Watford,Aston Villa,3,2,H,3,0,1,1,3,0,1,4,12,20,41,16,8,25,April,0.8660254037844388,-0.4999999999999998,43,1,1,1,3,0.6,1.8,33,40,-7,25,69,-44,"April, 2016"
2015-2016,36,2016-04-30,Stoke,Sunderland,1,1,D,1,1,1,1,3,2,3,0,10,18,47,31,8,16,April,0.8660254037844388,-0.4999999999999998,39,40,1,1,3,0.8,1.4,37,51,-14,39,57,-18,"April, 2016"
2015-2016,36,2016-04-30,Everton,Bournemouth,2,1,H,3,0,2,0,3,0,1,4,11,14,41,41,3,0,April,0.8660254037844388,-0.4999999999999998,18,7,0,1,0,3.0,3.0,53,48,5,42,61,-19,"April, 2016"
2015-2016,36,2016-04-30,Arsenal,Norwich,1,0,H,3,0,3,2,0,1,0,4,4,18,64,31,14,33,April,0.8660254037844388,-0.4999999999999998,0,31,3,1,1,2.0,0.8,58,34,24,35,60,-25,"April, 2016"
2015-2016,36,2016-04-30,Newcastle,Crystal Palace,1,0,H,3,0,2,3,0,1,1,3,19,16,30,39,3,9,April,0.8660254037844388,-0.4999999999999998,30,16,2,2,1,1.8,1.8,38,64,-26,36,45,-9,"April, 2016"
2015-2016,36,2016-05-01,Man United,Leicester,1,1,D,1,1,3,1,1,2,3,0,6,1,59,76,5,17,May,0.4999999999999999,-0.8660254037844387,28,24,3,1,1,2.4,1.6,42,30,12,63,33,30,"May, 2016"
2015-2016,36,2016-05-01,Southampton,Man City,4,2,H,3,0,4,1,0,1,3,1,8,4,54,64,4,10,May,0.4999999999999999,-0.8660254037844387,38,27,0,1,4,0.6,2.6,49,37,12,66,34,32,"May, 2016"
2015-2016,36,2016-05-01,Swansea,Liverpool,3,1,H,3,0,2,1,2,1,3,1,15,8,40,55,7,15,May,0.4999999999999999,-0.8660254037844387,41,25,0,1,4,1.2,2.4,34,49,-15,58,45,13,"May, 2016"
2015-2016,36,2016-05-02,Chelsea,Tottenham,2,2,D,1,1,1,3,1,1,2,2,10,2,47,69,8,22,May,0.4999999999999999,-0.8660254037844387,14,42,2,2,1,2.2,1.2,53,46,7,65,26,39,"May, 2016"
2015-2016,37,2016-05-07,Crystal Palace,Stoke,2,1,H,3,0,1,1,3,1,1,3,16,10,39,48,6,9,May,0.4999999999999999,-0.8660254037844387,16,39,3,1,1,1.4,1.0,36,46,-10,38,52,-14,"May, 2016"
2015-2016,37,2016-05-07,Aston Villa,Newcastle,0,0,D,1,1,0,1,4,2,3,0,20,17,16,33,3,17,May,0.4999999999999999,-0.8660254037844387,1,30,0,2,3,0.4,1.0,27,72,-45,39,64,-25,"May, 2016"
2015-2016,37,2016-05-07,Bournemouth,West Brom,1,1,D,1,1,0,1,4,0,3,2,15,14,41,41,1,0,May,0.4999999999999999,-0.8660254037844387,7,44,1,0,0,2.0,1.0,43,63,-20,32,46,-14,"May, 2016"
2015-2016,37,2016-05-07,Leicester,Everton,3,1,H,3,0,2,3,0,2,0,3,1,11,77,44,10,33,May,0.4999999999999999,-0.8660254037844387,24,18,1,3,1,2.0,2.0,64,34,30,55,49,6,"May, 2016"
2015-2016,37,2016-05-07,Norwich,Man United,0,1,A,0,3,1,0,4,3,1,1,19,5,31,60,14,29,May,0.4999999999999999,-0.8660254037844387,31,28,2,0,3,0.6,2.0,35,61,-26,43,31,12,"May, 2016"
2015-2016,37,2016-05-07,Sunderland,Chelsea,3,2,H,3,0,2,3,0,1,3,1,18,9,32,48,9,16,May,0.4999999999999999,-0.8660254037844387,40,14,1,1,3,1.4,2.2,40,58,-18,55,48,7,"May, 2016"
2015-2016,37,2016-05-07,West Ham,Swansea,1,4,A,0,3,3,0,2,2,1,2,6,13,59,43,7,16,May,0.4999999999999999,-0.8660254037844387,45,41,2,3,0,1.2,0.4,60,43,17,37,50,-13,"May, 2016"
2015-2016,37,2016-05-08,Liverpool,Watford,2,0,H,3,0,1,3,1,1,1,3,8,13,55,44,5,11,May,0.4999999999999999,-0.8660254037844387,25,43,3,0,2,1.6,1.2,59,48,11,36,42,-6,"May, 2016"
2015-2016,37,2016-05-08,Man City,Arsenal,2,2,D,1,1,1,3,1,3,2,0,4,3,64,67,1,3,May,0.4999999999999999,-0.8660254037844387,27,0,1,2,2,2.0,2.0,68,38,30,59,34,25,"May, 2016"
2015-2016,37,2016-05-08,Tottenham,Southampton,1,2,A,0,3,1,2,2,4,1,0,2,8,70,57,6,13,May,0.4999999999999999,-0.8660254037844387,42,38,4,1,0,2.2,1.2,67,28,39,53,39,14,"May, 2016"
2015-2016,37,2016-05-10,West Ham,Man United,3,2,H,3,0,3,0,2,3,1,1,7,5,59,63,2,4,May,0.4999999999999999,-0.8660254037844387,45,28,0,2,3,0.6,1.6,61,47,14,44,31,13,"May, 2016"
2015-2016,37,2016-05-11,Norwich,Watford,4,2,H,3,0,1,0,4,1,1,3,19,13,31,44,6,13,May,0.4999999999999999,-0.8660254037844387,31,43,0,0,1,0.0,2.0,35,62,-27,36,44,-8,"May, 2016"
2015-2016,37,2016-05-11,Sunderland,Everton,3,0,H,3,0,2,3,0,2,0,3,17,12,35,44,5,9,May,0.4999999999999999,-0.8660254037844387,40,18,2,1,2,1.2,1.6,43,60,-17,56,52,4,"May, 2016"
2015-2016,37,2016-05-11,Liverpool,Chelsea,1,1,D,1,1,1,3,1,1,3,1,8,9,58,48,1,10,May,0.4999999999999999,-0.8660254037844387,25,14,1,1,3,1.2,1.6,61,48,13,57,51,6,"May, 2016"
2015-2016,38,2016-05-15,Watford,Sunderland,2,2,D,1,1,1,1,3,2,3,0,13,17,44,38,4,6,May,0.4999999999999999,-0.8660254037844387,43,40,1,0,2,1.0,1.6666666666666667,38,48,-10,46,60,-14,"May, 2016"
2015-2016,38,2016-05-15,Swansea,Man City,1,1,D,1,1,2,1,2,1,3,1,12,4,46,65,8,19,May,0.4999999999999999,-0.8660254037844387,41,27,0,0,5,1.2,2.8,41,51,-10,70,40,30,"May, 2016"
2015-2016,38,2016-05-15,Stoke,West Ham,2,1,H,3,0,1,1,3,3,0,2,10,7,48,62,3,14,May,0.4999999999999999,-0.8660254037844387,39,45,2,3,0,1.4,0.8,39,54,-15,64,49,15,"May, 2016"
2015-2016,38,2016-05-15,Southampton,Crystal Palace,4,1,H,3,0,4,1,0,1,1,3,7,14,60,42,7,18,May,0.4999999999999999,-0.8660254037844387,38,16,4,0,1,1.4,0.4,55,40,15,38,47,-9,"May, 2016"
2015-2016,38,2016-05-15,West Brom,Liverpool,1,1,D,1,1,0,3,2,1,3,1,15,8,42,59,7,17,May,0.4999999999999999,-0.8660254037844387,44,25,0,3,2,1.0,1.8,33,47,-14,62,49,13,"May, 2016"
2015-2016,38,2016-05-15,Everton,Norwich,3,0,H,3,0,2,0,3,1,0,4,12,19,44,34,7,10,May,0.4999999999999999,-0.8660254037844387,18,31,1,3,1,1.4,1.2,56,55,1,39,64,-25,"May, 2016"
2015-2016,38,2016-05-15,Chelsea,Leicester,1,1,D,1,1,1,3,1,2,3,0,9,1,49,80,8,31,May,0.4999999999999999,-0.8660254037844387,14,24,4,0,1,2.4,0.8,58,52,6,67,35,32,"May, 2016"
2015-2016,38,2016-05-15,Arsenal,Aston Villa,4,0,H,3,0,3,2,0,0,1,4,3,20,68,17,17,51,May,0.4999999999999999,-0.8660254037844387,0,1,4,0,1,2.6,0.8,61,36,25,27,72,-45,"May, 2016"
2015-2016,38,2016-05-15,Newcastle,Tottenham,5,1,H,3,0,2,3,0,1,2,2,18,3,34,70,15,36,May,0.4999999999999999,-0.8660254037844387,30,42,3,0,2,1.2,1.8,39,64,-25,68,30,38,"May, 2016"
2015-2016,38,2016-05-17,Man United,Bournemouth,3,1,H,3,0,3,1,1,0,1,4,6,16,63,42,10,21,May,0.4999999999999999,-0.8660254037844387,28,7,0,0,1,1.0,2.0,46,34,12,44,64,-20,"May, 2016"
2016-2017,1,2016-08-13,Burnley,Swansea,0,1,A,0,3,1,1,3,4,1,0,3,16,0,0,13,0,August,-0.8660254037844384,-0.5000000000000004,11,41,0,0,2,0.0,1.0,0,0,0,0,0,0,"August, 2016"
2016-2017,1,2016-08-13,Crystal Palace,West Brom,0,1,A,0,3,1,0,4,0,1,4,5,18,0,0,13,0,August,-0.8660254037844384,-0.5000000000000004,16,44,2,1,2,1.8,1.6,0,0,0,0,0,0,"August, 2016"
2016-2017,1,2016-08-13,Everton,Tottenham,1,1,D,1,1,1,1,3,4,0,1,6,16,0,0,10,0,August,-0.8660254037844384,-0.5000000000000004,18,42,0,2,3,0.4,1.0,0,0,0,0,0,0,"August, 2016"
2016-2017,1,2016-08-13,Hull,Leicester,2,1,H,3,0,1,1,3,2,1,2,8,9,0,0,1,0,August,-0.8660254037844384,-0.5000000000000004,21,24,0,1,1,0.0,0.5,0,0,0,0,0,0,"August, 2016"
2016-2017,1,2016-08-13,Man City,Sunderland,2,1,H,3,0,4,1,0,1,0,4,10,15,0,0,5,0,August,-0.8660254037844384,-0.5000000000000004,27,40,4,1,0,2.8,1.2,0,0,0,0,0,0,"August, 2016"
2016-2017,1,2016-08-13,Middlesbrough,Stoke,1,1,D,1,1,1,1,3,1,2,2,12,14,0,0,2,0,August,-0.8660254037844384,-0.5000000000000004,29,39,1,0,1,1.0,1.0,0,0,0,0,0,0,"August, 2016"
2016-2017,1,2016-08-13,Southampton,Watford,1,1,D,1,1,1,2,2,0,0,5,14,15,0,0,1,0,August,-0.8660254037844384,-0.5000000000000004,38,43,2,1,1,1.5,0.75,0,0,0,0,0,0,"August, 2016"
2016-2017,1,2016-08-14,Arsenal,Liverpool,3,4,A,0,3,5,0,0,3,1,1,11,14,0,0,3,0,August,-0.8660254037844384,-0.5000000000000004,0,25,1,3,1,2.0,2.2,0,0,0,0,0,0,"August, 2016"
2016-2017,1,2016-08-14,Bournemouth,Man United,1,3,A,0,3,3,2,0,1,2,2,12,14,0,0,2,0,August,-0.8660254037844384,-0.5000000000000004,7,28,1,0,1,1.5,2.0,0,0,0,0,0,0,"August, 2016"
2016-2017,1,2016-08-15,Chelsea,West Ham,2,1,H,3,0,5,0,0,2,2,1,13,14,0,0,1,0,August,-0.8660254037844384,-0.5000000000000004,14,45,2,2,1,1.2,0.8,0,0,0,0,0,0,"August, 2016"
2016-2017,2,2016-08-19,Man United,Southampton,2,0,H,3,0,1,2,2,1,2,2,1,10,3,1,9,2,August,-0.8660254037844384,-0.5000000000000004,28,38,2,1,2,1.2,1.2,3,1,2,1,1,0,"August, 2016"
2016-2017,2,2016-08-20,Burnley,Liverpool,2,0,H,3,0,1,1,3,3,1,1,18,2,0,3,16,3,August,-0.8660254037844384,-0.5000000000000004,11,25,0,0,4,0.0,2.75,0,1,-1,4,3,1,"August, 2016"
2016-2017,2,2016-08-20,Leicester,Arsenal,0,0,D,1,1,2,1,2,5,0,0,16,15,0,0,1,0,August,-0.8660254037844384,-0.5000000000000004,24,0,0,1,4,1.2,2.4,1,2,-1,3,4,-1,"August, 2016"
2016-2017,2,2016-08-20,Stoke,Man City,1,4,A,0,3,1,2,2,4,1,0,11,5,1,3,6,2,August,-0.8660254037844384,-0.5000000000000004,39,27,2,0,3,0.8,1.8,1,1,0,2,1,1,"August, 2016"
2016-2017,2,2016-08-20,Swansea,Hull,0,2,A,0,3,4,1,0,1,1,3,6,5,3,3,1,0,August,-0.8660254037844384,-0.5000000000000004,41,21,2,1,1,1.25,0.75,1,0,1,2,1,1,"August, 2016"
2016-2017,2,2016-08-20,Tottenham,Crystal Palace,1,0,H,3,0,4,0,1,1,0,4,11,19,1,0,8,1,August,-0.8660254037844384,-0.5000000000000004,42,16,3,1,1,1.4,0.6,1,1,0,0,1,-1,"August, 2016"
2016-2017,2,2016-08-20,Watford,Chelsea,1,2,A,0,3,0,0,5,5,0,0,12,6,1,3,6,2,August,-0.8660254037844384,-0.5000000000000004,43,14,0,2,3,0.6,1.8,1,1,0,2,1,1,"August, 2016"
2016-2017,2,2016-08-20,West Brom,Everton,1,2,A,0,3,0,1,4,1,1,3,7,10,3,1,3,2,August,-0.8660254037844384,-0.5000000000000004,44,18,1,2,2,0.8,1.2,1,0,1,1,1,0,"August, 2016"
2016-2017,3,2016-08-21,West Ham,Bournemouth,1,0,H,3,0,2,2,1,3,2,0,17,19,0,0,2,0,August,-0.8660254037844384,-0.5000000000000004,45,7,1,0,1,3.0,2.5,1,2,-1,1,3,-2,"August, 2016"
2016-2017,2,2016-08-21,Sunderland,Middlesbrough,1,2,A,0,3,1,0,4,1,1,3,17,11,0,1,6,1,August,-0.8660254037844384,-0.5000000000000004,40,29,2,2,1,1.6,1.6,1,2,-1,1,1,0,"August, 2016"
2016-2017,3,2016-08-27,Chelsea,Burnley,3,0,H,3,0,5,0,0,1,1,3,4,8,6,3,4,3,August,-0.8660254037844384,-0.5000000000000004,14,11,3,1,0,2.25,0.75,4,2,2,2,1,1,"August, 2016"
2016-2017,3,2016-08-27,Crystal Palace,Bournemouth,1,1,D,1,1,1,0,4,3,2,0,19,20,0,0,1,0,August,-0.8660254037844384,-0.5000000000000004,16,7,0,1,1,0.5,1.0,0,2,-2,1,4,-3,"August, 2016"
2016-2017,3,2016-08-27,Everton,Stoke,1,0,H,3,0,1,1,3,1,2,2,5,19,4,1,14,3,August,-0.8660254037844384,-0.5000000000000004,18,39,1,1,3,1.4,1.6,3,2,1,2,5,-3,"August, 2016"
2016-2017,3,2016-08-27,Hull,Man United,0,1,A,0,3,1,1,3,1,2,2,5,4,6,6,1,0,August,-0.8660254037844384,-0.5000000000000004,21,28,0,1,4,0.6,2.6,4,1,3,5,1,4,"August, 2016"
2016-2017,3,2016-08-27,Leicester,Swansea,2,1,H,3,0,2,1,2,4,1,0,15,11,1,3,4,2,August,-0.8660254037844384,-0.5000000000000004,24,41,3,0,1,2.25,0.5,1,2,-1,1,2,-1,"August, 2016"
2016-2017,3,2016-08-27,Southampton,Sunderland,1,1,D,1,1,1,2,2,1,0,4,17,20,1,0,3,1,August,-0.8660254037844384,-0.5000000000000004,38,40,2,2,1,2.6,1.0,1,3,-2,2,4,-2,"August, 2016"
2016-2017,3,2016-08-27,Tottenham,Liverpool,1,1,D,1,1,4,0,1,3,1,1,7,11,4,3,4,1,August,-0.8660254037844384,-0.5000000000000004,42,25,0,2,3,0.6,2.2,2,1,1,4,5,-1,"August, 2016"
2016-2017,3,2016-08-27,Watford,Arsenal,1,3,A,0,3,0,0,5,5,0,0,16,15,1,1,1,0,August,-0.8660254037844384,-0.5000000000000004,43,0,0,0,5,0.6,3.0,2,3,-1,3,4,-1,"August, 2016"
2016-2017,3,2016-08-28,West Brom,Middlesbrough,0,0,D,1,1,0,1,4,1,1,3,11,8,3,4,3,1,August,-0.8660254037844384,-0.5000000000000004,44,29,2,1,2,1.2,1.6,2,2,0,3,2,1,"August, 2016"
2016-2017,3,2016-08-28,Man City,West Ham,3,1,H,3,0,4,1,0,2,2,1,4,12,6,3,8,3,August,-0.8660254037844384,-0.5000000000000004,27,45,2,1,2,1.6,1.2,6,2,4,2,2,0,"August, 2016"
2016-2017,4,2016-09-10,Stoke,Tottenham,0,4,A,0,3,1,2,2,4,0,1,20,8,1,5,12,4,September,-1.0,-1.8369701987210287e-16,39,42,2,1,2,1.4,1.6,2,6,-4,3,2,1,"September, 2016"
2016-2017,4,2016-09-10,Burnley,Hull,1,1,D,1,1,1,1,3,1,1,3,14,6,3,6,8,3,September,-1.0,-1.8369701987210287e-16,11,21,4,0,0,2.0,0.25,2,4,-2,4,2,2,"September, 2016"
2016-2017,4,2016-09-10,West Ham,Watford,2,4,A,0,3,2,2,1,0,0,5,15,19,3,1,4,2,September,-1.0,-1.8369701987210287e-16,45,43,2,1,2,1.2,1.2,3,5,-2,3,6,-3,"September, 2016"
2016-2017,4,2016-09-10,Middlesbrough,Crystal Palace,1,2,A,0,3,1,1,3,1,0,4,8,18,5,1,10,4,September,-1.0,-1.8369701987210287e-16,29,16,2,0,0,1.5,0.5,3,2,1,1,3,-2,"September, 2016"
2016-2017,4,2016-09-10,Bournemouth,West Brom,1,0,H,3,0,3,2,0,0,1,4,19,10,1,4,9,3,September,-1.0,-1.8369701987210287e-16,7,44,1,1,0,1.5,1.0,2,5,-3,2,2,0,"September, 2016"
2016-2017,4,2016-09-10,Liverpool,Leicester,4,1,H,3,0,3,1,1,2,1,2,10,9,4,4,1,0,September,-1.0,-1.8369701987210287e-16,25,24,2,2,1,1.2,1.0,5,6,-1,3,3,0,"September, 2016"
2016-2017,4,2016-09-10,Man United,Man City,1,2,A,0,3,1,2,2,4,1,0,3,1,9,9,2,0,September,-1.0,-1.8369701987210287e-16,28,27,2,1,2,1.0,1.2,6,1,5,9,3,6,"September, 2016"
2016-2017,4,2016-09-10,Arsenal,Southampton,2,1,H,3,0,5,0,0,1,2,2,8,15,4,2,7,2,September,-1.0,-1.8369701987210287e-16,0,38,1,2,2,0.6,1.6,6,5,1,2,4,-2,"September, 2016"
2016-2017,4,2016-09-11,Swansea,Chelsea,2,2,D,1,1,4,1,0,5,0,0,16,2,3,9,14,6,September,-1.0,-1.8369701987210287e-16,41,14,1,1,3,1.0,2.4,2,4,-2,7,2,5,"September, 2016"
2016-2017,4,2016-09-12,Sunderland,Everton,0,3,A,0,3,1,0,4,1,1,3,19,8,1,7,11,6,September,-1.0,-1.8369701987210287e-16,40,18,2,1,2,1.6,1.6,3,5,-2,4,2,2,"September, 2016"
2016-2017,5,2016-09-16,Chelsea,Liverpool,1,2,A,0,3,5,0,0,3,1,1,2,6,10,7,4,3,September,-1.0,-1.8369701987210287e-16,14,25,2,2,1,1.4,1.2,9,4,5,9,7,2,"September, 2016"
2016-2017,5,2016-09-17,West Brom,West Ham,4,2,H,3,0,0,1,4,2,2,1,13,17,4,3,4,1,September,-1.0,-1.8369701987210287e-16,44,45,1,2,2,0.8,1.4,2,3,-1,5,9,-4,"September, 2016"
2016-2017,5,2016-09-17,Man City,Bournemouth,4,0,H,3,0,4,1,0,3,2,0,2,15,12,4,13,8,September,-1.0,-1.8369701987210287e-16,27,7,2,0,0,4.5,0.5,11,4,7,3,5,-2,"September, 2016"
2016-2017,5,2016-09-17,Leicester,Burnley,3,0,H,3,0,2,1,2,1,1,3,16,15,4,4,1,0,September,-1.0,-1.8369701987210287e-16,24,11,1,1,0,1.5,1.0,4,7,-3,3,5,-2,"September, 2016"
2016-2017,5,2016-09-17,Hull,Arsenal,1,4,A,0,3,1,1,3,5,0,0,8,7,7,7,1,0,September,-1.0,-1.8369701987210287e-16,21,0,0,1,4,0.8,2.4,5,3,2,8,6,2,"September, 2016"
2016-2017,5,2016-09-17,Everton,Middlesbrough,3,1,H,3,0,1,1,3,1,1,3,2,9,10,5,7,5,September,-1.0,-1.8369701987210287e-16,18,29,3,2,0,1.2,0.2,7,2,5,4,4,0,"September, 2016"
2016-2017,5,2016-09-18,Crystal Palace,Stoke,4,1,H,3,0,1,0,4,1,2,2,13,20,4,1,7,3,September,-1.0,-1.8369701987210287e-16,16,39,4,1,0,1.6,0.8,3,4,-1,2,10,-8,"September, 2016"
2016-2017,5,2016-09-18,Southampton,Swansea,1,0,H,3,0,1,2,2,4,1,0,18,14,2,4,4,2,September,-1.0,-1.8369701987210287e-16,38,41,4,0,1,1.2,0.4,3,6,-3,4,6,-2,"September, 2016"
2016-2017,5,2016-09-18,Tottenham,Sunderland,1,0,H,3,0,4,0,1,1,0,4,7,19,8,1,12,7,September,-1.0,-1.8369701987210287e-16,42,40,4,1,0,2.8,1.0,7,2,5,3,8,-5,"September, 2016"
2016-2017,5,2016-09-18,Watford,Man United,3,1,H,3,0,0,0,5,1,2,2,14,7,4,9,7,5,September,-1.0,-1.8369701987210287e-16,43,28,0,0,5,0.8,2.4,7,8,-1,7,3,4,"September, 2016"
2016-2017,6,2016-09-24,Swansea,Man City,1,3,A,0,3,4,1,0,4,1,0,16,1,4,15,15,11,September,-1.0,-1.8369701987210287e-16,41,27,0,1,4,1.4,2.4,4,7,-3,15,4,11,"September, 2016"
2016-2017,6,2016-09-24,Sunderland,Crystal Palace,2,3,A,0,3,1,0,4,1,0,4,20,9,1,7,11,6,September,-1.0,-1.8369701987210287e-16,40,16,2,2,1,1.4,1.4,3,9,-6,7,5,2,"September, 2016"
2016-2017,6,2016-09-24,Middlesbrough,Tottenham,1,2,A,0,3,1,1,3,4,0,1,14,6,5,11,8,6,September,-1.0,-1.8369701987210287e-16,29,42,1,2,2,1.2,2.0,5,7,-2,8,2,6,"September, 2016"
2016-2017,6,2016-09-24,Stoke,West Brom,1,1,D,1,1,1,2,2,0,1,4,20,10,1,7,10,6,September,-1.0,-1.8369701987210287e-16,39,44,2,0,3,1.0,1.0,3,14,-11,6,5,1,"September, 2016"
2016-2017,6,2016-09-24,Liverpool,Hull,5,1,H,3,0,3,1,1,1,1,3,5,12,10,7,7,3,September,-1.0,-1.8369701987210287e-16,25,21,1,2,2,0.6,0.8,11,8,3,6,7,-1,"September, 2016"
2016-2017,6,2016-09-24,Man United,Leicester,4,1,H,3,0,1,2,2,2,1,2,7,11,9,7,4,2,September,-1.0,-1.8369701987210287e-16,28,24,2,2,1,1.8,1.6,8,6,2,7,7,0,"September, 2016"
2016-2017,6,2016-09-24,Bournemouth,Everton,1,0,H,3,0,3,2,0,1,1,3,17,3,4,13,14,9,September,-1.0,-1.8369701987210287e-16,7,18,0,1,1,2.0,2.5,3,9,-6,10,3,7,"September, 2016"
2016-2017,6,2016-09-24,Arsenal,Chelsea,3,0,H,3,0,5,0,0,5,0,0,4,5,10,10,1,0,September,-1.0,-1.8369701987210287e-16,0,14,0,1,4,0.0,2.2,12,7,5,10,6,4,"September, 2016"
2016-2017,6,2016-09-25,West Ham,Southampton,0,3,A,0,3,2,2,1,1,2,2,18,14,3,5,4,2,September,-1.0,-1.8369701987210287e-16,45,38,2,1,2,1.2,1.2,7,13,-6,4,6,-2,"September, 2016"
2016-2017,6,2016-09-26,Burnley,Watford,2,0,H,3,0,1,1,3,0,0,5,17,11,4,7,6,3,September,-1.0,-1.8369701987210287e-16,11,43,0,0,0,0.0,0.0,3,8,-5,10,9,1,"September, 2016"
2016-2017,7,2016-09-30,Everton,Crystal Palace,1,1,D,1,1,1,1,3,1,0,4,5,7,13,10,2,3,September,-1.0,-1.8369701987210287e-16,18,16,1,2,2,1.2,1.4,10,4,6,10,7,3,"September, 2016"
2016-2017,7,2016-10-01,Watford,Bournemouth,2,2,D,1,1,0,0,5,3,2,0,11,14,7,7,3,0,October,-0.8660254037844386,0.5,43,7,0,2,0,0.5,0.5,10,11,-1,4,9,-5,"October, 2016"
2016-2017,7,2016-10-01,Swansea,Liverpool,1,2,A,0,3,4,1,0,3,1,1,17,5,4,13,12,9,October,-0.8660254037844386,0.5,41,25,1,0,4,1.4,2.2,5,10,-5,16,9,7,"October, 2016"
2016-2017,7,2016-10-01,West Ham,Middlesbrough,1,1,D,1,1,2,2,1,1,1,3,18,16,3,5,2,2,October,-0.8660254037844386,0.5,45,29,4,1,0,2.0,0.6,7,16,-9,6,9,-3,"October, 2016"
2016-2017,7,2016-10-01,Hull,Chelsea,0,2,A,0,3,1,1,3,5,0,0,14,8,7,10,6,3,October,-0.8660254037844386,0.5,21,14,0,1,4,0.6,2.0,7,12,-5,10,9,1,"October, 2016"
2016-2017,7,2016-10-01,Sunderland,West Brom,1,1,D,1,1,1,0,4,0,1,4,20,10,1,8,10,7,October,-0.8660254037844386,0.5,40,44,1,3,1,0.8,0.6,5,12,-7,7,6,1,"October, 2016"
2016-2017,7,2016-10-02,Burnley,Arsenal,0,1,A,0,3,1,1,3,5,0,0,14,5,7,13,9,6,October,-0.8660254037844386,0.5,11,0,0,1,3,0.5,2.0,5,8,-3,15,7,8,"October, 2016"
2016-2017,7,2016-10-02,Leicester,Southampton,0,0,D,1,1,2,1,2,1,2,2,13,10,7,8,3,1,October,-0.8660254037844386,0.5,24,38,2,2,1,1.0,0.8,8,11,-3,7,6,1,"October, 2016"
2016-2017,7,2016-10-02,Man United,Stoke,1,1,D,1,1,1,2,2,1,2,2,7,20,12,2,13,10,October,-0.8660254037844386,0.5,28,39,2,1,2,1.4,1.2,12,7,5,4,15,-11,"October, 2016"
2016-2017,7,2016-10-02,Tottenham,Man City,2,0,H,3,0,4,0,1,4,1,0,4,1,14,18,3,4,October,-0.8660254037844386,0.5,42,27,2,0,3,1.6,2.4,10,3,7,18,5,13,"October, 2016"
2016-2017,8,2016-10-15,Stoke,Sunderland,2,0,H,3,0,1,2,2,1,0,4,19,20,3,2,1,1,October,-0.8660254037844386,0.5,39,40,0,2,3,0.6,1.6,5,16,-11,6,13,-7,"October, 2016"
2016-2017,8,2016-10-15,Arsenal,Swansea,3,2,H,3,0,5,0,0,4,1,0,3,17,16,4,14,12,October,-0.8660254037844386,0.5,0,41,1,1,3,1.4,1.4,16,7,9,6,12,-6,"October, 2016"
2016-2017,8,2016-10-15,Bournemouth,Hull,6,1,H,3,0,3,2,0,1,1,3,13,15,8,7,2,1,October,-0.8660254037844386,0.5,7,21,0,0,0,0.0,0.0,6,11,-5,7,14,-7,"October, 2016"
2016-2017,8,2016-10-15,Chelsea,Leicester,3,0,H,3,0,5,0,0,2,1,2,7,13,13,8,6,5,October,-0.8660254037844386,0.5,14,24,3,1,1,2.2,0.8,12,9,3,8,11,-3,"October, 2016"
2016-2017,8,2016-10-15,Crystal Palace,West Ham,0,1,A,0,3,1,0,4,2,2,1,8,18,11,4,10,7,October,-0.8660254037844386,0.5,16,45,2,1,2,1.6,1.8,11,8,3,8,17,-9,"October, 2016"
2016-2017,8,2016-10-15,Man City,Everton,1,1,D,1,1,4,1,0,1,1,3,2,6,18,14,4,4,October,-0.8660254037844386,0.5,27,18,3,2,0,1.4,0.6,18,7,11,11,5,6,"October, 2016"
2016-2017,8,2016-10-15,West Brom,Tottenham,1,1,D,1,1,0,1,4,4,0,1,10,3,9,17,7,8,October,-0.8660254037844386,0.5,44,42,1,3,1,1.2,1.6,8,7,1,12,3,9,"October, 2016"
2016-2017,8,2016-10-16,Southampton,Burnley,3,1,H,3,0,1,2,2,1,1,3,12,14,9,7,2,2,October,-0.8660254037844386,0.5,38,11,1,0,1,1.0,0.5,7,6,1,5,9,-4,"October, 2016"
2016-2017,8,2016-10-16,Middlesbrough,Watford,0,1,A,0,3,1,1,3,0,0,5,17,12,6,8,5,2,October,-0.8660254037844386,0.5,29,43,2,1,1,2.0,1.25,7,10,-3,12,13,-1,"October, 2016"
2016-2017,8,2016-10-17,Liverpool,Man United,0,0,D,1,1,3,1,1,1,2,2,4,7,16,13,3,3,October,-0.8660254037844386,0.5,25,28,1,0,4,1.0,1.8,18,10,8,13,8,5,"October, 2016"
2016-2017,9,2016-10-22,West Ham,Sunderland,1,0,H,3,0,2,2,1,1,0,4,17,20,7,2,3,5,October,-0.8660254037844386,0.5,45,40,3,2,0,1.4,0.8,9,17,-8,6,15,-9,"October, 2016"
2016-2017,9,2016-10-22,Arsenal,Middlesbrough,0,0,D,1,1,5,0,0,1,1,3,2,17,19,6,15,13,October,-0.8660254037844386,0.5,0,29,1,3,1,1.2,1.0,19,9,10,7,11,-4,"October, 2016"
2016-2017,9,2016-10-22,Bournemouth,Tottenham,0,0,D,1,1,3,2,0,4,0,1,11,3,11,18,8,7,October,-0.8660254037844386,0.5,7,42,0,0,2,0.5,4.0,12,12,0,13,4,9,"October, 2016"
2016-2017,9,2016-10-22,Burnley,Everton,2,1,H,3,0,1,1,3,1,1,3,15,6,7,15,9,8,October,-0.8660254037844386,0.5,11,18,1,0,3,0.5,1.5,6,12,-6,12,6,6,"October, 2016"
2016-2017,9,2016-10-22,Hull,Stoke,0,2,A,0,3,1,1,3,1,2,2,17,18,7,6,1,1,October,-0.8660254037844386,0.5,21,39,0,2,3,0.2,1.0,8,20,-12,7,16,-9,"October, 2016"
2016-2017,9,2016-10-22,Leicester,Crystal Palace,3,1,H,3,0,2,1,2,1,0,4,15,10,8,11,5,3,October,-0.8660254037844386,0.5,24,16,3,0,2,1.0,0.6,8,14,-6,11,9,2,"October, 2016"
2016-2017,9,2016-10-22,Liverpool,West Brom,2,1,H,3,0,3,1,1,0,1,4,4,13,17,10,9,7,October,-0.8660254037844386,0.5,25,44,1,4,0,1.2,1.0,18,10,8,9,8,1,"October, 2016"
2016-2017,9,2016-10-22,Swansea,Watford,0,0,D,1,1,4,1,0,0,0,5,19,10,4,11,9,7,October,-0.8660254037844386,0.5,41,43,1,0,1,0.5,0.5,8,15,-7,13,13,0,"October, 2016"
2016-2017,9,2016-10-23,Man City,Southampton,1,1,D,1,1,4,1,0,1,2,2,3,8,19,12,5,7,October,-0.8660254037844386,0.5,27,38,4,0,1,2.8,1.2,19,8,11,10,7,3,"October, 2016"
2016-2017,9,2016-10-23,Chelsea,Man United,4,0,H,3,0,5,0,0,1,2,2,5,7,16,14,2,2,October,-0.8660254037844386,0.5,14,28,2,3,0,1.2,0.6,15,9,6,13,8,5,"October, 2016"
2016-2017,10,2016-10-29,Watford,Hull,1,0,H,3,0,0,0,5,1,1,3,9,18,12,7,9,5,October,-0.8660254037844386,0.5,43,21,0,0,0,0.0,0.0,13,13,0,8,22,-14,"October, 2016"
2016-2017,10,2016-10-29,Crystal Palace,Liverpool,2,4,A,0,3,1,0,4,3,1,1,11,3,11,20,8,9,October,-0.8660254037844386,0.5,16,25,3,1,1,2.4,1.6,12,12,0,20,11,9,"October, 2016"
2016-2017,10,2016-10-29,Man United,Burnley,0,0,D,1,1,1,2,2,1,1,3,7,14,14,10,7,4,October,-0.8660254037844386,0.5,28,11,2,1,1,1.5,0.5,13,12,1,8,13,-5,"October, 2016"
2016-2017,10,2016-10-29,Middlesbrough,Bournemouth,2,0,H,3,0,1,1,3,3,2,0,17,10,7,12,7,5,October,-0.8660254037844386,0.5,29,7,0,0,0,0.0,0.0,7,11,-4,12,12,0,"October, 2016"
2016-2017,10,2016-10-29,Sunderland,Arsenal,1,4,A,0,3,1,0,4,5,0,0,20,3,2,20,17,18,October,-0.8660254037844386,0.5,40,0,0,2,3,0.4,1.8,6,16,-10,19,9,10,"October, 2016"
2016-2017,10,2016-10-29,Tottenham,Leicester,1,1,D,1,1,4,0,1,2,1,2,5,12,19,11,7,8,October,-0.8660254037844386,0.5,42,24,2,2,1,2.2,2.0,13,4,9,11,15,-4,"October, 2016"
2016-2017,10,2016-10-29,West Brom,Man City,0,4,A,0,3,0,1,4,4,1,0,14,3,10,20,11,10,October,-0.8660254037844386,0.5,44,27,0,0,5,0.6,2.8,10,10,0,20,9,11,"October, 2016"
2016-2017,10,2016-10-30,Southampton,Chelsea,0,2,A,0,3,1,2,2,5,0,0,9,5,13,19,4,6,October,-0.8660254037844386,0.5,38,14,1,2,2,1.2,1.6,11,8,3,19,9,10,"October, 2016"
2016-2017,10,2016-10-30,Everton,West Ham,2,0,H,3,0,1,1,3,2,2,1,6,16,15,10,10,5,October,-0.8660254037844386,0.5,18,45,3,1,1,1.6,1.2,13,8,5,10,17,-7,"October, 2016"
2016-2017,10,2016-10-31,Stoke,Swansea,3,1,H,3,0,1,2,2,4,1,0,17,19,9,5,2,4,October,-0.8660254037844386,0.5,39,41,2,2,1,1.2,1.2,9,16,-7,8,15,-7,"October, 2016"
2016-2017,11,2016-11-05,West Ham,Stoke,1,1,D,1,1,2,2,1,1,2,2,17,13,10,12,4,2,November,-0.5000000000000004,0.8660254037844384,45,39,0,3,2,1.0,1.6,10,19,-9,12,17,-5,"November, 2016"
2016-2017,11,2016-11-05,Man City,Middlesbrough,1,1,D,1,1,4,1,0,1,1,3,2,15,23,10,13,13,November,-0.5000000000000004,0.8660254037844384,27,29,3,0,2,1.4,2.2,24,9,15,9,11,-2,"November, 2016"
2016-2017,11,2016-11-05,Bournemouth,Sunderland,1,2,A,0,3,3,2,0,1,0,4,10,20,12,2,10,10,November,-0.5000000000000004,0.8660254037844384,7,40,1,1,0,1.5,0.5,12,14,-2,7,20,-13,"November, 2016"
2016-2017,11,2016-11-05,Burnley,Crystal Palace,3,2,H,3,0,1,1,3,1,0,4,14,13,11,11,1,0,November,-0.5000000000000004,0.8660254037844384,11,16,0,1,1,1.0,1.5,8,13,-5,14,16,-2,"November, 2016"
2016-2017,11,2016-11-05,Chelsea,Everton,5,0,H,3,0,5,0,0,1,1,3,4,6,22,18,2,4,November,-0.5000000000000004,0.8660254037844384,14,18,3,1,1,2.4,1.8,21,9,12,15,8,7,"November, 2016"
2016-2017,11,2016-11-06,Arsenal,Tottenham,1,1,D,1,1,5,0,0,4,0,1,3,5,23,20,2,3,November,-0.5000000000000004,0.8660254037844384,0,42,1,3,1,1.2,1.2,23,10,13,14,5,9,"November, 2016"
2016-2017,11,2016-11-06,Hull,Southampton,2,1,H,3,0,1,1,3,1,2,2,18,10,7,13,8,6,November,-0.5000000000000004,0.8660254037844384,21,38,0,0,4,0.25,2.0,8,23,-15,11,10,1,"November, 2016"
2016-2017,11,2016-11-06,Leicester,West Brom,1,2,A,0,3,2,1,2,0,1,4,13,17,12,10,4,2,November,-0.5000000000000004,0.8660254037844384,24,44,2,1,1,2.0,1.75,12,16,-4,10,14,-4,"November, 2016"
2016-2017,11,2016-11-06,Liverpool,Watford,6,1,H,3,0,3,1,1,0,0,5,4,7,23,15,3,8,November,-0.5000000000000004,0.8660254037844384,25,43,4,0,1,2.0,1.0,24,13,11,14,13,1,"November, 2016"
2016-2017,11,2016-11-06,Swansea,Man United,1,3,A,0,3,4,1,0,1,2,2,19,7,5,15,12,10,November,-0.5000000000000004,0.8660254037844384,41,28,3,0,2,1.4,1.4,9,18,-9,13,12,1,"November, 2016"
2016-2017,12,2016-11-19,Watford,Leicester,2,1,H,3,0,0,0,5,2,1,2,9,14,15,12,5,3,November,-0.5000000000000004,0.8660254037844384,43,24,0,1,3,0.5,1.25,15,19,-4,13,18,-5,"November, 2016"
2016-2017,12,2016-11-19,Tottenham,West Ham,3,2,H,3,0,4,0,1,2,2,1,5,17,21,11,12,10,November,-0.5000000000000004,0.8660254037844384,42,45,2,1,2,1.4,1.2,15,6,9,11,20,-9,"November, 2016"
2016-2017,12,2016-11-19,Sunderland,Hull,3,0,H,3,0,1,0,4,1,1,3,20,18,5,10,2,5,November,-0.5000000000000004,0.8660254037844384,40,21,1,1,3,0.6,1.4,9,21,-12,10,24,-14,"November, 2016"
2016-2017,12,2016-11-19,Stoke,Bournemouth,0,1,A,0,3,1,2,2,3,2,0,12,13,13,12,1,1,November,-0.5000000000000004,0.8660254037844384,39,7,2,0,0,2.5,1.0,13,18,-5,13,16,-3,"November, 2016"
2016-2017,12,2016-11-19,Everton,Swansea,1,1,D,1,1,1,1,3,4,1,0,7,19,18,5,12,13,November,-0.5000000000000004,0.8660254037844384,18,41,1,3,1,1.0,1.0,15,13,2,10,21,-11,"November, 2016"
2016-2017,12,2016-11-19,Man United,Arsenal,1,1,D,1,1,1,2,2,5,0,0,7,4,18,24,3,6,November,-0.5000000000000004,0.8660254037844384,28,0,2,2,1,1.2,1.4,16,13,3,24,11,13,"November, 2016"
2016-2017,12,2016-11-19,Crystal Palace,Man City,1,2,A,0,3,1,0,4,4,1,0,16,3,11,24,13,13,November,-0.5000000000000004,0.8660254037844384,16,27,1,0,4,0.4,2.2,16,19,-3,25,10,15,"November, 2016"
2016-2017,12,2016-11-19,Southampton,Liverpool,0,0,D,1,1,1,2,2,3,1,1,10,2,13,26,8,13,November,-0.5000000000000004,0.8660254037844384,38,25,1,1,3,1.0,2.0,12,12,0,30,14,16,"November, 2016"
2016-2017,12,2016-11-20,Middlesbrough,Chelsea,0,1,A,0,3,1,1,3,5,0,0,15,3,11,25,12,14,November,-0.5000000000000004,0.8660254037844384,29,14,0,0,5,0.0,2.6,10,12,-2,26,9,17,"November, 2016"
2016-2017,12,2016-11-21,West Brom,Burnley,4,0,H,3,0,0,1,4,1,1,3,12,11,13,14,1,1,November,-0.5000000000000004,0.8660254037844384,44,11,1,1,0,3.0,1.0,12,15,-3,11,15,-4,"November, 2016"
2016-2017,13,2016-11-26,Swansea,Crystal Palace,5,4,H,3,0,4,1,0,1,0,4,20,16,6,11,4,5,November,-0.5000000000000004,0.8660254037844384,41,16,0,4,1,0.6,0.8,11,22,-11,17,21,-4,"November, 2016"
2016-2017,13,2016-11-26,Liverpool,Sunderland,2,0,H,3,0,3,1,1,1,0,4,3,19,27,8,16,19,November,-0.5000000000000004,0.8660254037844384,25,40,3,2,0,1.2,0.6,30,14,16,12,21,-9,"November, 2016"
2016-2017,13,2016-11-26,Leicester,Middlesbrough,2,2,D,1,1,2,1,2,1,1,3,14,15,12,11,1,1,November,-0.5000000000000004,0.8660254037844384,24,29,0,2,3,0.8,1.8,14,20,-6,10,13,-3,"November, 2016"
2016-2017,13,2016-11-26,Chelsea,Tottenham,2,1,H,3,0,5,0,0,4,0,1,2,5,28,24,3,4,November,-0.5000000000000004,0.8660254037844384,14,42,2,2,1,2.4,1.4,27,9,18,18,8,10,"November, 2016"
2016-2017,13,2016-11-26,Burnley,Man City,1,2,A,0,3,1,1,3,4,1,0,12,3,14,27,9,13,November,-0.5000000000000004,0.8660254037844384,11,27,1,2,1,1.75,2.75,11,19,-8,27,11,16,"November, 2016"
2016-2017,13,2016-11-26,Hull,West Brom,1,1,D,1,1,1,1,3,0,1,4,18,9,10,16,9,6,November,-0.5000000000000004,0.8660254037844384,21,44,1,3,1,1.0,0.8,10,27,-17,16,15,1,"November, 2016"
2016-2017,13,2016-11-27,Arsenal,Bournemouth,3,1,H,3,0,5,0,0,3,2,0,4,10,25,15,6,10,November,-0.5000000000000004,0.8660254037844384,0,7,2,0,0,2.0,0.0,25,12,13,14,16,-2,"November, 2016"
2016-2017,13,2016-11-27,Man United,West Ham,1,1,D,1,1,1,2,2,2,2,1,6,17,19,11,11,8,November,-0.5000000000000004,0.8660254037844384,28,45,2,2,1,1.4,1.0,17,14,3,13,23,-10,"November, 2016"
2016-2017,13,2016-11-27,Southampton,Everton,1,0,H,3,0,1,2,2,1,1,3,11,7,14,19,4,5,November,-0.5000000000000004,0.8660254037844384,38,18,2,1,2,1.2,1.0,12,12,0,16,14,2,"November, 2016"
2016-2017,13,2016-11-27,Watford,Stoke,0,1,A,0,3,0,0,5,1,2,2,8,14,18,13,6,5,November,-0.5000000000000004,0.8660254037844384,43,39,1,0,1,1.5,1.0,17,20,-3,13,19,-6,"November, 2016"
2016-2017,14,2016-12-03,Crystal Palace,Southampton,3,0,H,3,0,1,0,4,1,2,2,17,10,11,17,7,6,December,-2.4492935982947064e-16,1.0,16,38,1,0,4,0.6,1.8,21,26,-5,13,12,1,"December, 2016"
2016-2017,14,2016-12-03,Man City,Chelsea,1,3,A,0,3,4,1,0,5,0,0,3,1,30,31,2,1,December,-2.4492935982947064e-16,1.0,27,14,2,2,1,1.6,0.6,29,12,17,29,10,19,"December, 2016"
2016-2017,14,2016-12-03,Stoke,Burnley,2,0,H,3,0,1,2,2,1,1,3,11,14,16,14,3,2,December,-2.4492935982947064e-16,1.0,39,11,1,2,1,1.0,0.75,14,19,-5,12,21,-9,"December, 2016"
2016-2017,14,2016-12-03,Sunderland,Leicester,2,1,H,3,0,1,0,4,2,1,2,20,15,8,13,5,5,December,-2.4492935982947064e-16,1.0,40,24,1,2,2,0.8,1.4,12,23,-11,16,22,-6,"December, 2016"
2016-2017,14,2016-12-03,Tottenham,Swansea,5,0,H,3,0,4,0,1,4,1,0,5,20,24,9,15,15,December,-2.4492935982947064e-16,1.0,42,41,4,1,0,2.4,1.4,19,10,9,16,26,-10,"December, 2016"
2016-2017,14,2016-12-03,West Brom,Watford,3,1,H,3,0,0,1,4,0,0,5,10,9,17,18,1,1,December,-2.4492935982947064e-16,1.0,44,43,0,1,1,0.0,0.5,17,16,1,17,21,-4,"December, 2016"
2016-2017,14,2016-12-03,West Ham,Arsenal,1,5,A,0,3,2,2,1,5,0,0,17,4,12,28,13,16,December,-2.4492935982947064e-16,1.0,45,0,1,1,3,1.4,2.2,14,24,-10,28,13,15,"December, 2016"
2016-2017,14,2016-12-04,Bournemouth,Liverpool,4,3,H,3,0,3,2,0,3,1,1,12,3,15,30,9,15,December,-2.4492935982947064e-16,1.0,7,25,0,0,2,0.5,1.5,15,19,-4,32,14,18,"December, 2016"
2016-2017,14,2016-12-04,Everton,Man United,1,1,D,1,1,1,1,3,1,2,2,8,7,19,20,1,1,December,-2.4492935982947064e-16,1.0,18,28,2,0,3,1.2,1.2,16,15,1,18,15,3,"December, 2016"
2016-2017,14,2016-12-05,Middlesbrough,Hull,1,0,H,3,0,1,1,3,1,1,3,16,19,12,11,3,1,December,-2.4492935982947064e-16,1.0,29,21,1,0,1,2.0,1.5,12,15,-3,11,28,-17,"December, 2016"
2016-2017,15,2016-12-10,Swansea,Sunderland,3,0,H,3,0,4,1,0,1,0,4,20,19,9,11,1,2,December,-2.4492935982947064e-16,1.0,41,40,1,3,1,1.4,1.4,16,31,-15,14,24,-10,"December, 2016"
2016-2017,15,2016-12-10,Leicester,Man City,4,2,H,3,0,2,1,2,4,1,0,16,4,13,30,12,17,December,-2.4492935982947064e-16,1.0,24,27,1,2,2,0.8,1.0,17,24,-7,30,15,15,"December, 2016"
2016-2017,15,2016-12-10,Watford,Everton,3,2,H,3,0,0,0,5,1,1,3,11,8,18,20,3,2,December,-2.4492935982947064e-16,1.0,43,18,0,2,3,1.2,2.4,18,24,-6,17,16,1,"December, 2016"
2016-2017,15,2016-12-10,Burnley,Bournemouth,3,2,H,3,0,1,1,3,3,2,0,15,10,14,18,5,4,December,-2.4492935982947064e-16,1.0,11,7,0,0,0,0.0,0.0,12,23,-11,19,22,-3,"December, 2016"
2016-2017,15,2016-12-10,Arsenal,Stoke,3,1,H,3,0,5,0,0,1,2,2,2,9,31,19,7,12,December,-2.4492935982947064e-16,1.0,0,39,2,1,2,1.4,0.8,33,14,19,16,19,-3,"December, 2016"
2016-2017,15,2016-12-10,Hull,Crystal Palace,3,3,D,1,1,1,1,3,1,0,4,19,15,11,14,4,3,December,-2.4492935982947064e-16,1.0,21,16,2,0,2,1.0,0.5,11,29,-18,24,26,-2,"December, 2016"
2016-2017,15,2016-12-11,Southampton,Middlesbrough,1,0,H,3,0,1,2,2,1,1,3,12,16,17,15,4,2,December,-2.4492935982947064e-16,1.0,38,29,1,2,2,1.6,1.8,13,15,-2,13,15,-2,"December, 2016"
2016-2017,15,2016-12-11,Man United,Tottenham,1,0,H,3,0,1,2,2,4,0,1,6,5,21,27,1,6,December,-2.4492935982947064e-16,1.0,28,42,2,1,2,1.0,1.0,19,16,3,24,10,14,"December, 2016"
2016-2017,15,2016-12-11,Chelsea,West Brom,1,0,H,3,0,5,0,0,0,1,4,2,8,34,20,6,14,December,-2.4492935982947064e-16,1.0,14,44,2,2,1,1.6,1.6,32,11,21,20,17,3,"December, 2016"
2016-2017,15,2016-12-11,Liverpool,West Ham,2,2,D,1,1,3,1,1,2,2,1,3,18,30,12,15,18,December,-2.4492935982947064e-16,1.0,25,45,2,0,3,1.0,1.8,35,18,17,15,29,-14,"December, 2016"
2016-2017,16,2016-12-13,Bournemouth,Leicester,1,0,H,3,0,3,2,0,2,1,2,12,14,18,16,2,2,December,-2.4492935982947064e-16,1.0,7,24,0,2,0,0.5,0.5,21,25,-4,21,26,-5,"December, 2016"
2016-2017,16,2016-12-13,Everton,Arsenal,2,1,H,3,0,1,1,3,5,0,0,10,2,20,34,8,14,December,-2.4492935982947064e-16,1.0,18,0,1,1,3,1.2,1.6,19,19,0,36,15,21,"December, 2016"
2016-2017,16,2016-12-14,Tottenham,Hull,3,0,H,3,0,4,0,1,1,1,3,5,19,27,12,14,15,December,-2.4492935982947064e-16,1.0,42,21,3,2,0,1.2,0.4,24,11,13,14,32,-18,"December, 2016"
2016-2017,16,2016-12-14,West Ham,Burnley,1,0,H,3,0,2,2,1,1,1,3,17,13,13,17,4,4,December,-2.4492935982947064e-16,1.0,45,11,3,0,1,2.5,1.5,17,31,-14,15,25,-10,"December, 2016"
2016-2017,16,2016-12-14,West Brom,Swansea,3,1,H,3,0,0,1,4,4,1,0,11,18,20,12,7,8,December,-2.4492935982947064e-16,1.0,44,41,2,1,2,1.0,1.2,20,18,2,19,31,-12,"December, 2016"
2016-2017,16,2016-12-14,Sunderland,Chelsea,0,1,A,0,3,1,0,4,5,0,0,20,1,11,37,19,26,December,-2.4492935982947064e-16,1.0,40,14,2,1,2,1.4,1.8,14,27,-13,33,11,22,"December, 2016"
2016-2017,16,2016-12-14,Middlesbrough,Liverpool,0,3,A,0,3,1,1,3,3,1,1,16,4,15,31,12,16,December,-2.4492935982947064e-16,1.0,29,25,1,1,3,1.2,1.6,13,16,-3,37,20,17,"December, 2016"
2016-2017,16,2016-12-14,Man City,Watford,2,0,H,3,0,4,1,0,0,0,5,4,9,30,21,5,9,December,-2.4492935982947064e-16,1.0,27,43,2,2,0,1.25,0.5,32,19,13,21,26,-5,"December, 2016"
2016-2017,16,2016-12-14,Crystal Palace,Man United,1,2,A,0,3,1,0,4,1,2,2,15,6,15,24,9,9,December,-2.4492935982947064e-16,1.0,16,28,0,1,4,0.2,1.4,27,29,-2,20,16,4,"December, 2016"
2016-2017,16,2016-12-14,Stoke,Southampton,0,0,D,1,1,1,2,2,1,2,2,12,11,19,20,1,1,December,-2.4492935982947064e-16,1.0,39,38,2,1,2,1.2,1.2,17,22,-5,14,15,-1,"December, 2016"
2016-2017,17,2016-12-17,West Ham,Hull,1,0,H,3,0,2,2,1,1,1,3,16,20,16,12,4,4,December,-2.4492935982947064e-16,1.0,45,21,3,1,1,2.0,0.8,18,31,-13,14,35,-21,"December, 2016"
2016-2017,17,2016-12-17,Crystal Palace,Chelsea,0,1,A,0,3,1,0,4,5,0,0,16,1,15,40,15,25,December,-2.4492935982947064e-16,1.0,16,14,2,0,3,0.8,1.4,28,31,-3,34,11,23,"December, 2016"
2016-2017,17,2016-12-17,Middlesbrough,Swansea,3,0,H,3,0,1,1,3,4,1,0,17,18,15,12,1,3,December,-2.4492935982947064e-16,1.0,29,41,0,0,0,0.0,0.0,13,19,-6,20,34,-14,"December, 2016"
2016-2017,17,2016-12-17,Stoke,Leicester,2,2,D,1,1,1,2,2,2,1,2,12,15,20,16,3,4,December,-2.4492935982947064e-16,1.0,39,24,1,1,2,0.75,1.5,17,22,-5,21,27,-6,"December, 2016"
2016-2017,17,2016-12-17,Sunderland,Watford,1,0,H,3,0,1,0,4,0,0,5,20,12,11,21,8,10,December,-2.4492935982947064e-16,1.0,40,43,2,1,1,1.75,1.25,14,28,-14,21,28,-7,"December, 2016"
2016-2017,17,2016-12-17,West Brom,Man United,0,2,A,0,3,0,1,4,1,2,2,7,6,23,27,1,4,December,-2.4492935982947064e-16,1.0,44,28,2,1,2,0.8,1.4,23,19,4,22,17,5,"December, 2016"
2016-2017,17,2016-12-18,Tottenham,Burnley,2,1,H,3,0,4,0,1,1,1,3,5,16,30,17,11,13,December,-2.4492935982947064e-16,1.0,42,11,2,1,1,2.25,1.25,27,11,16,15,26,-11,"December, 2016"
2016-2017,17,2016-12-18,Bournemouth,Southampton,1,3,A,0,3,3,2,0,1,2,2,10,9,21,21,1,0,December,-2.4492935982947064e-16,1.0,7,38,1,0,1,1.0,1.0,22,25,-3,14,15,-1,"December, 2016"
2016-2017,17,2016-12-18,Man City,Arsenal,2,1,H,3,0,4,1,0,5,0,0,4,3,33,34,1,1,December,-2.4492935982947064e-16,1.0,27,0,0,3,2,1.2,1.8,34,19,15,37,17,20,"December, 2016"
2016-2017,17,2016-12-19,Everton,Liverpool,0,1,A,0,3,1,1,3,3,1,1,9,3,23,34,6,11,December,-2.4492935982947064e-16,1.0,18,25,0,3,2,0.4,2.0,21,20,1,40,20,20,"December, 2016"
2016-2017,18,2016-12-26,Arsenal,West Brom,1,0,H,3,0,5,0,0,0,1,4,4,8,34,23,4,11,December,-2.4492935982947064e-16,1.0,0,44,4,0,1,1.8,0.6,38,19,19,23,21,2,"December, 2016"
2016-2017,18,2016-12-26,Burnley,Middlesbrough,1,0,H,3,0,1,1,3,1,1,3,16,14,17,18,2,1,December,-2.4492935982947064e-16,1.0,11,29,0,0,0,0.0,0.0,16,28,-12,16,19,-3,"December, 2016"
2016-2017,18,2016-12-26,Chelsea,Bournemouth,3,0,H,3,0,5,0,0,3,2,0,1,10,43,21,9,22,December,-2.4492935982947064e-16,1.0,14,7,1,0,1,2.0,1.0,35,11,24,23,28,-5,"December, 2016"
2016-2017,18,2016-12-26,Hull,Man City,0,3,A,0,3,1,1,3,4,1,0,20,4,12,36,16,24,December,-2.4492935982947064e-16,1.0,21,27,1,1,3,1.0,2.0,14,36,-22,36,20,16,"December, 2016"
2016-2017,18,2016-12-26,Leicester,Everton,0,2,A,0,3,2,1,2,1,1,3,16,9,17,23,7,6,December,-2.4492935982947064e-16,1.0,24,18,2,3,0,2.2,1.6,23,29,-6,21,21,0,"December, 2016"
2016-2017,18,2016-12-26,Man United,Sunderland,3,1,H,3,0,1,2,2,1,0,4,6,18,30,14,12,16,December,-2.4492935982947064e-16,1.0,28,40,2,1,2,1.4,0.8,24,17,7,15,28,-13,"December, 2016"
2016-2017,18,2016-12-26,Swansea,West Ham,1,4,A,0,3,4,1,0,2,2,1,19,14,12,19,5,7,December,-2.4492935982947064e-16,1.0,41,45,1,2,2,1.2,1.4,20,37,-17,19,31,-12,"December, 2016"
2016-2017,18,2016-12-26,Watford,Crystal Palace,1,1,D,1,1,0,0,5,1,0,4,13,17,21,15,4,6,December,-2.4492935982947064e-16,1.0,43,16,1,0,1,1.0,1.0,21,29,-8,28,32,-4,"December, 2016"
2016-2017,18,2016-12-27,Liverpool,Stoke,4,1,H,3,0,3,1,1,1,2,2,3,12,37,21,9,16,December,-2.4492935982947064e-16,1.0,25,39,4,0,1,2.4,2.0,41,20,21,19,24,-5,"December, 2016"
2016-2017,18,2016-12-28,Southampton,Tottenham,1,4,A,0,3,1,2,2,4,0,1,8,5,24,33,3,9,December,-2.4492935982947064e-16,1.0,38,42,1,1,3,1.2,1.8,17,16,1,29,12,17,"December, 2016"
2016-2017,19,2016-12-30,Hull,Everton,2,2,D,1,1,1,1,3,1,1,3,20,7,12,26,13,14,December,-2.4492935982947064e-16,1.0,21,18,1,1,3,1.0,2.0,14,39,-25,23,21,2,"December, 2016"
2016-2017,19,2016-12-31,Burnley,Sunderland,4,1,H,3,0,1,1,3,1,0,4,14,18,20,14,4,6,December,-2.4492935982947064e-16,1.0,11,40,1,1,2,1.0,1.25,17,28,-11,16,31,-15,"December, 2016"
2016-2017,19,2016-12-31,Chelsea,Stoke,4,2,H,3,0,5,0,0,1,2,2,1,14,46,21,13,25,December,-2.4492935982947064e-16,1.0,14,39,3,1,1,1.6,0.6,38,11,27,20,28,-8,"December, 2016"
2016-2017,19,2016-12-31,Leicester,West Ham,1,0,H,3,0,2,1,2,2,2,1,16,12,17,22,4,5,December,-2.4492935982947064e-16,1.0,24,45,2,1,2,1.2,1.4,23,31,-8,23,32,-9,"December, 2016"
2016-2017,19,2016-12-31,Liverpool,Man City,1,0,H,3,0,3,1,1,4,1,0,2,3,40,39,1,1,December,-2.4492935982947064e-16,1.0,25,27,4,0,1,2.6,1.4,45,21,24,39,20,19,"December, 2016"
2016-2017,19,2016-12-31,Southampton,West Brom,1,2,A,0,3,1,2,2,0,1,4,8,9,24,23,1,1,December,-2.4492935982947064e-16,1.0,38,44,2,2,1,0.8,0.2,18,20,-2,23,22,1,"December, 2016"
2016-2017,19,2016-12-31,Swansea,Bournemouth,0,3,A,0,3,4,1,0,3,2,0,20,13,12,21,7,9,December,-2.4492935982947064e-16,1.0,41,7,0,1,1,2.0,2.5,21,41,-20,23,31,-8,"December, 2016"
2016-2017,19,2016-12-31,Man United,Middlesbrough,2,1,H,3,0,1,2,2,1,1,3,6,16,33,18,10,15,December,-2.4492935982947064e-16,1.0,28,29,3,2,0,2.0,0.8,27,18,9,16,20,-4,"December, 2016"
2016-2017,19,2017-01-01,Watford,Tottenham,1,4,A,0,3,0,0,5,4,0,1,12,5,22,36,7,14,January,0.4999999999999999,0.8660254037844387,43,42,0,2,3,0.6,1.4,22,30,-8,33,13,20,"January, 2017"
2016-2017,19,2017-01-01,Arsenal,Crystal Palace,2,0,H,3,0,5,0,0,1,0,4,4,17,37,16,13,21,January,0.4999999999999999,0.8660254037844387,0,16,4,1,0,1.8,0.8,39,19,20,29,33,-4,"January, 2017"
2016-2017,20,2017-01-02,Everton,Southampton,3,0,H,3,0,1,1,3,1,2,2,7,9,27,24,2,3,January,0.4999999999999999,0.8660254037844387,18,38,2,1,2,1.0,1.0,25,23,2,19,22,-3,"January, 2017"
2016-2017,20,2017-01-02,Man City,Burnley,2,1,H,3,0,4,1,0,1,1,3,5,11,39,23,6,16,January,0.4999999999999999,0.8660254037844387,27,11,2,2,1,2.6,1.6,39,21,18,21,29,-8,"January, 2017"
2016-2017,20,2017-01-02,Middlesbrough,Leicester,0,0,D,1,1,1,1,3,2,1,2,16,15,18,20,1,2,January,0.4999999999999999,0.8660254037844387,29,24,2,3,0,1.6,1.2,17,22,-5,24,31,-7,"January, 2017"
2016-2017,20,2017-01-02,Sunderland,Liverpool,2,2,D,1,1,1,0,4,3,1,1,18,2,14,43,16,29,January,0.4999999999999999,0.8660254037844387,40,25,0,2,3,0.4,1.2,17,35,-18,46,21,25,"January, 2017"
2016-2017,20,2017-01-02,West Brom,Hull,3,1,H,3,0,0,1,4,1,1,3,8,19,26,13,11,13,January,0.4999999999999999,0.8660254037844387,44,21,1,3,1,0.6,0.8,25,23,2,16,41,-25,"January, 2017"
2016-2017,20,2017-01-02,West Ham,Man United,0,2,A,0,3,2,2,1,1,2,2,12,6,22,36,6,14,January,0.4999999999999999,0.8660254037844387,45,28,1,3,1,1.2,1.2,23,33,-10,29,19,10,"January, 2017"
2016-2017,20,2017-01-03,Bournemouth,Arsenal,3,3,D,1,1,3,2,0,5,0,0,9,4,24,40,5,16,January,0.4999999999999999,0.8660254037844387,7,0,0,0,3,0.3333333333333333,2.333333333333333,26,31,-5,41,19,22,"January, 2017"
2016-2017,20,2017-01-03,Crystal Palace,Swansea,1,2,A,0,3,1,0,4,4,1,0,17,20,16,12,3,4,January,0.4999999999999999,0.8660254037844387,16,41,1,3,1,1.4,1.4,29,35,-6,21,44,-23,"January, 2017"
2016-2017,20,2017-01-03,Stoke,Watford,2,0,H,3,0,1,2,2,0,0,5,15,12,21,22,3,1,January,0.4999999999999999,0.8660254037844387,39,43,2,0,1,1.0,1.0,22,32,-10,23,34,-11,"January, 2017"
2016-2017,20,2017-01-04,Tottenham,Chelsea,2,0,H,3,0,4,0,1,5,0,0,5,1,39,49,4,10,January,0.4999999999999999,0.8660254037844387,42,14,1,2,2,1.6,2.0,37,14,23,42,13,29,"January, 2017"
2016-2017,21,2017-01-14,Watford,Middlesbrough,0,0,D,1,1,0,0,5,1,1,3,14,16,22,19,2,3,January,0.4999999999999999,0.8660254037844387,43,29,2,1,2,1.2,1.6,23,36,-13,17,22,-5,"January, 2017"
2016-2017,21,2017-01-14,Tottenham,West Brom,4,0,H,3,0,4,0,1,0,1,4,4,8,42,29,4,13,January,0.4999999999999999,0.8660254037844387,42,44,1,3,1,1.2,0.8,39,14,25,28,24,4,"January, 2017"
2016-2017,21,2017-01-14,Swansea,Arsenal,0,4,A,0,3,4,1,0,5,0,0,20,5,15,41,15,26,January,0.4999999999999999,0.8660254037844387,41,0,3,0,2,1.4,1.6,23,45,-22,44,22,22,"January, 2017"
2016-2017,21,2017-01-14,West Ham,Crystal Palace,3,0,H,3,0,2,2,1,1,0,4,14,17,22,16,3,6,January,0.4999999999999999,0.8660254037844387,45,16,3,1,1,2.0,1.4,23,35,-12,30,37,-7,"January, 2017"
2016-2017,21,2017-01-14,Leicester,Chelsea,0,3,A,0,3,2,1,2,5,0,0,15,1,21,49,14,28,January,0.4999999999999999,0.8660254037844387,24,14,1,1,3,0.8,2.0,24,31,-7,42,15,27,"January, 2017"
2016-2017,21,2017-01-14,Hull,Bournemouth,3,1,H,3,0,1,1,3,3,2,0,20,10,13,25,10,12,January,0.4999999999999999,0.8660254037844387,21,7,0,0,1,1.0,6.0,17,44,-27,29,34,-5,"January, 2017"
2016-2017,21,2017-01-14,Burnley,Southampton,1,0,H,3,0,1,1,3,1,2,2,12,10,23,24,2,1,January,0.4999999999999999,0.8660254037844387,11,38,1,0,2,0.6666666666666666,1.6666666666666667,22,31,-9,19,25,-6,"January, 2017"
2016-2017,21,2017-01-14,Sunderland,Stoke,1,3,A,0,3,1,0,4,1,2,2,19,12,15,24,7,9,January,0.4999999999999999,0.8660254037844387,40,39,2,2,1,1.4,1.0,19,37,-18,24,32,-8,"January, 2017"
2016-2017,21,2017-01-15,Man United,Liverpool,1,1,D,1,1,1,2,2,3,1,1,6,4,39,44,2,5,January,0.4999999999999999,0.8660254037844387,28,25,4,1,0,1.8,0.4,31,19,12,48,23,25,"January, 2017"
2016-2017,21,2017-01-15,Everton,Man City,4,0,H,3,0,1,1,3,4,1,0,7,5,30,42,2,12,January,0.4999999999999999,0.8660254037844387,18,27,0,3,2,0.4,1.0,28,23,5,41,22,19,"January, 2017"
2016-2017,22,2017-01-21,Bournemouth,Watford,2,2,D,1,1,3,2,0,0,0,5,11,14,25,23,3,2,January,0.4999999999999999,0.8660254037844387,7,43,0,3,0,1.0,1.0,30,37,-7,23,36,-13,"January, 2017"
2016-2017,22,2017-01-21,Crystal Palace,Everton,0,1,A,0,3,1,0,4,1,1,3,17,7,16,33,10,17,January,0.4999999999999999,0.8660254037844387,16,18,1,3,1,1.0,1.0,30,40,-10,32,23,9,"January, 2017"
2016-2017,22,2017-01-21,Liverpool,Swansea,2,3,A,0,3,3,1,1,4,1,0,3,20,45,15,17,30,January,0.4999999999999999,0.8660254037844387,25,41,4,0,1,1.8,1.0,49,24,25,23,49,-26,"January, 2017"
2016-2017,22,2017-01-21,Man City,Tottenham,2,2,D,1,1,4,1,0,4,0,1,5,2,42,45,3,3,January,0.4999999999999999,0.8660254037844387,27,42,2,0,3,1.4,1.8,41,26,15,43,14,29,"January, 2017"
2016-2017,22,2017-01-21,Middlesbrough,West Ham,1,3,A,0,3,1,1,3,2,2,1,16,12,20,25,4,5,January,0.4999999999999999,0.8660254037844387,29,45,0,2,3,0.8,1.8,17,22,-5,26,35,-9,"January, 2017"
2016-2017,22,2017-01-21,Stoke,Man United,1,1,D,1,1,1,2,2,1,2,2,10,6,27,40,4,13,January,0.4999999999999999,0.8660254037844387,39,28,1,2,2,1.0,1.4,27,33,-6,32,20,12,"January, 2017"
2016-2017,22,2017-01-21,West Brom,Sunderland,2,0,H,3,0,0,1,4,1,0,4,8,20,29,15,12,14,January,0.4999999999999999,0.8660254037844387,44,40,1,4,0,0.8,0.6,28,28,0,20,40,-20,"January, 2017"
2016-2017,22,2017-01-22,Arsenal,Burnley,2,1,H,3,0,5,0,0,1,1,3,4,12,44,26,8,18,January,0.4999999999999999,0.8660254037844387,0,11,4,1,0,1.8,0.4,48,22,26,23,31,-8,"January, 2017"
2016-2017,22,2017-01-22,Chelsea,Hull,2,0,H,3,0,5,0,0,1,1,3,1,19,52,16,18,36,January,0.4999999999999999,0.8660254037844387,14,21,5,0,0,2.2,0.4,45,15,30,20,45,-25,"January, 2017"
2016-2017,22,2017-01-22,Southampton,Leicester,3,0,H,3,0,1,2,2,2,1,2,13,15,24,21,2,3,January,0.4999999999999999,0.8660254037844387,38,24,1,2,2,0.8,1.0,19,26,-7,24,34,-10,"January, 2017"
2016-2017,23,2017-01-31,Swansea,Southampton,2,1,H,3,0,4,1,0,1,2,2,18,12,18,27,6,9,January,0.4999999999999999,0.8660254037844387,41,38,1,0,4,0.4,1.2,26,51,-25,22,26,-4,"January, 2017"
2016-2017,23,2017-01-31,Sunderland,Tottenham,0,0,D,1,1,1,0,4,4,0,1,20,3,15,46,17,31,January,0.4999999999999999,0.8660254037844387,40,42,0,1,4,0.8,2.0,20,42,-22,45,16,29,"January, 2017"
2016-2017,23,2017-01-31,Middlesbrough,West Brom,1,1,D,1,1,1,1,3,0,1,4,16,8,20,32,8,12,January,0.4999999999999999,0.8660254037844387,29,44,1,2,2,0.8,1.2,18,25,-7,30,28,2,"January, 2017"
2016-2017,23,2017-01-31,Bournemouth,Crystal Palace,0,2,A,0,3,3,2,0,1,0,4,13,18,26,16,5,10,January,0.4999999999999999,0.8660254037844387,7,16,1,2,0,1.0,0.6666666666666666,32,39,-7,30,41,-11,"January, 2017"
2016-2017,23,2017-01-31,Burnley,Leicester,1,0,H,3,0,1,1,3,2,1,2,14,15,26,21,1,5,January,0.4999999999999999,0.8660254037844387,11,24,0,1,2,0.6666666666666666,2.0,24,33,-9,24,37,-13,"January, 2017"
2016-2017,23,2017-01-31,Arsenal,Watford,1,2,A,0,3,5,0,0,0,0,5,2,14,47,24,12,23,January,0.4999999999999999,0.8660254037844387,0,43,5,0,0,3.0,0.4,50,23,27,25,38,-13,"January, 2017"
2016-2017,23,2017-01-31,Liverpool,Chelsea,1,1,D,1,1,3,1,1,5,0,0,4,1,45,55,3,10,January,0.4999999999999999,0.8660254037844387,25,14,2,2,1,1.6,1.2,51,27,24,47,15,32,"January, 2017"
2016-2017,23,2017-02-01,Man United,Hull,0,0,D,1,1,1,2,2,1,1,3,6,20,41,16,14,25,February,0.8660254037844386,0.5000000000000001,28,21,4,1,0,2.0,0.6,33,21,12,20,47,-27,"February, 2017"
2016-2017,23,2017-02-01,Stoke,Everton,1,1,D,1,1,1,2,2,1,1,3,10,7,28,36,3,8,February,0.8660254037844386,0.5000000000000001,39,18,3,0,2,1.4,1.4,28,34,-6,33,23,10,"February, 2017"
2016-2017,23,2017-02-01,West Ham,Man City,0,4,A,0,3,2,2,1,4,1,0,11,5,28,43,6,15,February,0.8660254037844386,0.5000000000000001,45,27,2,1,2,1.4,1.8,29,36,-7,43,28,15,"February, 2017"
2016-2017,24,2017-02-04,Tottenham,Middlesbrough,1,0,H,3,0,4,0,1,1,1,3,2,15,47,21,13,26,February,0.8660254037844386,0.5000000000000001,42,29,2,2,1,1.8,1.0,45,16,29,19,26,-7,"February, 2017"
2016-2017,24,2017-02-04,West Brom,Stoke,1,0,H,3,0,0,1,4,1,2,2,8,11,33,29,3,4,February,0.8660254037844386,0.5000000000000001,44,39,3,1,1,1.0,0.8,31,29,2,29,35,-6,"February, 2017"
2016-2017,24,2017-02-04,Watford,Burnley,2,1,H,3,0,0,0,5,1,1,3,13,11,27,29,2,2,February,0.8660254037844386,0.5000000000000001,43,11,0,0,1,0.0,2.0,27,39,-12,25,33,-8,"February, 2017"
2016-2017,24,2017-02-04,Southampton,West Ham,1,3,A,0,3,1,2,2,2,2,1,12,11,27,28,1,1,February,0.8660254037844386,0.5000000000000001,38,45,3,1,1,1.6,0.6,23,28,-5,29,40,-11,"February, 2017"
2016-2017,24,2017-02-04,Crystal Palace,Sunderland,0,4,A,0,3,1,0,4,1,0,4,18,20,19,16,2,3,February,0.8660254037844386,0.5000000000000001,16,40,2,1,2,2.0,1.8,32,41,-9,20,42,-22,"February, 2017"
2016-2017,24,2017-02-04,Everton,Bournemouth,6,3,H,3,0,1,1,3,3,2,0,7,14,37,26,7,11,February,0.8660254037844386,0.5000000000000001,18,7,1,1,1,1.6666666666666667,1.6666666666666667,34,24,10,32,41,-9,"February, 2017"
2016-2017,24,2017-02-04,Chelsea,Arsenal,3,1,H,3,0,5,0,0,5,0,0,1,3,56,47,2,9,February,0.8660254037844386,0.5000000000000001,14,0,3,1,1,1.0,0.6,48,16,32,51,25,26,"February, 2017"
2016-2017,24,2017-02-04,Hull,Liverpool,2,0,H,3,0,1,1,3,3,1,1,20,4,17,46,16,29,February,0.8660254037844386,0.5000000000000001,21,25,2,1,2,1.0,1.6,20,47,-27,52,28,24,"February, 2017"
2016-2017,24,2017-02-05,Leicester,Man United,0,3,A,0,3,2,1,2,1,2,2,16,6,21,42,10,21,February,0.8660254037844386,0.5000000000000001,24,28,1,2,2,1.8,2.4,24,38,-14,33,21,12,"February, 2017"
2016-2017,24,2017-02-05,Man City,Swansea,2,1,H,3,0,4,1,0,4,1,0,5,17,46,21,12,25,February,0.8660254037844386,0.5000000000000001,27,41,4,1,0,2.4,1.2,47,28,19,28,52,-24,"February, 2017"
2016-2017,25,2017-02-11,West Ham,West Brom,2,2,D,1,1,2,2,1,0,1,4,10,8,31,36,2,5,February,0.8660254037844386,0.5000000000000001,45,44,2,2,1,1.8,1.4,32,41,-9,32,29,3,"February, 2017"
2016-2017,25,2017-02-11,Sunderland,Southampton,0,4,A,0,3,1,0,4,1,2,2,20,13,19,27,7,8,February,0.8660254037844386,0.5000000000000001,40,38,1,2,2,0.8,2.4,24,42,-18,24,31,-7,"February, 2017"
2016-2017,25,2017-02-11,Stoke,Crystal Palace,1,0,H,3,0,1,2,2,1,0,4,11,19,29,19,8,10,February,0.8660254037844386,0.5000000000000001,39,16,0,1,4,1.0,2.2,29,36,-7,32,45,-13,"February, 2017"
2016-2017,25,2017-02-11,Middlesbrough,Everton,0,0,D,1,1,1,1,3,1,1,3,15,7,21,40,8,19,February,0.8660254037844386,0.5000000000000001,29,18,0,1,4,0.4,1.8,19,27,-8,40,27,13,"February, 2017"
2016-2017,25,2017-02-11,Liverpool,Tottenham,2,0,H,3,0,3,1,1,4,0,1,5,2,46,50,3,4,February,0.8660254037844386,0.5000000000000001,25,42,2,3,0,1.6,0.8,52,30,22,46,16,30,"February, 2017"
2016-2017,25,2017-02-11,Arsenal,Hull,2,0,H,3,0,5,0,0,1,1,3,4,18,47,20,14,27,February,0.8660254037844386,0.5000000000000001,0,21,4,1,0,2.8,0.8,52,28,24,22,47,-25,"February, 2017"
2016-2017,25,2017-02-11,Man United,Watford,2,0,H,3,0,1,2,2,0,0,5,6,10,45,30,4,15,February,0.8660254037844386,0.5000000000000001,28,43,4,0,1,2.0,1.0,36,21,15,29,40,-11,"February, 2017"
2016-2017,25,2017-02-12,Burnley,Chelsea,1,1,D,1,1,1,1,3,5,0,0,13,1,29,59,12,30,February,0.8660254037844386,0.5000000000000001,11,14,0,1,4,0.6,2.4,26,35,-9,51,17,34,"February, 2017"
2016-2017,25,2017-02-12,Swansea,Leicester,2,0,H,3,0,4,1,0,2,1,2,17,16,21,21,1,0,February,0.8660254037844386,0.5000000000000001,41,24,1,0,4,0.6,2.2,29,54,-25,24,41,-17,"February, 2017"
2016-2017,25,2017-02-13,Bournemouth,Man City,0,2,A,0,3,3,2,0,4,1,0,14,5,26,49,9,23,February,0.8660254037844386,0.5000000000000001,7,27,0,0,3,0.3333333333333333,4.333333333333333,35,47,-12,49,29,20,"February, 2017"
2016-2017,26,2017-02-25,Watford,West Ham,1,1,D,1,1,0,0,5,2,2,1,13,10,30,32,3,2,February,0.8660254037844386,0.5000000000000001,43,45,3,1,1,1.8,1.2,29,42,-13,34,43,-9,"February, 2017"
2016-2017,26,2017-02-25,West Brom,Bournemouth,2,1,H,3,0,0,1,4,3,2,0,8,14,37,26,6,11,February,0.8660254037844386,0.5000000000000001,44,7,0,1,2,0.6666666666666666,1.3333333333333333,34,31,3,35,49,-14,"February, 2017"
2016-2017,26,2017-02-25,Hull,Burnley,1,1,D,1,1,1,1,3,1,1,3,19,12,20,30,7,10,February,0.8660254037844386,0.5000000000000001,21,11,0,1,4,0.4,1.8,22,49,-27,27,36,-9,"February, 2017"
2016-2017,26,2017-02-25,Crystal Palace,Middlesbrough,1,0,H,3,0,1,0,4,1,1,3,19,16,19,22,3,3,February,0.8660254037844386,0.5000000000000001,16,29,1,0,2,1.0,1.3333333333333333,32,46,-14,19,27,-8,"February, 2017"
2016-2017,26,2017-02-25,Chelsea,Swansea,3,1,H,3,0,5,0,0,4,1,0,1,15,60,24,14,36,February,0.8660254037844386,0.5000000000000001,14,41,2,2,1,2.6,1.4,52,18,34,31,54,-23,"February, 2017"
2016-2017,26,2017-02-25,Everton,Sunderland,2,0,H,3,0,1,1,3,1,0,4,7,20,41,19,13,22,February,0.8660254037844386,0.5000000000000001,18,40,2,1,2,2.0,1.6,40,27,13,24,46,-22,"February, 2017"
2016-2017,26,2017-02-26,Tottenham,Stoke,4,0,H,3,0,4,0,1,1,2,2,3,10,50,32,7,18,February,0.8660254037844386,0.5000000000000001,42,39,2,1,2,2.2,1.4,46,18,28,30,36,-6,"February, 2017"
2016-2017,26,2017-02-27,Leicester,Liverpool,3,1,H,3,0,2,1,2,3,1,1,18,5,21,49,13,28,February,0.8660254037844386,0.5000000000000001,24,25,1,1,3,1.2,2.0,24,43,-19,54,30,24,"February, 2017"
2016-2017,27,2017-03-04,West Brom,Crystal Palace,0,2,A,0,3,0,1,4,1,0,4,8,18,40,22,10,18,March,1.0,6.123233995736766e-17,44,16,3,1,1,1.6,1.2,36,32,4,33,46,-13,"March, 2017"
2016-2017,27,2017-03-04,Watford,Southampton,3,4,A,0,3,0,0,5,1,2,2,12,13,31,30,1,1,March,1.0,6.123233995736766e-17,43,38,1,2,2,0.8,1.4,30,43,-13,28,31,-3,"March, 2017"
2016-2017,27,2017-03-04,Stoke,Middlesbrough,2,0,H,3,0,1,2,2,1,1,3,10,17,32,22,7,10,March,1.0,6.123233995736766e-17,39,29,1,1,1,1.0,1.0,30,40,-10,19,28,-9,"March, 2017"
2016-2017,27,2017-03-04,Swansea,Burnley,3,2,H,3,0,4,1,0,1,1,3,16,11,24,31,5,7,March,1.0,6.123233995736766e-17,41,11,3,0,0,1.0,0.0,32,57,-25,28,37,-9,"March, 2017"
2016-2017,27,2017-03-04,Liverpool,Arsenal,3,1,H,3,0,3,1,1,5,0,0,5,4,49,50,1,1,March,1.0,6.123233995736766e-17,25,0,1,3,1,2.0,2.4,55,33,22,54,28,26,"March, 2017"
2016-2017,27,2017-03-04,Leicester,Hull,3,1,H,3,0,2,1,2,1,1,3,15,19,24,21,4,3,March,1.0,6.123233995736766e-17,24,21,1,1,1,0.6666666666666666,0.6666666666666666,27,44,-17,23,50,-27,"March, 2017"
2016-2017,27,2017-03-04,Man United,Bournemouth,1,1,D,1,1,1,2,2,3,2,0,6,15,48,26,9,22,March,1.0,6.123233995736766e-17,28,7,2,0,1,2.333333333333333,1.3333333333333333,38,21,17,36,51,-15,"March, 2017"
2016-2017,27,2017-03-05,Sunderland,Man City,0,2,A,0,3,1,0,4,4,1,0,20,4,19,52,16,33,March,1.0,6.123233995736766e-17,40,27,0,0,5,1.0,2.8,24,48,-24,51,29,22,"March, 2017"
2016-2017,27,2017-03-05,Tottenham,Everton,3,2,H,3,0,4,0,1,1,1,3,3,7,53,44,4,9,March,1.0,6.123233995736766e-17,42,18,2,3,0,1.0,0.6,50,18,32,42,27,15,"March, 2017"
2016-2017,27,2017-03-06,West Ham,Chelsea,1,2,A,0,3,2,2,1,5,0,0,11,1,33,63,10,30,March,1.0,6.123233995736766e-17,45,14,1,1,3,1.0,1.6,35,44,-9,55,19,36,"March, 2017"
2016-2017,27,2017-03-08,Man City,Stoke,0,0,D,1,1,4,1,0,1,2,2,3,9,55,35,6,20,March,1.0,6.123233995736766e-17,27,39,3,0,2,2.4,1.0,53,29,24,32,40,-8,"March, 2017"
2016-2017,28,2017-03-11,Everton,West Brom,3,0,H,3,0,1,1,3,0,1,4,7,8,44,40,1,4,March,1.0,6.123233995736766e-17,18,44,3,1,1,1.4,0.8,44,30,14,36,34,2,"March, 2017"
2016-2017,28,2017-03-11,Bournemouth,West Ham,3,2,H,3,0,3,2,0,2,2,1,14,11,27,33,3,6,March,1.0,6.123233995736766e-17,7,45,1,0,2,1.6666666666666667,2.333333333333333,37,52,-15,36,46,-10,"March, 2017"
2016-2017,28,2017-03-11,Hull,Swansea,2,1,H,3,0,1,1,3,4,1,0,19,16,21,27,3,6,March,1.0,6.123233995736766e-17,21,41,2,1,2,1.0,1.0,24,53,-29,35,59,-24,"March, 2017"
2016-2017,28,2017-03-12,Liverpool,Burnley,2,1,H,3,0,3,1,1,1,1,3,4,12,52,31,8,21,March,1.0,6.123233995736766e-17,25,11,4,0,1,2.2,0.4,58,34,24,30,40,-10,"March, 2017"
2016-2017,29,2017-03-18,West Brom,Arsenal,3,1,H,3,0,0,1,4,5,0,0,8,5,40,50,3,10,March,1.0,6.123233995736766e-17,44,0,1,0,4,0.6,1.8,36,37,-1,55,31,24,"March, 2017"
2016-2017,29,2017-03-18,West Ham,Leicester,2,3,A,0,3,2,2,1,2,1,2,11,16,33,27,5,6,March,1.0,6.123233995736766e-17,45,24,1,1,3,1.2,1.4,38,49,-11,30,45,-15,"March, 2017"
2016-2017,29,2017-03-18,Sunderland,Burnley,0,0,D,1,1,1,0,4,1,1,3,20,13,19,31,7,12,March,1.0,6.123233995736766e-17,40,11,2,1,2,1.2,1.6,24,50,-26,31,42,-11,"March, 2017"
2016-2017,29,2017-03-18,Bournemouth,Swansea,2,0,H,3,0,3,2,0,4,1,0,14,16,30,27,2,3,March,1.0,6.123233995736766e-17,7,41,2,1,0,2.6666666666666665,1.3333333333333333,40,54,-14,36,61,-25,"March, 2017"
2016-2017,29,2017-03-18,Everton,Hull,4,0,H,3,0,1,1,3,1,1,3,7,18,47,24,11,23,March,1.0,6.123233995736766e-17,18,21,2,2,1,1.4,1.2,47,30,17,26,54,-28,"March, 2017"
2016-2017,29,2017-03-18,Crystal Palace,Watford,1,0,H,3,0,1,0,4,0,0,5,17,14,25,31,3,6,March,1.0,6.123233995736766e-17,16,43,1,1,1,1.0,1.0,35,46,-11,33,47,-14,"March, 2017"
2016-2017,29,2017-03-18,Stoke,Chelsea,1,2,A,0,3,1,2,2,5,0,0,9,1,36,66,8,30,March,1.0,6.123233995736766e-17,39,14,1,1,3,1.0,1.8,32,40,-8,57,20,37,"March, 2017"
2016-2017,29,2017-03-19,Man City,Liverpool,1,1,D,1,1,4,1,0,3,1,1,3,4,56,55,1,1,March,1.0,6.123233995736766e-17,27,25,1,0,4,1.0,2.2,53,29,24,60,35,25,"March, 2017"
2016-2017,29,2017-03-19,Middlesbrough,Man United,1,3,A,0,3,1,1,3,1,2,2,19,7,22,49,12,27,March,1.0,6.123233995736766e-17,29,28,0,1,4,0.8,2.2,19,30,-11,39,22,17,"March, 2017"
2016-2017,29,2017-03-19,Tottenham,Southampton,2,1,H,3,0,4,0,1,1,2,2,3,10,56,33,7,23,March,1.0,6.123233995736766e-17,42,38,3,1,1,2.0,1.0,53,20,33,32,34,-2,"March, 2017"
2016-2017,30,2017-04-01,Southampton,Bournemouth,0,0,D,1,1,1,2,2,3,2,0,10,11,33,33,1,0,April,0.8660254037844388,-0.4999999999999998,38,7,2,0,1,1.6666666666666667,1.0,33,36,-3,42,54,-12,"April, 2017"
2016-2017,30,2017-04-01,Burnley,Tottenham,0,2,A,0,3,1,1,3,4,0,1,13,2,32,59,11,27,April,0.8660254037844388,-0.4999999999999998,11,42,1,1,3,1.2,2.2,31,42,-11,55,21,34,"April, 2017"
2016-2017,30,2017-04-01,Chelsea,Crystal Palace,1,2,A,0,3,5,0,0,1,0,4,1,16,69,28,15,41,April,0.8660254037844388,-0.4999999999999998,14,16,4,0,1,1.6,0.6,59,21,38,36,46,-10,"April, 2017"
2016-2017,30,2017-04-01,Hull,West Ham,2,1,H,3,0,1,1,3,2,2,1,18,12,24,33,6,9,April,0.8660254037844388,-0.4999999999999998,21,45,1,1,3,0.8,1.6,26,58,-32,40,52,-12,"April, 2017"
2016-2017,30,2017-04-01,Leicester,Stoke,2,0,H,3,0,2,1,2,1,2,2,16,9,30,36,7,6,April,0.8660254037844388,-0.4999999999999998,24,39,2,2,1,1.6,1.0,33,47,-14,33,42,-9,"April, 2017"
2016-2017,30,2017-04-01,Liverpool,Everton,3,1,H,3,0,3,1,1,1,1,3,4,7,56,50,3,6,April,0.8660254037844388,-0.4999999999999998,25,18,2,3,0,1.4,0.4,61,36,25,51,30,21,"April, 2017"
2016-2017,30,2017-04-01,Man United,West Brom,0,0,D,1,1,1,2,2,0,1,4,5,8,52,43,3,9,April,0.8660254037844388,-0.4999999999999998,28,44,2,1,2,1.2,0.8,42,23,19,39,38,1,"April, 2017"
2016-2017,30,2017-04-01,Watford,Sunderland,1,0,H,3,0,0,0,5,1,0,4,16,20,31,20,4,11,April,0.8660254037844388,-0.4999999999999998,43,40,1,1,3,1.0,1.6,33,48,-15,24,50,-26,"April, 2017"
2016-2017,30,2017-04-02,Swansea,Middlesbrough,0,0,D,1,1,4,1,0,1,1,3,17,19,27,22,2,5,April,0.8660254037844388,-0.4999999999999998,41,29,0,0,1,0.0,3.0,36,63,-27,20,33,-13,"April, 2017"
2016-2017,30,2017-04-02,Arsenal,Man City,2,2,D,1,1,5,0,0,4,1,0,6,4,50,57,2,7,April,0.8660254037844388,-0.4999999999999998,0,27,2,2,1,1.8,1.4,56,34,22,54,30,24,"April, 2017"
2016-2017,31,2017-04-04,Man United,Everton,1,1,D,1,1,1,2,2,1,1,3,5,7,53,50,2,3,April,0.8660254037844388,-0.4999999999999998,28,18,3,1,1,1.4,1.0,42,23,19,52,33,19,"April, 2017"
2016-2017,31,2017-04-04,Watford,West Brom,2,0,H,3,0,0,0,5,0,1,4,14,8,34,44,6,10,April,0.8660254037844388,-0.4999999999999998,43,44,1,1,1,0.6666666666666666,1.0,34,48,-14,39,38,1,"April, 2017"
2016-2017,31,2017-04-04,Burnley,Stoke,1,0,H,3,0,1,1,3,1,2,2,15,9,32,36,6,4,April,0.8660254037844388,-0.4999999999999998,11,39,1,2,2,0.6,1.2,31,44,-13,33,44,-11,"April, 2017"
2016-2017,31,2017-04-04,Leicester,Sunderland,2,0,H,3,0,2,1,2,1,0,4,14,20,33,20,6,13,April,0.8660254037844388,-0.4999999999999998,24,40,2,2,1,1.4,0.8,35,47,-12,24,51,-27,"April, 2017"
2016-2017,31,2017-04-05,Arsenal,West Ham,3,0,H,3,0,5,0,0,2,2,1,6,15,51,33,9,18,April,0.8660254037844388,-0.4999999999999998,0,45,3,1,1,2.6,1.4,58,36,22,41,54,-13,"April, 2017"
2016-2017,31,2017-04-05,Chelsea,Man City,2,1,H,3,0,5,0,0,4,1,0,1,4,69,58,3,11,April,0.8660254037844388,-0.4999999999999998,14,27,1,2,2,1.0,1.8,60,23,37,56,32,24,"April, 2017"
2016-2017,31,2017-04-05,Hull,Middlesbrough,4,2,H,3,0,1,1,3,1,1,3,18,19,27,23,1,4,April,0.8660254037844388,-0.4999999999999998,21,29,1,0,2,1.0,1.6666666666666667,28,59,-31,20,33,-13,"April, 2017"
2016-2017,31,2017-04-05,Liverpool,Bournemouth,2,2,D,1,1,3,1,1,3,2,0,3,14,59,34,11,25,April,0.8660254037844388,-0.4999999999999998,25,7,2,0,1,2.0,1.6666666666666667,64,37,27,42,54,-12,"April, 2017"
2016-2017,31,2017-04-05,Southampton,Crystal Palace,3,1,H,3,0,1,2,2,1,0,4,14,16,34,31,2,3,April,0.8660254037844388,-0.4999999999999998,38,16,3,0,2,1.6,1.2,33,36,-3,38,47,-9,"April, 2017"
2016-2017,31,2017-04-05,Swansea,Tottenham,1,3,A,0,3,4,1,0,4,0,1,18,2,28,62,16,34,April,0.8660254037844388,-0.4999999999999998,41,42,0,1,4,1.2,2.8,36,63,-27,57,21,36,"April, 2017"
2016-2017,32,2017-04-08,West Ham,Swansea,1,0,H,3,0,2,2,1,4,1,0,15,18,33,28,3,5,April,0.8660254037844388,-0.4999999999999998,45,41,2,2,1,1.8,1.4,41,57,-16,37,66,-29,"April, 2017"
2016-2017,32,2017-04-08,West Brom,Southampton,0,1,A,0,3,0,1,4,1,2,2,8,9,44,37,1,7,April,0.8660254037844388,-0.4999999999999998,44,38,2,2,1,0.6,0.8,39,40,-1,36,37,-1,"April, 2017"
2016-2017,32,2017-04-08,Tottenham,Watford,4,0,H,3,0,4,0,1,0,0,5,2,10,65,37,8,28,April,0.8660254037844388,-0.4999999999999998,42,43,4,1,0,2.0,0.6,60,22,38,36,48,-12,"April, 2017"
2016-2017,32,2017-04-08,Middlesbrough,Burnley,0,0,D,1,1,1,1,3,1,1,3,19,13,23,35,6,12,April,0.8660254037844388,-0.4999999999999998,29,11,0,0,1,0.0,1.0,22,37,-15,32,44,-12,"April, 2017"
2016-2017,32,2017-04-08,Man City,Hull,3,1,H,3,0,4,1,0,1,1,3,4,17,58,30,13,28,April,0.8660254037844388,-0.4999999999999998,27,21,4,1,0,2.4,0.6,57,34,23,32,61,-29,"April, 2017"
2016-2017,32,2017-04-08,Bournemouth,Chelsea,1,3,A,0,3,3,2,0,5,0,0,13,1,35,72,12,37,April,0.8660254037844388,-0.4999999999999998,7,14,1,0,2,0.6666666666666666,2.333333333333333,44,56,-12,62,24,38,"April, 2017"
2016-2017,32,2017-04-08,Stoke,Liverpool,1,2,A,0,3,1,2,2,3,1,1,12,4,36,60,8,24,April,0.8660254037844388,-0.4999999999999998,39,25,1,0,4,1.6,2.2,33,45,-12,66,39,27,"April, 2017"
2016-2017,32,2017-04-09,Everton,Leicester,4,2,H,3,0,1,1,3,2,1,2,7,11,51,36,4,15,April,0.8660254037844388,-0.4999999999999998,18,24,1,2,2,1.8,2.0,53,34,19,37,47,-10,"April, 2017"
2016-2017,32,2017-04-09,Sunderland,Man United,0,3,A,0,3,1,0,4,1,2,2,20,7,20,54,13,34,April,0.8660254037844388,-0.4999999999999998,40,28,1,1,3,0.8,2.0,24,53,-29,43,24,19,"April, 2017"
2016-2017,32,2017-04-10,Crystal Palace,Arsenal,3,0,H,3,0,1,0,4,5,0,0,16,6,31,54,10,23,April,0.8660254037844388,-0.4999999999999998,16,0,0,1,4,0.8,1.8,39,50,-11,61,36,25,"April, 2017"
2016-2017,33,2017-04-15,Watford,Swansea,1,0,H,3,0,0,0,5,4,1,0,13,18,37,28,5,9,April,0.8660254037844388,-0.4999999999999998,43,41,1,1,1,0.3333333333333333,0.3333333333333333,36,52,-16,37,67,-30,"April, 2017"
2016-2017,33,2017-04-15,Tottenham,Bournemouth,4,0,H,3,0,4,0,1,3,2,0,2,16,68,35,14,33,April,0.8660254037844388,-0.4999999999999998,42,7,2,1,0,2.6666666666666665,0.3333333333333333,64,22,42,45,59,-14,"April, 2017"
2016-2017,33,2017-04-15,Stoke,Hull,3,1,H,3,0,1,2,2,1,1,3,12,17,36,30,5,6,April,0.8660254037844388,-0.4999999999999998,39,21,3,2,0,1.0,0.2,34,47,-13,33,64,-31,"April, 2017"
2016-2017,33,2017-04-15,Sunderland,West Ham,2,2,D,1,1,1,0,4,2,2,1,20,14,20,36,6,16,April,0.8660254037844388,-0.4999999999999998,40,45,0,2,3,0.6,1.2,24,56,-32,42,57,-15,"April, 2017"
2016-2017,33,2017-04-15,Everton,Burnley,3,1,H,3,0,1,1,3,1,1,3,7,12,54,36,5,18,April,0.8660254037844388,-0.4999999999999998,18,11,3,0,2,1.4,0.8,57,36,21,32,44,-12,"April, 2017"
2016-2017,33,2017-04-15,Crystal Palace,Leicester,2,2,D,1,1,1,0,4,2,1,2,16,11,34,36,5,2,April,0.8660254037844388,-0.4999999999999998,16,24,2,0,3,0.8,1.0,42,50,-8,39,51,-12,"April, 2017"
2016-2017,33,2017-04-15,Southampton,Man City,0,3,A,0,3,1,2,2,4,1,0,9,4,40,61,5,21,April,0.8660254037844388,-0.4999999999999998,38,27,1,1,3,1.2,2.2,37,37,0,60,35,25,"April, 2017"
2016-2017,33,2017-04-16,Man United,Chelsea,2,0,H,3,0,1,2,2,5,0,0,6,1,57,75,5,18,April,0.8660254037844388,-0.4999999999999998,28,14,0,3,2,0.4,1.4,46,24,22,65,25,40,"April, 2017"
2016-2017,33,2017-04-16,West Brom,Liverpool,0,1,A,0,3,0,1,4,3,1,1,8,4,44,63,4,19,April,0.8660254037844388,-0.4999999999999998,44,25,0,3,2,1.0,1.4,39,41,-2,68,40,28,"April, 2017"
2016-2017,33,2017-04-17,Middlesbrough,Arsenal,1,2,A,0,3,1,1,3,5,0,0,19,7,24,54,12,30,April,0.8660254037844388,-0.4999999999999998,29,0,1,3,1,0.8,1.0,22,37,-15,61,39,22,"April, 2017"
2016-2017,34,2017-04-22,Bournemouth,Middlesbrough,4,0,H,3,0,3,2,0,1,1,3,16,19,35,24,3,11,April,0.8660254037844388,-0.4999999999999998,7,29,0,0,1,0.0,2.0,45,63,-18,23,39,-16,"April, 2017"
2016-2017,34,2017-04-22,Hull,Watford,2,0,H,3,0,1,1,3,0,0,5,17,10,30,40,7,10,April,0.8660254037844388,-0.4999999999999998,21,43,0,0,1,0.0,1.0,34,67,-33,37,52,-15,"April, 2017"
2016-2017,34,2017-04-22,Swansea,Stoke,2,0,H,3,0,4,1,0,1,2,2,18,11,28,39,7,11,April,0.8660254037844388,-0.4999999999999998,41,39,1,1,3,1.2,1.6,37,68,-31,37,48,-11,"April, 2017"
2016-2017,34,2017-04-22,West Ham,Everton,0,0,D,1,1,2,2,1,1,1,3,14,7,37,57,7,20,April,0.8660254037844388,-0.4999999999999998,45,18,1,1,3,1.2,1.8,44,59,-15,60,37,23,"April, 2017"
2016-2017,34,2017-04-23,Liverpool,Crystal Palace,1,2,A,0,3,3,1,1,1,0,4,3,16,66,35,13,31,April,0.8660254037844388,-0.4999999999999998,25,16,2,0,3,1.8,2.2,69,40,29,44,52,-8,"April, 2017"
2016-2017,34,2017-04-23,Burnley,Man United,0,2,A,0,3,1,1,3,1,2,2,15,5,36,60,10,24,April,0.8660254037844388,-0.4999999999999998,11,28,1,2,2,0.4,1.2,33,47,-14,48,24,24,"April, 2017"
2016-2017,34,2017-04-25,Chelsea,Southampton,4,2,H,3,0,5,0,0,1,2,2,1,9,75,40,8,35,April,0.8660254037844388,-0.4999999999999998,14,38,2,2,1,1.4,1.2,65,27,38,37,40,-3,"April, 2017"
2016-2017,34,2017-04-26,Arsenal,Leicester,1,0,H,3,0,5,0,0,2,1,2,7,15,57,37,8,20,April,0.8660254037844388,-0.4999999999999998,0,24,3,2,0,2.0,1.0,63,40,23,41,53,-12,"April, 2017"
2016-2017,34,2017-04-26,Crystal Palace,Tottenham,0,1,A,0,3,1,0,4,4,0,1,12,2,38,71,10,33,April,0.8660254037844388,-0.4999999999999998,16,42,1,1,3,0.6,1.2,46,53,-7,68,22,46,"April, 2017"
2016-2017,34,2017-04-26,Middlesbrough,Sunderland,1,0,H,3,0,1,1,3,1,0,4,19,20,24,21,1,3,April,0.8660254037844388,-0.4999999999999998,29,40,1,2,2,1.4,1.8,23,43,-20,26,58,-32,"April, 2017"
2016-2017,34,2017-04-27,Man City,Man United,0,0,D,1,1,4,1,0,1,2,2,4,5,64,63,1,1,April,0.8660254037844388,-0.4999999999999998,27,28,2,1,2,1.0,1.2,63,35,28,50,24,26,"April, 2017"
2016-2017,35,2017-04-29,Crystal Palace,Burnley,0,2,A,0,3,1,0,4,1,1,3,12,16,38,36,4,2,April,0.8660254037844388,-0.4999999999999998,16,11,1,1,1,1.6666666666666667,1.6666666666666667,46,54,-8,33,49,-16,"April, 2017"
2016-2017,35,2017-04-29,Southampton,Hull,0,0,D,1,1,1,2,2,1,1,3,9,17,40,33,8,7,April,0.8660254037844388,-0.4999999999999998,38,21,4,0,1,1.8,0.6,39,44,-5,36,67,-31,"April, 2017"
2016-2017,35,2017-04-29,Stoke,West Ham,0,0,D,1,1,1,2,2,2,2,1,11,15,39,38,4,1,April,0.8660254037844388,-0.4999999999999998,39,45,1,4,0,1.2,1.0,37,50,-13,44,59,-15,"April, 2017"
2016-2017,35,2017-04-29,Sunderland,Bournemouth,0,1,A,0,3,1,0,4,3,2,0,20,15,21,38,5,17,April,0.8660254037844388,-0.4999999999999998,40,7,1,1,1,1.0,1.3333333333333333,26,59,-33,49,63,-14,"April, 2017"
2016-2017,35,2017-04-29,West Brom,Leicester,0,1,A,0,3,0,1,4,2,1,2,8,16,44,37,8,7,April,0.8660254037844388,-0.4999999999999998,44,24,2,1,2,1.8,1.8,39,42,-3,41,54,-13,"April, 2017"
2016-2017,35,2017-04-30,Tottenham,Arsenal,2,0,H,3,0,4,0,1,5,0,0,2,6,74,60,4,14,April,0.8660254037844388,-0.4999999999999998,42,0,1,4,0,1.4,1.2,69,22,47,64,40,24,"April, 2017"
2016-2017,35,2017-04-30,Middlesbrough,Man City,2,2,D,1,1,1,1,3,4,1,0,19,4,27,65,15,38,April,0.8660254037844388,-0.4999999999999998,29,27,2,1,2,2.4,1.2,24,43,-19,63,35,28,"April, 2017"
2016-2017,35,2017-04-30,Everton,Chelsea,0,3,A,0,3,1,1,3,5,0,0,7,1,58,78,6,20,April,0.8660254037844388,-0.4999999999999998,18,14,1,1,3,1.8,3.2,60,37,23,69,29,40,"April, 2017"
2016-2017,35,2017-04-30,Man United,Swansea,1,1,D,1,1,1,2,2,4,1,0,5,18,64,31,13,33,April,0.8660254037844388,-0.4999999999999998,28,41,2,0,3,1.6,1.6,50,24,26,39,68,-29,"April, 2017"
2016-2017,35,2017-05-01,Watford,Liverpool,0,1,A,0,3,0,0,5,3,1,1,13,3,40,66,10,26,May,0.4999999999999999,-0.8660254037844387,43,25,1,0,4,0.8,2.6,37,54,-17,70,42,28,"May, 2017"
2016-2017,36,2017-05-05,West Ham,Tottenham,1,0,H,3,0,2,2,1,4,0,1,15,2,39,77,13,38,May,0.4999999999999999,-0.8660254037844387,45,42,1,1,3,1.2,2.0,44,59,-15,71,22,49,"May, 2017"
2016-2017,36,2017-05-06,Bournemouth,Stoke,2,2,D,1,1,3,2,0,1,2,2,11,13,41,40,2,1,May,0.4999999999999999,-0.8660254037844387,7,39,1,0,2,1.0,1.6666666666666667,50,63,-13,37,50,-13,"May, 2017"
2016-2017,36,2017-05-06,Burnley,West Brom,2,2,D,1,1,1,1,3,0,1,4,15,8,39,44,7,5,May,0.4999999999999999,-0.8660254037844387,11,44,0,1,2,0.6666666666666666,3.333333333333333,35,49,-14,39,43,-4,"May, 2017"
2016-2017,36,2017-05-06,Hull,Sunderland,0,2,A,0,3,1,1,3,1,0,4,17,20,34,21,3,13,May,0.4999999999999999,-0.8660254037844387,21,40,3,1,1,1.4,1.0,36,67,-31,26,60,-34,"May, 2017"
2016-2017,36,2017-05-06,Leicester,Watford,3,0,H,3,0,2,1,2,0,0,5,13,15,40,40,2,0,May,0.4999999999999999,-0.8660254037844387,24,43,3,1,1,1.2,0.8,42,54,-12,37,55,-18,"May, 2017"
2016-2017,36,2017-05-06,Man City,Crystal Palace,5,0,H,3,0,4,1,0,1,0,4,4,16,66,38,12,28,May,0.4999999999999999,-0.8660254037844387,27,16,4,0,1,2.2,0.6,65,37,28,46,56,-10,"May, 2017"
2016-2017,36,2017-05-06,Swansea,Everton,1,0,H,3,0,4,1,0,1,1,3,18,7,32,58,11,26,May,0.4999999999999999,-0.8660254037844387,41,18,1,4,0,0.8,0.6,40,69,-29,60,40,20,"May, 2017"
2016-2017,36,2017-05-07,Liverpool,Southampton,0,0,D,1,1,3,1,1,1,2,2,4,12,69,41,8,28,May,0.4999999999999999,-0.8660254037844387,25,38,2,2,1,1.4,1.0,71,42,29,39,44,-5,"May, 2017"
2016-2017,36,2017-05-07,Arsenal,Man United,2,0,H,3,0,5,0,0,1,2,2,6,5,60,65,1,5,May,0.4999999999999999,-0.8660254037844387,0,28,1,2,2,1.6,1.4,64,42,22,51,25,26,"May, 2017"
2016-2017,36,2017-05-08,Chelsea,Middlesbrough,3,0,H,3,0,5,0,0,1,1,3,1,19,81,28,18,53,May,0.4999999999999999,-0.8660254037844387,14,29,5,0,0,2.2,0.0,72,29,43,26,45,-19,"May, 2017"
2016-2017,36,2017-05-10,Southampton,Arsenal,0,2,A,0,3,1,2,2,5,0,0,10,6,42,63,4,21,May,0.4999999999999999,-0.8660254037844387,38,0,2,1,2,1.4,0.6,39,44,-5,66,42,24,"May, 2017"
2016-2017,37,2017-05-12,Everton,Watford,1,0,H,3,0,1,1,3,0,0,5,7,15,58,40,8,18,May,0.4999999999999999,-0.8660254037844387,18,43,2,2,1,2.0,1.4,60,41,19,37,58,-21,"May, 2017"
2016-2017,37,2017-05-12,West Brom,Chelsea,0,1,A,0,3,0,1,4,5,0,0,8,1,45,84,7,39,May,0.4999999999999999,-0.8660254037844387,44,14,1,1,3,1.4,1.6,41,45,-4,75,29,46,"May, 2017"
2016-2017,37,2017-05-13,Bournemouth,Burnley,2,1,H,3,0,3,2,0,1,1,3,11,14,42,40,3,2,May,0.4999999999999999,-0.8660254037844387,7,11,0,0,1,2.0,3.0,52,65,-13,37,51,-14,"May, 2017"
2016-2017,37,2017-05-13,Man City,Leicester,2,1,H,3,0,4,1,0,2,1,2,4,10,69,43,6,26,May,0.4999999999999999,-0.8660254037844387,27,24,2,1,2,1.2,1.4,70,37,33,45,54,-9,"May, 2017"
2016-2017,37,2017-05-13,Middlesbrough,Southampton,1,2,A,0,3,1,1,3,1,2,2,19,11,28,42,8,14,May,0.4999999999999999,-0.8660254037844387,29,38,2,1,2,1.4,1.4,26,48,-22,39,46,-7,"May, 2017"
2016-2017,37,2017-05-13,Stoke,Arsenal,1,4,A,0,3,1,2,2,5,0,0,13,5,41,66,8,25,May,0.4999999999999999,-0.8660254037844387,39,0,1,1,3,0.8,2.0,39,52,-13,68,42,26,"May, 2017"
2016-2017,37,2017-05-13,Sunderland,Swansea,0,2,A,0,3,1,0,4,4,1,0,20,17,24,35,3,11,May,0.4999999999999999,-0.8660254037844387,40,41,1,3,1,1.2,1.4,28,60,-32,41,69,-28,"May, 2017"
2016-2017,37,2017-05-14,West Ham,Liverpool,0,4,A,0,3,2,2,1,3,1,1,12,4,42,70,8,28,May,0.4999999999999999,-0.8660254037844387,45,25,3,1,1,2.0,1.0,45,59,-14,71,42,29,"May, 2017"
2016-2017,37,2017-05-14,Crystal Palace,Hull,4,0,H,3,0,1,0,4,1,1,3,16,18,38,34,2,4,May,0.4999999999999999,-0.8660254037844387,16,21,2,1,2,1.0,1.4,46,61,-15,36,69,-33,"May, 2017"
2016-2017,37,2017-05-14,Tottenham,Man United,2,1,H,3,0,4,0,1,1,2,2,2,6,77,65,4,12,May,0.4999999999999999,-0.8660254037844387,42,28,1,1,3,0.6,1.0,71,23,48,51,27,24,"May, 2017"
2016-2017,37,2017-05-15,Chelsea,Watford,4,3,H,3,0,5,0,0,0,0,5,1,16,87,40,15,47,May,0.4999999999999999,-0.8660254037844387,14,43,3,2,0,1.8,0.6,76,29,47,37,59,-22,"May, 2017"
2016-2017,37,2017-05-16,Arsenal,Sunderland,2,0,H,3,0,5,0,0,1,0,4,5,20,69,24,15,45,May,0.4999999999999999,-0.8660254037844387,0,40,3,2,0,1.8,0.4,72,43,29,28,62,-34,"May, 2017"
2016-2017,37,2017-05-16,Man City,West Brom,3,1,H,3,0,4,1,0,0,1,4,4,8,72,45,4,27,May,0.4999999999999999,-0.8660254037844387,27,44,5,0,0,3.0,0.4,72,38,34,41,46,-5,"May, 2017"
2016-2017,37,2017-05-17,Southampton,Man United,0,0,D,1,1,1,2,2,1,2,2,8,6,45,65,2,20,May,0.4999999999999999,-0.8660254037844387,38,28,2,0,3,1.0,1.4,41,47,-6,52,29,23,"May, 2017"
2016-2017,37,2017-05-18,Leicester,Tottenham,1,6,A,0,3,2,1,2,4,0,1,11,2,43,80,9,37,May,0.4999999999999999,-0.8660254037844387,24,42,1,2,2,1.4,1.6,46,56,-10,73,24,49,"May, 2017"
2016-2017,38,2017-05-21,Watford,Man City,0,5,A,0,3,0,0,5,4,1,0,17,4,40,75,13,35,May,0.4999999999999999,-0.8660254037844387,43,27,0,2,3,0.4,1.4,40,63,-23,75,39,36,"May, 2017"
2016-2017,38,2017-05-21,Swansea,West Brom,2,1,H,3,0,4,1,0,0,1,4,17,10,38,45,7,7,May,0.4999999999999999,-0.8660254037844387,41,44,2,1,2,1.2,1.2,43,69,-26,42,49,-7,"May, 2017"
2016-2017,38,2017-05-21,Southampton,Stoke,0,1,A,0,3,1,2,2,1,2,2,8,14,46,41,6,5,May,0.4999999999999999,-0.8660254037844387,38,39,2,1,2,0.8,0.8,41,47,-6,40,56,-16,"May, 2017"
2016-2017,38,2017-05-21,Man United,Crystal Palace,2,0,H,3,0,1,2,2,1,0,4,6,13,66,41,7,25,May,0.4999999999999999,-0.8660254037844387,28,16,4,1,0,1.4,0.4,52,29,23,50,61,-11,"May, 2017"
2016-2017,38,2017-05-21,Liverpool,Middlesbrough,3,0,H,3,0,3,1,1,1,1,3,5,19,73,28,14,45,May,0.4999999999999999,-0.8660254037844387,25,29,3,1,1,1.8,1.2,75,42,33,27,50,-23,"May, 2017"
2016-2017,38,2017-05-21,Chelsea,Sunderland,5,1,H,3,0,5,0,0,1,0,4,1,20,90,24,19,66,May,0.4999999999999999,-0.8660254037844387,14,40,3,1,1,1.8,1.0,80,32,48,28,64,-36,"May, 2017"
2016-2017,38,2017-05-21,Hull,Tottenham,1,7,A,0,3,1,1,3,4,0,1,18,2,34,83,16,49,May,0.4999999999999999,-0.8660254037844387,21,42,0,1,4,0.4,1.8,36,73,-37,79,25,54,"May, 2017"
2016-2017,38,2017-05-21,Burnley,West Ham,1,2,A,0,3,1,1,3,2,2,1,15,12,40,42,3,2,May,0.4999999999999999,-0.8660254037844387,11,45,1,0,4,1.2,2.2,38,53,-15,45,63,-18,"May, 2017"
2016-2017,38,2017-05-21,Arsenal,Everton,3,1,H,3,0,5,0,0,1,1,3,5,7,72,61,2,11,May,0.4999999999999999,-0.8660254037844387,0,18,3,1,1,1.8,1.0,74,43,31,61,41,20,"May, 2017"
2016-2017,38,2017-05-21,Leicester,Bournemouth,1,1,D,1,1,2,1,2,3,2,0,12,10,43,45,2,2,May,0.4999999999999999,-0.8660254037844387,24,7,0,2,1,0.3333333333333333,0.6666666666666666,47,62,-15,54,66,-12,"May, 2017"
2017-2018,1,2017-08-11,Arsenal,Leicester,4,3,H,3,0,3,0,2,1,1,3,1,9,0,0,8,0,August,-0.8660254037844384,-0.5000000000000004,0,24,4,1,0,2.0,0.8,0,0,0,0,0,0,"August, 2017"
2017-2018,1,2017-08-12,Watford,Liverpool,3,3,D,1,1,1,1,3,2,2,1,13,9,0,0,4,0,August,-0.8660254037844384,-0.5000000000000004,43,25,1,0,4,0.8,2.4,0,0,0,0,0,0,"August, 2017"
2017-2018,1,2017-08-12,West Brom,Bournemouth,1,0,H,3,0,3,1,1,2,0,3,14,10,0,0,4,0,August,-0.8660254037844384,-0.5000000000000004,44,7,1,1,2,1.0,1.25,0,0,0,0,0,0,"August, 2017"
2017-2018,1,2017-08-12,Everton,Stoke,1,0,H,3,0,2,2,1,1,3,1,6,11,0,0,5,0,August,-0.8660254037844384,-0.5000000000000004,18,39,2,1,2,1.6,1.4,0,0,0,0,0,0,"August, 2017"
2017-2018,1,2017-08-12,Southampton,Swansea,0,0,D,1,1,2,2,1,0,0,5,10,11,0,0,1,0,August,-0.8660254037844384,-0.5000000000000004,38,41,3,0,2,1.2,0.8,0,0,0,0,0,0,"August, 2017"
2017-2018,1,2017-08-12,Crystal Palace,Huddersfield,0,3,A,0,3,4,1,0,1,2,2,5,7,0,0,2,0,August,-0.8660254037844384,-0.5000000000000004,16,20,0,0,0,0.0,0.0,0,0,0,0,0,0,"August, 2017"
2017-2018,1,2017-08-12,Chelsea,Burnley,2,3,A,0,3,3,1,1,0,2,3,5,4,0,0,1,0,August,-0.8660254037844384,-0.5000000000000004,14,11,3,2,0,2.0,0.8,0,0,0,0,0,0,"August, 2017"
2017-2018,1,2017-08-12,Brighton,Man City,0,2,A,0,3,1,2,2,4,1,0,3,10,0,0,7,0,August,-0.8660254037844384,-0.5000000000000004,10,27,0,0,0,0.0,0.0,0,0,0,0,0,0,"August, 2017"
2017-2018,1,2017-08-13,Man United,West Ham,4,0,H,3,0,3,1,1,2,1,2,11,14,0,0,3,0,August,-0.8660254037844384,-0.5000000000000004,28,45,1,3,1,1.2,1.0,0,0,0,0,0,0,"August, 2017"
2017-2018,1,2017-08-13,Newcastle,Tottenham,0,2,A,0,3,1,0,4,3,1,1,12,13,0,0,1,0,August,-0.8660254037844384,-0.5000000000000004,30,42,3,0,2,2.0,2.0,0,0,0,0,0,0,"August, 2017"
2017-2018,2,2017-08-19,Stoke,Arsenal,1,0,H,3,0,1,3,1,3,0,2,15,10,0,3,5,3,August,-0.8660254037844384,-0.5000000000000004,39,0,0,1,4,0.4,2.4,0,1,-1,4,3,1,"August, 2017"
2017-2018,2,2017-08-19,Southampton,West Ham,3,2,H,3,0,2,2,1,2,1,2,12,20,1,0,8,1,August,-0.8660254037844384,-0.5000000000000004,38,45,2,1,2,1.2,1.0,0,0,0,0,4,-4,"August, 2017"
2017-2018,2,2017-08-19,Liverpool,Crystal Palace,1,0,H,3,0,2,2,1,4,1,0,11,18,1,0,7,1,August,-0.8660254037844384,-0.5000000000000004,25,16,2,0,3,1.8,2.0,3,3,0,0,3,-3,"August, 2017"
2017-2018,2,2017-08-19,Swansea,Man United,0,4,A,0,3,0,0,5,3,1,1,14,5,1,3,9,2,August,-0.8660254037844384,-0.5000000000000004,41,28,2,1,2,1.4,1.6,0,0,0,4,0,4,"August, 2017"
2017-2018,2,2017-08-19,Burnley,West Brom,0,1,A,0,3,0,2,3,3,1,1,7,9,3,3,2,0,August,-0.8660254037844384,-0.5000000000000004,11,44,0,2,2,1.0,3.0,3,2,1,1,0,1,"August, 2017"
2017-2018,2,2017-08-19,Bournemouth,Watford,0,2,A,0,3,2,0,3,1,1,3,15,10,0,1,5,1,August,-0.8660254037844384,-0.5000000000000004,7,43,0,4,0,1.25,1.25,0,1,-1,3,3,0,"August, 2017"
2017-2018,2,2017-08-19,Leicester,Brighton,2,0,H,3,0,1,1,3,1,2,2,13,16,0,0,3,0,August,-0.8660254037844384,-0.5000000000000004,24,10,0,0,0,0.0,0.0,3,4,-1,0,2,-2,"August, 2017"
2017-2018,2,2017-08-20,Huddersfield,Newcastle,1,0,H,3,0,1,2,2,1,0,4,6,16,3,0,10,3,August,-0.8660254037844384,-0.5000000000000004,20,30,0,0,0,0.0,0.0,3,0,3,0,2,-2,"August, 2017"
2017-2018,2,2017-08-20,Tottenham,Chelsea,1,2,A,0,3,3,1,1,3,1,1,8,15,3,0,7,3,August,-0.8660254037844384,-0.5000000000000004,42,14,2,2,1,2.0,1.4,2,0,2,2,3,-1,"August, 2017"
2017-2018,2,2017-08-21,Man City,Everton,1,1,D,1,1,4,1,0,2,2,1,7,10,3,3,3,0,August,-0.8660254037844384,-0.5000000000000004,27,18,1,3,1,0.8,1.2,2,0,2,1,0,1,"August, 2017"
2017-2018,3,2017-08-26,Bournemouth,Man City,1,2,A,0,3,2,0,3,4,1,0,16,5,0,4,11,4,August,-0.8660254037844384,-0.5000000000000004,7,27,0,0,4,0.25,3.75,0,3,-3,3,1,2,"August, 2017"
2017-2018,3,2017-08-26,Crystal Palace,Swansea,0,2,A,0,3,4,1,0,0,0,5,19,15,0,1,4,1,August,-0.8660254037844384,-0.5000000000000004,16,41,1,2,2,1.4,1.6,0,4,-4,0,4,-4,"August, 2017"
2017-2018,3,2017-08-26,Huddersfield,Southampton,0,0,D,1,1,1,2,2,2,2,1,3,7,6,4,4,2,August,-0.8660254037844384,-0.5000000000000004,20,38,0,0,0,0.0,0.0,4,0,4,3,2,1,"August, 2017"
2017-2018,3,2017-08-26,Man United,Leicester,2,0,H,3,0,3,1,1,1,1,3,3,10,6,3,7,3,August,-0.8660254037844384,-0.5000000000000004,28,24,3,2,0,2.4,0.8,8,0,8,5,4,1,"August, 2017"
2017-2018,3,2017-08-26,Newcastle,West Ham,3,0,H,3,0,1,0,4,2,1,2,16,19,0,0,3,0,August,-0.8660254037844384,-0.5000000000000004,30,45,3,0,2,1.4,1.0,0,3,-3,2,7,-5,"August, 2017"
2017-2018,3,2017-08-26,Watford,Brighton,0,0,D,1,1,1,1,3,1,2,2,6,18,4,0,12,4,August,-0.8660254037844384,-0.5000000000000004,43,10,0,0,0,0.0,0.0,5,3,2,0,4,-4,"August, 2017"
2017-2018,3,2017-08-27,West Brom,Stoke,1,1,D,1,1,3,1,1,1,3,1,6,14,6,3,8,3,August,-0.8660254037844384,-0.5000000000000004,44,39,4,1,0,1.2,0.4,2,0,2,1,1,0,"August, 2017"
2017-2018,3,2017-08-27,Tottenham,Burnley,1,1,D,1,1,3,1,1,0,2,3,11,12,3,3,1,0,August,-0.8660254037844384,-0.5000000000000004,42,11,3,1,1,1.6,1.2,3,2,1,3,3,0,"August, 2017"
2017-2018,3,2017-08-27,Chelsea,Everton,2,0,H,3,0,3,1,1,2,2,1,12,8,3,4,4,1,August,-0.8660254037844384,-0.5000000000000004,14,18,3,1,1,2.6,1.2,4,4,0,2,1,1,"August, 2017"
2017-2018,3,2017-08-27,Liverpool,Arsenal,4,0,H,3,0,2,2,1,3,0,2,8,12,4,3,4,1,August,-0.8660254037844384,-0.5000000000000004,25,0,2,2,1,2.2,2.2,4,3,1,4,4,0,"August, 2017"
2017-2018,4,2017-09-09,Arsenal,Bournemouth,3,0,H,3,0,3,0,2,2,0,3,16,18,3,0,2,3,September,-1.0,-1.8369701987210287e-16,0,7,3,1,0,2.5,1.0,4,8,-4,1,5,-4,"September, 2017"
2017-2018,4,2017-09-09,Brighton,West Brom,3,1,H,3,0,1,2,2,3,1,1,17,5,1,7,12,6,September,-1.0,-1.8369701987210287e-16,10,44,0,0,0,0.0,0.0,0,4,-4,3,1,2,"September, 2017"
2017-2018,4,2017-09-09,Everton,Tottenham,0,3,A,0,3,2,2,1,3,1,1,13,10,4,4,3,0,September,-1.0,-1.8369701987210287e-16,18,42,0,3,2,0.8,1.2,2,3,-1,4,3,1,"September, 2017"
2017-2018,4,2017-09-09,Leicester,Chelsea,1,2,A,0,3,1,1,3,3,1,1,17,7,3,6,10,3,September,-1.0,-1.8369701987210287e-16,24,14,1,1,3,0.8,2.2,5,6,-1,6,4,2,"September, 2017"
2017-2018,4,2017-09-09,Man City,Liverpool,5,0,H,3,0,4,1,0,2,2,1,6,3,7,7,3,0,September,-1.0,-1.8369701987210287e-16,27,25,0,1,4,0.6,2.2,5,2,3,8,3,5,"September, 2017"
2017-2018,4,2017-09-09,Southampton,Watford,0,2,A,0,3,2,2,1,1,1,3,10,9,5,5,1,0,September,-1.0,-1.8369701987210287e-16,38,43,3,2,0,1.8,0.8,3,2,1,5,3,2,"September, 2017"
2017-2018,4,2017-09-09,Stoke,Man United,2,2,D,1,1,1,3,1,3,1,1,12,2,4,9,10,5,September,-1.0,-1.8369701987210287e-16,39,28,1,3,1,1.0,1.2,2,2,0,10,0,10,"September, 2017"
2017-2018,4,2017-09-10,Swansea,Newcastle,0,1,A,0,3,0,0,5,1,0,4,14,16,4,3,2,1,September,-1.0,-1.8369701987210287e-16,41,30,3,1,1,1.8,1.6,2,4,-2,3,3,0,"September, 2017"
2017-2018,4,2017-09-10,Burnley,Crystal Palace,1,0,H,3,0,0,2,3,4,1,0,12,18,4,0,6,4,September,-1.0,-1.8369701987210287e-16,11,16,2,1,1,1.75,1.25,4,4,0,0,6,-6,"September, 2017"
2017-2018,4,2017-09-11,West Ham,Huddersfield,2,0,H,3,0,2,1,2,1,2,2,20,6,0,7,14,7,September,-1.0,-1.8369701987210287e-16,45,20,0,0,0,0.0,0.0,2,10,-8,4,0,4,"September, 2017"
2017-2018,5,2017-09-15,Bournemouth,Brighton,2,1,H,3,0,2,0,3,1,2,2,19,14,0,4,5,4,September,-1.0,-1.8369701987210287e-16,7,10,0,0,0,0.0,0.0,1,8,-7,3,5,-2,"September, 2017"
2017-2018,5,2017-09-16,Tottenham,Swansea,0,0,D,1,1,3,1,1,0,0,5,10,16,7,4,6,3,September,-1.0,-1.8369701987210287e-16,42,41,4,1,0,3.0,1.2,7,3,4,2,5,-3,"September, 2017"
2017-2018,5,2017-09-16,Newcastle,Stoke,2,1,H,3,0,1,0,4,1,3,1,11,13,6,5,2,1,September,-1.0,-1.8369701987210287e-16,30,39,0,2,3,0.2,0.8,4,3,1,4,4,0,"September, 2017"
2017-2018,5,2017-09-16,Watford,Man City,0,6,A,0,3,1,1,3,4,1,0,6,2,8,10,4,2,September,-1.0,-1.8369701987210287e-16,43,27,0,1,4,0.4,2.4,7,3,4,10,2,8,"September, 2017"
2017-2018,5,2017-09-16,Huddersfield,Leicester,1,1,D,1,1,1,2,2,1,1,3,7,17,7,3,10,4,September,-1.0,-1.8369701987210287e-16,20,24,0,0,0,0.0,0.0,4,2,2,6,8,-2,"September, 2017"
2017-2018,5,2017-09-16,Crystal Palace,Southampton,0,1,A,0,3,4,1,0,2,2,1,20,13,0,5,7,5,September,-1.0,-1.8369701987210287e-16,16,38,2,0,3,1.2,1.6,0,7,-7,3,4,-1,"September, 2017"
2017-2018,5,2017-09-16,Liverpool,Burnley,1,1,D,1,1,2,2,1,0,2,3,9,8,7,7,1,0,September,-1.0,-1.8369701987210287e-16,25,11,4,0,1,1.8,0.6,8,8,0,5,4,1,"September, 2017"
2017-2018,5,2017-09-16,West Brom,West Ham,0,0,D,1,1,3,1,1,2,1,2,11,18,7,3,7,4,September,-1.0,-1.8369701987210287e-16,44,45,1,3,1,1.6,1.8,4,4,0,4,10,-6,"September, 2017"
2017-2018,5,2017-09-17,Man United,Everton,4,0,H,3,0,3,1,1,2,2,1,2,17,10,4,15,6,September,-1.0,-1.8369701987210287e-16,28,18,2,2,1,1.2,1.0,12,2,10,2,6,-4,"September, 2017"
2017-2018,5,2017-09-17,Chelsea,Arsenal,0,0,D,1,1,3,1,1,3,0,2,3,12,9,6,9,3,September,-1.0,-1.8369701987210287e-16,14,0,3,1,1,1.2,0.8,8,5,3,7,8,-1,"September, 2017"
2017-2018,6,2017-09-23,Burnley,Huddersfield,0,0,D,1,1,0,2,3,1,2,2,7,6,8,8,1,0,September,-1.0,-1.8369701987210287e-16,11,20,0,0,0,0.0,0.0,6,5,1,5,3,2,"September, 2017"
2017-2018,6,2017-09-23,Everton,Bournemouth,2,1,H,3,0,2,2,1,2,0,3,18,19,4,3,1,1,September,-1.0,-1.8369701987210287e-16,18,7,2,1,1,2.75,2.0,2,10,-8,3,9,-6,"September, 2017"
2017-2018,6,2017-09-23,Leicester,Liverpool,2,3,A,0,3,1,1,3,2,2,1,16,8,4,8,8,4,September,-1.0,-1.8369701987210287e-16,24,25,2,1,2,1.6,1.6,7,9,-2,9,9,0,"September, 2017"
2017-2018,6,2017-09-23,Man City,Crystal Palace,5,0,H,3,0,4,1,0,4,1,0,1,20,13,0,19,13,September,-1.0,-1.8369701987210287e-16,27,16,4,0,1,2.6,0.6,16,2,14,0,8,-8,"September, 2017"
2017-2018,6,2017-09-23,Southampton,Man United,0,1,A,0,3,2,2,1,3,1,1,9,2,8,13,7,5,September,-1.0,-1.8369701987210287e-16,38,28,2,1,2,0.8,1.0,4,4,0,16,2,14,"September, 2017"
2017-2018,6,2017-09-23,Stoke,Chelsea,0,4,A,0,3,1,3,1,3,1,1,14,4,5,10,10,5,September,-1.0,-1.8369701987210287e-16,39,14,1,1,3,1.2,1.8,5,6,-1,8,5,3,"September, 2017"
2017-2018,6,2017-09-23,Swansea,Watford,1,2,A,0,3,0,0,5,1,1,3,14,11,5,8,3,3,September,-1.0,-1.8369701987210287e-16,41,43,1,1,2,0.25,0.5,2,5,-3,7,9,-2,"September, 2017"
2017-2018,6,2017-09-23,West Ham,Tottenham,2,3,A,0,3,2,1,2,3,1,1,18,9,4,8,9,4,September,-1.0,-1.8369701987210287e-16,45,42,2,1,2,1.4,1.8,4,10,-6,7,3,4,"September, 2017"
2017-2018,6,2017-09-24,Brighton,Newcastle,1,0,H,3,0,1,2,2,1,0,4,17,7,4,9,10,5,September,-1.0,-1.8369701987210287e-16,10,30,0,0,0,0.0,0.0,4,7,-3,6,4,2,"September, 2017"
2017-2018,6,2017-09-25,Arsenal,West Brom,2,0,H,3,0,3,0,2,3,1,1,12,10,7,8,2,1,September,-1.0,-1.8369701987210287e-16,0,44,3,0,2,1.8,1.2,7,8,-1,4,4,0,"September, 2017"
2017-2018,7,2017-09-30,West Brom,Watford,2,2,D,1,1,3,1,1,1,1,3,12,6,8,11,6,3,September,-1.0,-1.8369701987210287e-16,44,43,1,1,2,0.75,1.0,4,6,-2,9,10,-1,"September, 2017"
2017-2018,7,2017-09-30,Stoke,Southampton,2,1,H,3,0,1,3,1,2,2,1,17,11,5,8,6,3,September,-1.0,-1.8369701987210287e-16,39,38,3,1,1,1.0,0.6,5,10,-5,4,5,-1,"September, 2017"
2017-2018,7,2017-09-30,Man United,Crystal Palace,4,0,H,3,0,3,1,1,4,1,0,2,20,16,0,18,16,September,-1.0,-1.8369701987210287e-16,28,16,4,1,0,1.6,0.4,17,2,15,0,13,-13,"September, 2017"
2017-2018,7,2017-09-30,Bournemouth,Leicester,0,0,D,1,1,2,0,3,1,1,3,19,17,3,4,2,1,September,-1.0,-1.8369701987210287e-16,7,24,1,3,0,0.75,0.5,4,11,-7,9,12,-3,"September, 2017"
2017-2018,7,2017-09-30,Chelsea,Man City,0,1,A,0,3,3,1,1,4,1,0,3,1,13,16,2,3,September,-1.0,-1.8369701987210287e-16,14,27,2,1,2,1.2,1.8,12,5,7,21,2,19,"September, 2017"
2017-2018,7,2017-09-30,West Ham,Swansea,1,0,H,3,0,2,1,2,0,0,5,18,17,4,5,1,1,September,-1.0,-1.8369701987210287e-16,45,41,2,2,1,1.4,1.2,6,13,-7,3,7,-4,"September, 2017"
2017-2018,7,2017-09-30,Huddersfield,Tottenham,0,4,A,0,3,1,2,2,3,1,1,8,4,9,11,4,2,September,-1.0,-1.8369701987210287e-16,20,42,0,0,0,0.0,0.0,5,3,2,10,5,5,"September, 2017"
2017-2018,7,2017-10-01,Everton,Burnley,0,1,A,0,3,2,2,1,0,2,3,16,8,7,9,8,2,October,-0.8660254037844386,0.5,18,11,4,0,1,2.0,0.8,4,11,-7,6,5,1,"October, 2017"
2017-2018,7,2017-10-01,Newcastle,Liverpool,1,1,D,1,1,1,0,4,2,2,1,9,8,9,11,1,2,October,-0.8660254037844386,0.5,30,25,2,1,2,1.2,1.2,6,5,1,12,11,1,"October, 2017"
2017-2018,7,2017-10-01,Arsenal,Brighton,2,0,H,3,0,3,0,2,1,2,2,7,14,10,7,7,3,October,-0.8660254037844386,0.5,0,10,0,0,0,0.0,0.0,9,8,1,5,7,-2,"October, 2017"
2017-2018,8,2017-10-14,Watford,Arsenal,2,1,H,3,0,1,1,3,3,0,2,8,5,12,13,3,1,October,-0.8660254037844386,0.5,43,0,1,0,4,0.8,2.6,11,12,-1,11,8,3,"October, 2017"
2017-2018,8,2017-10-14,Tottenham,Bournemouth,1,0,H,3,0,3,1,1,2,0,3,3,19,14,4,16,10,October,-0.8660254037844386,0.5,42,7,3,1,0,3.0,0.25,14,5,9,4,11,-7,"October, 2017"
2017-2018,8,2017-10-14,Swansea,Huddersfield,2,0,H,3,0,0,0,5,1,2,2,18,11,5,9,7,4,October,-0.8660254037844386,0.5,41,20,0,0,0,0.0,0.0,3,8,-5,5,7,-2,"October, 2017"
2017-2018,8,2017-10-14,Crystal Palace,Chelsea,2,1,H,3,0,4,1,0,3,1,1,20,4,0,13,16,13,October,-0.8660254037844386,0.5,16,14,2,0,3,0.8,1.4,0,17,-17,12,6,6,"October, 2017"
2017-2018,8,2017-10-14,Liverpool,Man United,0,0,D,1,1,2,2,1,3,1,1,7,2,12,19,5,7,October,-0.8660254037844386,0.5,25,28,0,2,3,0.6,1.4,13,12,1,21,2,19,"October, 2017"
2017-2018,8,2017-10-14,Burnley,West Ham,1,1,D,1,1,0,2,3,2,1,2,6,15,12,7,9,5,October,-0.8660254037844386,0.5,11,45,1,0,4,0.8,1.6,7,5,2,7,13,-6,"October, 2017"
2017-2018,8,2017-10-14,Man City,Stoke,7,2,H,3,0,4,1,0,1,3,1,2,13,19,8,11,11,October,-0.8660254037844386,0.5,27,39,3,1,1,2.4,0.8,22,2,20,7,11,-4,"October, 2017"
2017-2018,8,2017-10-15,Brighton,Everton,1,1,D,1,1,1,2,2,2,2,1,16,17,7,7,1,0,October,-0.8660254037844386,0.5,10,18,0,0,0,0.0,0.0,5,9,-4,4,12,-8,"October, 2017"
2017-2018,8,2017-10-15,Southampton,Newcastle,2,2,D,1,1,2,2,1,1,0,4,12,9,8,10,3,2,October,-0.8660254037844386,0.5,38,30,4,1,0,3.0,0.8,5,7,-2,7,6,1,"October, 2017"
2017-2018,8,2017-10-16,Leicester,West Brom,1,1,D,1,1,1,1,3,3,1,1,18,11,5,9,7,4,October,-0.8660254037844386,0.5,24,44,3,1,1,2.0,1.6,9,12,-3,6,8,-2,"October, 2017"
2017-2018,9,2017-10-20,West Ham,Brighton,0,3,A,0,3,2,1,2,1,2,2,15,14,8,8,1,0,October,-0.8660254037844386,0.5,45,10,0,0,0,0.0,0.0,8,14,-6,6,10,-4,"October, 2017"
2017-2018,9,2017-10-21,Swansea,Leicester,1,2,A,0,3,0,0,5,1,1,3,14,19,8,6,5,2,October,-0.8660254037844386,0.5,41,24,1,0,4,0.6,2.2,5,8,-3,10,13,-3,"October, 2017"
2017-2018,9,2017-10-21,Stoke,Bournemouth,1,2,A,0,3,1,3,1,2,0,3,16,19,8,4,3,4,October,-0.8660254037844386,0.5,39,7,2,1,1,1.75,1.25,9,18,-9,4,12,-8,"October, 2017"
2017-2018,9,2017-10-21,Southampton,West Brom,1,0,H,3,0,2,2,1,3,1,1,13,12,9,10,1,1,October,-0.8660254037844386,0.5,38,44,2,1,2,1.0,0.6,7,9,-2,7,9,-2,"October, 2017"
2017-2018,9,2017-10-21,Huddersfield,Man United,2,1,H,3,0,1,2,2,3,1,1,13,2,9,20,11,11,October,-0.8660254037844386,0.5,20,28,0,0,0,0.0,0.0,5,9,-4,21,2,19,"October, 2017"
2017-2018,9,2017-10-21,Man City,Burnley,3,0,H,3,0,4,1,0,0,2,3,1,7,22,13,6,9,October,-0.8660254037844386,0.5,27,11,3,1,1,2.4,1.2,29,4,25,8,6,2,"October, 2017"
2017-2018,9,2017-10-21,Chelsea,Watford,4,2,H,3,0,3,1,1,1,1,3,5,4,13,15,1,2,October,-0.8660254037844386,0.5,14,43,3,2,0,1.8,1.2,13,8,5,13,13,0,"October, 2017"
2017-2018,9,2017-10-21,Newcastle,Crystal Palace,1,0,H,3,0,1,0,4,4,1,0,10,20,11,3,10,8,October,-0.8660254037844386,0.5,30,16,2,2,1,1.4,1.8,9,8,1,2,18,-16,"October, 2017"
2017-2018,9,2017-10-22,Tottenham,Liverpool,4,1,H,3,0,3,1,1,2,2,1,3,8,17,13,5,4,October,-0.8660254037844386,0.5,42,25,0,3,2,0.8,1.4,15,5,10,13,12,1,"October, 2017"
2017-2018,9,2017-10-22,Everton,Arsenal,2,5,A,0,3,2,2,1,3,0,2,16,7,8,13,9,5,October,-0.8660254037844386,0.5,18,0,1,0,4,0.8,2.0,5,13,-8,12,10,2,"October, 2017"
2017-2018,10,2017-10-28,Watford,Stoke,0,1,A,0,3,1,1,3,1,3,1,7,17,15,8,10,7,October,-0.8660254037844386,0.5,43,39,1,0,3,0.75,1.25,15,17,-2,10,20,-10,"October, 2017"
2017-2018,10,2017-10-28,Man United,Tottenham,1,0,H,3,0,3,1,1,3,1,1,2,3,20,20,1,0,October,-0.8660254037844386,0.5,28,42,3,0,2,1.2,1.0,22,4,18,19,6,13,"October, 2017"
2017-2018,10,2017-10-28,West Brom,Man City,2,3,A,0,3,3,1,1,4,1,0,14,1,10,25,13,15,October,-0.8660254037844386,0.5,44,27,0,0,5,0.4,3.0,7,10,-3,32,4,28,"October, 2017"
2017-2018,10,2017-10-28,Liverpool,Huddersfield,3,0,H,3,0,2,2,1,1,2,2,9,11,13,12,2,1,October,-0.8660254037844386,0.5,25,20,0,0,0,0.0,0.0,14,16,-2,7,10,-3,"October, 2017"
2017-2018,10,2017-10-28,Crystal Palace,West Ham,2,2,D,1,1,4,1,0,2,1,2,20,16,3,8,4,5,October,-0.8660254037844386,0.5,16,45,1,1,3,1.2,2.0,2,19,-17,8,17,-9,"October, 2017"
2017-2018,10,2017-10-28,Bournemouth,Chelsea,0,1,A,0,3,2,0,3,3,1,1,19,5,7,16,14,9,October,-0.8660254037844386,0.5,7,14,1,0,3,0.75,2.5,6,13,-7,17,10,7,"October, 2017"
2017-2018,10,2017-10-28,Arsenal,Swansea,2,1,H,3,0,3,0,2,0,0,5,5,15,16,8,10,8,October,-0.8660254037844386,0.5,0,41,3,0,2,2.2,1.0,17,12,5,6,10,-4,"October, 2017"
2017-2018,10,2017-10-29,Brighton,Southampton,1,1,D,1,1,1,2,2,2,2,1,12,10,11,12,2,1,October,-0.8660254037844386,0.5,10,38,0,0,0,0.0,0.0,9,10,-1,8,9,-1,"October, 2017"
2017-2018,10,2017-10-29,Leicester,Everton,2,0,H,3,0,1,1,3,2,2,1,15,18,9,8,3,1,October,-0.8660254037844386,0.5,24,18,2,1,2,2.0,2.2,12,14,-2,7,18,-11,"October, 2017"
2017-2018,10,2017-10-30,Burnley,Newcastle,1,0,H,3,0,0,2,3,1,0,4,10,8,13,14,2,1,October,-0.8660254037844386,0.5,11,30,0,2,0,2.0,2.0,8,9,-1,10,8,2,"October, 2017"
2017-2018,11,2017-11-04,West Ham,Liverpool,1,4,A,0,3,2,1,2,2,2,1,17,7,9,16,10,7,November,-0.5000000000000004,0.8660254037844384,45,25,2,1,2,1.4,1.6,10,19,-9,17,16,1,"November, 2017"
2017-2018,11,2017-11-04,Swansea,Brighton,0,1,A,0,3,0,0,5,1,2,2,18,13,8,12,5,4,November,-0.5000000000000004,0.8660254037844384,41,10,0,0,0,0.0,0.0,7,12,-5,10,11,-1,"November, 2017"
2017-2018,11,2017-11-04,Stoke,Leicester,2,2,D,1,1,1,3,1,1,1,3,14,12,11,12,2,1,November,-0.5000000000000004,0.8660254037844384,39,24,1,2,2,1.0,1.8,11,20,-9,14,14,0,"November, 2017"
2017-2018,11,2017-11-04,Newcastle,Bournemouth,0,1,A,0,3,1,0,4,2,0,3,10,19,14,7,9,7,November,-0.5000000000000004,0.8660254037844384,30,7,1,0,1,1.0,1.5,10,9,1,6,14,-8,"November, 2017"
2017-2018,11,2017-11-04,Huddersfield,West Brom,1,0,H,3,0,1,2,2,3,1,1,13,15,12,10,2,2,November,-0.5000000000000004,0.8660254037844384,20,44,0,0,0,0.0,0.0,7,13,-6,9,13,-4,"November, 2017"
2017-2018,11,2017-11-04,Southampton,Burnley,0,1,A,0,3,2,2,1,0,2,3,11,7,13,16,4,3,November,-0.5000000000000004,0.8660254037844384,38,11,2,0,2,1.25,0.75,9,10,-1,9,9,0,"November, 2017"
2017-2018,11,2017-11-05,Chelsea,Man United,1,0,H,3,0,3,1,1,3,1,1,4,2,19,23,2,4,November,-0.5000000000000004,0.8660254037844384,14,28,2,2,1,1.2,0.6,18,10,8,23,4,19,"November, 2017"
2017-2018,11,2017-11-05,Everton,Watford,3,2,H,3,0,2,2,1,1,1,3,19,9,8,15,10,7,November,-0.5000000000000004,0.8660254037844384,18,43,2,2,1,1.8,1.2,7,20,-13,15,18,-3,"November, 2017"
2017-2018,11,2017-11-05,Man City,Arsenal,3,1,H,3,0,4,1,0,3,0,2,1,5,28,19,4,9,November,-0.5000000000000004,0.8660254037844384,27,0,1,2,2,1.4,1.8,35,6,29,19,13,6,"November, 2017"
2017-2018,11,2017-11-05,Tottenham,Crystal Palace,1,0,H,3,0,3,1,1,4,1,0,4,20,20,4,16,16,November,-0.5000000000000004,0.8660254037844384,42,16,4,0,1,1.4,0.6,19,7,12,4,21,-17,"November, 2017"
2017-2018,12,2017-11-18,Man United,Newcastle,4,1,H,3,0,3,1,1,1,0,4,2,11,23,14,9,9,November,-0.5000000000000004,0.8660254037844384,28,30,3,2,0,2.2,0.8,23,5,18,10,10,0,"November, 2017"
2017-2018,12,2017-11-18,West Brom,Chelsea,0,4,A,0,3,3,1,1,3,1,1,17,4,10,22,13,12,November,-0.5000000000000004,0.8660254037844384,44,14,1,1,3,1.4,1.4,9,14,-5,19,10,9,"November, 2017"
2017-2018,12,2017-11-18,Leicester,Man City,0,2,A,0,3,1,1,3,4,1,0,12,1,13,31,11,18,November,-0.5000000000000004,0.8660254037844384,24,27,2,1,2,1.6,1.4,16,16,0,38,7,31,"November, 2017"
2017-2018,12,2017-11-18,Liverpool,Southampton,3,0,H,3,0,2,2,1,2,2,1,7,13,19,13,6,6,November,-0.5000000000000004,0.8660254037844384,25,38,1,3,1,1.0,0.8,21,17,4,9,11,-2,"November, 2017"
2017-2018,12,2017-11-18,Burnley,Swansea,2,0,H,3,0,0,2,3,0,0,5,7,19,19,8,12,11,November,-0.5000000000000004,0.8660254037844384,11,41,0,0,4,0.5,1.5,10,9,1,7,13,-6,"November, 2017"
2017-2018,12,2017-11-18,Bournemouth,Huddersfield,4,0,H,3,0,2,0,3,1,2,2,17,10,10,15,7,5,November,-0.5000000000000004,0.8660254037844384,7,20,0,0,0,0.0,0.0,7,14,-7,8,13,-5,"November, 2017"
2017-2018,12,2017-11-18,Arsenal,Tottenham,2,0,H,3,0,3,0,2,3,1,1,6,3,19,23,3,4,November,-0.5000000000000004,0.8660254037844384,0,42,0,3,2,1.0,1.6,20,16,4,20,7,13,"November, 2017"
2017-2018,12,2017-11-18,Crystal Palace,Everton,2,2,D,1,1,4,1,0,2,2,1,20,16,4,11,4,7,November,-0.5000000000000004,0.8660254037844384,16,18,0,3,2,0.4,0.8,4,22,-18,10,22,-12,"November, 2017"
2017-2018,12,2017-11-19,Watford,West Ham,2,0,H,3,0,1,1,3,2,1,2,9,18,15,9,9,6,November,-0.5000000000000004,0.8660254037844384,43,45,3,1,1,1.8,1.2,17,21,-4,11,23,-12,"November, 2017"
2017-2018,12,2017-11-20,Brighton,Stoke,2,2,D,1,1,1,2,2,1,3,1,9,15,15,12,6,3,November,-0.5000000000000004,0.8660254037844384,10,39,0,0,0,0.0,0.0,11,11,0,13,22,-9,"November, 2017"
2017-2018,13,2017-11-24,West Ham,Leicester,1,1,D,1,1,2,1,2,1,1,3,18,12,9,13,6,4,November,-0.5000000000000004,0.8660254037844384,45,24,0,1,4,1.2,2.0,11,25,-14,16,18,-2,"November, 2017"
2017-2018,13,2017-11-25,Tottenham,West Brom,1,1,D,1,1,3,1,1,3,1,1,4,17,23,10,13,13,November,-0.5000000000000004,0.8660254037844384,42,44,2,3,0,2.0,0.6,20,9,11,9,18,-9,"November, 2017"
2017-2018,13,2017-11-25,Swansea,Bournemouth,0,0,D,1,1,0,0,5,2,0,3,19,13,8,13,6,5,November,-0.5000000000000004,0.8660254037844384,41,7,0,1,3,1.0,2.5,7,15,-8,11,14,-3,"November, 2017"
2017-2018,13,2017-11-25,Newcastle,Watford,0,3,A,0,3,1,0,4,1,1,3,12,8,14,18,4,4,November,-0.5000000000000004,0.8660254037844384,30,43,2,1,2,1.2,1.2,11,14,-3,19,21,-2,"November, 2017"
2017-2018,13,2017-11-25,Liverpool,Chelsea,1,1,D,1,1,2,2,1,3,1,1,5,3,22,25,2,3,November,-0.5000000000000004,0.8660254037844384,25,14,2,3,0,1.6,1.0,24,17,7,23,10,13,"November, 2017"
2017-2018,13,2017-11-25,Crystal Palace,Stoke,2,1,H,3,0,4,1,0,1,3,1,20,15,5,13,5,8,November,-0.5000000000000004,0.8660254037844384,16,39,4,0,1,2.0,1.0,6,24,-18,15,24,-9,"November, 2017"
2017-2018,13,2017-11-25,Man United,Brighton,1,0,H,3,0,3,1,1,1,2,2,2,9,26,16,7,10,November,-0.5000000000000004,0.8660254037844384,28,10,0,0,0,0.0,0.0,27,6,21,13,13,0,"November, 2017"
2017-2018,13,2017-11-26,Burnley,Arsenal,0,1,A,0,3,0,2,3,3,0,2,7,6,22,22,1,0,November,-0.5000000000000004,0.8660254037844384,11,0,0,0,5,0.4,2.0,12,9,3,22,16,6,"November, 2017"
2017-2018,13,2017-11-26,Huddersfield,Man City,1,2,A,0,3,1,2,2,4,1,0,10,1,15,34,9,19,November,-0.5000000000000004,0.8660254037844384,20,27,0,0,0,0.0,0.0,8,17,-9,40,7,33,"November, 2017"
2017-2018,13,2017-11-26,Southampton,Everton,4,1,H,3,0,2,2,1,2,2,1,14,16,13,12,2,1,November,-0.5000000000000004,0.8660254037844384,38,18,1,1,3,0.4,1.6,9,14,-5,12,24,-12,"November, 2017"
2017-2018,14,2017-11-28,Brighton,Crystal Palace,0,0,D,1,1,1,2,2,4,1,0,9,20,16,8,11,8,November,-0.5000000000000004,0.8660254037844384,10,16,0,0,0,0.0,0.0,13,14,-1,8,25,-17,"November, 2017"
2017-2018,14,2017-11-28,Leicester,Tottenham,2,1,H,3,0,1,1,3,3,1,1,12,5,14,24,7,10,November,-0.5000000000000004,0.8660254037844384,24,42,1,2,2,1.4,2.4,17,19,-2,21,10,11,"November, 2017"
2017-2018,14,2017-11-28,Watford,Man United,2,4,A,0,3,1,1,3,3,1,1,8,2,21,29,6,8,November,-0.5000000000000004,0.8660254037844384,43,28,1,0,4,0.8,2.0,22,21,1,28,6,22,"November, 2017"
2017-2018,14,2017-11-28,West Brom,Newcastle,2,2,D,1,1,3,1,1,1,0,4,17,14,11,14,3,3,November,-0.5000000000000004,0.8660254037844384,44,30,2,1,2,0.6,0.8,10,19,-9,11,17,-6,"November, 2017"
2017-2018,14,2017-11-29,Stoke,Liverpool,0,3,A,0,3,1,3,1,2,2,1,16,7,13,23,9,10,November,-0.5000000000000004,0.8660254037844384,39,25,1,0,4,1.8,2.4,16,26,-10,25,18,7,"November, 2017"
2017-2018,14,2017-11-29,Man City,Southampton,2,1,H,3,0,4,1,0,2,2,1,1,11,37,16,10,21,November,-0.5000000000000004,0.8660254037844384,27,38,3,1,1,2.2,1.2,42,8,34,13,15,-2,"November, 2017"
2017-2018,14,2017-11-29,Everton,West Ham,4,0,H,3,0,2,2,1,2,1,2,17,18,12,10,1,2,November,-0.5000000000000004,0.8660254037844384,18,45,2,2,1,1.4,1.0,13,28,-15,12,26,-14,"November, 2017"
2017-2018,14,2017-11-29,Chelsea,Swansea,1,0,H,3,0,3,1,1,0,0,5,4,19,26,9,15,17,November,-0.5000000000000004,0.8660254037844384,14,41,2,2,1,2.4,1.2,24,11,13,7,15,-8,"November, 2017"
2017-2018,14,2017-11-29,Bournemouth,Burnley,1,2,A,0,3,2,0,3,0,2,3,14,7,14,22,7,8,November,-0.5000000000000004,0.8660254037844384,7,11,1,0,1,2.0,2.0,11,14,-3,12,10,2,"November, 2017"
2017-2018,14,2017-11-29,Arsenal,Huddersfield,5,0,H,3,0,3,0,2,1,2,2,4,13,25,15,9,10,November,-0.5000000000000004,0.8660254037844384,0,20,0,0,0,0.0,0.0,23,16,7,9,19,-10,"November, 2017"
2017-2018,15,2017-12-02,Watford,Tottenham,1,1,D,1,1,1,1,3,3,1,1,8,7,21,24,1,3,December,-2.4492935982947064e-16,1.0,43,42,0,0,5,0.6,2.8,24,25,-1,22,12,10,"December, 2017"
2017-2018,15,2017-12-02,Stoke,Swansea,2,1,H,3,0,1,3,1,0,0,5,16,19,13,9,3,4,December,-2.4492935982947064e-16,1.0,39,41,2,1,2,1.2,1.4,16,29,-13,7,16,-9,"December, 2017"
2017-2018,15,2017-12-02,Leicester,Burnley,1,0,H,3,0,1,1,3,0,2,3,10,6,17,25,4,8,December,-2.4492935982947064e-16,1.0,24,11,2,1,1,1.5,0.75,19,20,-1,14,11,3,"December, 2017"
2017-2018,15,2017-12-02,West Brom,Crystal Palace,0,0,D,1,1,3,1,1,4,1,0,17,20,12,9,3,3,December,-2.4492935982947064e-16,1.0,44,16,3,0,2,1.2,1.2,12,21,-9,8,25,-17,"December, 2017"
2017-2018,15,2017-12-02,Chelsea,Newcastle,3,1,H,3,0,3,1,1,1,0,4,4,12,29,15,8,14,December,-2.4492935982947064e-16,1.0,14,30,3,1,1,2.6,1.0,25,11,14,13,19,-6,"December, 2017"
2017-2018,15,2017-12-02,Brighton,Liverpool,1,5,A,0,3,1,2,2,2,2,1,10,5,17,26,5,9,December,-2.4492935982947064e-16,1.0,10,25,0,0,0,0.0,0.0,13,14,-1,28,18,10,"December, 2017"
2017-2018,15,2017-12-02,Arsenal,Man United,1,3,A,0,3,3,0,2,3,1,1,4,2,28,32,2,4,December,-2.4492935982947064e-16,1.0,0,28,2,2,1,1.8,1.0,28,16,12,32,8,24,"December, 2017"
2017-2018,15,2017-12-02,Everton,Huddersfield,2,0,H,3,0,2,2,1,1,2,2,13,14,15,15,1,0,December,-2.4492935982947064e-16,1.0,18,20,0,0,0,0.0,0.0,17,28,-11,9,24,-15,"December, 2017"
2017-2018,15,2017-12-03,Bournemouth,Southampton,1,1,D,1,1,2,0,3,2,2,1,16,12,14,16,4,2,December,-2.4492935982947064e-16,1.0,7,38,1,1,2,0.75,1.25,12,16,-4,14,17,-3,"December, 2017"
2017-2018,15,2017-12-03,Man City,West Ham,2,1,H,3,0,4,1,0,2,1,2,1,19,40,10,18,30,December,-2.4492935982947064e-16,1.0,27,45,3,1,1,2.4,1.0,44,9,35,12,30,-18,"December, 2017"
2017-2018,16,2017-12-09,Burnley,Watford,1,0,H,3,0,0,2,3,1,1,3,7,8,25,22,1,3,December,-2.4492935982947064e-16,1.0,11,43,1,0,1,1.5,1.0,14,12,2,25,26,-1,"December, 2017"
2017-2018,16,2017-12-09,Crystal Palace,Bournemouth,2,2,D,1,1,4,1,0,2,0,3,18,14,10,15,4,5,December,-2.4492935982947064e-16,1.0,16,7,1,2,1,1.0,0.75,8,25,-17,13,17,-4,"December, 2017"
2017-2018,16,2017-12-09,Huddersfield,Brighton,2,0,H,3,0,1,2,2,1,2,2,16,12,15,17,4,2,December,-2.4492935982947064e-16,1.0,20,10,0,0,0,0.0,0.0,9,26,-17,14,19,-5,"December, 2017"
2017-2018,16,2017-12-09,Newcastle,Leicester,2,3,A,0,3,1,0,4,1,1,3,16,9,15,20,7,5,December,-2.4492935982947064e-16,1.0,30,24,2,0,3,0.8,1.6,14,22,-8,20,20,0,"December, 2017"
2017-2018,16,2017-12-09,Swansea,West Brom,1,0,H,3,0,0,0,5,3,1,1,20,17,9,13,3,4,December,-2.4492935982947064e-16,1.0,41,44,2,1,2,1.0,1.4,8,18,-10,12,21,-9,"December, 2017"
2017-2018,16,2017-12-09,Tottenham,Stoke,5,1,H,3,0,3,1,1,1,3,1,7,15,25,16,8,9,December,-2.4492935982947064e-16,1.0,42,39,3,1,1,2.8,1.0,23,13,10,18,30,-12,"December, 2017"
2017-2018,16,2017-12-09,West Ham,Chelsea,1,0,H,3,0,2,1,2,3,1,1,20,3,10,32,17,22,December,-2.4492935982947064e-16,1.0,45,14,1,1,3,1.2,1.6,13,32,-19,28,12,16,"December, 2017"
2017-2018,16,2017-12-10,Southampton,Arsenal,1,1,D,1,1,2,2,1,3,0,2,12,6,17,28,6,11,December,-2.4492935982947064e-16,1.0,38,0,2,1,2,1.4,0.8,15,18,-3,29,19,10,"December, 2017"
2017-2018,16,2017-12-10,Man United,Man City,1,2,A,0,3,3,1,1,4,1,0,2,1,35,43,1,8,December,-2.4492935982947064e-16,1.0,28,27,2,2,1,1.2,0.8,35,9,26,46,10,36,"December, 2017"
2017-2018,16,2017-12-10,Liverpool,Everton,1,1,D,1,1,2,2,1,2,2,1,4,10,29,18,6,11,December,-2.4492935982947064e-16,1.0,25,18,3,2,0,1.8,0.4,33,19,14,19,28,-9,"December, 2017"
2017-2018,17,2017-12-12,Burnley,Stoke,1,0,H,3,0,0,2,3,1,3,1,7,15,28,16,8,12,December,-2.4492935982947064e-16,1.0,11,39,2,2,1,0.8,0.8,15,12,3,19,35,-16,"December, 2017"
2017-2018,17,2017-12-12,Crystal Palace,Watford,2,1,H,3,0,4,1,0,1,1,3,20,9,11,22,11,11,December,-2.4492935982947064e-16,1.0,16,43,2,1,1,1.0,0.75,10,27,-17,25,27,-2,"December, 2017"
2017-2018,17,2017-12-12,Huddersfield,Chelsea,1,3,A,0,3,1,2,2,3,1,1,12,3,18,32,9,14,December,-2.4492935982947064e-16,1.0,20,14,0,0,0,0.0,0.0,11,26,-15,28,13,15,"December, 2017"
2017-2018,17,2017-12-13,Swansea,Man City,0,4,A,0,3,0,0,5,4,1,0,20,1,12,46,19,34,December,-2.4492935982947064e-16,1.0,41,27,0,1,4,1.2,2.4,9,18,-9,48,11,37,"December, 2017"
2017-2018,17,2017-12-13,Liverpool,West Brom,0,0,D,1,1,2,2,1,3,1,1,5,18,30,13,13,17,December,-2.4492935982947064e-16,1.0,25,44,2,3,0,1.2,0.8,34,20,14,12,22,-10,"December, 2017"
2017-2018,17,2017-12-13,Man United,Bournemouth,1,0,H,3,0,3,1,1,2,0,3,2,14,35,16,12,19,December,-2.4492935982947064e-16,1.0,28,7,2,1,1,2.0,1.25,36,11,25,15,19,-4,"December, 2017"
2017-2018,17,2017-12-13,Newcastle,Everton,0,1,A,0,3,1,0,4,2,2,1,16,10,15,19,6,4,December,-2.4492935982947064e-16,1.0,30,18,1,0,4,0.6,2.4,16,25,-9,20,29,-9,"December, 2017"
2017-2018,17,2017-12-13,Southampton,Leicester,1,4,A,0,3,2,2,1,1,1,3,11,8,18,23,3,5,December,-2.4492935982947064e-16,1.0,38,24,1,2,2,1.0,1.0,16,19,-3,23,22,1,"December, 2017"
2017-2018,17,2017-12-13,Tottenham,Brighton,2,0,H,3,0,3,1,1,1,2,2,7,13,28,17,6,11,December,-2.4492935982947064e-16,1.0,42,10,0,0,0,0.0,0.0,28,14,14,14,21,-7,"December, 2017"
2017-2018,17,2017-12-13,West Ham,Arsenal,0,0,D,1,1,2,1,2,3,0,2,19,7,13,29,12,16,December,-2.4492935982947064e-16,1.0,45,0,1,1,3,1.2,2.8,14,32,-18,30,20,10,"December, 2017"
2017-2018,18,2017-12-16,Man City,Tottenham,4,1,H,3,0,4,1,0,3,1,1,1,6,49,31,5,18,December,-2.4492935982947064e-16,1.0,27,42,1,1,3,1.0,2.0,52,11,41,30,14,16,"December, 2017"
2017-2018,18,2017-12-16,Leicester,Crystal Palace,0,3,A,0,3,1,1,3,4,1,0,8,18,26,14,10,12,December,-2.4492935982947064e-16,1.0,24,16,3,1,1,1.4,0.8,27,23,4,12,28,-16,"December, 2017"
2017-2018,18,2017-12-16,Stoke,West Ham,0,3,A,0,3,1,3,1,2,1,2,16,19,16,14,3,2,December,-2.4492935982947064e-16,1.0,39,45,1,4,0,0.8,0.6,19,36,-17,14,32,-18,"December, 2017"
2017-2018,18,2017-12-16,Brighton,Burnley,0,0,D,1,1,1,2,2,0,2,3,13,7,17,31,6,14,December,-2.4492935982947064e-16,1.0,10,11,0,0,0,0.0,0.0,14,23,-9,16,12,4,"December, 2017"
2017-2018,18,2017-12-16,Arsenal,Newcastle,1,0,H,3,0,3,0,2,1,0,4,7,16,30,15,9,15,December,-2.4492935982947064e-16,1.0,0,30,5,0,0,2.2,0.4,30,20,10,16,26,-10,"December, 2017"
2017-2018,18,2017-12-16,Chelsea,Southampton,1,0,H,3,0,3,1,1,2,2,1,3,11,35,18,8,17,December,-2.4492935982947064e-16,1.0,14,38,3,1,1,2.0,1.4,31,14,17,17,23,-6,"December, 2017"
2017-2018,18,2017-12-16,Watford,Huddersfield,1,4,A,0,3,1,1,3,1,2,2,9,13,22,18,4,4,December,-2.4492935982947064e-16,1.0,43,20,0,0,0,0.0,0.0,26,29,-3,12,29,-17,"December, 2017"
2017-2018,18,2017-12-17,West Brom,Man United,1,2,A,0,3,3,1,1,3,1,1,19,2,14,38,17,24,December,-2.4492935982947064e-16,1.0,44,28,2,1,2,0.4,0.8,12,22,-10,37,11,26,"December, 2017"
2017-2018,18,2017-12-17,Bournemouth,Liverpool,0,4,A,0,3,2,0,3,2,2,1,16,6,16,31,10,15,December,-2.4492935982947064e-16,1.0,7,25,1,1,2,1.75,2.0,15,20,-5,34,20,14,"December, 2017"
2017-2018,18,2017-12-18,Everton,Swansea,3,1,H,3,0,2,2,1,0,0,5,10,20,22,12,10,10,December,-2.4492935982947064e-16,1.0,18,41,0,3,2,0.6,1.0,21,29,-8,9,22,-13,"December, 2017"
2017-2018,19,2017-12-22,Arsenal,Liverpool,3,3,D,1,1,3,0,2,2,2,1,5,4,33,34,1,1,December,-2.4492935982947064e-16,1.0,0,25,0,2,3,1.4,2.8,31,20,11,38,20,18,"December, 2017"
2017-2018,19,2017-12-23,West Ham,Newcastle,2,3,A,0,3,2,1,2,1,0,4,16,18,17,15,2,2,December,-2.4492935982947064e-16,1.0,45,30,2,0,3,0.8,1.4,17,32,-15,16,27,-11,"December, 2017"
2017-2018,19,2017-12-23,Southampton,Huddersfield,1,1,D,1,1,2,2,1,1,2,2,13,12,18,21,1,3,December,-2.4492935982947064e-16,1.0,38,20,0,1,0,0.0,0.0,17,24,-7,16,30,-14,"December, 2017"
2017-2018,19,2017-12-23,Swansea,Crystal Palace,1,1,D,1,1,0,0,5,4,1,0,20,15,12,17,5,5,December,-2.4492935982947064e-16,1.0,41,16,3,2,0,2.0,1.2,10,25,-15,15,28,-13,"December, 2017"
2017-2018,19,2017-12-23,Man City,Bournemouth,4,0,H,3,0,4,1,0,2,0,3,1,16,52,16,15,36,December,-2.4492935982947064e-16,1.0,27,7,5,0,0,3.4,0.4,56,12,44,15,24,-9,"December, 2017"
2017-2018,19,2017-12-23,Stoke,West Brom,3,1,H,3,0,1,3,1,3,1,1,17,19,16,14,2,2,December,-2.4492935982947064e-16,1.0,39,44,0,2,3,0.6,1.2,19,39,-20,13,24,-11,"December, 2017"
2017-2018,19,2017-12-23,Everton,Chelsea,0,0,D,1,1,2,2,1,3,1,1,9,3,25,38,6,13,December,-2.4492935982947064e-16,1.0,18,14,1,1,3,1.2,2.8,24,30,-6,32,14,18,"December, 2017"
2017-2018,19,2017-12-23,Brighton,Watford,1,0,H,3,0,1,2,2,1,1,3,13,10,18,22,3,4,December,-2.4492935982947064e-16,1.0,10,43,0,1,0,0.0,0.0,14,23,-9,27,33,-6,"December, 2017"
2017-2018,19,2017-12-23,Leicester,Man United,2,2,D,1,1,1,1,3,3,1,1,8,2,26,41,6,15,December,-2.4492935982947064e-16,1.0,24,28,0,2,3,0.6,2.2,27,26,1,39,12,27,"December, 2017"
2017-2018,19,2017-12-23,Burnley,Tottenham,0,3,A,0,3,0,2,3,3,1,1,6,7,32,31,1,1,December,-2.4492935982947064e-16,1.0,11,42,0,2,3,0.6,1.4,16,12,4,31,18,13,"December, 2017"
2017-2018,20,2017-12-26,Bournemouth,West Ham,3,3,D,1,1,2,0,3,2,1,2,18,17,16,17,1,1,December,-2.4492935982947064e-16,1.0,7,45,2,0,2,2.0,2.25,15,28,-13,19,35,-16,"December, 2017"
2017-2018,20,2017-12-26,Chelsea,Brighton,2,0,H,3,0,3,1,1,1,2,2,3,12,39,21,9,18,December,-2.4492935982947064e-16,1.0,14,10,0,0,0,0.0,0.0,32,14,18,15,23,-8,"December, 2017"
2017-2018,20,2017-12-26,Huddersfield,Stoke,1,1,D,1,1,1,2,2,1,3,1,11,14,22,19,3,3,December,-2.4492935982947064e-16,1.0,20,39,0,0,0,0.0,0.0,17,31,-14,22,40,-18,"December, 2017"
2017-2018,20,2017-12-26,Liverpool,Swansea,5,0,H,3,0,2,2,1,0,0,5,4,20,35,13,16,22,December,-2.4492935982947064e-16,1.0,25,41,3,0,2,1.4,1.4,41,23,18,11,26,-15,"December, 2017"
2017-2018,20,2017-12-26,Man United,Burnley,2,2,D,1,1,3,1,1,0,2,3,2,7,42,32,5,10,December,-2.4492935982947064e-16,1.0,28,11,3,2,0,1.6,0.2,41,14,27,16,15,1,"December, 2017"
2017-2018,20,2017-12-26,Tottenham,Southampton,5,2,H,3,0,3,1,1,2,2,1,5,14,34,19,9,15,December,-2.4492935982947064e-16,1.0,42,38,3,1,1,2.2,1.2,34,18,16,18,25,-7,"December, 2017"
2017-2018,20,2017-12-26,Watford,Leicester,2,1,H,3,0,1,1,3,1,1,3,11,8,22,27,3,5,December,-2.4492935982947064e-16,1.0,43,24,1,1,3,0.8,1.6,27,34,-7,29,28,1,"December, 2017"
2017-2018,20,2017-12-26,West Brom,Everton,0,0,D,1,1,3,1,1,2,2,1,19,9,14,26,10,12,December,-2.4492935982947064e-16,1.0,44,18,1,1,3,0.8,1.6,14,27,-13,24,30,-6,"December, 2017"
2017-2018,20,2017-12-27,Newcastle,Man City,0,1,A,0,3,1,0,4,4,1,0,15,1,18,55,14,37,December,-2.4492935982947064e-16,1.0,30,27,0,1,4,0.4,3.2,19,29,-10,60,12,48,"December, 2017"
2017-2018,20,2017-12-28,Crystal Palace,Arsenal,2,3,A,0,3,4,1,0,3,0,2,16,6,18,34,10,16,December,-2.4492935982947064e-16,1.0,16,0,1,1,3,1.2,1.4,16,29,-13,34,23,11,"December, 2017"
2017-2018,21,2017-12-30,Bournemouth,Everton,2,1,H,3,0,2,0,3,2,2,1,18,9,17,27,9,10,December,-2.4492935982947064e-16,1.0,7,18,1,1,3,1.8,2.6,18,31,-13,24,30,-6,"December, 2017"
2017-2018,21,2017-12-30,Chelsea,Stoke,5,0,H,3,0,3,1,1,1,3,1,3,14,42,20,11,22,December,-2.4492935982947064e-16,1.0,14,39,3,1,1,2.2,1.0,34,14,20,23,41,-18,"December, 2017"
2017-2018,21,2017-12-30,Huddersfield,Burnley,0,0,D,1,1,1,2,2,0,2,3,11,7,23,33,4,10,December,-2.4492935982947064e-16,1.0,20,11,0,1,0,0.0,0.0,18,32,-14,18,17,1,"December, 2017"
2017-2018,21,2017-12-30,Liverpool,Leicester,2,1,H,3,0,2,2,1,1,1,3,4,8,38,27,4,11,December,-2.4492935982947064e-16,1.0,25,24,3,0,2,1.8,1.6,46,23,23,30,30,0,"December, 2017"
2017-2018,21,2017-12-30,Man United,Southampton,0,0,D,1,1,3,1,1,2,2,1,3,15,43,19,12,24,December,-2.4492935982947064e-16,1.0,28,38,3,1,1,1.2,0.6,43,16,27,20,30,-10,"December, 2017"
2017-2018,21,2017-12-30,Newcastle,Brighton,0,0,D,1,1,1,0,4,1,2,2,16,12,18,21,4,3,December,-2.4492935982947064e-16,1.0,30,10,0,0,1,0.0,1.0,19,30,-11,15,25,-10,"December, 2017"
2017-2018,21,2017-12-30,Watford,Swansea,1,2,A,0,3,1,1,3,0,0,5,10,20,25,13,10,12,December,-2.4492935982947064e-16,1.0,43,41,3,1,1,0.8,0.4,29,35,-6,11,31,-20,"December, 2017"
2017-2018,21,2017-12-31,Crystal Palace,Man City,0,0,D,1,1,4,1,0,4,1,0,17,1,18,58,16,40,December,-2.4492935982947064e-16,1.0,16,27,0,0,5,0.2,3.4,18,32,-14,61,12,49,"December, 2017"
2017-2018,21,2017-12-31,West Brom,Arsenal,1,1,D,1,1,3,1,1,3,0,2,20,6,15,37,14,22,December,-2.4492935982947064e-16,1.0,44,0,2,0,3,1.0,1.4,14,27,-13,37,25,12,"December, 2017"
2017-2018,22,2018-01-01,Stoke,Newcastle,0,1,A,0,3,1,3,1,1,0,4,15,16,20,19,1,1,January,0.4999999999999999,0.8660254037844387,39,30,2,2,1,0.8,0.6,23,46,-23,19,30,-11,"January, 2018"
2017-2018,22,2018-01-01,Leicester,Huddersfield,3,0,H,3,0,1,1,3,1,2,2,8,11,27,24,3,3,January,0.4999999999999999,0.8660254037844387,24,20,0,1,0,1.0,1.0,31,32,-1,18,32,-14,"January, 2018"
2017-2018,22,2018-01-01,Everton,Man United,0,2,A,0,3,2,2,1,3,1,1,9,3,27,44,6,17,January,0.4999999999999999,0.8660254037844387,18,28,0,2,3,0.4,2.0,25,32,-7,43,16,27,"January, 2018"
2017-2018,22,2018-01-01,Burnley,Liverpool,1,2,A,0,3,0,2,3,2,2,1,7,4,34,41,3,7,January,0.4999999999999999,0.8660254037844387,11,25,1,1,3,0.8,1.2,18,17,1,48,24,24,"January, 2018"
2017-2018,22,2018-01-01,Brighton,Bournemouth,2,2,D,1,1,1,2,2,2,0,3,12,14,22,20,2,2,January,0.4999999999999999,0.8660254037844387,10,7,0,0,1,1.0,2.0,15,25,-10,20,32,-12,"January, 2018"
2017-2018,22,2018-01-02,Man City,Watford,3,1,H,3,0,4,1,0,1,1,3,1,10,59,25,9,34,January,0.4999999999999999,0.8660254037844387,27,43,5,0,0,3.4,0.2,61,12,49,30,37,-7,"January, 2018"
2017-2018,22,2018-01-02,Southampton,Crystal Palace,1,2,A,0,3,2,2,1,4,1,0,15,17,20,19,2,1,January,0.4999999999999999,0.8660254037844387,38,16,3,0,2,1.6,1.2,20,30,-10,18,32,-14,"January, 2018"
2017-2018,22,2018-01-02,Swansea,Tottenham,0,2,A,0,3,0,0,5,3,1,1,20,6,16,37,14,21,January,0.4999999999999999,0.8660254037844387,41,42,0,2,3,0.8,2.4,13,32,-19,39,20,19,"January, 2018"
2017-2018,22,2018-01-02,West Ham,West Brom,2,1,H,3,0,2,1,2,3,1,1,18,19,18,16,1,2,January,0.4999999999999999,0.8660254037844387,45,44,1,3,1,1.6,1.4,22,38,-16,15,28,-13,"January, 2018"
2017-2018,22,2018-01-03,Arsenal,Chelsea,2,2,D,1,1,3,0,2,3,1,1,6,3,38,45,3,7,January,0.4999999999999999,0.8660254037844387,0,14,1,1,3,0.8,1.2,38,26,12,39,14,25,"January, 2018"
2017-2018,22,2018-01-04,Tottenham,West Ham,1,1,D,1,1,3,1,1,2,1,2,5,16,40,21,11,19,January,0.4999999999999999,0.8660254037844387,42,45,3,0,2,2.0,1.4,41,20,21,24,39,-15,"January, 2018"
2017-2018,23,2018-01-13,West Brom,Brighton,2,0,H,3,0,3,1,1,1,2,2,20,15,16,23,5,7,January,0.4999999999999999,0.8660254037844387,44,10,0,0,1,1.0,3.0,16,30,-14,17,27,-10,"January, 2018"
2017-2018,23,2018-01-13,Watford,Southampton,2,2,D,1,1,1,1,3,2,2,1,10,17,25,20,7,5,January,0.4999999999999999,0.8660254037844387,43,38,1,2,2,1.2,1.4,31,40,-9,21,32,-11,"January, 2018"
2017-2018,23,2018-01-13,Tottenham,Everton,4,0,H,3,0,3,1,1,2,2,1,5,9,41,27,4,14,January,0.4999999999999999,0.8660254037844387,42,18,2,3,0,1.6,0.8,42,21,21,25,34,-9,"January, 2018"
2017-2018,23,2018-01-13,Huddersfield,West Ham,1,4,A,0,3,1,2,2,2,1,2,12,15,24,22,3,2,January,0.4999999999999999,0.8660254037844387,20,45,0,0,1,0.0,2.0,18,35,-17,25,40,-15,"January, 2018"
2017-2018,23,2018-01-13,Crystal Palace,Burnley,1,0,H,3,0,4,1,0,0,2,3,14,7,22,34,7,12,January,0.4999999999999999,0.8660254037844387,16,11,1,1,3,1.0,1.6,20,33,-13,19,19,0,"January, 2018"
2017-2018,23,2018-01-13,Chelsea,Leicester,0,0,D,1,1,3,1,1,1,1,3,3,8,46,30,5,16,January,0.4999999999999999,0.8660254037844387,14,24,3,1,1,2.0,0.8,41,16,25,34,32,2,"January, 2018"
2017-2018,23,2018-01-13,Newcastle,Swansea,1,1,D,1,1,1,0,4,0,0,5,15,20,22,16,5,6,January,0.4999999999999999,0.8660254037844387,30,41,2,1,2,1.6,1.4,20,30,-10,13,34,-21,"January, 2018"
2017-2018,23,2018-01-14,Bournemouth,Arsenal,2,1,H,3,0,2,0,3,3,0,2,17,6,21,39,11,18,January,0.4999999999999999,0.8660254037844387,7,0,0,1,4,0.8,2.6,22,34,-12,40,28,12,"January, 2018"
2017-2018,23,2018-01-14,Liverpool,Man City,4,3,H,3,0,2,2,1,4,1,0,4,1,44,62,3,18,January,0.4999999999999999,0.8660254037844387,25,27,3,1,1,1.8,1.4,50,25,25,64,13,51,"January, 2018"
2017-2018,23,2018-01-15,Man United,Stoke,3,0,H,3,0,3,1,1,1,3,1,2,18,47,20,16,27,January,0.4999999999999999,0.8660254037844387,28,39,1,3,1,1.4,1.2,45,16,29,23,47,-24,"January, 2018"
2017-2018,24,2018-01-20,Man City,Newcastle,3,1,H,3,0,4,1,0,1,0,4,1,15,62,23,14,39,January,0.4999999999999999,0.8660254037844387,27,30,4,1,0,3.0,0.4,67,17,50,21,31,-10,"January, 2018"
2017-2018,24,2018-01-20,West Ham,Bournemouth,1,1,D,1,1,2,1,2,2,0,3,11,13,25,24,2,1,January,0.4999999999999999,0.8660254037844387,45,7,2,1,2,2.4,2.2,29,41,-12,24,35,-11,"January, 2018"
2017-2018,24,2018-01-20,Stoke,Huddersfield,2,0,H,3,0,1,3,1,1,2,2,19,14,20,24,5,4,January,0.4999999999999999,0.8660254037844387,39,20,0,1,0,1.0,1.0,23,50,-27,19,39,-20,"January, 2018"
2017-2018,24,2018-01-20,Leicester,Watford,2,0,H,3,0,1,1,3,1,1,3,8,10,31,26,2,5,January,0.4999999999999999,0.8660254037844387,24,43,3,0,2,1.6,1.0,34,32,2,33,42,-9,"January, 2018"
2017-2018,24,2018-01-20,Everton,West Brom,1,1,D,1,1,2,2,1,3,1,1,9,19,27,19,10,8,January,0.4999999999999999,0.8660254037844387,18,44,3,1,1,1.6,0.8,25,38,-13,18,30,-12,"January, 2018"
2017-2018,24,2018-01-20,Burnley,Man United,0,1,A,0,3,0,2,3,3,1,1,7,2,34,50,5,16,January,0.4999999999999999,0.8660254037844387,11,28,0,3,2,0.6,1.4,19,20,-1,48,16,32,"January, 2018"
2017-2018,24,2018-01-20,Brighton,Chelsea,0,4,A,0,3,1,2,2,3,1,1,16,4,23,47,12,24,January,0.4999999999999999,0.8660254037844387,10,14,0,0,1,0.0,2.0,17,29,-12,41,16,25,"January, 2018"
2017-2018,24,2018-01-20,Arsenal,Crystal Palace,4,1,H,3,0,3,0,2,4,1,0,6,12,39,25,6,14,January,0.4999999999999999,0.8660254037844387,0,16,3,1,1,1.6,1.4,41,30,11,21,33,-12,"January, 2018"
2017-2018,24,2018-01-21,Southampton,Tottenham,1,1,D,1,1,2,2,1,3,1,1,18,5,21,44,13,23,January,0.4999999999999999,0.8660254037844387,38,42,1,0,4,1.2,2.8,23,34,-11,46,21,25,"January, 2018"
2017-2018,24,2018-01-22,Swansea,Liverpool,1,0,H,3,0,0,0,5,2,2,1,20,4,17,47,16,30,January,0.4999999999999999,0.8660254037844387,41,25,2,0,3,1.4,2.2,14,35,-21,54,28,26,"January, 2018"
2017-2018,25,2018-01-30,Huddersfield,Liverpool,0,3,A,0,3,1,2,2,2,2,1,14,4,24,47,10,23,January,0.4999999999999999,0.8660254037844387,20,25,0,0,1,0.0,3.0,19,41,-22,54,29,25,"January, 2018"
2017-2018,25,2018-01-30,Swansea,Arsenal,3,1,H,3,0,0,0,5,3,0,2,20,6,20,42,14,22,January,0.4999999999999999,0.8660254037844387,41,0,1,0,4,1.0,2.6,15,35,-20,45,31,14,"January, 2018"
2017-2018,25,2018-01-30,West Ham,Crystal Palace,1,1,D,1,1,2,1,2,4,1,0,11,13,26,25,2,1,January,0.4999999999999999,0.8660254037844387,45,16,3,2,0,2.2,1.0,30,42,-12,22,37,-15,"January, 2018"
2017-2018,25,2018-01-31,Tottenham,Man United,2,0,H,3,0,3,1,1,3,1,1,5,2,45,53,3,8,January,0.4999999999999999,0.8660254037844387,42,28,2,0,3,1.0,0.8,47,22,25,49,16,33,"January, 2018"
2017-2018,25,2018-01-31,Stoke,Watford,0,0,D,1,1,1,3,1,1,1,3,19,12,23,26,7,3,January,0.4999999999999999,0.8660254037844387,39,43,4,0,1,1.2,0.6,25,50,-25,33,44,-11,"January, 2018"
2017-2018,25,2018-01-31,Southampton,Brighton,1,1,D,1,1,2,2,1,1,2,2,19,16,22,23,3,1,January,0.4999999999999999,0.8660254037844387,38,10,0,1,0,1.0,1.0,24,35,-11,17,33,-16,"January, 2018"
2017-2018,25,2018-01-31,Chelsea,Bournemouth,0,3,A,0,3,3,1,1,2,0,3,3,13,50,25,10,25,January,0.4999999999999999,0.8660254037844387,14,7,4,0,1,2.2,0.6,45,16,29,25,36,-11,"January, 2018"
2017-2018,25,2018-01-31,Man City,West Brom,3,0,H,3,0,4,1,0,3,1,1,1,20,65,20,19,45,January,0.4999999999999999,0.8660254037844387,27,44,5,0,0,3.0,0.8,70,18,52,19,31,-12,"January, 2018"
2017-2018,25,2018-01-31,Everton,Leicester,2,1,H,3,0,2,2,1,1,1,3,10,7,28,34,3,6,January,0.4999999999999999,0.8660254037844387,18,24,2,0,3,1.8,2.0,26,39,-13,36,32,4,"January, 2018"
2017-2018,25,2018-01-31,Newcastle,Burnley,1,1,D,1,1,1,0,4,0,2,3,15,8,23,34,7,11,January,0.4999999999999999,0.8660254037844387,30,11,0,2,1,1.3333333333333333,1.6666666666666667,22,34,-12,19,21,-2,"January, 2018"
2017-2018,26,2018-02-03,Leicester,Swansea,1,1,D,1,1,1,1,3,0,0,5,8,19,34,23,11,11,February,0.8660254037844386,0.5000000000000001,24,41,4,0,1,2.2,0.8,37,34,3,18,36,-18,"February, 2018"
2017-2018,26,2018-02-03,Man United,Huddersfield,2,0,H,3,0,3,1,1,1,2,2,2,17,53,24,15,29,February,0.8660254037844386,0.5000000000000001,28,20,0,0,1,1.0,2.0,49,18,31,19,44,-25,"February, 2018"
2017-2018,26,2018-02-03,Burnley,Man City,1,1,D,1,1,0,2,3,4,1,0,7,1,35,68,6,33,February,0.8660254037844386,0.5000000000000001,11,27,1,1,3,1.0,1.8,20,22,-2,73,18,55,"February, 2018"
2017-2018,26,2018-02-03,West Brom,Southampton,2,3,A,0,3,3,1,1,2,2,1,20,19,20,23,1,3,February,0.8660254037844386,0.5000000000000001,44,38,1,1,3,0.4,1.2,19,34,-15,25,36,-11,"February, 2018"
2017-2018,26,2018-02-03,Bournemouth,Stoke,2,1,H,3,0,2,0,3,1,3,1,10,16,28,24,6,4,February,0.8660254037844386,0.5000000000000001,7,39,2,1,2,1.4,1.6,28,36,-8,25,50,-25,"February, 2018"
2017-2018,26,2018-02-03,Arsenal,Everton,5,1,H,3,0,3,0,2,2,2,1,6,9,42,31,3,11,February,0.8660254037844386,0.5000000000000001,0,18,4,0,1,2.6,1.2,46,34,12,28,40,-12,"February, 2018"
2017-2018,26,2018-02-03,Brighton,West Ham,3,1,H,3,0,1,2,2,2,1,2,15,12,24,27,3,3,February,0.8660254037844386,0.5000000000000001,10,45,1,0,0,3.0,0.0,18,34,-16,31,43,-12,"February, 2018"
2017-2018,26,2018-02-04,Crystal Palace,Newcastle,1,1,D,1,1,4,1,0,1,0,4,15,16,26,24,1,2,February,0.8660254037844386,0.5000000000000001,16,30,1,2,2,1.8,1.4,23,38,-15,23,35,-12,"February, 2018"
2017-2018,26,2018-02-04,Liverpool,Tottenham,2,2,D,1,1,2,2,1,3,1,1,3,5,50,48,2,2,February,0.8660254037844386,0.5000000000000001,25,42,1,3,1,1.0,1.2,57,29,28,49,22,27,"February, 2018"
2017-2018,26,2018-02-05,Watford,Chelsea,4,1,H,3,0,1,1,3,3,1,1,11,4,27,50,7,23,February,0.8660254037844386,0.5000000000000001,43,14,0,2,3,1.6,2.4,33,44,-11,45,19,26,"February, 2018"
2017-2018,27,2018-02-10,Tottenham,Arsenal,1,0,H,3,0,3,1,1,3,0,2,5,6,49,45,1,4,February,0.8660254037844386,0.5000000000000001,42,0,1,3,1,1.2,1.2,51,24,27,51,35,16,"February, 2018"
2017-2018,27,2018-02-10,Swansea,Burnley,1,0,H,3,0,0,0,5,0,2,3,18,7,24,36,11,12,February,0.8660254037844386,0.5000000000000001,41,11,4,0,1,1.2,0.8,19,37,-18,21,23,-2,"February, 2018"
2017-2018,27,2018-02-10,West Ham,Watford,2,0,H,3,0,2,1,2,1,1,3,13,11,27,30,2,3,February,0.8660254037844386,0.5000000000000001,45,43,1,1,3,1.2,2.0,32,46,-14,37,45,-8,"February, 2018"
2017-2018,27,2018-02-10,Man City,Leicester,5,1,H,3,0,4,1,0,1,1,3,1,8,69,35,7,34,February,0.8660254037844386,0.5000000000000001,27,24,2,1,2,1.4,1.6,74,19,55,38,35,3,"February, 2018"
2017-2018,27,2018-02-10,Everton,Crystal Palace,3,1,H,3,0,2,2,1,4,1,0,10,14,31,27,4,4,February,0.8660254037844386,0.5000000000000001,18,16,1,4,0,1.0,0.8,29,45,-16,24,39,-15,"February, 2018"
2017-2018,27,2018-02-10,Stoke,Brighton,1,1,D,1,1,1,3,1,1,2,2,18,13,24,27,5,3,February,0.8660254037844386,0.5000000000000001,39,10,0,1,0,2.0,2.0,26,52,-26,21,35,-14,"February, 2018"
2017-2018,27,2018-02-11,Huddersfield,Bournemouth,4,1,H,3,0,1,2,2,2,0,3,19,10,24,31,9,7,February,0.8660254037844386,0.5000000000000001,20,7,0,0,1,0.0,4.0,19,46,-27,30,37,-7,"February, 2018"
2017-2018,27,2018-02-11,Newcastle,Man United,1,0,H,3,0,1,0,4,3,1,1,18,2,25,56,16,31,February,0.8660254037844386,0.5000000000000001,30,28,0,2,3,1.0,2.2,24,36,-12,51,18,33,"February, 2018"
2017-2018,27,2018-02-11,Southampton,Liverpool,0,2,A,0,3,2,2,1,2,2,1,18,4,26,51,14,25,February,0.8660254037844386,0.5000000000000001,38,25,1,3,1,0.8,1.2,28,38,-10,59,31,28,"February, 2018"
2017-2018,27,2018-02-12,Chelsea,West Brom,3,0,H,3,0,3,1,1,3,1,1,5,20,50,20,15,30,February,0.8660254037844386,0.5000000000000001,14,44,4,1,0,2.2,0.8,46,23,23,21,37,-16,"February, 2018"
2017-2018,28,2018-02-24,West Brom,Huddersfield,1,2,A,0,3,3,1,1,1,2,2,20,18,20,27,2,7,February,0.8660254037844386,0.5000000000000001,44,20,0,0,1,0.0,1.0,21,40,-19,23,47,-24,"February, 2018"
2017-2018,28,2018-02-24,Bournemouth,Newcastle,2,2,D,1,1,2,0,3,1,0,4,10,13,31,28,3,3,February,0.8660254037844386,0.5000000000000001,7,30,2,0,1,1.3333333333333333,0.6666666666666666,31,41,-10,25,36,-11,"February, 2018"
2017-2018,28,2018-02-24,Brighton,Swansea,4,1,H,3,0,1,2,2,0,0,5,14,16,28,27,2,1,February,0.8660254037844386,0.5000000000000001,10,41,1,0,0,1.0,0.0,22,36,-14,20,37,-17,"February, 2018"
2017-2018,28,2018-02-24,Burnley,Southampton,1,1,D,1,1,0,2,3,2,2,1,7,18,36,26,11,10,February,0.8660254037844386,0.5000000000000001,11,38,3,0,2,0.8,1.0,21,24,-3,28,40,-12,"February, 2018"
2017-2018,28,2018-02-24,Leicester,Stoke,1,1,D,1,1,1,1,3,1,3,1,8,19,35,25,11,10,February,0.8660254037844386,0.5000000000000001,24,39,2,3,0,2.2,1.2,39,40,-1,27,53,-26,"February, 2018"
2017-2018,28,2018-02-24,Liverpool,West Ham,4,1,H,3,0,2,2,1,2,1,2,3,13,54,30,10,24,February,0.8660254037844386,0.5000000000000001,25,45,2,1,2,2.0,1.6,61,31,30,34,46,-12,"February, 2018"
2017-2018,28,2018-02-24,Watford,Everton,1,0,H,3,0,1,1,3,2,2,1,12,9,30,34,3,4,February,0.8660254037844386,0.5000000000000001,43,18,1,2,2,1.6,1.8,37,47,-10,32,46,-14,"February, 2018"
2017-2018,28,2018-02-25,Man United,Chelsea,2,1,H,3,0,3,1,1,3,1,1,3,5,56,53,2,3,February,0.8660254037844386,0.5000000000000001,28,14,1,2,2,0.6,1.2,51,19,32,49,23,26,"February, 2018"
2017-2018,28,2018-02-25,Crystal Palace,Tottenham,0,1,A,0,3,4,1,0,3,1,1,17,5,27,52,12,25,February,0.8660254037844386,0.5000000000000001,16,42,0,0,5,0.2,1.4,25,42,-17,52,24,28,"February, 2018"
2017-2018,28,2018-03-01,Arsenal,Man City,0,3,A,0,3,3,0,2,4,1,0,6,1,45,72,5,27,March,1.0,6.123233995736766e-17,0,27,1,2,2,1.6,2.0,51,36,15,79,20,59,"March, 2018"
2017-2018,29,2018-03-03,Burnley,Everton,2,1,H,3,0,0,2,3,2,2,1,7,9,37,34,2,3,March,1.0,6.123233995736766e-17,11,18,2,0,3,1.0,1.6,22,25,-3,32,47,-15,"March, 2018"
2017-2018,29,2018-03-03,Leicester,Bournemouth,1,1,D,1,1,1,1,3,2,0,3,8,11,36,32,3,4,March,1.0,6.123233995736766e-17,24,7,0,4,1,0.4,0.6,40,41,-1,33,43,-10,"March, 2018"
2017-2018,29,2018-03-03,Liverpool,Newcastle,2,0,H,3,0,2,2,1,1,0,4,3,15,57,29,12,28,March,1.0,6.123233995736766e-17,25,30,1,2,2,1.0,1.2,65,32,33,27,38,-11,"March, 2018"
2017-2018,29,2018-03-03,Southampton,Stoke,0,0,D,1,1,2,2,1,1,3,1,16,19,27,26,3,1,March,1.0,6.123233995736766e-17,38,39,1,1,3,0.6,1.0,29,41,-12,28,54,-26,"March, 2018"
2017-2018,29,2018-03-03,Swansea,West Ham,4,1,H,3,0,0,0,5,2,1,2,18,13,27,30,5,3,March,1.0,6.123233995736766e-17,41,45,1,1,3,1.0,1.4,21,41,-20,35,50,-15,"March, 2018"
2017-2018,29,2018-03-03,Tottenham,Huddersfield,2,0,H,3,0,3,1,1,1,2,2,4,15,55,30,11,25,March,1.0,6.123233995736766e-17,42,20,1,0,0,4.0,0.0,53,24,29,25,48,-23,"March, 2018"
2017-2018,29,2018-03-03,Watford,West Brom,1,0,H,3,0,1,1,3,3,1,1,10,20,33,20,10,13,March,1.0,6.123233995736766e-17,43,44,2,2,1,1.2,1.0,38,47,-9,22,42,-20,"March, 2018"
2017-2018,29,2018-03-04,Brighton,Arsenal,2,1,H,3,0,1,2,2,3,0,2,12,6,31,45,6,14,March,1.0,6.123233995736766e-17,10,0,0,0,1,0.0,2.0,26,37,-11,51,39,12,"March, 2018"
2017-2018,29,2018-03-04,Man City,Chelsea,1,0,H,3,0,4,1,0,3,1,1,1,5,75,53,4,22,March,1.0,6.123233995736766e-17,27,14,3,0,2,1.8,1.0,82,20,62,50,25,25,"March, 2018"
2017-2018,29,2018-03-05,Crystal Palace,Man United,2,3,A,0,3,4,1,0,3,1,1,18,3,27,59,15,32,March,1.0,6.123233995736766e-17,16,28,0,1,4,0.2,2.0,25,43,-18,53,20,33,"March, 2018"
2017-2018,30,2018-03-10,West Ham,Burnley,0,3,A,0,3,2,1,2,0,2,3,16,8,30,40,8,10,March,1.0,6.123233995736766e-17,45,11,4,1,0,1.6,0.6,36,54,-18,24,26,-2,"March, 2018"
2017-2018,30,2018-03-10,West Brom,Leicester,1,4,A,0,3,3,1,1,1,1,3,20,8,20,37,12,17,March,1.0,6.123233995736766e-17,44,24,1,2,2,1.4,1.6,22,43,-21,41,42,-1,"March, 2018"
2017-2018,30,2018-03-10,Newcastle,Southampton,3,0,H,3,0,1,0,4,2,2,1,16,17,29,28,1,1,March,1.0,6.123233995736766e-17,30,38,0,2,3,1.2,2.6,27,40,-13,29,41,-12,"March, 2018"
2017-2018,30,2018-03-10,Chelsea,Crystal Palace,2,1,H,3,0,3,1,1,4,1,0,5,18,53,27,13,26,March,1.0,6.123233995736766e-17,14,16,2,0,3,1.4,1.2,50,26,24,27,46,-19,"March, 2018"
2017-2018,30,2018-03-10,Huddersfield,Swansea,0,0,D,1,1,1,2,2,0,0,5,15,13,30,30,2,0,March,1.0,6.123233995736766e-17,20,41,0,0,1,0.0,2.0,25,50,-25,25,42,-17,"March, 2018"
2017-2018,30,2018-03-10,Everton,Brighton,2,0,H,3,0,2,2,1,1,2,2,11,10,34,34,1,0,March,1.0,6.123233995736766e-17,18,10,0,1,0,1.0,1.0,33,49,-16,28,38,-10,"March, 2018"
2017-2018,30,2018-03-10,Man United,Liverpool,2,1,H,3,0,3,1,1,2,2,1,2,3,62,60,1,2,March,1.0,6.123233995736766e-17,28,25,2,3,0,1.0,0.4,56,22,34,67,32,35,"March, 2018"
2017-2018,30,2018-03-11,Arsenal,Watford,3,0,H,3,0,3,0,2,1,1,3,6,10,45,36,4,9,March,1.0,6.123233995736766e-17,0,43,3,0,2,2.4,1.0,52,41,11,39,47,-8,"March, 2018"
2017-2018,30,2018-03-11,Bournemouth,Tottenham,1,4,A,0,3,2,0,3,3,1,1,12,4,33,58,8,25,March,1.0,6.123233995736766e-17,7,42,0,1,4,0.2,2.6,34,44,-10,55,24,31,"March, 2018"
2017-2018,30,2018-03-12,Stoke,Man City,0,2,A,0,3,1,3,1,4,1,0,19,1,27,78,18,51,March,1.0,6.123233995736766e-17,39,27,1,1,3,1.0,3.0,28,54,-26,83,20,63,"March, 2018"
2017-2018,31,2018-03-17,Stoke,Everton,1,2,A,0,3,1,3,1,2,2,1,19,9,27,37,10,10,March,1.0,6.123233995736766e-17,39,18,1,1,3,1.0,1.8,28,56,-28,35,49,-14,"March, 2018"
2017-2018,31,2018-03-17,Liverpool,Watford,5,0,H,3,0,2,2,1,1,1,3,4,10,60,36,6,24,March,1.0,6.123233995736766e-17,25,43,3,1,1,2.4,1.4,68,34,34,39,50,-11,"March, 2018"
2017-2018,31,2018-03-17,Bournemouth,West Brom,2,1,H,3,0,2,0,3,3,1,1,12,20,33,20,8,13,March,1.0,6.123233995736766e-17,7,44,2,1,2,1.0,1.0,35,48,-13,23,47,-24,"March, 2018"
2017-2018,31,2018-03-17,Huddersfield,Crystal Palace,0,2,A,0,3,1,2,2,4,1,0,15,18,31,27,3,4,March,1.0,6.123233995736766e-17,20,16,1,0,0,3.0,0.0,25,50,-25,28,48,-20,"March, 2018"
2017-2018,32,2018-03-31,Brighton,Leicester,0,2,A,0,3,1,2,2,1,1,3,12,8,34,40,4,6,March,1.0,6.123233995736766e-17,10,24,0,0,1,0.0,2.0,28,40,-12,45,43,2,"March, 2018"
2017-2018,32,2018-03-31,Crystal Palace,Liverpool,1,2,A,0,3,4,1,0,2,2,1,16,3,30,63,13,33,March,1.0,6.123233995736766e-17,16,25,2,0,3,1.4,1.8,30,48,-18,73,34,39,"March, 2018"
2017-2018,32,2018-03-31,Everton,Man City,1,3,A,0,3,2,2,1,4,1,0,9,1,40,81,8,41,March,1.0,6.123233995736766e-17,18,27,1,3,1,1.2,0.8,37,50,-13,85,20,65,"March, 2018"
2017-2018,32,2018-03-31,Man United,Swansea,2,0,H,3,0,3,1,1,0,0,5,3,14,65,31,11,34,March,1.0,6.123233995736766e-17,28,41,3,1,1,2.2,1.0,58,23,35,25,42,-17,"March, 2018"
2017-2018,32,2018-03-31,Newcastle,Huddersfield,1,0,H,3,0,1,0,4,1,2,2,13,15,32,31,2,1,March,1.0,6.123233995736766e-17,30,20,0,0,1,0.0,1.0,30,40,-10,25,52,-27,"March, 2018"
2017-2018,32,2018-03-31,Watford,Bournemouth,2,2,D,1,1,1,1,3,2,0,3,11,10,36,36,1,0,March,1.0,6.123233995736766e-17,43,7,1,4,0,1.4,1.0,39,55,-16,37,49,-12,"March, 2018"
2017-2018,32,2018-03-31,West Brom,Burnley,1,2,A,0,3,3,1,1,0,2,3,20,8,20,43,12,23,March,1.0,6.123233995736766e-17,44,11,3,2,0,2.6,0.8,24,49,-25,27,26,1,"March, 2018"
2017-2018,32,2018-03-31,West Ham,Southampton,3,0,H,3,0,2,1,2,2,2,1,17,18,30,28,1,2,March,1.0,6.123233995736766e-17,45,38,2,0,3,1.4,1.8,36,57,-21,29,44,-15,"March, 2018"
2017-2018,32,2018-04-01,Arsenal,Stoke,3,0,H,3,0,3,0,2,1,3,1,6,19,48,27,13,21,April,0.8660254037844388,-0.4999999999999998,0,39,3,1,1,1.8,0.6,55,41,14,29,58,-29,"April, 2018"
2017-2018,32,2018-04-01,Chelsea,Tottenham,1,3,A,0,3,3,1,1,3,1,1,5,4,56,61,1,5,April,0.8660254037844388,-0.4999999999999998,14,42,2,2,1,1.2,1.2,52,27,25,59,25,34,"April, 2018"
2017-2018,33,2018-04-07,Watford,Burnley,1,2,A,0,3,1,1,3,0,2,3,12,7,37,46,5,9,April,0.8660254037844388,-0.4999999999999998,43,11,1,0,2,0.6666666666666666,1.3333333333333333,41,57,-16,29,27,2,"April, 2018"
2017-2018,33,2018-04-07,Stoke,Tottenham,1,2,A,0,3,1,3,1,3,1,1,19,4,27,64,15,37,April,0.8660254037844388,-0.4999999999999998,39,42,0,1,4,0.6,3.8,29,61,-32,62,26,36,"April, 2018"
2017-2018,33,2018-04-07,Man City,Man United,2,3,A,0,3,4,1,0,3,1,1,1,2,84,68,1,16,April,0.8660254037844388,-0.4999999999999998,27,28,2,2,1,0.8,0.6,88,21,67,60,23,37,"April, 2018"
2017-2018,33,2018-04-07,West Brom,Swansea,1,1,D,1,1,3,1,1,0,0,5,20,17,20,31,3,11,April,0.8660254037844388,-0.4999999999999998,44,41,1,1,3,1.0,1.2,25,51,-26,25,44,-19,"April, 2018"
2017-2018,33,2018-04-07,Everton,Liverpool,0,0,D,1,1,2,2,1,2,2,1,9,3,40,66,6,26,April,0.8660254037844388,-0.4999999999999998,18,25,0,2,3,0.6,2.0,38,53,-15,75,35,40,"April, 2018"
2017-2018,33,2018-04-07,Brighton,Huddersfield,1,1,D,1,1,1,2,2,1,2,2,13,17,34,31,4,3,April,0.8660254037844388,-0.4999999999999998,10,20,0,0,1,0.0,2.0,28,42,-14,25,53,-28,"April, 2018"
2017-2018,33,2018-04-07,Bournemouth,Crystal Palace,2,2,D,1,1,2,0,3,4,1,0,10,17,37,30,7,7,April,0.8660254037844388,-0.4999999999999998,7,16,1,3,1,1.0,1.2,39,51,-12,31,50,-19,"April, 2018"
2017-2018,33,2018-04-07,Leicester,Newcastle,1,2,A,0,3,1,1,3,1,0,4,8,12,43,35,4,8,April,0.8660254037844388,-0.4999999999999998,24,30,4,0,1,2.0,0.6,47,43,4,31,40,-9,"April, 2018"
2017-2018,33,2018-04-08,Chelsea,West Ham,1,1,D,1,1,3,1,1,2,1,2,5,14,56,33,9,23,April,0.8660254037844388,-0.4999999999999998,14,45,2,1,2,1.4,1.4,53,30,23,39,57,-18,"April, 2018"
2017-2018,33,2018-04-08,Arsenal,Southampton,3,2,H,3,0,3,0,2,2,2,1,6,18,51,28,12,23,April,0.8660254037844388,-0.4999999999999998,0,38,2,2,1,1.0,1.2,58,41,17,29,47,-18,"April, 2018"
2017-2018,34,2018-04-14,Burnley,Leicester,2,1,H,3,0,0,2,3,1,1,3,7,8,49,43,1,6,April,0.8660254037844388,-0.4999999999999998,11,24,1,1,3,0.6,1.4,31,28,3,48,45,3,"April, 2018"
2017-2018,34,2018-04-14,Crystal Palace,Brighton,3,2,H,3,0,4,1,0,1,2,2,17,13,31,35,4,4,April,0.8660254037844388,-0.4999999999999998,16,10,0,1,0,0.0,0.0,33,52,-19,29,43,-14,"April, 2018"
2017-2018,34,2018-04-14,Huddersfield,Watford,1,0,H,3,0,1,2,2,1,1,3,17,12,32,37,5,5,April,0.8660254037844388,-0.4999999999999998,20,43,1,0,0,4.0,1.0,26,54,-28,42,59,-17,"April, 2018"
2017-2018,34,2018-04-14,Liverpool,Bournemouth,3,0,H,3,0,2,2,1,2,0,3,3,11,67,38,8,29,April,0.8660254037844388,-0.4999999999999998,25,7,3,1,1,2.4,1.4,75,35,40,41,53,-12,"April, 2018"
2017-2018,34,2018-04-14,Southampton,Chelsea,2,3,A,0,3,2,2,1,3,1,1,18,5,28,57,13,29,April,0.8660254037844388,-0.4999999999999998,38,14,1,0,4,1.2,2.0,31,50,-19,54,31,23,"April, 2018"
2017-2018,34,2018-04-14,Swansea,Everton,1,1,D,1,1,0,0,5,2,2,1,17,9,32,41,8,9,April,0.8660254037844388,-0.4999999999999998,41,18,2,2,1,1.0,1.0,26,45,-19,38,53,-15,"April, 2018"
2017-2018,34,2018-04-14,Tottenham,Man City,1,3,A,0,3,3,1,1,4,1,0,4,1,67,84,3,17,April,0.8660254037844388,-0.4999999999999998,42,27,3,1,1,2.2,1.6,64,27,37,90,24,66,"April, 2018"
2017-2018,34,2018-04-15,Man United,West Brom,0,1,A,0,3,3,1,1,3,1,1,2,20,71,21,18,50,April,0.8660254037844388,-0.4999999999999998,28,44,3,1,1,1.2,0.4,63,25,38,26,52,-26,"April, 2018"
2017-2018,34,2018-04-15,Newcastle,Arsenal,2,1,H,3,0,1,0,4,3,0,2,10,6,38,54,4,16,April,0.8660254037844388,-0.4999999999999998,30,0,0,0,5,0.4,1.8,33,41,-8,61,43,18,"April, 2018"
2017-2018,34,2018-04-16,West Ham,Stoke,1,1,D,1,1,2,1,2,1,3,1,15,19,34,27,4,7,April,0.8660254037844388,-0.4999999999999998,45,39,1,3,1,1.0,0.6,40,58,-18,30,63,-33,"April, 2018"
2017-2018,34,2018-04-17,Brighton,Tottenham,1,1,D,1,1,1,2,2,3,1,1,13,4,35,67,9,32,April,0.8660254037844388,-0.4999999999999998,10,42,0,0,1,0.0,2.0,31,46,-15,65,30,35,"April, 2018"
2017-2018,34,2018-04-18,Bournemouth,Man United,0,2,A,0,3,2,0,3,3,1,1,11,2,38,71,9,33,April,0.8660254037844388,-0.4999999999999998,7,28,1,1,3,1.0,1.8,41,56,-15,63,26,37,"April, 2018"
2017-2018,34,2018-04-19,Burnley,Chelsea,1,2,A,0,3,0,2,3,3,1,1,7,5,52,60,2,8,April,0.8660254037844388,-0.4999999999999998,11,14,1,2,2,1.2,2.0,33,29,4,57,33,24,"April, 2018"
2017-2018,34,2018-04-19,Leicester,Southampton,0,0,D,1,1,1,1,3,2,2,1,8,18,43,28,10,15,April,0.8660254037844388,-0.4999999999999998,24,38,2,2,1,1.4,1.2,49,47,2,33,53,-20,"April, 2018"
2017-2018,35,2018-04-21,Watford,Crystal Palace,0,0,D,1,1,1,1,3,4,1,0,12,16,37,34,4,3,April,0.8660254037844388,-0.4999999999999998,43,16,1,1,3,0.8,1.2,42,60,-18,36,54,-18,"April, 2018"
2017-2018,35,2018-04-21,West Brom,Liverpool,2,2,D,1,1,3,1,1,2,2,1,20,3,24,70,17,46,April,0.8660254037844388,-0.4999999999999998,44,25,0,3,2,0.8,1.2,27,52,-25,78,35,43,"April, 2018"
2017-2018,35,2018-04-22,Arsenal,West Ham,4,1,H,3,0,3,0,2,2,1,2,6,14,54,35,8,19,April,0.8660254037844388,-0.4999999999999998,0,45,2,2,1,2.2,1.2,62,45,17,41,59,-18,"April, 2018"
2017-2018,35,2018-04-22,Man City,Swansea,5,0,H,3,0,4,1,0,0,0,5,1,17,87,33,16,54,April,0.8660254037844388,-0.4999999999999998,27,41,4,1,0,2.4,0.8,93,25,68,27,46,-19,"April, 2018"
2017-2018,35,2018-04-22,Stoke,Burnley,1,1,D,1,1,1,3,1,0,2,3,19,7,28,52,12,24,April,0.8660254037844388,-0.4999999999999998,39,11,1,1,3,0.6,0.8,31,64,-33,34,31,3,"April, 2018"
2017-2018,35,2018-04-23,Everton,Newcastle,1,0,H,3,0,2,2,1,1,0,4,9,10,42,41,1,1,April,0.8660254037844388,-0.4999999999999998,18,30,4,0,1,2.0,0.6,39,54,-15,35,42,-7,"April, 2018"
2017-2018,36,2018-04-28,Swansea,Chelsea,0,1,A,0,3,0,0,5,3,1,1,17,5,33,63,12,30,April,0.8660254037844388,-0.4999999999999998,41,14,1,2,2,1.2,1.6,27,51,-24,59,34,25,"April, 2018"
2017-2018,36,2018-04-28,Southampton,Bournemouth,2,1,H,3,0,2,2,1,2,0,3,19,12,29,38,7,9,April,0.8660254037844388,-0.4999999999999998,38,7,2,2,1,1.2,0.8,33,53,-20,41,58,-17,"April, 2018"
2017-2018,36,2018-04-28,Newcastle,West Brom,0,1,A,0,3,1,0,4,3,1,1,10,20,41,25,10,16,April,0.8660254037844388,-0.4999999999999998,30,44,2,2,1,1.2,0.8,35,43,-8,29,54,-25,"April, 2018"
2017-2018,36,2018-04-28,Crystal Palace,Leicester,5,0,H,3,0,4,1,0,1,1,3,14,9,35,44,5,9,April,0.8660254037844388,-0.4999999999999998,16,24,1,1,3,1.2,1.4,36,54,-18,49,47,2,"April, 2018"
2017-2018,36,2018-04-28,Huddersfield,Everton,0,2,A,0,3,1,2,2,2,2,1,16,8,35,45,8,10,April,0.8660254037844388,-0.4999999999999998,20,18,0,0,1,0.0,2.0,27,54,-27,40,54,-14,"April, 2018"
2017-2018,36,2018-04-28,Burnley,Brighton,0,0,D,1,1,0,2,3,1,2,2,7,13,53,36,6,17,April,0.8660254037844388,-0.4999999999999998,11,10,0,1,0,0.0,0.0,35,32,3,32,47,-15,"April, 2018"
2017-2018,36,2018-04-28,Liverpool,Stoke,0,0,D,1,1,2,2,1,1,3,1,3,19,71,29,16,42,April,0.8660254037844388,-0.4999999999999998,25,39,5,0,0,2.8,0.6,80,37,43,32,65,-33,"April, 2018"
2017-2018,36,2018-04-29,Man United,Arsenal,2,1,H,3,0,3,1,1,3,0,2,2,6,74,57,4,17,April,0.8660254037844388,-0.4999999999999998,28,0,2,1,2,1.4,1.8,65,26,39,66,46,20,"April, 2018"
2017-2018,36,2018-04-29,West Ham,Man City,1,4,A,0,3,2,1,2,4,1,0,15,1,35,90,14,55,April,0.8660254037844388,-0.4999999999999998,45,27,1,1,3,1.2,2.4,42,63,-21,98,25,73,"April, 2018"
2017-2018,36,2018-04-30,Tottenham,Watford,2,0,H,3,0,3,1,1,1,1,3,4,13,68,38,9,30,April,0.8660254037844388,-0.4999999999999998,42,43,4,1,0,2.4,0.6,66,31,35,42,60,-18,"April, 2018"
2017-2018,37,2018-05-04,Brighton,Man United,1,0,H,3,0,1,2,2,3,1,1,14,2,37,77,12,40,May,0.4999999999999999,-0.8660254037844387,10,28,0,0,1,0.0,1.0,32,47,-15,67,27,40,"May, 2018"
2017-2018,37,2018-05-05,West Brom,Tottenham,1,0,H,3,0,3,1,1,3,1,1,20,4,28,71,16,43,May,0.4999999999999999,-0.8660254037844387,44,42,0,4,1,0.8,1.6,30,54,-24,68,31,37,"May, 2018"
2017-2018,37,2018-05-05,Watford,Newcastle,2,1,H,3,0,1,1,3,1,0,4,14,10,38,41,4,3,May,0.4999999999999999,-0.8660254037844387,43,30,3,1,1,1.8,1.0,42,62,-20,35,44,-9,"May, 2018"
2017-2018,37,2018-05-05,Stoke,Crystal Palace,1,2,A,0,3,1,3,1,4,1,0,19,13,30,38,6,8,May,0.4999999999999999,-0.8660254037844387,39,16,1,0,4,1.0,2.0,32,65,-33,41,54,-13,"May, 2018"
2017-2018,37,2018-05-05,Leicester,West Ham,0,2,A,0,3,1,1,3,2,1,2,9,15,44,35,6,9,May,0.4999999999999999,-0.8660254037844387,24,45,3,2,0,1.8,1.2,49,52,-3,43,67,-24,"May, 2018"
2017-2018,37,2018-05-05,Bournemouth,Swansea,1,0,H,3,0,2,0,3,0,0,5,13,17,38,33,4,5,May,0.4999999999999999,-0.8660254037844387,7,41,3,2,0,2.0,0.8,42,60,-18,27,52,-25,"May, 2018"
2017-2018,37,2018-05-05,Everton,Southampton,1,1,D,1,1,2,2,1,2,2,1,8,18,48,32,10,16,May,0.4999999999999999,-0.8660254037844387,18,38,2,1,2,1.6,1.2,42,54,-12,35,54,-19,"May, 2018"
2017-2018,37,2018-05-06,Arsenal,Burnley,5,0,H,3,0,3,0,2,0,2,3,6,7,57,54,1,3,May,0.4999999999999999,-0.8660254037844387,0,11,5,0,0,1.6,0.2,67,48,19,35,32,3,"May, 2018"
2017-2018,37,2018-05-06,Chelsea,Liverpool,1,0,H,3,0,3,1,1,2,2,1,5,3,66,72,2,6,May,0.4999999999999999,-0.8660254037844387,14,25,0,3,2,1.0,1.6,60,34,26,80,37,43,"May, 2018"
2017-2018,37,2018-05-06,Man City,Huddersfield,0,0,D,1,1,4,1,0,1,2,2,1,16,93,35,15,58,May,0.4999999999999999,-0.8660254037844387,27,20,1,0,0,2.0,1.0,102,26,76,27,56,-29,"May, 2018"
2017-2018,37,2018-05-08,Swansea,Southampton,0,1,A,0,3,0,0,5,2,2,1,18,17,33,33,1,0,May,0.4999999999999999,-0.8660254037844387,41,38,1,1,3,0.6,1.2,27,53,-26,36,55,-19,"May, 2018"
2017-2018,37,2018-05-09,Tottenham,Newcastle,1,0,H,3,0,3,1,1,1,0,4,4,10,71,41,6,30,May,0.4999999999999999,-0.8660254037844387,42,30,2,0,3,1.6,2.0,68,32,36,36,46,-10,"May, 2018"
2017-2018,37,2018-05-09,Man City,Brighton,3,1,H,3,0,4,1,0,1,2,2,1,14,94,40,13,54,May,0.4999999999999999,-0.8660254037844387,27,10,1,0,0,2.0,0.0,102,26,76,33,47,-14,"May, 2018"
2017-2018,37,2018-05-09,Chelsea,Huddersfield,1,1,D,1,1,3,1,1,1,2,2,5,17,69,36,12,33,May,0.4999999999999999,-0.8660254037844387,14,20,1,0,0,3.0,1.0,61,34,27,27,56,-29,"May, 2018"
2017-2018,37,2018-05-09,Leicester,Arsenal,3,1,H,3,0,1,1,3,3,0,2,9,6,44,60,3,16,May,0.4999999999999999,-0.8660254037844387,24,0,0,1,4,1.2,2.4,49,54,-5,72,48,24,"May, 2018"
2017-2018,37,2018-05-10,West Ham,Man United,0,0,D,1,1,2,1,2,3,1,1,15,2,38,77,13,39,May,0.4999999999999999,-0.8660254037844387,45,28,1,2,2,0.8,1.8,45,67,-22,67,28,39,"May, 2018"
2017-2018,38,2018-05-13,Swansea,Stoke,1,2,A,0,3,0,0,5,1,3,1,18,20,33,30,2,3,May,0.4999999999999999,-0.8660254037844387,41,39,1,1,3,1.2,1.6,27,54,-27,33,67,-34,"May, 2018"
2017-2018,38,2018-05-13,Burnley,Bournemouth,1,2,A,0,3,0,2,3,2,0,3,7,12,54,41,5,13,May,0.4999999999999999,-0.8660254037844387,11,7,2,0,1,2.0,1.6666666666666667,35,37,-2,43,60,-17,"May, 2018"
2017-2018,38,2018-05-13,Crystal Palace,West Brom,2,0,H,3,0,4,1,0,3,1,1,12,19,41,31,7,10,May,0.4999999999999999,-0.8660254037844387,16,44,2,1,2,1.2,0.8,43,55,-12,31,54,-23,"May, 2018"
2017-2018,38,2018-05-13,Huddersfield,Arsenal,0,1,A,0,3,1,2,2,3,0,2,16,6,37,60,10,23,May,0.4999999999999999,-0.8660254037844387,20,0,0,0,1,0.0,5.0,28,57,-29,73,51,22,"May, 2018"
2017-2018,38,2018-05-13,Liverpool,Brighton,4,0,H,3,0,2,2,1,1,2,2,4,14,72,40,10,32,May,0.4999999999999999,-0.8660254037844387,25,10,1,0,0,5.0,1.0,80,38,42,34,50,-16,"May, 2018"
2017-2018,38,2018-05-13,Man United,Watford,1,0,H,3,0,3,1,1,1,1,3,2,13,78,41,11,37,May,0.4999999999999999,-0.8660254037844387,28,43,4,0,1,2.0,1.2,67,28,39,44,63,-19,"May, 2018"
2017-2018,38,2018-05-13,Newcastle,Chelsea,3,0,H,3,0,1,0,4,3,1,1,12,5,41,70,7,29,May,0.4999999999999999,-0.8660254037844387,30,14,1,1,3,1.2,2.6,36,47,-11,62,35,27,"May, 2018"
2017-2018,38,2018-05-13,Southampton,Man City,0,1,A,0,3,2,2,1,4,1,0,17,1,36,97,16,61,May,0.4999999999999999,-0.8660254037844387,38,27,1,1,3,1.4,2.2,37,55,-18,105,27,78,"May, 2018"
2017-2018,38,2018-05-13,Tottenham,Leicester,5,4,H,3,0,3,1,1,1,1,3,4,9,74,47,5,27,May,0.4999999999999999,-0.8660254037844387,42,24,1,2,2,1.8,1.2,69,32,37,52,55,-3,"May, 2018"
2017-2018,38,2018-05-13,West Ham,Everton,3,1,H,3,0,2,1,2,2,2,1,15,8,39,49,7,10,May,0.4999999999999999,-0.8660254037844387,45,18,1,2,2,0.8,1.8,45,67,-22,43,55,-12,"May, 2018"
2018-2019,1,2018-08-10,Man United,Leicester,2,1,H,3,0,0,2,3,1,2,2,14,11,0,0,3,0,August,-0.8660254037844384,-0.5000000000000004,28,24,3,2,0,2.4,0.8,0,0,0,0,0,0,"August, 2018"
2018-2019,1,2018-08-11,Bournemouth,Cardiff,2,0,H,3,0,2,1,2,2,0,3,3,6,0,0,3,0,August,-0.8660254037844384,-0.5000000000000004,7,12,0,0,0,0.0,0.0,0,0,0,0,0,0,"August, 2018"
2018-2019,1,2018-08-11,Fulham,Crystal Palace,0,2,A,0,3,3,0,2,3,1,1,9,7,0,0,2,0,August,-0.8660254037844384,-0.5000000000000004,19,16,2,1,1,2.25,1.5,0,0,0,0,0,0,"August, 2018"
2018-2019,1,2018-08-11,Huddersfield,Chelsea,0,3,A,0,3,0,2,3,1,3,1,9,7,0,0,2,0,August,-0.8660254037844384,-0.5000000000000004,20,14,0,1,1,1.0,2.0,0,0,0,0,0,0,"August, 2018"
2018-2019,1,2018-08-11,Newcastle,Tottenham,1,2,A,0,3,3,1,1,1,1,3,11,13,0,0,2,0,August,-0.8660254037844384,-0.5000000000000004,30,42,2,0,3,1.6,1.6,0,0,0,0,0,0,"August, 2018"
2018-2019,1,2018-08-11,Watford,Brighton,2,0,H,3,0,1,1,3,0,3,2,13,7,0,0,6,0,August,-0.8660254037844384,-0.5000000000000004,43,10,0,1,1,0.0,0.5,0,0,0,0,0,0,"August, 2018"
2018-2019,1,2018-08-11,Wolves,Everton,2,2,D,1,1,3,1,1,2,2,1,14,9,0,0,5,0,August,-0.8660254037844384,-0.5000000000000004,48,18,0,3,2,0.4,1.2,0,0,0,0,0,0,"August, 2018"
2018-2019,1,2018-08-12,Southampton,Burnley,0,0,D,1,1,0,3,2,1,1,3,12,11,0,0,1,0,August,-0.8660254037844384,-0.5000000000000004,38,11,2,1,2,1.2,0.8,0,0,0,0,0,0,"August, 2018"
2018-2019,1,2018-08-12,Liverpool,West Ham,4,0,H,3,0,5,0,0,3,1,1,11,13,0,0,2,0,August,-0.8660254037844384,-0.5000000000000004,25,45,3,1,1,2.8,1.2,0,0,0,0,0,0,"August, 2018"
2018-2019,1,2018-08-12,Arsenal,Man City,0,2,A,0,3,1,1,3,5,0,0,9,12,0,0,3,0,August,-0.8660254037844384,-0.5000000000000004,0,27,0,2,3,1.2,2.4,0,0,0,0,0,0,"August, 2018"
2018-2019,2,2018-08-18,Tottenham,Fulham,3,1,H,3,0,1,1,3,3,0,2,10,17,3,0,7,3,August,-0.8660254037844384,-0.5000000000000004,42,19,4,0,1,2.0,0.6,2,1,1,0,2,-2,"August, 2018"
2018-2019,2,2018-08-18,West Ham,Bournemouth,1,2,A,0,3,3,1,1,2,1,2,20,5,0,3,15,3,August,-0.8660254037844384,-0.5000000000000004,45,7,2,2,1,2.0,1.6,0,4,-4,2,0,2,"August, 2018"
2018-2019,2,2018-08-18,Leicester,Wolves,2,0,H,3,0,1,2,2,3,1,1,15,10,0,1,5,1,August,-0.8660254037844384,-0.5000000000000004,24,48,0,1,1,1.5,2.0,1,2,-1,2,2,0,"August, 2018"
2018-2019,2,2018-08-18,Cardiff,Newcastle,0,0,D,1,1,2,0,3,3,1,1,17,14,0,0,3,0,August,-0.8660254037844384,-0.5000000000000004,12,30,0,0,2,0.5,2.5,0,2,-2,1,2,-1,"August, 2018"
2018-2019,2,2018-08-18,Chelsea,Arsenal,3,2,H,3,0,1,3,1,1,1,3,2,16,3,0,14,3,August,-0.8660254037844384,-0.5000000000000004,14,0,2,2,1,1.2,1.2,3,0,3,0,2,-2,"August, 2018"
2018-2019,2,2018-08-18,Everton,Southampton,2,1,H,3,0,2,2,1,0,3,2,9,12,1,1,3,0,August,-0.8660254037844384,-0.5000000000000004,18,38,1,2,2,1.2,1.4,2,2,0,0,0,0,"August, 2018"
2018-2019,2,2018-08-19,Brighton,Man United,3,2,H,3,0,0,3,2,0,2,3,16,10,0,3,6,3,August,-0.8660254037844384,-0.5000000000000004,10,28,1,0,1,0.5,0.5,0,2,-2,2,1,1,"August, 2018"
2018-2019,2,2018-08-19,Burnley,Watford,1,3,A,0,3,1,1,3,1,1,3,12,8,1,3,4,2,August,-0.8660254037844384,-0.5000000000000004,11,43,3,0,1,1.5,0.75,0,0,0,2,0,2,"August, 2018"
2018-2019,2,2018-08-19,Man City,Huddersfield,6,1,H,3,0,5,0,0,0,2,3,8,18,3,0,10,3,August,-0.8660254037844384,-0.5000000000000004,27,20,1,1,0,1.0,0.5,2,0,2,0,3,-3,"August, 2018"
2018-2019,2,2018-08-20,Crystal Palace,Liverpool,0,2,A,0,3,3,1,1,5,0,0,8,7,3,3,1,0,August,-0.8660254037844384,-0.5000000000000004,16,25,1,0,4,1.2,2.0,2,0,2,4,0,4,"August, 2018"
2018-2019,3,2018-08-25,Arsenal,West Ham,3,1,H,3,0,1,1,3,3,1,1,17,19,0,0,2,0,August,-0.8660254037844384,-0.5000000000000004,0,45,3,2,0,3.0,1.0,2,5,-3,1,6,-5,"August, 2018"
2018-2019,3,2018-08-25,Bournemouth,Everton,2,2,D,1,1,2,1,2,2,2,1,6,7,6,4,1,2,August,-0.8660254037844384,-0.5000000000000004,7,18,2,0,3,1.6,2.2,4,1,3,4,3,1,"August, 2018"
2018-2019,3,2018-08-25,Huddersfield,Cardiff,0,0,D,1,1,0,2,3,2,0,3,20,17,0,1,3,1,August,-0.8660254037844384,-0.5000000000000004,20,12,0,0,0,0.0,0.0,1,9,-8,0,2,-2,"August, 2018"
2018-2019,3,2018-08-25,Liverpool,Brighton,1,0,H,3,0,5,0,0,0,3,2,3,12,6,3,9,3,August,-0.8660254037844384,-0.5000000000000004,25,10,2,0,0,4.5,0.5,6,0,6,3,4,-1,"August, 2018"
2018-2019,3,2018-08-25,Southampton,Leicester,1,2,A,0,3,0,3,2,1,2,2,15,8,1,3,7,2,August,-0.8660254037844384,-0.5000000000000004,38,24,1,2,2,0.8,1.0,1,2,-1,3,2,1,"August, 2018"
2018-2019,3,2018-08-25,Wolves,Man City,1,1,D,1,1,3,1,1,5,0,0,16,3,1,6,13,5,August,-0.8660254037844384,-0.5000000000000004,48,27,1,0,4,1.2,2.6,2,4,-2,8,1,7,"August, 2018"
2018-2019,3,2018-08-26,Newcastle,Chelsea,1,2,A,0,3,3,1,1,1,3,1,16,4,1,6,12,5,August,-0.8660254037844384,-0.5000000000000004,30,14,1,1,3,1.4,2.4,1,2,-1,6,2,4,"August, 2018"
2018-2019,3,2018-08-26,Fulham,Burnley,4,2,H,3,0,3,0,2,1,1,3,19,17,0,1,2,1,August,-0.8660254037844384,-0.5000000000000004,19,11,1,1,0,2.0,0.5,1,5,-4,1,3,-2,"August, 2018"
2018-2019,3,2018-08-26,Watford,Crystal Palace,2,1,H,3,0,1,1,3,3,1,1,5,10,6,3,5,3,August,-0.8660254037844384,-0.5000000000000004,43,16,1,2,2,0.8,1.0,5,1,4,2,2,0,"August, 2018"
2018-2019,3,2018-08-27,Man United,Tottenham,0,3,A,0,3,0,2,3,1,1,3,9,6,3,6,3,3,August,-0.8660254037844384,-0.5000000000000004,28,42,2,0,3,0.6,1.4,4,4,0,5,2,3,"August, 2018"
2018-2019,4,2018-09-01,Man City,Newcastle,2,1,H,3,0,5,0,0,3,1,1,5,18,7,1,13,6,September,-1.0,-1.8369701987210287e-16,27,30,4,1,0,3.2,0.6,9,2,7,2,4,-2,"September, 2018"
2018-2019,4,2018-09-01,West Ham,Wolves,0,1,A,0,3,3,1,1,3,1,1,20,15,0,2,5,2,September,-1.0,-1.8369701987210287e-16,45,48,2,1,1,1.5,1.0,2,9,-7,3,5,-2,"September, 2018"
2018-2019,4,2018-09-01,Leicester,Liverpool,1,2,A,0,3,1,2,2,5,0,0,7,2,6,9,5,3,September,-1.0,-1.8369701987210287e-16,24,25,2,0,3,1.8,2.0,5,3,2,7,0,7,"September, 2018"
2018-2019,4,2018-09-01,Brighton,Fulham,2,2,D,1,1,0,3,2,3,0,2,12,11,3,3,1,0,September,-1.0,-1.8369701987210287e-16,10,19,0,0,0,0.0,0.0,3,5,-2,5,7,-2,"September, 2018"
2018-2019,4,2018-09-01,Crystal Palace,Southampton,0,2,A,0,3,3,1,1,0,3,2,12,17,3,1,5,2,September,-1.0,-1.8369701987210287e-16,16,38,2,0,3,1.4,1.8,3,4,-1,2,4,-2,"September, 2018"
2018-2019,4,2018-09-01,Chelsea,Bournemouth,2,0,H,3,0,1,3,1,2,1,2,3,6,9,7,3,2,September,-1.0,-1.8369701987210287e-16,14,7,4,0,1,2.2,1.0,8,3,5,6,3,3,"September, 2018"
2018-2019,4,2018-09-01,Everton,Huddersfield,1,1,D,1,1,2,2,1,0,2,3,8,19,5,1,11,4,September,-1.0,-1.8369701987210287e-16,18,20,2,0,0,2.0,0.0,6,5,1,1,9,-8,"September, 2018"
2018-2019,4,2018-09-02,Burnley,Man United,0,2,A,0,3,1,1,3,0,2,3,19,14,1,3,5,2,September,-1.0,-1.8369701987210287e-16,11,28,0,2,3,0.6,1.6,3,7,-4,4,7,-3,"September, 2018"
2018-2019,4,2018-09-02,Cardiff,Arsenal,2,3,A,0,3,2,0,3,1,1,3,16,14,2,3,2,1,September,-1.0,-1.8369701987210287e-16,12,0,0,0,2,0.0,2.5,0,2,-2,5,6,-1,"September, 2018"
2018-2019,4,2018-09-02,Watford,Tottenham,2,1,H,3,0,1,1,3,1,1,3,5,4,9,9,1,0,September,-1.0,-1.8369701987210287e-16,43,42,0,1,4,0.4,2.4,7,2,5,8,2,6,"September, 2018"
2018-2019,5,2018-09-15,Watford,Man United,1,2,A,0,3,1,1,3,0,2,3,4,10,12,6,6,6,September,-1.0,-1.8369701987210287e-16,43,28,1,0,4,1.0,1.8,9,3,6,6,7,-1,"September, 2018"
2018-2019,5,2018-09-15,Tottenham,Liverpool,1,2,A,0,3,1,1,3,5,0,0,6,3,9,12,3,3,September,-1.0,-1.8369701987210287e-16,42,25,1,3,1,1.6,1.4,9,4,5,9,1,8,"September, 2018"
2018-2019,5,2018-09-15,Newcastle,Arsenal,1,2,A,0,3,3,1,1,1,1,3,18,8,1,6,10,5,September,-1.0,-1.8369701987210287e-16,30,0,1,0,4,0.6,1.2,3,6,-3,8,8,0,"September, 2018"
2018-2019,5,2018-09-15,Man City,Fulham,3,0,H,3,0,5,0,0,3,0,2,4,14,10,4,10,6,September,-1.0,-1.8369701987210287e-16,27,19,5,0,0,3.2,0.6,11,3,8,7,9,-2,"September, 2018"
2018-2019,5,2018-09-15,Chelsea,Cardiff,4,1,H,3,0,1,3,1,2,0,3,2,16,12,2,14,10,September,-1.0,-1.8369701987210287e-16,14,12,2,0,0,3.0,1.0,10,3,7,2,5,-3,"September, 2018"
2018-2019,5,2018-09-15,Bournemouth,Leicester,4,2,H,3,0,2,1,2,1,2,2,6,8,7,6,2,1,September,-1.0,-1.8369701987210287e-16,7,24,1,4,0,0.6,0.4,6,5,1,6,5,1,"September, 2018"
2018-2019,5,2018-09-15,Huddersfield,Crystal Palace,0,1,A,0,3,0,2,3,3,1,1,17,15,2,3,2,1,September,-1.0,-1.8369701987210287e-16,20,16,1,0,1,1.5,1.0,2,10,-8,3,6,-3,"September, 2018"
2018-2019,5,2018-09-16,Everton,West Ham,1,3,A,0,3,2,2,1,3,1,1,9,20,6,0,11,6,September,-1.0,-1.8369701987210287e-16,18,45,2,1,2,1.8,1.2,7,6,1,2,10,-8,"September, 2018"
2018-2019,5,2018-09-16,Wolves,Burnley,1,0,H,3,0,3,1,1,1,1,3,12,20,5,1,8,4,September,-1.0,-1.8369701987210287e-16,48,11,2,0,0,2.0,0.5,4,5,-1,3,9,-6,"September, 2018"
2018-2019,5,2018-09-17,Southampton,Brighton,2,2,D,1,1,0,3,2,0,3,2,13,14,4,4,1,0,September,-1.0,-1.8369701987210287e-16,38,10,0,2,0,1.0,1.0,4,4,0,5,7,-2,"September, 2018"
2018-2019,6,2018-09-22,Man United,Wolves,1,1,D,1,1,0,2,3,3,1,1,9,10,9,8,1,1,September,-1.0,-1.8369701987210287e-16,28,48,4,0,1,2.6,0.8,8,8,0,5,5,0,"September, 2018"
2018-2019,6,2018-09-22,Liverpool,Southampton,3,0,H,3,0,5,0,0,0,3,2,3,13,15,5,10,10,September,-1.0,-1.8369701987210287e-16,25,38,2,2,1,1.4,0.6,11,2,9,6,6,0,"September, 2018"
2018-2019,6,2018-09-22,Leicester,Huddersfield,3,1,H,3,0,1,2,2,0,2,3,12,19,6,2,7,4,September,-1.0,-1.8369701987210287e-16,24,20,1,1,0,2.0,0.5,8,9,-1,2,11,-9,"September, 2018"
2018-2019,6,2018-09-22,Fulham,Watford,1,1,D,1,1,3,0,2,1,1,3,16,5,4,12,11,8,September,-1.0,-1.8369701987210287e-16,19,43,0,2,0,1.5,1.5,7,12,-5,10,5,5,"September, 2018"
2018-2019,6,2018-09-22,Cardiff,Man City,0,5,A,0,3,2,0,3,5,0,0,18,3,2,13,15,11,September,-1.0,-1.8369701987210287e-16,12,27,1,0,1,2.5,3.0,3,9,-6,14,3,11,"September, 2018"
2018-2019,6,2018-09-22,Burnley,Bournemouth,4,0,H,3,0,1,1,3,2,1,2,20,6,1,10,14,9,September,-1.0,-1.8369701987210287e-16,11,7,2,0,2,1.75,1.75,3,10,-7,10,7,3,"September, 2018"
2018-2019,6,2018-09-22,Brighton,Tottenham,1,2,A,0,3,0,3,2,1,1,3,14,6,5,9,8,4,September,-1.0,-1.8369701987210287e-16,10,42,0,1,1,0.5,1.5,7,9,-2,10,6,4,"September, 2018"
2018-2019,6,2018-09-22,Crystal Palace,Newcastle,0,0,D,1,1,3,1,1,3,1,1,12,20,6,1,8,5,September,-1.0,-1.8369701987210287e-16,16,30,1,2,2,1.4,1.0,4,6,-2,4,8,-4,"September, 2018"
2018-2019,6,2018-09-23,Arsenal,Everton,2,0,H,3,0,1,1,3,2,2,1,9,12,9,6,3,3,September,-1.0,-1.8369701987210287e-16,0,18,4,0,1,3.2,1.2,10,9,1,8,9,-1,"September, 2018"
2018-2019,6,2018-09-23,West Ham,Chelsea,0,0,D,1,1,3,1,1,1,3,1,17,3,3,15,14,12,September,-1.0,-1.8369701987210287e-16,45,14,1,2,2,1.2,1.4,5,11,-6,14,4,10,"September, 2018"
2018-2019,7,2018-09-29,Arsenal,Watford,2,0,H,3,0,1,1,3,1,1,3,6,4,12,13,2,1,September,-1.0,-1.8369701987210287e-16,0,43,3,0,2,2.4,1.0,12,9,3,11,6,5,"September, 2018"
2018-2019,7,2018-09-29,Chelsea,Liverpool,1,1,D,1,1,1,3,1,5,0,0,3,1,16,18,2,2,September,-1.0,-1.8369701987210287e-16,14,25,1,3,1,1.0,1.0,14,4,10,14,2,12,"September, 2018"
2018-2019,7,2018-09-29,Everton,Fulham,3,0,H,3,0,2,2,1,3,0,2,12,15,6,5,3,1,September,-1.0,-1.8369701987210287e-16,18,19,4,1,0,2.8,0.8,8,11,-3,8,13,-5,"September, 2018"
2018-2019,7,2018-09-29,Huddersfield,Tottenham,0,2,A,0,3,0,2,3,1,1,3,20,6,2,12,14,10,September,-1.0,-1.8369701987210287e-16,20,42,0,0,2,0.0,3.0,3,14,-11,12,7,5,"September, 2018"
2018-2019,7,2018-09-29,Man City,Brighton,2,0,H,3,0,5,0,0,0,3,2,3,13,16,5,10,11,September,-1.0,-1.8369701987210287e-16,27,10,2,0,0,2.5,0.5,19,3,16,8,11,-3,"September, 2018"
2018-2019,7,2018-09-29,Newcastle,Leicester,0,2,A,0,3,3,1,1,1,2,2,18,9,2,9,9,7,September,-1.0,-1.8369701987210287e-16,30,24,1,0,4,0.8,2.2,4,8,-4,11,10,1,"September, 2018"
2018-2019,7,2018-09-29,West Ham,Man United,3,1,H,3,0,3,1,1,0,2,3,17,8,4,10,9,6,September,-1.0,-1.8369701987210287e-16,45,28,1,2,2,0.8,1.8,5,11,-6,9,9,0,"September, 2018"
2018-2019,7,2018-09-29,Wolves,Southampton,2,0,H,3,0,3,1,1,0,3,2,11,14,9,5,3,4,September,-1.0,-1.8369701987210287e-16,48,38,0,0,2,0.5,3.0,6,6,0,6,9,-3,"September, 2018"
2018-2019,7,2018-09-30,Cardiff,Burnley,1,2,A,0,3,2,0,3,1,1,3,19,17,2,4,2,2,September,-1.0,-1.8369701987210287e-16,12,11,0,0,0,0.0,0.0,3,14,-11,7,10,-3,"September, 2018"
2018-2019,7,2018-10-01,Bournemouth,Crystal Palace,2,1,H,3,0,2,1,2,3,1,1,9,13,10,7,4,3,October,-0.8660254037844386,0.5,7,16,1,3,1,1.4,1.6,10,11,-1,4,6,-2,"October, 2018"
2018-2019,8,2018-10-05,Brighton,West Ham,1,0,H,3,0,0,3,2,3,1,1,15,14,5,7,1,2,October,-0.8660254037844386,0.5,10,45,2,0,0,3.0,0.5,8,13,-5,8,12,-4,"October, 2018"
2018-2019,8,2018-10-06,Tottenham,Cardiff,1,0,H,3,0,1,1,3,2,0,3,4,20,15,2,16,13,October,-0.8660254037844386,0.5,42,12,2,0,0,1.0,0.0,14,7,7,4,16,-12,"October, 2018"
2018-2019,8,2018-10-06,Watford,Bournemouth,0,4,A,0,3,1,1,3,2,1,2,7,8,13,13,1,0,October,-0.8660254037844386,0.5,43,7,1,4,0,1.6,1.2,11,8,3,12,12,0,"October, 2018"
2018-2019,8,2018-10-06,Man United,Newcastle,3,2,H,3,0,0,2,3,3,1,1,11,19,10,2,8,8,October,-0.8660254037844386,0.5,28,30,2,2,1,1.6,1.0,10,12,-2,4,10,-6,"October, 2018"
2018-2019,8,2018-10-06,Leicester,Everton,1,2,A,0,3,1,2,2,2,2,1,9,11,12,9,2,3,October,-0.8660254037844386,0.5,24,18,2,0,3,1.6,1.8,13,10,3,11,11,0,"October, 2018"
2018-2019,8,2018-10-06,Crystal Palace,Wolves,0,1,A,0,3,3,1,1,3,1,1,14,9,7,12,5,5,October,-0.8660254037844386,0.5,16,48,0,0,0,0.0,0.0,5,8,-3,8,6,2,"October, 2018"
2018-2019,8,2018-10-06,Burnley,Huddersfield,1,1,D,1,1,1,1,3,0,2,3,13,20,7,2,7,5,October,-0.8660254037844386,0.5,11,20,0,2,0,0.0,0.0,9,11,-2,3,16,-13,"October, 2018"
2018-2019,8,2018-10-07,Fulham,Arsenal,1,5,A,0,3,3,0,2,1,1,3,17,6,5,15,11,10,October,-0.8660254037844386,0.5,19,0,1,1,3,1.2,2.0,8,16,-8,14,9,5,"October, 2018"
2018-2019,8,2018-10-07,Liverpool,Man City,0,0,D,1,1,5,0,0,5,0,0,2,1,19,19,1,0,October,-0.8660254037844386,0.5,25,27,3,1,1,1.8,1.8,15,3,12,21,3,18,"October, 2018"
2018-2019,8,2018-10-07,Southampton,Chelsea,0,3,A,0,3,0,3,2,1,3,1,16,5,5,17,11,12,October,-0.8660254037844386,0.5,38,14,0,0,5,1.0,2.4,6,11,-5,15,5,10,"October, 2018"
2018-2019,9,2018-10-20,Wolves,Watford,0,2,A,0,3,3,1,1,1,1,3,7,9,15,13,2,2,October,-0.8660254037844386,0.5,48,43,0,0,0,0.0,0.0,9,6,3,11,12,-1,"October, 2018"
2018-2019,9,2018-10-20,West Ham,Tottenham,0,1,A,0,3,3,1,1,1,1,3,15,5,7,18,10,11,October,-0.8660254037844386,0.5,45,42,2,1,2,1.4,1.4,8,13,-5,15,7,8,"October, 2018"
2018-2019,9,2018-10-20,Man City,Burnley,5,0,H,3,0,5,0,0,1,1,3,3,12,20,8,9,12,October,-0.8660254037844386,0.5,27,11,3,1,1,1.6,0.8,21,3,18,10,12,-2,"October, 2018"
2018-2019,9,2018-10-20,Newcastle,Brighton,0,1,A,0,3,3,1,1,0,3,2,20,12,2,8,8,6,October,-0.8660254037844386,0.5,30,10,0,1,1,0.0,0.5,6,13,-7,9,13,-4,"October, 2018"
2018-2019,9,2018-10-20,Chelsea,Man United,2,2,D,1,1,1,3,1,0,2,3,2,8,20,13,6,7,October,-0.8660254037844386,0.5,14,28,2,1,2,1.4,1.0,18,5,13,13,14,-1,"October, 2018"
2018-2019,9,2018-10-20,Cardiff,Fulham,4,2,H,3,0,2,0,3,3,0,2,20,17,2,5,3,3,October,-0.8660254037844386,0.5,12,19,2,0,0,2.5,1.0,4,17,-13,9,21,-12,"October, 2018"
2018-2019,9,2018-10-20,Bournemouth,Southampton,0,0,D,1,1,2,1,2,0,3,2,6,16,16,5,10,11,October,-0.8660254037844386,0.5,7,38,1,2,2,1.0,1.2,16,12,4,6,14,-8,"October, 2018"
2018-2019,9,2018-10-20,Huddersfield,Liverpool,0,1,A,0,3,0,2,3,5,0,0,19,3,3,20,16,17,October,-0.8660254037844386,0.5,20,25,0,0,2,0.0,3.0,4,17,-13,15,3,12,"October, 2018"
2018-2019,9,2018-10-21,Everton,Crystal Palace,2,0,H,3,0,2,2,1,3,1,1,11,14,12,7,3,5,October,-0.8660254037844386,0.5,18,16,2,3,0,1.4,0.8,13,12,1,5,9,-4,"October, 2018"
2018-2019,9,2018-10-22,Arsenal,Leicester,3,1,H,3,0,1,1,3,1,2,2,5,11,18,12,6,6,October,-0.8660254037844386,0.5,0,24,3,1,1,1.6,1.4,19,10,9,14,12,2,"October, 2018"
2018-2019,10,2018-10-27,Watford,Huddersfield,3,0,H,3,0,1,1,3,0,2,3,7,20,16,3,13,13,October,-0.8660254037844386,0.5,43,20,0,0,2,0.5,2.5,13,12,1,4,18,-14,"October, 2018"
2018-2019,10,2018-10-27,Brighton,Wolves,1,0,H,3,0,0,3,2,3,1,1,12,9,11,15,3,4,October,-0.8660254037844386,0.5,10,48,0,0,0,0.0,0.0,10,13,-3,9,8,1,"October, 2018"
2018-2019,10,2018-10-27,Fulham,Bournemouth,0,3,A,0,3,3,0,2,2,1,2,18,6,5,17,12,12,October,-0.8660254037844386,0.5,19,7,0,0,0,0.0,0.0,11,25,-14,16,12,4,"October, 2018"
2018-2019,10,2018-10-27,Leicester,West Ham,1,1,D,1,1,1,2,2,3,1,1,12,14,12,7,2,5,October,-0.8660254037844386,0.5,24,45,2,2,1,1.4,1.4,15,15,0,8,14,-6,"October, 2018"
2018-2019,10,2018-10-27,Liverpool,Cardiff,4,1,H,3,0,5,0,0,2,0,3,2,17,23,5,15,18,October,-0.8660254037844386,0.5,25,12,2,0,0,4.5,2.0,16,3,13,8,19,-11,"October, 2018"
2018-2019,10,2018-10-27,Southampton,Newcastle,0,0,D,1,1,0,3,2,3,1,1,16,20,6,2,4,4,October,-0.8660254037844386,0.5,38,30,2,2,1,1.8,1.8,6,14,-8,6,14,-8,"October, 2018"
2018-2019,10,2018-10-28,Man United,Everton,2,1,H,3,0,0,2,3,2,2,1,10,8,14,15,2,1,October,-0.8660254037844386,0.5,28,18,3,2,0,1.8,0.4,15,16,-1,15,12,3,"October, 2018"
2018-2019,10,2018-10-28,Burnley,Chelsea,0,4,A,0,3,1,1,3,1,3,1,14,3,8,21,11,13,October,-0.8660254037844386,0.5,11,14,1,2,2,1.2,1.8,10,17,-7,20,7,13,"October, 2018"
2018-2019,10,2018-10-28,Crystal Palace,Arsenal,2,2,D,1,1,3,1,1,1,1,3,15,4,7,21,11,14,October,-0.8660254037844386,0.5,16,0,1,1,3,1.4,2.0,5,11,-6,22,11,11,"October, 2018"
2018-2019,10,2018-10-29,Tottenham,Man City,0,1,A,0,3,1,1,3,5,0,0,5,3,21,23,2,2,October,-0.8660254037844386,0.5,42,27,2,1,2,1.6,2.0,16,7,9,26,3,23,"October, 2018"
2018-2019,11,2018-11-03,Wolves,Tottenham,2,3,A,0,3,3,1,1,1,1,3,11,5,15,21,6,6,November,-0.5000000000000004,0.8660254037844384,48,42,1,2,2,1.2,1.8,9,9,0,16,8,8,"November, 2018"
2018-2019,11,2018-11-03,Arsenal,Liverpool,1,1,D,1,1,1,1,3,5,0,0,4,2,22,26,2,4,November,-0.5000000000000004,0.8660254037844384,0,25,0,2,3,2.0,3.4,24,13,11,20,4,16,"November, 2018"
2018-2019,11,2018-11-03,Bournemouth,Man United,1,2,A,0,3,2,1,2,0,2,3,6,8,20,17,2,3,November,-0.5000000000000004,0.8660254037844384,7,28,0,1,4,0.6,2.0,19,12,7,17,17,0,"November, 2018"
2018-2019,11,2018-11-03,Cardiff,Leicester,0,1,A,0,3,2,0,3,1,2,2,17,12,5,13,5,8,November,-0.5000000000000004,0.8660254037844384,12,24,0,0,0,0.0,0.0,9,23,-14,16,16,0,"November, 2018"
2018-2019,11,2018-11-03,Everton,Brighton,3,1,H,3,0,2,2,1,0,3,2,10,12,15,14,2,1,November,-0.5000000000000004,0.8660254037844384,18,10,1,1,0,1.5,0.5,16,14,2,11,13,-2,"November, 2018"
2018-2019,11,2018-11-03,Newcastle,Watford,1,0,H,3,0,3,1,1,1,1,3,19,8,3,19,11,16,November,-0.5000000000000004,0.8660254037844384,30,43,0,1,4,0.8,2.0,6,14,-8,16,12,4,"November, 2018"
2018-2019,11,2018-11-03,West Ham,Burnley,4,2,H,3,0,3,1,1,1,1,3,13,15,8,8,2,0,November,-0.5000000000000004,0.8660254037844384,45,11,3,1,1,1.0,1.0,9,15,-6,10,21,-11,"November, 2018"
2018-2019,11,2018-11-04,Man City,Southampton,6,1,H,3,0,5,0,0,0,3,2,3,16,26,7,13,19,November,-0.5000000000000004,0.8660254037844384,27,38,3,1,1,1.8,1.2,27,3,24,6,14,-8,"November, 2018"
2018-2019,11,2018-11-04,Chelsea,Crystal Palace,3,1,H,3,0,1,3,1,3,1,1,3,14,24,8,11,16,November,-0.5000000000000004,0.8660254037844384,14,16,3,0,2,1.6,1.0,24,7,17,7,13,-6,"November, 2018"
2018-2019,11,2018-11-05,Huddersfield,Fulham,1,0,H,3,0,0,2,3,3,0,2,20,19,3,5,1,2,November,-0.5000000000000004,0.8660254037844384,20,19,0,0,0,0.0,0.0,4,21,-17,11,28,-17,"November, 2018"
2018-2019,12,2018-11-10,Cardiff,Brighton,2,1,H,3,0,2,0,3,0,3,2,19,12,5,14,7,9,November,-0.5000000000000004,0.8660254037844384,12,10,0,0,0,0.0,0.0,9,24,-15,12,16,-4,"November, 2018"
2018-2019,12,2018-11-10,Crystal Palace,Tottenham,0,1,A,0,3,3,1,1,1,1,3,14,4,8,24,10,16,November,-0.5000000000000004,0.8660254037844384,16,42,0,0,5,0.2,1.4,8,16,-8,19,10,9,"November, 2018"
2018-2019,12,2018-11-10,Huddersfield,West Ham,1,1,D,1,1,0,2,3,3,1,1,19,13,6,11,6,5,November,-0.5000000000000004,0.8660254037844384,20,45,0,0,2,0.5,3.0,5,21,-16,13,17,-4,"November, 2018"
2018-2019,12,2018-11-10,Leicester,Burnley,0,0,D,1,1,1,2,2,1,1,3,10,15,16,8,5,8,November,-0.5000000000000004,0.8660254037844384,24,11,3,0,2,1.2,0.6,17,16,1,12,25,-13,"November, 2018"
2018-2019,12,2018-11-10,Newcastle,Bournemouth,2,1,H,3,0,3,1,1,2,1,2,19,6,6,20,13,14,November,-0.5000000000000004,0.8660254037844384,30,7,1,1,2,1.0,1.5,7,14,-7,20,14,6,"November, 2018"
2018-2019,12,2018-11-10,Southampton,Watford,1,1,D,1,1,0,3,2,1,1,3,18,8,7,19,10,12,November,-0.5000000000000004,0.8660254037844384,38,43,2,2,1,1.8,1.6,7,20,-13,16,13,3,"November, 2018"
2018-2019,12,2018-11-11,Man City,Man United,3,1,H,3,0,5,0,0,0,2,3,2,8,29,20,6,9,November,-0.5000000000000004,0.8660254037844384,27,28,2,1,2,1.2,1.2,33,4,29,19,18,1,"November, 2018"
2018-2019,12,2018-11-11,Liverpool,Fulham,2,0,H,3,0,5,0,0,3,0,2,3,20,27,5,17,22,November,-0.5000000000000004,0.8660254037844384,25,19,4,0,1,2.8,0.8,21,5,16,11,29,-18,"November, 2018"
2018-2019,12,2018-11-11,Chelsea,Everton,0,0,D,1,1,1,3,1,2,2,1,2,9,27,18,7,9,November,-0.5000000000000004,0.8660254037844384,14,18,3,2,0,2.6,0.6,27,8,19,19,15,4,"November, 2018"
2018-2019,12,2018-11-11,Arsenal,Wolves,1,1,D,1,1,1,1,3,3,1,1,5,11,23,15,6,8,November,-0.5000000000000004,0.8660254037844384,0,48,4,1,0,1.8,0.2,25,14,11,11,12,-1,"November, 2018"
2018-2019,13,2018-11-24,Brighton,Leicester,1,1,D,1,1,0,3,2,1,2,2,12,10,14,17,2,3,November,-0.5000000000000004,0.8660254037844384,10,24,0,0,2,0.0,2.0,13,18,-5,17,16,1,"November, 2018"
2018-2019,13,2018-11-24,Everton,Cardiff,1,0,H,3,0,2,2,1,2,0,3,9,18,19,8,9,11,November,-0.5000000000000004,0.8660254037844384,18,12,1,1,0,1.0,0.5,19,15,4,11,25,-14,"November, 2018"
2018-2019,13,2018-11-24,Fulham,Southampton,3,2,H,3,0,3,0,2,0,3,2,20,17,5,8,3,3,November,-0.5000000000000004,0.8660254037844384,19,38,0,3,2,1.2,2.2,11,31,-20,8,21,-13,"November, 2018"
2018-2019,13,2018-11-24,Man United,Crystal Palace,0,0,D,1,1,0,2,3,3,1,1,9,16,20,8,7,12,November,-0.5000000000000004,0.8660254037844384,28,16,5,0,0,2.6,0.6,20,21,-1,8,17,-9,"November, 2018"
2018-2019,13,2018-11-24,Tottenham,Chelsea,3,1,H,3,0,1,1,3,1,3,1,4,3,27,28,1,1,November,-0.5000000000000004,0.8660254037844384,42,14,2,1,2,1.8,1.4,20,10,10,27,8,19,"November, 2018"
2018-2019,13,2018-11-24,Watford,Liverpool,0,3,A,0,3,1,1,3,5,0,0,9,2,20,30,7,10,November,-0.5000000000000004,0.8660254037844384,43,25,0,1,4,0.8,3.4,17,14,3,23,5,18,"November, 2018"
2018-2019,13,2018-11-24,West Ham,Man City,0,4,A,0,3,3,1,1,5,0,0,13,2,12,32,11,20,November,-0.5000000000000004,0.8660254037844384,45,27,0,1,4,1.0,3.0,14,18,-4,36,5,31,"November, 2018"
2018-2019,13,2018-11-25,Wolves,Huddersfield,0,2,A,0,3,3,1,1,0,2,3,11,20,16,7,9,9,November,-0.5000000000000004,0.8660254037844384,48,20,0,0,0,0.0,0.0,12,13,-1,6,22,-16,"November, 2018"
2018-2019,13,2018-11-25,Bournemouth,Arsenal,1,2,A,0,3,2,1,2,1,1,3,8,5,20,24,3,4,November,-0.5000000000000004,0.8660254037844384,7,0,1,1,3,1.2,2.4,21,16,5,26,15,11,"November, 2018"
2018-2019,13,2018-11-26,Burnley,Newcastle,1,2,A,0,3,1,1,3,3,1,1,17,15,9,9,2,0,November,-0.5000000000000004,0.8660254037844384,11,30,1,3,0,1.5,1.25,12,25,-13,9,15,-6,"November, 2018"
2018-2019,14,2018-11-30,Cardiff,Wolves,2,1,H,3,0,2,0,3,3,1,1,19,11,8,16,8,8,November,-0.5000000000000004,0.8660254037844384,12,48,0,0,0,0.0,0.0,11,26,-15,12,15,-3,"November, 2018"
2018-2019,14,2018-12-01,Southampton,Man United,2,2,D,1,1,0,3,2,0,2,3,19,8,8,21,11,13,December,-2.4492935982947064e-16,1.0,38,28,1,2,2,0.2,0.6,10,24,-14,20,21,-1,"December, 2018"
2018-2019,14,2018-12-01,Crystal Palace,Burnley,2,0,H,3,0,3,1,1,1,1,3,17,18,9,9,1,0,December,-2.4492935982947064e-16,1.0,16,11,2,0,3,1.2,1.6,8,17,-9,13,27,-14,"December, 2018"
2018-2019,14,2018-12-01,Huddersfield,Brighton,1,2,A,0,3,0,2,3,0,3,2,17,12,10,15,5,5,December,-2.4492935982947064e-16,1.0,20,10,1,1,0,1.5,0.5,8,22,-14,14,19,-5,"December, 2018"
2018-2019,14,2018-12-01,Leicester,Watford,2,0,H,3,0,1,2,2,1,1,3,10,9,18,20,1,2,December,-2.4492935982947064e-16,1.0,24,43,3,0,2,1.6,0.8,18,17,1,17,17,0,"December, 2018"
2018-2019,14,2018-12-01,Man City,Bournemouth,3,1,H,3,0,5,0,0,2,1,2,1,9,35,20,8,15,December,-2.4492935982947064e-16,1.0,27,7,5,0,0,3.2,0.2,40,5,35,22,18,4,"December, 2018"
2018-2019,14,2018-12-01,Newcastle,West Ham,0,3,A,0,3,3,1,1,3,1,1,13,15,12,12,2,0,December,-2.4492935982947064e-16,1.0,30,45,4,0,1,2.0,1.0,11,16,-5,14,22,-8,"December, 2018"
2018-2019,14,2018-12-02,Chelsea,Fulham,2,0,H,3,0,1,3,1,3,0,2,5,20,28,8,15,20,December,-2.4492935982947064e-16,1.0,14,19,3,2,0,1.8,0.4,28,11,17,14,33,-19,"December, 2018"
2018-2019,14,2018-12-02,Liverpool,Everton,1,0,H,3,0,5,0,0,2,2,1,2,6,33,22,4,11,December,-2.4492935982947064e-16,1.0,25,18,3,2,0,1.8,0.4,26,5,21,20,15,5,"December, 2018"
2018-2019,14,2018-12-02,Arsenal,Tottenham,4,2,H,3,0,1,1,3,1,1,3,5,3,27,30,2,3,December,-2.4492935982947064e-16,1.0,0,42,1,2,2,1.0,1.2,28,16,12,23,11,12,"December, 2018"
2018-2019,15,2018-12-04,Bournemouth,Huddersfield,2,1,H,3,0,2,1,2,0,2,3,9,17,20,10,8,10,December,-2.4492935982947064e-16,1.0,7,20,1,0,1,2.5,2.0,23,21,2,9,24,-15,"December, 2018"
2018-2019,15,2018-12-04,Brighton,Crystal Palace,3,1,H,3,0,0,3,2,3,1,1,11,14,18,12,3,6,December,-2.4492935982947064e-16,1.0,10,16,0,1,1,1.0,1.5,16,20,-4,10,17,-7,"December, 2018"
2018-2019,15,2018-12-04,Watford,Man City,1,2,A,0,3,1,1,3,5,0,0,11,1,20,38,10,18,December,-2.4492935982947064e-16,1.0,43,27,0,0,5,0.4,3.6,17,19,-2,43,6,37,"December, 2018"
2018-2019,15,2018-12-04,West Ham,Cardiff,3,1,H,3,0,3,1,1,2,0,3,13,16,15,11,3,4,December,-2.4492935982947064e-16,1.0,45,12,2,0,0,2.0,0.0,17,22,-5,13,27,-14,"December, 2018"
2018-2019,15,2018-12-05,Wolves,Chelsea,2,1,H,3,0,3,1,1,1,3,1,13,4,16,31,9,15,December,-2.4492935982947064e-16,1.0,48,14,1,0,4,0.4,1.8,13,17,-4,30,11,19,"December, 2018"
2018-2019,15,2018-12-05,Man United,Arsenal,2,2,D,1,1,0,2,3,1,1,3,9,4,22,30,5,8,December,-2.4492935982947064e-16,1.0,28,0,3,1,1,1.8,1.4,22,23,-1,32,18,14,"December, 2018"
2018-2019,15,2018-12-05,Tottenham,Southampton,3,1,H,3,0,1,1,3,0,3,2,5,18,30,9,13,21,December,-2.4492935982947064e-16,1.0,42,38,3,1,1,2.6,1.4,25,15,10,12,26,-14,"December, 2018"
2018-2019,15,2018-12-05,Everton,Newcastle,1,1,D,1,1,2,2,1,3,1,1,7,14,22,12,7,10,December,-2.4492935982947064e-16,1.0,18,30,5,0,0,1.8,0.0,20,16,4,11,19,-8,"December, 2018"
2018-2019,15,2018-12-05,Burnley,Liverpool,1,3,A,0,3,1,1,3,5,0,0,19,2,9,36,17,27,December,-2.4492935982947064e-16,1.0,11,25,1,1,3,1.0,1.4,13,29,-16,27,5,22,"December, 2018"
2018-2019,15,2018-12-05,Fulham,Leicester,1,1,D,1,1,3,0,2,1,2,2,20,9,8,21,11,13,December,-2.4492935982947064e-16,1.0,19,24,2,2,0,1.0,0.0,14,35,-21,20,17,3,"December, 2018"
2018-2019,16,2018-12-08,Man United,Fulham,4,1,H,3,0,0,2,3,3,0,2,8,20,23,9,12,14,December,-2.4492935982947064e-16,1.0,28,19,4,1,0,2.0,1.0,24,25,-1,15,36,-21,"December, 2018"
2018-2019,16,2018-12-08,Arsenal,Huddersfield,1,0,H,3,0,1,1,3,0,2,3,5,17,31,10,12,21,December,-2.4492935982947064e-16,1.0,0,20,2,0,0,3.0,0.0,34,20,14,10,26,-16,"December, 2018"
2018-2019,16,2018-12-08,Bournemouth,Liverpool,0,4,A,0,3,2,1,2,5,0,0,7,2,23,39,5,16,December,-2.4492935982947064e-16,1.0,7,25,1,1,3,1.4,2.8,25,22,3,30,6,24,"December, 2018"
2018-2019,16,2018-12-08,Burnley,Brighton,1,0,H,3,0,1,1,3,0,3,2,19,10,9,21,9,12,December,-2.4492935982947064e-16,1.0,11,10,0,2,0,0.0,0.0,14,32,-18,19,21,-2,"December, 2018"
2018-2019,16,2018-12-08,Cardiff,Southampton,1,0,H,3,0,2,0,3,0,3,2,17,19,11,9,2,2,December,-2.4492935982947064e-16,1.0,12,38,1,0,1,0.5,1.5,14,30,-16,13,29,-16,"December, 2018"
2018-2019,16,2018-12-08,Chelsea,Man City,2,0,H,3,0,1,3,1,5,0,0,5,2,31,41,3,10,December,-2.4492935982947064e-16,1.0,14,27,2,0,3,1.0,1.4,31,13,18,45,7,38,"December, 2018"
2018-2019,16,2018-12-08,Leicester,Tottenham,0,2,A,0,3,1,2,2,1,1,3,9,5,22,33,4,11,December,-2.4492935982947064e-16,1.0,24,42,2,1,2,1.8,2.6,21,18,3,28,16,12,"December, 2018"
2018-2019,16,2018-12-08,West Ham,Crystal Palace,3,2,H,3,0,3,1,1,3,1,1,13,16,18,12,3,6,December,-2.4492935982947064e-16,1.0,45,16,2,3,0,1.8,1.0,20,23,-3,11,20,-9,"December, 2018"
2018-2019,16,2018-12-09,Newcastle,Wolves,1,2,A,0,3,3,1,1,3,1,1,15,13,13,19,2,6,December,-2.4492935982947064e-16,1.0,30,48,2,3,0,2.0,1.2,12,20,-8,15,18,-3,"December, 2018"
2018-2019,16,2018-12-10,Everton,Watford,2,2,D,1,1,2,2,1,1,1,3,7,13,23,20,6,3,December,-2.4492935982947064e-16,1.0,18,43,2,1,2,1.4,1.4,21,17,4,18,21,-3,"December, 2018"
2018-2019,17,2018-12-15,Watford,Cardiff,3,2,H,3,0,1,1,3,2,0,3,12,16,21,14,4,7,December,-2.4492935982947064e-16,1.0,43,12,0,0,0,0.0,0.0,20,23,-3,15,30,-15,"December, 2018"
2018-2019,17,2018-12-15,Wolves,Bournemouth,2,0,H,3,0,3,1,1,2,1,2,12,10,22,23,2,1,December,-2.4492935982947064e-16,1.0,48,7,0,0,0,0.0,0.0,17,19,-2,25,26,-1,"December, 2018"
2018-2019,17,2018-12-15,Man City,Everton,3,1,H,3,0,5,0,0,2,2,1,2,7,41,24,5,17,December,-2.4492935982947064e-16,1.0,27,18,1,3,1,1.0,1.4,45,9,36,23,19,4,"December, 2018"
2018-2019,17,2018-12-15,Tottenham,Burnley,1,0,H,3,0,1,1,3,1,1,3,3,17,36,12,14,24,December,-2.4492935982947064e-16,1.0,42,11,3,2,0,1.6,0.4,30,16,14,15,32,-17,"December, 2018"
2018-2019,17,2018-12-15,Huddersfield,Newcastle,0,1,A,0,3,0,2,3,3,1,1,18,16,10,13,2,3,December,-2.4492935982947064e-16,1.0,20,30,1,0,1,0.5,0.5,10,27,-17,13,22,-9,"December, 2018"
2018-2019,17,2018-12-15,Fulham,West Ham,0,2,A,0,3,3,0,2,3,1,1,20,11,9,21,9,12,December,-2.4492935982947064e-16,1.0,19,45,2,0,3,1.2,2.2,16,40,-24,23,25,-2,"December, 2018"
2018-2019,17,2018-12-15,Crystal Palace,Leicester,1,0,H,3,0,3,1,1,1,2,2,16,9,12,22,7,10,December,-2.4492935982947064e-16,1.0,16,24,2,1,2,2.2,1.2,13,23,-10,21,20,1,"December, 2018"
2018-2019,17,2018-12-16,Brighton,Chelsea,1,2,A,0,3,0,3,2,1,3,1,13,4,21,34,9,13,December,-2.4492935982947064e-16,1.0,10,14,0,0,2,0.0,3.0,19,22,-3,33,13,20,"December, 2018"
2018-2019,17,2018-12-16,Liverpool,Man United,3,1,H,3,0,5,0,0,0,2,3,2,6,42,26,4,16,December,-2.4492935982947064e-16,1.0,25,28,0,3,2,0.4,0.8,34,6,28,28,26,2,"December, 2018"
2018-2019,17,2018-12-16,Southampton,Arsenal,3,2,H,3,0,0,3,2,1,1,3,19,5,9,34,14,25,December,-2.4492935982947064e-16,1.0,38,0,0,2,3,0.8,1.6,13,30,-17,35,20,15,"December, 2018"
2018-2019,18,2018-12-21,Wolves,Liverpool,0,2,A,0,3,3,1,1,5,0,0,7,1,25,45,6,20,December,-2.4492935982947064e-16,1.0,48,25,1,1,3,0.4,1.6,19,19,0,37,7,30,"December, 2018"
2018-2019,18,2018-12-22,West Ham,Watford,0,2,A,0,3,3,1,1,1,1,3,11,12,24,24,1,0,December,-2.4492935982947064e-16,1.0,45,43,2,1,2,1.6,1.6,25,25,0,23,25,-2,"December, 2018"
2018-2019,18,2018-12-22,Newcastle,Fulham,0,0,D,1,1,3,1,1,3,0,2,15,20,16,9,5,7,December,-2.4492935982947064e-16,1.0,30,19,2,0,3,1.0,1.6,14,22,-8,16,42,-26,"December, 2018"
2018-2019,18,2018-12-22,Man City,Crystal Palace,2,3,A,0,3,5,0,0,3,1,1,2,15,44,15,13,29,December,-2.4492935982947064e-16,1.0,27,16,4,1,0,3.2,0.2,48,10,38,14,23,-9,"December, 2018"
2018-2019,18,2018-12-22,Huddersfield,Southampton,1,3,A,0,3,0,2,3,0,3,2,19,17,10,12,2,2,December,-2.4492935982947064e-16,1.0,20,38,0,2,0,0.5,0.5,10,28,-18,16,32,-16,"December, 2018"
2018-2019,18,2018-12-22,Cardiff,Man United,1,5,A,0,3,2,0,3,0,2,3,16,6,14,26,10,12,December,-2.4492935982947064e-16,1.0,12,28,0,1,1,1.0,2.0,17,33,-16,29,29,0,"December, 2018"
2018-2019,18,2018-12-22,Bournemouth,Brighton,2,0,H,3,0,2,1,2,0,3,2,11,13,23,21,2,2,December,-2.4492935982947064e-16,1.0,7,10,1,1,0,2.0,1.5,25,28,-3,20,24,-4,"December, 2018"
2018-2019,18,2018-12-22,Arsenal,Burnley,3,1,H,3,0,1,1,3,1,1,3,5,18,34,12,13,22,December,-2.4492935982947064e-16,1.0,0,11,5,0,0,2.0,0.2,37,23,14,15,33,-18,"December, 2018"
2018-2019,18,2018-12-22,Chelsea,Leicester,0,1,A,0,3,1,3,1,1,2,2,4,12,37,22,8,15,December,-2.4492935982947064e-16,1.0,14,24,3,2,0,1.8,0.4,35,14,21,21,21,0,"December, 2018"
2018-2019,18,2018-12-23,Everton,Tottenham,2,6,A,0,3,2,2,1,1,1,3,11,3,24,39,8,15,December,-2.4492935982947064e-16,1.0,18,42,0,2,3,0.8,2.4,24,22,2,31,16,15,"December, 2018"
2018-2019,19,2018-12-26,Man United,Huddersfield,3,1,H,3,0,0,2,3,0,2,3,6,20,29,10,14,19,December,-2.4492935982947064e-16,1.0,28,20,1,0,1,1.5,1.0,34,30,4,11,31,-20,"December, 2018"
2018-2019,19,2018-12-26,Watford,Chelsea,1,2,A,0,3,1,1,3,1,3,1,9,5,27,37,4,10,December,-2.4492935982947064e-16,1.0,43,14,1,1,3,2.0,2.2,25,25,0,35,15,20,"December, 2018"
2018-2019,19,2018-12-26,Tottenham,Bournemouth,5,0,H,3,0,1,1,3,2,1,2,3,10,42,26,7,16,December,-2.4492935982947064e-16,1.0,42,7,4,1,0,2.4,0.2,37,18,19,27,28,-1,"December, 2018"
2018-2019,19,2018-12-26,Liverpool,Newcastle,4,0,H,3,0,5,0,0,3,1,1,1,15,48,17,14,31,December,-2.4492935982947064e-16,1.0,25,30,2,2,1,1.4,1.0,39,7,32,14,22,-8,"December, 2018"
2018-2019,19,2018-12-26,Leicester,Man City,2,1,H,3,0,1,2,2,5,0,0,11,2,25,44,9,19,December,-2.4492935982947064e-16,1.0,24,27,2,0,3,1.8,2.4,22,21,1,50,13,37,"December, 2018"
2018-2019,19,2018-12-26,Fulham,Wolves,1,1,D,1,1,3,0,2,3,1,1,20,11,10,25,9,15,December,-2.4492935982947064e-16,1.0,19,48,2,2,1,1.6,0.8,16,42,-26,19,21,-2,"December, 2018"
2018-2019,19,2018-12-26,Crystal Palace,Cardiff,0,0,D,1,1,3,1,1,2,0,3,14,17,18,14,3,4,December,-2.4492935982947064e-16,1.0,16,12,2,0,0,2.5,0.0,17,25,-8,18,38,-20,"December, 2018"
2018-2019,19,2018-12-26,Burnley,Everton,1,5,A,0,3,1,1,3,2,2,1,18,11,12,24,7,12,December,-2.4492935982947064e-16,1.0,11,18,3,0,2,1.2,1.2,16,36,-20,26,28,-2,"December, 2018"
2018-2019,19,2018-12-26,Brighton,Arsenal,1,1,D,1,1,0,3,2,1,1,3,13,5,21,37,8,16,December,-2.4492935982947064e-16,1.0,10,0,1,0,1,1.0,1.5,20,26,-6,40,24,16,"December, 2018"
2018-2019,19,2018-12-27,Southampton,West Ham,1,2,A,0,3,0,3,2,3,1,1,16,12,15,24,4,9,December,-2.4492935982947064e-16,1.0,38,45,3,0,2,1.6,1.6,19,33,-14,25,27,-2,"December, 2018"
2018-2019,20,2018-12-29,Watford,Newcastle,1,1,D,1,1,1,1,3,3,1,1,11,16,27,17,5,10,December,-2.4492935982947064e-16,1.0,43,30,4,0,1,1.8,0.8,26,27,-1,14,26,-12,"December, 2018"
2018-2019,20,2018-12-29,Liverpool,Arsenal,5,1,H,3,0,5,0,0,1,1,3,1,5,51,38,4,13,December,-2.4492935982947064e-16,1.0,25,0,3,2,0,3.0,1.6,43,7,36,41,25,16,"December, 2018"
2018-2019,20,2018-12-29,Tottenham,Wolves,1,3,A,0,3,1,1,3,3,1,1,2,11,45,26,9,19,December,-2.4492935982947064e-16,1.0,42,48,3,2,0,2.4,1.4,42,18,24,20,22,-2,"December, 2018"
2018-2019,20,2018-12-29,Fulham,Huddersfield,1,0,H,3,0,3,0,2,0,2,3,19,20,11,10,1,1,December,-2.4492935982947064e-16,1.0,19,20,0,0,1,0.0,1.0,17,43,-26,12,34,-22,"December, 2018"
2018-2019,20,2018-12-29,Brighton,Everton,1,0,H,3,0,0,3,2,2,2,1,13,8,22,27,5,5,December,-2.4492935982947064e-16,1.0,10,18,0,1,2,0.6666666666666666,2.0,21,27,-6,31,29,2,"December, 2018"
2018-2019,20,2018-12-29,Leicester,Cardiff,0,1,A,0,3,1,2,2,2,0,3,7,17,28,15,10,13,December,-2.4492935982947064e-16,1.0,24,12,1,0,0,1.0,0.0,24,22,2,18,38,-20,"December, 2018"
2018-2019,20,2018-12-30,Burnley,West Ham,2,0,H,3,0,1,1,3,3,1,1,19,11,12,27,8,15,December,-2.4492935982947064e-16,1.0,11,45,1,1,3,1.4,1.6,17,41,-24,27,28,-1,"December, 2018"
2018-2019,20,2018-12-30,Crystal Palace,Chelsea,0,1,A,0,3,3,1,1,1,3,1,14,4,19,40,10,21,December,-2.4492935982947064e-16,1.0,16,14,2,0,3,1.2,1.6,17,25,-8,37,16,21,"December, 2018"
2018-2019,20,2018-12-30,Man United,Bournemouth,4,1,H,3,0,0,2,3,2,1,2,6,12,32,26,6,6,December,-2.4492935982947064e-16,1.0,28,7,4,1,0,1.8,0.6,37,31,6,27,33,-6,"December, 2018"
2018-2019,20,2018-12-30,Southampton,Man City,1,3,A,0,3,0,3,2,5,0,0,17,3,15,44,14,29,December,-2.4492935982947064e-16,1.0,38,27,0,1,4,0.6,2.6,20,35,-15,51,15,36,"December, 2018"
2018-2019,21,2019-01-01,Arsenal,Fulham,4,1,H,3,0,1,1,3,3,0,2,5,19,38,14,14,24,January,0.4999999999999999,0.8660254037844387,0,19,4,1,0,2.8,1.0,42,30,12,18,43,-25,"January, 2019"
2018-2019,21,2019-01-01,Cardiff,Tottenham,0,3,A,0,3,2,0,3,1,1,3,16,3,18,45,13,27,January,0.4999999999999999,0.8660254037844387,12,42,0,0,3,0.0,1.0,19,38,-19,43,21,22,"January, 2019"
2018-2019,21,2019-01-01,Everton,Leicester,0,1,A,0,3,2,2,1,1,2,2,10,8,27,28,2,1,January,0.4999999999999999,0.8660254037844387,18,24,4,0,1,2.0,1.2,31,30,1,24,23,1,"January, 2019"
2018-2019,21,2019-01-02,West Ham,Brighton,2,2,D,1,1,3,1,1,0,3,2,11,13,27,25,2,2,January,0.4999999999999999,0.8660254037844387,45,10,0,0,3,0.3333333333333333,2.333333333333333,27,30,-3,22,27,-5,"January, 2019"
2018-2019,21,2019-01-02,Newcastle,Man United,0,2,A,0,3,3,1,1,0,2,3,15,6,18,35,9,17,January,0.4999999999999999,0.8660254037844387,30,28,1,2,2,1.4,2.0,15,27,-12,41,32,9,"January, 2019"
2018-2019,21,2019-01-02,Wolves,Crystal Palace,0,2,A,0,3,3,1,1,3,1,1,8,14,29,19,6,10,January,0.4999999999999999,0.8660254037844387,48,16,1,0,0,1.0,0.0,23,23,0,17,26,-9,"January, 2019"
2018-2019,21,2019-01-02,Chelsea,Southampton,0,0,D,1,1,1,3,1,0,3,2,4,17,43,15,13,28,January,0.4999999999999999,0.8660254037844387,14,38,5,0,0,2.6,0.8,38,16,22,21,38,-17,"January, 2019"
2018-2019,21,2019-01-02,Bournemouth,Watford,3,3,D,1,1,2,1,2,1,1,3,12,9,26,28,3,2,January,0.4999999999999999,0.8660254037844387,7,43,1,3,1,2.0,1.6,28,37,-9,27,28,-1,"January, 2019"
2018-2019,21,2019-01-02,Huddersfield,Burnley,1,2,A,0,3,0,2,3,1,1,3,20,18,10,15,2,5,January,0.4999999999999999,0.8660254037844387,20,11,0,3,0,0.3333333333333333,0.3333333333333333,12,35,-23,19,41,-22,"January, 2019"
2018-2019,21,2019-01-03,Man City,Liverpool,2,1,H,3,0,5,0,0,5,0,0,3,1,47,54,2,7,January,0.4999999999999999,0.8660254037844387,27,25,1,2,2,1.8,1.2,54,16,38,48,8,40,"January, 2019"
2018-2019,22,2019-01-12,Leicester,Southampton,1,2,A,0,3,1,2,2,0,3,2,8,18,31,16,10,15,January,0.4999999999999999,0.8660254037844387,24,38,2,2,1,1.2,1.0,25,23,2,21,38,-17,"January, 2019"
2018-2019,22,2019-01-12,Crystal Palace,Watford,1,2,A,0,3,3,1,1,1,1,3,14,8,22,29,6,7,January,0.4999999999999999,0.8660254037844387,16,43,2,2,1,1.0,0.8,19,26,-7,30,31,-1,"January, 2019"
2018-2019,22,2019-01-12,Chelsea,Newcastle,2,1,H,3,0,1,3,1,3,1,1,4,17,44,18,13,26,January,0.4999999999999999,0.8660254037844387,14,30,3,1,1,2.4,1.6,38,16,22,15,29,-14,"January, 2019"
2018-2019,22,2019-01-12,West Ham,Arsenal,1,0,H,3,0,3,1,1,1,1,3,10,5,28,41,5,13,January,0.4999999999999999,0.8660254037844387,45,0,0,1,4,0.6,3.0,29,32,-3,46,31,15,"January, 2019"
2018-2019,22,2019-01-12,Burnley,Fulham,2,1,H,3,0,1,1,3,3,0,2,16,19,18,14,3,4,January,0.4999999999999999,0.8660254037844387,11,19,0,1,2,1.0,2.6666666666666665,21,42,-21,19,47,-28,"January, 2019"
2018-2019,22,2019-01-12,Brighton,Liverpool,0,1,A,0,3,0,3,2,5,0,0,13,1,26,54,12,28,January,0.4999999999999999,0.8660254037844387,10,25,0,0,3,0.3333333333333333,3.333333333333333,24,29,-5,49,10,39,"January, 2019"
2018-2019,22,2019-01-12,Cardiff,Huddersfield,0,0,D,1,1,2,0,3,0,2,3,17,20,18,10,3,8,January,0.4999999999999999,0.8660254037844387,12,20,0,1,0,0.0,0.0,19,41,-22,13,37,-24,"January, 2019"
2018-2019,22,2019-01-13,Everton,Bournemouth,2,0,H,3,0,2,2,1,2,1,2,11,12,27,27,1,0,January,0.4999999999999999,0.8660254037844387,18,7,2,1,2,2.2,1.8,31,31,0,31,40,-9,"January, 2019"
2018-2019,22,2019-01-13,Tottenham,Man United,0,1,A,0,3,1,1,3,0,2,3,3,6,48,38,3,10,January,0.4999999999999999,0.8660254037844387,42,28,3,0,2,1.4,0.6,46,21,25,43,32,11,"January, 2019"
2018-2019,22,2019-01-14,Man City,Wolves,3,0,H,3,0,5,0,0,3,1,1,2,11,50,29,9,21,January,0.4999999999999999,0.8660254037844387,27,48,3,1,1,2.2,1.4,56,17,39,23,25,-2,"January, 2019"
2018-2019,23,2019-01-19,Watford,Burnley,0,0,D,1,1,1,1,3,1,1,3,7,17,32,21,10,11,January,0.4999999999999999,0.8660254037844387,43,11,2,0,3,1.2,1.4,32,32,0,23,43,-20,"January, 2019"
2018-2019,23,2019-01-19,Arsenal,Chelsea,2,0,H,3,0,1,1,3,1,3,1,5,4,41,47,1,6,January,0.4999999999999999,0.8660254037844387,0,14,1,2,2,1.6,1.6,46,32,14,40,17,23,"January, 2019"
2018-2019,23,2019-01-19,Bournemouth,West Ham,2,0,H,3,0,2,1,2,3,1,1,12,9,27,31,3,4,January,0.4999999999999999,0.8660254037844387,7,45,2,2,1,1.8,1.6,31,42,-11,30,32,-2,"January, 2019"
2018-2019,23,2019-01-19,Liverpool,Crystal Palace,4,3,H,3,0,5,0,0,3,1,1,1,14,57,22,13,35,January,0.4999999999999999,0.8660254037844387,25,16,4,0,1,2.0,1.0,50,10,40,20,28,-8,"January, 2019"
2018-2019,23,2019-01-19,Man United,Brighton,2,1,H,3,0,0,2,3,0,3,2,6,13,41,26,7,15,January,0.4999999999999999,0.8660254037844387,28,10,1,0,2,1.0,1.3333333333333333,44,32,12,24,30,-6,"January, 2019"
2018-2019,23,2019-01-19,Newcastle,Cardiff,3,0,H,3,0,3,1,1,2,0,3,18,17,18,19,1,1,January,0.4999999999999999,0.8660254037844387,30,12,2,1,0,1.6666666666666667,0.3333333333333333,16,31,-15,19,41,-22,"January, 2019"
2018-2019,23,2019-01-19,Southampton,Everton,2,1,H,3,0,0,3,2,2,2,1,17,10,19,30,7,11,January,0.4999999999999999,0.8660254037844387,38,18,2,1,2,1.4,1.4,23,39,-16,33,31,2,"January, 2019"
2018-2019,23,2019-01-19,Wolves,Leicester,4,3,H,3,0,3,1,1,1,2,2,12,8,29,31,4,2,January,0.4999999999999999,0.8660254037844387,48,24,1,1,1,1.3333333333333333,1.6666666666666667,23,28,-5,26,25,1,"January, 2019"
2018-2019,23,2019-01-20,Huddersfield,Man City,0,3,A,0,3,0,2,3,5,0,0,20,2,11,53,18,42,January,0.4999999999999999,0.8660254037844387,20,27,0,1,2,0.6666666666666666,2.6666666666666665,13,37,-24,59,17,42,"January, 2019"
2018-2019,23,2019-01-20,Fulham,Tottenham,1,2,A,0,3,3,0,2,1,1,3,19,3,14,48,16,34,January,0.4999999999999999,0.8660254037844387,19,42,1,0,4,0.8,2.2,20,49,-29,46,22,24,"January, 2019"
2018-2019,24,2019-01-29,Arsenal,Cardiff,2,1,H,3,0,1,1,3,2,0,3,5,18,44,19,13,25,January,0.4999999999999999,0.8660254037844387,0,12,3,0,0,2.6666666666666665,0.6666666666666666,48,32,16,19,44,-25,"January, 2019"
2018-2019,24,2019-01-29,Fulham,Brighton,4,2,H,3,0,3,0,2,0,3,2,19,13,14,26,6,12,January,0.4999999999999999,0.8660254037844387,19,10,0,1,0,2.0,2.0,21,51,-30,25,32,-7,"January, 2019"
2018-2019,24,2019-01-29,Huddersfield,Everton,0,1,A,0,3,0,2,3,2,2,1,20,11,11,30,9,19,January,0.4999999999999999,0.8660254037844387,20,18,0,1,2,0.3333333333333333,1.6666666666666667,13,40,-27,34,33,1,"January, 2019"
2018-2019,24,2019-01-29,Man United,Burnley,2,2,D,1,1,0,2,3,1,1,3,6,16,44,22,10,22,January,0.4999999999999999,0.8660254037844387,28,11,3,2,0,1.4,0.4,46,33,13,23,43,-20,"January, 2019"
2018-2019,24,2019-01-29,Newcastle,Man City,2,1,H,3,0,3,1,1,5,0,0,17,2,21,56,15,35,January,0.4999999999999999,0.8660254037844387,30,27,0,1,4,0.8,2.6,19,31,-12,62,17,45,"January, 2019"
2018-2019,24,2019-01-29,Wolves,West Ham,3,0,H,3,0,3,1,1,3,1,1,9,11,32,31,2,1,January,0.4999999999999999,0.8660254037844387,48,45,2,1,2,1.0,1.2,27,31,-4,30,34,-4,"January, 2019"
2018-2019,24,2019-01-30,Tottenham,Watford,2,1,H,3,0,1,1,3,1,1,3,3,9,51,33,6,18,January,0.4999999999999999,0.8660254037844387,42,43,3,1,1,2.4,0.8,48,23,25,32,32,0,"January, 2019"
2018-2019,24,2019-01-30,Bournemouth,Chelsea,4,0,H,3,0,2,1,2,1,3,1,12,4,30,47,8,17,January,0.4999999999999999,0.8660254037844387,7,14,1,0,4,0.8,1.8,33,42,-9,40,19,21,"January, 2019"
2018-2019,24,2019-01-30,Liverpool,Leicester,1,1,D,1,1,5,0,0,1,2,2,1,11,60,31,10,29,January,0.4999999999999999,0.8660254037844387,25,24,4,0,1,2.4,1.6,54,13,41,29,29,0,"January, 2019"
2018-2019,24,2019-01-30,Southampton,Crystal Palace,1,1,D,1,1,0,3,2,3,1,1,17,16,22,22,1,0,January,0.4999999999999999,0.8660254037844387,38,16,3,0,2,1.4,1.2,25,40,-15,23,32,-9,"January, 2019"
2018-2019,25,2019-02-02,Tottenham,Newcastle,1,0,H,3,0,1,1,3,3,1,1,3,15,54,24,12,30,February,0.8660254037844386,0.5000000000000001,42,30,3,0,2,1.4,1.6,50,24,26,21,32,-11,"February, 2019"
2018-2019,25,2019-02-02,Everton,Wolves,1,3,A,0,3,2,2,1,3,1,1,9,7,33,35,2,2,February,0.8660254037844386,0.5000000000000001,18,48,2,3,0,1.6,0.8,35,33,2,30,31,-1,"February, 2019"
2018-2019,25,2019-02-02,Crystal Palace,Fulham,2,0,H,3,0,3,1,1,3,0,2,17,19,23,17,2,6,February,0.8660254037844386,0.5000000000000001,16,19,2,1,2,1.6,1.8,24,33,-9,25,53,-28,"February, 2019"
2018-2019,25,2019-02-02,Burnley,Southampton,1,1,D,1,1,1,1,3,0,3,2,17,16,23,23,1,0,February,0.8660254037844386,0.5000000000000001,11,38,2,2,1,0.8,0.8,25,45,-20,26,41,-15,"February, 2019"
2018-2019,25,2019-02-02,Cardiff,Bournemouth,2,0,H,3,0,2,0,3,2,1,2,18,10,19,33,8,14,February,0.8660254037844386,0.5000000000000001,12,7,0,0,1,0.0,2.0,20,46,-26,37,42,-5,"February, 2019"
2018-2019,25,2019-02-02,Brighton,Watford,0,0,D,1,1,0,3,2,1,1,3,13,9,26,33,4,7,February,0.8660254037844386,0.5000000000000001,10,43,1,1,1,0.3333333333333333,0.6666666666666666,27,36,-9,33,34,-1,"February, 2019"
2018-2019,25,2019-02-02,Chelsea,Huddersfield,5,0,H,3,0,1,3,1,0,2,3,5,20,47,11,15,36,February,0.8660254037844386,0.5000000000000001,14,20,2,1,0,2.333333333333333,0.6666666666666666,40,23,17,13,41,-28,"February, 2019"
2018-2019,25,2019-02-03,Leicester,Man United,0,1,A,0,3,1,2,2,0,2,3,11,6,32,45,5,13,February,0.8660254037844386,0.5000000000000001,24,28,0,1,4,0.8,2.6,30,30,0,48,35,13,"February, 2019"
2018-2019,25,2019-02-03,Man City,Arsenal,3,1,H,3,0,5,0,0,1,1,3,3,6,56,47,3,9,February,0.8660254037844386,0.5000000000000001,27,0,4,1,0,2.4,0.8,63,19,44,50,33,17,"February, 2019"
2018-2019,25,2019-02-04,West Ham,Liverpool,1,1,D,1,1,3,1,1,5,0,0,12,1,31,61,11,30,February,0.8660254037844386,0.5000000000000001,45,25,0,1,4,0.8,3.6,30,37,-7,55,14,41,"February, 2019"
2018-2019,25,2019-02-06,Everton,Man City,0,2,A,0,3,2,2,1,5,0,0,9,2,33,59,7,26,February,0.8660254037844386,0.5000000000000001,18,27,1,2,2,1.6,1.6,36,36,0,66,20,46,"February, 2019"
2018-2019,26,2019-02-09,Southampton,Cardiff,1,2,A,0,3,0,3,2,2,0,3,17,18,24,22,1,2,February,0.8660254037844386,0.5000000000000001,38,12,1,0,2,1.0,0.6666666666666666,27,42,-15,22,46,-24,"February, 2019"
2018-2019,26,2019-02-09,Watford,Everton,1,0,H,3,0,1,1,3,2,2,1,8,9,34,33,1,1,February,0.8660254037844386,0.5000000000000001,43,18,2,1,2,1.6,1.6,33,34,-1,36,38,-2,"February, 2019"
2018-2019,26,2019-02-09,Liverpool,Bournemouth,3,0,H,3,0,5,0,0,2,1,2,2,10,62,33,8,29,February,0.8660254037844386,0.5000000000000001,25,7,3,1,1,3.2,1.2,56,15,41,37,44,-7,"February, 2019"
2018-2019,26,2019-02-09,Fulham,Man United,0,3,A,0,3,3,0,2,0,2,3,19,5,17,48,14,31,February,0.8660254037844386,0.5000000000000001,19,28,0,1,4,1.2,2.6,25,55,-30,49,35,14,"February, 2019"
2018-2019,26,2019-02-09,Huddersfield,Arsenal,1,2,A,0,3,0,2,3,1,1,3,20,6,11,47,14,36,February,0.8660254037844386,0.5000000000000001,20,0,0,0,3,0.0,2.333333333333333,13,46,-33,51,36,15,"February, 2019"
2018-2019,26,2019-02-09,Crystal Palace,West Ham,1,1,D,1,1,3,1,1,3,1,1,15,12,26,32,3,6,February,0.8660254037844386,0.5000000000000001,16,45,0,2,3,1.0,2.0,26,33,-7,31,38,-7,"February, 2019"
2018-2019,26,2019-02-09,Brighton,Burnley,1,3,A,0,3,0,3,2,1,1,3,13,17,27,24,4,3,February,0.8660254037844386,0.5000000000000001,10,11,0,2,1,0.0,0.3333333333333333,27,36,-9,26,46,-20,"February, 2019"
2018-2019,26,2019-02-10,Man City,Chelsea,6,0,H,3,0,5,0,0,1,3,1,2,5,62,50,3,12,February,0.8660254037844386,0.5000000000000001,27,14,2,0,3,0.8,1.4,68,20,48,45,23,22,"February, 2019"
2018-2019,26,2019-02-10,Tottenham,Leicester,3,1,H,3,0,1,1,3,1,2,2,3,12,57,32,9,25,February,0.8660254037844386,0.5000000000000001,42,24,3,1,1,3.0,1.6,51,24,27,30,31,-1,"February, 2019"
2018-2019,26,2019-02-11,Wolves,Newcastle,1,1,D,1,1,3,1,1,3,1,1,7,17,38,24,10,14,February,0.8660254037844386,0.5000000000000001,48,30,1,2,2,1.4,2.0,33,32,1,21,33,-12,"February, 2019"
2018-2019,27,2019-02-22,Cardiff,Watford,1,5,A,0,3,2,0,3,1,1,3,17,8,25,37,9,12,February,0.8660254037844386,0.5000000000000001,12,43,0,0,1,2.0,3.0,24,47,-23,34,34,0,"February, 2019"
2018-2019,27,2019-02-22,West Ham,Fulham,3,1,H,3,0,3,1,1,3,0,2,10,19,33,17,9,16,February,0.8660254037844386,0.5000000000000001,45,19,3,0,2,2.0,1.0,32,39,-7,25,58,-33,"February, 2019"
2018-2019,27,2019-02-23,Newcastle,Huddersfield,2,0,H,3,0,3,1,1,0,2,3,16,20,25,11,4,14,February,0.8660254037844386,0.5000000000000001,30,20,2,0,1,0.6666666666666666,0.3333333333333333,22,34,-12,14,48,-34,"February, 2019"
2018-2019,27,2019-02-23,Leicester,Crystal Palace,1,4,A,0,3,1,2,2,3,1,1,12,14,32,27,2,5,February,0.8660254037844386,0.5000000000000001,24,16,1,1,3,1.0,2.4,31,34,-3,27,34,-7,"February, 2019"
2018-2019,27,2019-02-23,Bournemouth,Wolves,1,1,D,1,1,2,1,2,3,1,1,11,8,33,39,3,6,February,0.8660254037844386,0.5000000000000001,7,48,0,0,1,0.0,2.0,37,47,-10,34,33,1,"February, 2019"
2018-2019,27,2019-02-23,Burnley,Tottenham,2,1,H,3,0,1,1,3,1,1,3,15,3,27,60,12,33,February,0.8660254037844386,0.5000000000000001,11,42,0,1,4,0.4,1.8,29,47,-18,54,25,29,"February, 2019"
2018-2019,27,2019-02-24,Arsenal,Southampton,2,0,H,3,0,1,1,3,0,3,2,5,18,50,24,13,26,February,0.8660254037844386,0.5000000000000001,0,38,3,1,1,2.0,1.4,53,37,16,28,44,-16,"February, 2019"
2018-2019,27,2019-02-24,Man United,Liverpool,0,0,D,1,1,0,2,3,5,0,0,5,2,51,65,3,14,February,0.8660254037844386,0.5000000000000001,28,25,1,3,1,0.8,1.0,52,35,17,59,15,44,"February, 2019"
2018-2019,28,2019-02-26,Cardiff,Everton,0,3,A,0,3,2,0,3,2,2,1,17,11,25,33,6,8,February,0.8660254037844386,0.5000000000000001,12,18,0,1,2,0.3333333333333333,1.0,25,52,-27,36,39,-3,"February, 2019"
2018-2019,28,2019-02-26,Huddersfield,Wolves,1,0,H,3,0,0,2,3,3,1,1,20,8,11,40,12,29,February,0.8660254037844386,0.5000000000000001,20,48,1,0,0,2.0,0.0,14,50,-36,35,34,1,"February, 2019"
2018-2019,28,2019-02-26,Leicester,Brighton,2,1,H,3,0,1,2,2,0,3,2,12,16,32,27,4,5,February,0.8660254037844386,0.5000000000000001,24,10,2,1,0,1.6666666666666667,0.3333333333333333,32,38,-6,28,39,-11,"February, 2019"
2018-2019,28,2019-02-26,Newcastle,Burnley,2,0,H,3,0,3,1,1,1,1,3,15,14,28,30,1,2,February,0.8660254037844386,0.5000000000000001,30,11,1,3,1,1.4,1.4,24,34,-10,31,48,-17,"February, 2019"
2018-2019,28,2019-02-27,Man City,West Ham,1,0,H,3,0,5,0,0,3,1,1,2,10,65,36,8,29,February,0.8660254037844386,0.5000000000000001,27,45,5,0,0,3.4,0.6,74,20,54,35,40,-5,"February, 2019"
2018-2019,28,2019-02-27,Southampton,Fulham,2,0,H,3,0,0,3,2,3,0,2,18,19,24,17,1,7,February,0.8660254037844386,0.5000000000000001,38,19,2,2,1,2.0,1.2,28,46,-18,26,61,-35,"February, 2019"
2018-2019,28,2019-02-27,Liverpool,Watford,5,0,H,3,0,5,0,0,1,1,3,1,7,66,40,6,26,February,0.8660254037844386,0.5000000000000001,25,43,4,1,0,3.6,0.8,59,15,44,39,35,4,"February, 2019"
2018-2019,28,2019-02-27,Crystal Palace,Man United,1,3,A,0,3,3,1,1,0,2,3,14,6,30,52,8,22,February,0.8660254037844386,0.5000000000000001,16,28,0,1,4,0.6,2.2,31,35,-4,52,35,17,"February, 2019"
2018-2019,28,2019-02-27,Chelsea,Tottenham,2,0,H,3,0,1,3,1,1,1,3,6,3,50,60,3,10,February,0.8660254037844386,0.5000000000000001,14,42,2,0,3,1.2,2.0,45,29,16,55,27,28,"February, 2019"
2018-2019,28,2019-02-27,Arsenal,Bournemouth,5,1,H,3,0,1,1,3,2,1,2,4,12,53,34,8,19,February,0.8660254037844386,0.5000000000000001,0,7,3,1,1,2.4,1.4,55,37,18,38,48,-10,"February, 2019"
2018-2019,29,2019-03-02,Bournemouth,Man City,0,1,A,0,3,2,1,2,5,0,0,12,2,34,68,10,34,March,1.0,6.123233995736766e-17,7,27,0,0,5,0.4,3.0,39,53,-14,75,20,55,"March, 2019"
2018-2019,29,2019-03-02,Brighton,Huddersfield,1,0,H,3,0,0,3,2,0,2,3,16,20,27,14,4,13,March,1.0,6.123233995736766e-17,10,20,1,1,1,1.0,1.3333333333333333,29,41,-12,15,50,-35,"March, 2019"
2018-2019,29,2019-03-02,Burnley,Crystal Palace,1,3,A,0,3,1,1,3,3,1,1,16,14,30,30,2,0,March,1.0,6.123233995736766e-17,11,16,3,0,2,1.2,1.0,31,50,-19,32,38,-6,"March, 2019"
2018-2019,29,2019-03-02,Man United,Southampton,3,2,H,3,0,0,2,3,0,3,2,5,17,55,27,12,28,March,1.0,6.123233995736766e-17,28,38,2,3,0,1.0,0.4,55,36,19,30,46,-16,"March, 2019"
2018-2019,29,2019-03-02,Tottenham,Arsenal,1,1,D,1,1,1,1,3,1,1,3,3,5,60,56,2,4,March,1.0,6.123233995736766e-17,42,0,2,1,2,1.2,1.4,55,29,26,60,38,22,"March, 2019"
2018-2019,29,2019-03-02,West Ham,Newcastle,2,0,H,3,0,3,1,1,3,1,1,10,14,36,31,4,5,March,1.0,6.123233995736766e-17,45,30,2,0,3,1.6,1.6,35,41,-6,26,34,-8,"March, 2019"
2018-2019,29,2019-03-02,Wolves,Cardiff,2,0,H,3,0,3,1,1,2,0,3,7,18,40,25,11,15,March,1.0,6.123233995736766e-17,48,12,0,0,1,1.0,2.0,35,35,0,25,55,-30,"March, 2019"
2018-2019,29,2019-03-03,Watford,Leicester,2,1,H,3,0,1,1,3,1,2,2,8,11,40,35,3,5,March,1.0,6.123233995736766e-17,43,24,2,0,3,0.8,1.8,39,40,-1,34,39,-5,"March, 2019"
2018-2019,29,2019-03-03,Everton,Liverpool,0,0,D,1,1,2,2,1,5,0,0,10,2,36,69,8,33,March,1.0,6.123233995736766e-17,18,25,0,2,3,0.4,1.2,39,39,0,64,15,49,"March, 2019"
2018-2019,29,2019-03-03,Fulham,Chelsea,1,2,A,0,3,3,0,2,1,3,1,19,6,17,53,13,36,March,1.0,6.123233995736766e-17,19,14,0,1,4,0.2,2.0,26,63,-37,47,29,18,"March, 2019"
2018-2019,30,2019-03-09,Southampton,Tottenham,2,1,H,3,0,0,3,2,1,1,3,18,3,27,61,15,34,March,1.0,6.123233995736766e-17,38,42,0,1,4,1.2,3.0,32,49,-17,56,30,26,"March, 2019"
2018-2019,30,2019-03-09,Cardiff,West Ham,2,0,H,3,0,2,0,3,3,1,1,18,9,25,39,9,14,March,1.0,6.123233995736766e-17,12,45,0,0,3,0.3333333333333333,2.333333333333333,25,57,-32,37,41,-4,"March, 2019"
2018-2019,30,2019-03-09,Crystal Palace,Brighton,1,2,A,0,3,3,1,1,0,3,2,13,15,33,30,2,3,March,1.0,6.123233995736766e-17,16,10,1,1,1,1.3333333333333333,1.6666666666666667,35,39,-4,30,41,-11,"March, 2019"
2018-2019,30,2019-03-09,Huddersfield,Bournemouth,0,2,A,0,3,0,2,3,2,1,2,20,12,14,34,8,20,March,1.0,6.123233995736766e-17,20,7,1,0,2,1.6666666666666667,2.333333333333333,15,51,-36,39,54,-15,"March, 2019"
2018-2019,30,2019-03-09,Leicester,Fulham,3,1,H,3,0,1,2,2,3,0,2,12,19,35,17,7,18,March,1.0,6.123233995736766e-17,24,19,0,3,2,0.2,1.0,35,41,-6,27,65,-38,"March, 2019"
2018-2019,30,2019-03-09,Man City,Watford,3,1,H,3,0,5,0,0,1,1,3,1,8,71,43,7,28,March,1.0,6.123233995736766e-17,27,43,5,0,0,3.6,0.4,76,20,56,41,41,0,"March, 2019"
2018-2019,30,2019-03-09,Newcastle,Everton,3,2,H,3,0,3,1,1,2,2,1,15,11,31,37,4,6,March,1.0,6.123233995736766e-17,30,18,0,1,4,0.2,1.4,26,36,-10,39,39,0,"March, 2019"
2018-2019,30,2019-03-10,Liverpool,Burnley,4,2,H,3,0,5,0,0,1,1,3,2,17,70,30,15,40,March,1.0,6.123233995736766e-17,25,11,3,1,1,1.6,1.2,64,15,49,32,53,-21,"March, 2019"
2018-2019,30,2019-03-10,Arsenal,Man United,2,0,H,3,0,1,1,3,0,2,3,5,4,57,58,1,1,March,1.0,6.123233995736766e-17,0,28,1,2,2,1.4,1.6,61,39,22,58,38,20,"March, 2019"
2018-2019,30,2019-03-10,Chelsea,Wolves,1,1,D,1,1,1,3,1,3,1,1,6,7,56,43,1,13,March,1.0,6.123233995736766e-17,14,48,3,0,2,1.6,0.8,49,30,19,37,35,2,"March, 2019"
2018-2019,31,2019-03-16,Bournemouth,Newcastle,2,2,D,1,1,2,1,2,3,1,1,12,13,37,34,1,3,March,1.0,6.123233995736766e-17,7,30,2,1,2,1.4,1.2,41,54,-13,29,38,-9,"March, 2019"
2018-2019,31,2019-03-16,Burnley,Leicester,1,2,A,0,3,1,1,3,1,2,2,17,10,30,38,7,8,March,1.0,6.123233995736766e-17,11,24,2,1,2,0.6,1.0,34,57,-23,38,42,-4,"March, 2019"
2018-2019,31,2019-03-16,West Ham,Huddersfield,4,3,H,3,0,3,1,1,0,2,3,10,20,39,14,10,25,March,1.0,6.123233995736766e-17,45,20,2,1,0,2.333333333333333,0.6666666666666666,37,43,-6,15,53,-38,"March, 2019"
2018-2019,31,2019-03-17,Everton,Chelsea,2,0,H,3,0,2,2,1,1,3,1,12,6,37,57,6,20,March,1.0,6.123233995736766e-17,18,14,0,2,3,0.0,2.0,41,42,-1,50,31,19,"March, 2019"
2018-2019,31,2019-03-17,Fulham,Liverpool,1,2,A,0,3,3,0,2,5,0,0,19,2,17,73,17,56,March,1.0,6.123233995736766e-17,19,25,0,0,5,0.6,3.2,28,68,-40,68,17,51,"March, 2019"
2018-2019,32,2019-03-30,West Ham,Everton,0,2,A,0,3,3,1,1,2,2,1,10,11,42,40,1,2,March,1.0,6.123233995736766e-17,45,18,2,1,2,1.2,1.6,41,46,-5,43,42,1,"March, 2019"
2018-2019,32,2019-03-30,Man United,Watford,2,1,H,3,0,0,2,3,1,1,3,5,9,58,43,4,15,March,1.0,6.123233995736766e-17,28,43,4,0,1,2.0,1.2,58,40,18,42,44,-2,"March, 2019"
2018-2019,32,2019-03-30,Leicester,Bournemouth,2,0,H,3,0,1,2,2,2,1,2,10,12,41,38,2,3,March,1.0,6.123233995736766e-17,24,7,0,3,2,0.8,1.4,40,43,-3,43,56,-13,"March, 2019"
2018-2019,32,2019-03-30,Fulham,Man City,0,2,A,0,3,3,0,2,5,0,0,19,2,17,74,17,57,March,1.0,6.123233995736766e-17,19,27,0,0,5,0.6,3.2,29,70,-41,79,21,58,"March, 2019"
2018-2019,32,2019-03-30,Crystal Palace,Huddersfield,2,0,H,3,0,3,1,1,0,2,3,14,20,33,14,6,19,March,1.0,6.123233995736766e-17,16,20,2,0,1,1.0,1.0,36,41,-5,18,57,-39,"March, 2019"
2018-2019,32,2019-03-30,Burnley,Wolves,2,0,H,3,0,1,1,3,3,1,1,17,7,30,44,10,14,March,1.0,6.123233995736766e-17,11,48,0,0,3,0.3333333333333333,1.6666666666666667,35,59,-24,38,36,2,"March, 2019"
2018-2019,32,2019-03-30,Brighton,Southampton,0,1,A,0,3,0,3,2,0,3,2,15,16,33,30,1,3,March,1.0,6.123233995736766e-17,10,38,0,3,0,1.3333333333333333,1.3333333333333333,32,42,-10,34,50,-16,"March, 2019"
2018-2019,32,2019-03-31,Cardiff,Chelsea,1,2,A,0,3,2,0,3,1,3,1,18,6,28,57,12,29,March,1.0,6.123233995736766e-17,12,14,0,0,3,1.0,3.333333333333333,27,57,-30,50,33,17,"March, 2019"
2018-2019,32,2019-03-31,Liverpool,Tottenham,2,1,H,3,0,5,0,0,1,1,3,2,3,76,61,1,15,March,1.0,6.123233995736766e-17,25,42,2,2,1,1.6,1.6,70,18,52,57,32,25,"March, 2019"
2018-2019,32,2019-04-01,Arsenal,Newcastle,2,0,H,3,0,1,1,3,3,1,1,5,14,60,35,9,25,April,0.8660254037844388,-0.4999999999999998,0,30,4,0,1,1.2,0.6,63,39,24,31,40,-9,"April, 2019"
2018-2019,32,2019-04-02,Watford,Fulham,4,1,H,3,0,1,1,3,3,0,2,10,19,43,17,9,26,April,0.8660254037844388,-0.4999999999999998,43,19,0,3,0,1.3333333333333333,1.3333333333333333,43,46,-3,29,72,-43,"April, 2019"
2018-2019,32,2019-04-02,Wolves,Man United,2,1,H,3,0,3,1,1,0,2,3,8,5,44,61,3,17,April,0.8660254037844388,-0.4999999999999998,48,28,1,1,3,1.0,2.6,38,38,0,60,41,19,"April, 2019"
2018-2019,32,2019-04-03,Tottenham,Crystal Palace,2,0,H,3,0,1,1,3,3,1,1,5,13,61,36,8,25,April,0.8660254037844388,-0.4999999999999998,42,16,5,0,0,1.0,0.0,58,34,24,38,41,-3,"April, 2019"
2018-2019,32,2019-04-03,Man City,Cardiff,2,0,H,3,0,5,0,0,2,0,3,2,18,77,28,16,49,April,0.8660254037844388,-0.4999999999999998,27,12,2,0,1,3.6666666666666665,1.6666666666666667,81,21,60,28,59,-31,"April, 2019"
2018-2019,32,2019-04-03,Chelsea,Brighton,3,0,H,3,0,1,3,1,0,3,2,6,15,60,33,9,27,April,0.8660254037844388,-0.4999999999999998,14,10,3,0,0,2.6666666666666665,0.3333333333333333,52,34,18,32,43,-11,"April, 2019"
2018-2019,33,2019-04-05,Southampton,Liverpool,1,3,A,0,3,0,3,2,5,0,0,16,2,33,79,14,46,April,0.8660254037844388,-0.4999999999999998,38,25,0,2,3,0.0,1.6,35,50,-15,72,19,53,"April, 2019"
2018-2019,33,2019-04-06,Bournemouth,Burnley,1,3,A,0,3,2,1,2,1,1,3,12,17,38,33,5,5,April,0.8660254037844388,-0.4999999999999998,7,11,2,0,3,1.4,2.2,43,58,-15,37,59,-22,"April, 2019"
2018-2019,33,2019-04-06,Huddersfield,Leicester,1,4,A,0,3,0,2,3,1,2,2,20,9,14,44,11,30,April,0.8660254037844388,-0.4999999999999998,20,24,0,1,2,0.6666666666666666,2.333333333333333,18,59,-41,42,43,-1,"April, 2019"
2018-2019,33,2019-04-06,Newcastle,Crystal Palace,0,1,A,0,3,3,1,1,3,1,1,15,13,35,36,2,1,April,0.8660254037844388,-0.4999999999999998,30,16,2,2,1,0.8,1.2,31,42,-11,38,43,-5,"April, 2019"
2018-2019,33,2019-04-07,Everton,Arsenal,1,0,H,3,0,2,2,1,1,1,3,10,4,43,63,6,20,April,0.8660254037844388,-0.4999999999999998,18,0,1,0,4,1.2,3.2,45,42,3,65,39,26,"April, 2019"
2018-2019,33,2019-04-08,Chelsea,West Ham,2,0,H,3,0,1,3,1,3,1,1,5,11,63,42,6,21,April,0.8660254037844388,-0.4999999999999998,14,45,2,2,1,1.0,0.8,55,34,21,41,48,-7,"April, 2019"
2018-2019,34,2019-04-12,Leicester,Newcastle,0,1,A,0,3,1,2,2,3,1,1,7,15,47,35,8,12,April,0.8660254037844388,-0.4999999999999998,24,30,4,0,1,2.0,0.8,46,44,2,31,43,-12,"April, 2019"
2018-2019,34,2019-04-13,Tottenham,Huddersfield,4,0,H,3,0,1,1,3,0,2,3,4,20,64,14,16,50,April,0.8660254037844388,-0.4999999999999998,42,20,3,0,0,2.6666666666666665,0.0,60,34,26,19,63,-44,"April, 2019"
2018-2019,34,2019-04-13,Southampton,Wolves,3,1,H,3,0,0,3,2,3,1,1,16,8,33,47,8,14,April,0.8660254037844388,-0.4999999999999998,38,48,2,0,1,2.0,1.0,36,53,-17,40,39,1,"April, 2019"
2018-2019,34,2019-04-13,Man United,West Ham,2,1,H,3,0,0,2,3,3,1,1,6,11,61,42,5,19,April,0.8660254037844388,-0.4999999999999998,28,45,2,2,1,1.6,0.8,61,43,18,41,50,-9,"April, 2019"
2018-2019,34,2019-04-13,Burnley,Cardiff,2,0,H,3,0,1,1,3,2,0,3,15,18,36,28,3,8,April,0.8660254037844388,-0.4999999999999998,11,12,1,0,0,2.0,1.0,40,60,-20,28,61,-33,"April, 2019"
2018-2019,34,2019-04-13,Brighton,Bournemouth,0,5,A,0,3,0,3,2,2,1,2,16,14,33,38,2,5,April,0.8660254037844388,-0.4999999999999998,10,7,0,1,2,1.0,2.0,32,46,-14,44,61,-17,"April, 2019"
2018-2019,34,2019-04-13,Fulham,Everton,2,0,H,3,0,3,0,2,2,2,1,19,9,17,46,10,29,April,0.8660254037844388,-0.4999999999999998,19,18,0,1,4,0.8,2.6,30,76,-46,46,42,4,"April, 2019"
2018-2019,34,2019-04-14,Crystal Palace,Man City,1,3,A,0,3,3,1,1,5,0,0,13,2,39,80,11,41,April,0.8660254037844388,-0.4999999999999998,16,27,1,1,3,0.8,2.8,39,43,-4,83,21,62,"April, 2019"
2018-2019,34,2019-04-14,Liverpool,Chelsea,2,0,H,3,0,5,0,0,1,3,1,2,4,82,66,2,16,April,0.8660254037844388,-0.4999999999999998,25,14,1,3,1,1.0,1.0,75,20,55,57,34,23,"April, 2019"
2018-2019,34,2019-04-15,Watford,Arsenal,0,1,A,0,3,1,1,3,1,1,3,10,6,46,63,4,17,April,0.8660254037844388,-0.4999999999999998,43,0,2,0,3,1.0,2.0,47,47,0,65,40,25,"April, 2019"
2018-2019,34,2019-04-16,Brighton,Cardiff,0,2,A,0,3,0,3,2,2,0,3,17,18,33,28,1,5,April,0.8660254037844388,-0.4999999999999998,10,12,0,0,1,1.0,2.0,32,51,-19,28,63,-35,"April, 2019"
2018-2019,35,2019-04-20,Newcastle,Southampton,3,1,H,3,0,3,1,1,0,3,2,15,16,38,36,1,2,April,0.8660254037844388,-0.4999999999999998,30,38,1,3,1,1.6,1.4,32,43,-11,39,54,-15,"April, 2019"
2018-2019,35,2019-04-20,Man City,Tottenham,1,0,H,3,0,5,0,0,1,1,3,2,3,83,67,1,16,April,0.8660254037844388,-0.4999999999999998,27,42,3,1,1,2.0,1.2,86,22,64,64,34,30,"April, 2019"
2018-2019,35,2019-04-20,Wolves,Brighton,0,0,D,1,1,3,1,1,0,3,2,9,17,47,33,8,14,April,0.8660254037844388,-0.4999999999999998,48,10,0,0,1,0.0,1.0,41,42,-1,32,53,-21,"April, 2019"
2018-2019,35,2019-04-20,Bournemouth,Fulham,0,1,A,0,3,2,1,2,3,0,2,12,19,41,20,7,21,April,0.8660254037844388,-0.4999999999999998,7,19,1,0,0,3.0,0.0,49,61,-12,32,76,-44,"April, 2019"
2018-2019,35,2019-04-20,Huddersfield,Watford,1,2,A,0,3,0,2,3,1,1,3,20,10,14,46,10,32,April,0.8660254037844388,-0.4999999999999998,20,43,2,0,1,1.6666666666666667,1.3333333333333333,19,67,-48,47,48,-1,"April, 2019"
2018-2019,35,2019-04-20,West Ham,Leicester,2,2,D,1,1,3,1,1,1,2,2,11,8,42,47,3,5,April,0.8660254037844388,-0.4999999999999998,45,24,1,2,2,1.2,1.2,42,52,-10,46,45,1,"April, 2019"
2018-2019,35,2019-04-21,Everton,Man United,4,0,H,3,0,2,2,1,0,2,3,10,6,46,64,4,18,April,0.8660254037844388,-0.4999999999999998,18,28,0,2,3,0.6,2.0,46,44,2,63,44,19,"April, 2019"
2018-2019,35,2019-04-21,Arsenal,Crystal Palace,2,3,A,0,3,1,1,3,3,1,1,4,14,66,39,10,27,April,0.8660254037844388,-0.4999999999999998,0,16,3,1,1,2.2,1.6,66,40,26,40,46,-6,"April, 2019"
2018-2019,35,2019-04-21,Cardiff,Liverpool,0,2,A,0,3,2,0,3,5,0,0,18,2,31,85,16,54,April,0.8660254037844388,-0.4999999999999998,12,25,0,0,3,1.6666666666666667,4.333333333333333,30,63,-33,77,20,57,"April, 2019"
2018-2019,35,2019-04-22,Chelsea,Burnley,2,2,D,1,1,1,3,1,1,1,3,5,15,66,39,10,27,April,0.8660254037844388,-0.4999999999999998,14,11,3,1,1,2.4,1.0,57,36,21,42,60,-18,"April, 2019"
2018-2019,35,2019-04-23,Tottenham,Brighton,1,0,H,3,0,1,1,3,0,3,2,3,17,67,34,14,33,April,0.8660254037844388,-0.4999999999999998,42,10,2,1,0,1.6666666666666667,0.6666666666666666,64,35,29,32,53,-21,"April, 2019"
2018-2019,35,2019-04-23,Watford,Southampton,1,1,D,1,1,1,1,3,0,3,2,8,16,49,36,8,13,April,0.8660254037844388,-0.4999999999999998,43,38,1,3,1,1.8,1.6,49,49,0,40,57,-17,"April, 2019"
2018-2019,35,2019-04-24,Man United,Man City,0,2,A,0,3,0,2,3,5,0,0,6,2,64,86,4,22,April,0.8660254037844388,-0.4999999999999998,28,27,1,1,3,1.2,1.8,63,48,15,87,22,65,"April, 2019"
2018-2019,35,2019-04-24,Wolves,Arsenal,3,1,H,3,0,3,1,1,1,1,3,10,5,48,66,5,18,April,0.8660254037844388,-0.4999999999999998,48,0,0,2,3,0.4,1.8,41,42,-1,68,43,25,"April, 2019"
2018-2019,36,2019-04-26,Liverpool,Huddersfield,5,0,H,3,0,5,0,0,0,2,3,2,20,88,14,18,74,April,0.8660254037844388,-0.4999999999999998,25,20,3,0,0,2.333333333333333,0.0,79,20,59,20,69,-49,"April, 2019"
2018-2019,36,2019-04-27,Watford,Wolves,1,2,A,0,3,1,1,3,3,1,1,9,7,50,51,2,1,April,0.8660254037844388,-0.4999999999999998,43,48,1,0,0,2.0,0.0,50,50,0,44,43,1,"April, 2019"
2018-2019,36,2019-04-27,Tottenham,West Ham,0,1,A,0,3,1,1,3,3,1,1,3,12,70,43,9,27,April,0.8660254037844388,-0.4999999999999998,42,45,3,1,1,1.6,1.2,65,35,30,44,54,-10,"April, 2019"
2018-2019,36,2019-04-27,Southampton,Bournemouth,3,3,D,1,1,0,3,2,2,1,2,16,14,37,41,2,4,April,0.8660254037844388,-0.4999999999999998,38,7,2,3,0,1.2,0.6,41,58,-17,49,62,-13,"April, 2019"
2018-2019,36,2019-04-27,Fulham,Cardiff,1,0,H,3,0,3,0,2,2,0,3,19,18,23,31,1,8,April,0.8660254037844388,-0.4999999999999998,19,12,0,0,3,1.3333333333333333,3.0,33,76,-43,30,65,-35,"April, 2019"
2018-2019,36,2019-04-27,Crystal Palace,Everton,0,0,D,1,1,3,1,1,2,2,1,12,9,42,49,3,7,April,0.8660254037844388,-0.4999999999999998,16,18,0,2,3,0.8,1.8,43,48,-5,50,44,6,"April, 2019"
2018-2019,36,2019-04-27,Brighton,Newcastle,1,1,D,1,1,0,3,2,3,1,1,17,13,34,41,4,7,April,0.8660254037844388,-0.4999999999999998,10,30,2,1,0,0.6666666666666666,0.0,32,54,-22,35,44,-9,"April, 2019"
2018-2019,36,2019-04-28,Burnley,Man City,0,1,A,0,3,1,1,3,5,0,0,15,2,40,89,13,49,April,0.8660254037844388,-0.4999999999999998,11,27,0,1,4,0.6,2.6,44,62,-18,89,22,67,"April, 2019"
2018-2019,36,2019-04-28,Leicester,Arsenal,3,0,H,3,0,1,2,2,1,1,3,10,5,48,66,5,18,April,0.8660254037844388,-0.4999999999999998,24,0,1,1,3,1.4,1.8,48,47,1,69,46,23,"April, 2019"
2018-2019,36,2019-04-28,Man United,Chelsea,1,1,D,1,1,0,2,3,1,3,1,6,4,64,67,2,3,April,0.8660254037844388,-0.4999999999999998,28,14,2,1,2,1.2,1.6,63,50,13,59,38,21,"April, 2019"
2018-2019,37,2019-05-03,Everton,Burnley,2,0,H,3,0,2,2,1,1,1,3,9,15,50,40,6,10,May,0.4999999999999999,-0.8660254037844387,18,11,2,0,3,2.0,1.4,50,44,6,44,63,-19,"May, 2019"
2018-2019,37,2019-05-04,Wolves,Fulham,1,0,H,3,0,3,1,1,3,0,2,7,19,54,26,12,28,May,0.4999999999999999,-0.8660254037844387,48,19,1,2,2,1.0,1.8,46,44,2,34,76,-42,"May, 2019"
2018-2019,37,2019-05-04,West Ham,Southampton,3,0,H,3,0,3,1,1,0,3,2,12,16,46,38,4,8,May,0.4999999999999999,-0.8660254037844387,45,38,3,0,2,2.0,1.6,45,54,-9,44,61,-17,"May, 2019"
2018-2019,37,2019-05-04,Newcastle,Liverpool,2,3,A,0,3,3,1,1,5,0,0,14,2,42,91,12,49,May,0.4999999999999999,-0.8660254037844387,30,25,1,2,2,1.0,1.8,36,45,-9,84,20,64,"May, 2019"
2018-2019,37,2019-05-04,Cardiff,Crystal Palace,2,3,A,0,3,2,0,3,3,1,1,18,13,31,43,5,12,May,0.4999999999999999,-0.8660254037844387,12,16,0,1,2,0.0,1.6666666666666667,30,66,-36,43,48,-5,"May, 2019"
2018-2019,37,2019-05-04,Bournemouth,Tottenham,1,0,H,3,0,2,1,2,1,1,3,14,3,42,70,11,28,May,0.4999999999999999,-0.8660254037844387,7,42,0,1,4,0.2,2.8,52,65,-13,65,36,29,"May, 2019"
2018-2019,37,2019-05-05,Arsenal,Brighton,1,1,D,1,1,1,1,3,0,3,2,5,17,66,35,12,31,May,0.4999999999999999,-0.8660254037844387,0,10,1,1,1,1.3333333333333333,1.0,69,49,20,33,55,-22,"May, 2019"
2018-2019,37,2019-05-05,Chelsea,Watford,3,0,H,3,0,1,3,1,1,1,3,4,10,68,50,6,18,May,0.4999999999999999,-0.8660254037844387,14,43,4,0,1,2.6,2.2,60,39,21,51,52,-1,"May, 2019"
2018-2019,37,2019-05-05,Huddersfield,Man United,1,1,D,1,1,0,2,3,0,2,3,20,6,14,65,14,51,May,0.4999999999999999,-0.8660254037844387,20,28,1,0,2,1.0,2.0,20,74,-54,64,51,13,"May, 2019"
2018-2019,37,2019-05-06,Man City,Leicester,1,0,H,3,0,5,0,0,1,2,2,2,9,92,51,7,41,May,0.4999999999999999,-0.8660254037844387,27,24,3,0,2,2.4,1.6,90,22,68,51,47,4,"May, 2019"
2018-2019,38,2019-05-12,Brighton,Man City,1,4,A,0,3,0,3,2,5,0,0,17,1,36,95,16,59,May,0.4999999999999999,-0.8660254037844387,10,27,0,0,3,0.3333333333333333,2.333333333333333,34,56,-22,91,22,69,"May, 2019"
2018-2019,38,2019-05-12,Burnley,Arsenal,1,3,A,0,3,1,1,3,1,1,3,15,5,40,67,10,27,May,0.4999999999999999,-0.8660254037844387,11,0,0,0,5,0.4,2.4,44,65,-21,70,50,20,"May, 2019"
2018-2019,38,2019-05-12,Crystal Palace,Bournemouth,5,3,H,3,0,3,1,1,2,1,2,12,13,46,45,1,1,May,0.4999999999999999,-0.8660254037844387,16,7,1,3,1,1.6,1.4,46,50,-4,53,65,-12,"May, 2019"
2018-2019,38,2019-05-12,Fulham,Newcastle,0,4,A,0,3,3,0,2,3,1,1,19,14,26,42,5,16,May,0.4999999999999999,-0.8660254037844387,19,30,2,1,2,0.6,0.6,34,77,-43,38,48,-10,"May, 2019"
2018-2019,38,2019-05-12,Leicester,Chelsea,0,0,D,1,1,1,2,2,1,3,1,9,3,51,71,6,20,May,0.4999999999999999,-0.8660254037844387,24,14,1,1,3,0.4,1.6,51,48,3,63,39,24,"May, 2019"
2018-2019,38,2019-05-12,Liverpool,Wolves,2,0,H,3,0,5,0,0,3,1,1,2,7,94,57,5,37,May,0.4999999999999999,-0.8660254037844387,25,48,4,0,1,2.0,0.4,87,22,65,47,44,3,"May, 2019"
2018-2019,38,2019-05-12,Man United,Cardiff,0,2,A,0,3,0,2,3,2,0,3,6,18,66,31,12,35,May,0.4999999999999999,-0.8660254037844387,28,12,2,1,0,3.0,1.0,65,52,13,32,69,-37,"May, 2019"
2018-2019,38,2019-05-12,Southampton,Huddersfield,1,1,D,1,1,0,3,2,0,2,3,16,20,38,15,4,23,May,0.4999999999999999,-0.8660254037844387,38,20,1,2,0,1.3333333333333333,0.6666666666666666,44,64,-20,21,75,-54,"May, 2019"
2018-2019,38,2019-05-12,Tottenham,Everton,2,2,D,1,1,1,1,3,2,2,1,4,8,70,53,4,17,May,0.4999999999999999,-0.8660254037844387,42,18,4,1,0,3.4,1.0,65,37,28,52,44,8,"May, 2019"
2018-2019,38,2019-05-12,Watford,West Ham,1,4,A,0,3,1,1,3,3,1,1,10,12,50,49,2,1,May,0.4999999999999999,-0.8660254037844387,43,45,3,1,1,1.8,1.0,51,55,-4,48,54,-6,"May, 2019"
2019-2020,1,2019-08-09,Liverpool,Norwich,4,1,H,3,0,3,1,1,0,0,5,10,14,0,0,4,0,August,-0.8660254037844384,-0.5000000000000004,25,31,4,1,0,3.8,1.6,0,0,0,0,0,0,"August, 2019"
2019-2020,1,2019-08-10,Tottenham,Aston Villa,3,1,H,3,0,3,2,0,2,2,1,15,10,0,0,5,0,August,-0.8660254037844384,-0.5000000000000004,42,1,4,0,1,2.0,0.6,0,0,0,0,0,0,"August, 2019"
2019-2020,1,2019-08-10,Crystal Palace,Everton,0,0,D,1,1,0,1,4,1,2,2,10,11,0,0,1,0,August,-0.8660254037844384,-0.5000000000000004,16,18,0,2,3,0.6,1.6,0,0,0,0,0,0,"August, 2019"
2019-2020,1,2019-08-10,Watford,Brighton,0,3,A,0,3,2,0,3,1,2,2,16,10,0,0,6,0,August,-0.8660254037844384,-0.5000000000000004,43,10,1,2,1,0.5,0.25,0,0,0,0,0,0,"August, 2019"
2019-2020,1,2019-08-10,Bournemouth,Sheffield United,1,1,D,1,1,2,1,2,2,0,3,5,14,0,0,9,0,August,-0.8660254037844384,-0.5000000000000004,7,36,0,0,0,0.0,0.0,0,0,0,0,0,0,"August, 2019"
2019-2020,1,2019-08-10,West Ham,Man City,0,5,A,0,3,2,2,1,5,0,0,18,11,0,0,7,0,August,-0.8660254037844384,-0.5000000000000004,45,27,0,0,5,0.4,3.0,0,0,0,0,0,0,"August, 2019"
2019-2020,1,2019-08-10,Burnley,Southampton,3,0,H,3,0,2,2,1,2,3,0,8,15,0,0,7,0,August,-0.8660254037844384,-0.5000000000000004,11,38,2,3,0,0.8,0.4,0,0,0,0,0,0,"August, 2019"
2019-2020,1,2019-08-11,Leicester,Wolves,0,0,D,1,1,1,1,3,2,1,2,12,15,0,0,3,0,August,-0.8660254037844384,-0.5000000000000004,24,48,1,1,2,2.0,2.0,0,0,0,0,0,0,"August, 2019"
2019-2020,1,2019-08-11,Newcastle,Arsenal,0,1,A,0,3,0,1,4,2,1,2,15,12,0,0,3,0,August,-0.8660254037844384,-0.5000000000000004,30,0,1,0,4,0.6,1.4,0,0,0,0,0,0,"August, 2019"
2019-2020,1,2019-08-11,Man United,Chelsea,4,0,H,3,0,3,2,0,3,0,2,14,13,0,0,1,0,August,-0.8660254037844384,-0.5000000000000004,28,14,2,2,1,1.4,1.0,0,0,0,0,0,0,"August, 2019"
2019-2020,2,2019-08-17,Man City,Tottenham,2,2,D,1,1,5,0,0,3,2,0,6,9,3,3,3,0,August,-0.8660254037844384,-0.5000000000000004,27,42,4,1,0,2.2,0.8,5,0,5,3,1,2,"August, 2019"
2019-2020,2,2019-08-17,Southampton,Liverpool,1,2,A,0,3,2,3,0,3,1,1,18,7,0,3,11,3,August,-0.8660254037844384,-0.5000000000000004,38,25,0,1,4,0.2,2.2,0,3,-3,4,1,3,"August, 2019"
2019-2020,2,2019-08-17,Norwich,Newcastle,3,1,H,3,0,0,0,5,0,1,4,17,15,0,0,2,0,August,-0.8660254037844384,-0.5000000000000004,31,30,1,2,2,1.2,2.0,1,4,-3,0,1,-1,"August, 2019"
2019-2020,2,2019-08-17,Everton,Watford,1,0,H,3,0,1,2,2,2,0,3,11,19,1,0,8,1,August,-0.8660254037844384,-0.5000000000000004,18,43,2,1,2,1.2,1.2,0,0,0,0,3,-3,"August, 2019"
2019-2020,2,2019-08-17,Aston Villa,Bournemouth,1,2,A,0,3,2,2,1,2,1,2,15,8,0,1,7,1,August,-0.8660254037844384,-0.5000000000000004,1,7,1,0,1,1.0,1.0,1,3,-2,1,1,0,"August, 2019"
2019-2020,2,2019-08-17,Arsenal,Burnley,2,1,H,3,0,2,1,2,2,2,1,7,5,3,3,2,0,August,-0.8660254037844384,-0.5000000000000004,0,11,5,0,0,2.8,0.6,1,0,1,3,0,3,"August, 2019"
2019-2020,2,2019-08-17,Brighton,West Ham,1,1,D,1,1,1,2,2,2,2,1,6,20,3,0,14,3,August,-0.8660254037844384,-0.5000000000000004,10,45,3,1,0,2.25,0.75,3,0,3,0,5,-5,"August, 2019"
2019-2020,2,2019-08-18,Sheffield United,Crystal Palace,1,0,H,3,0,2,0,3,0,1,4,11,12,1,1,1,0,August,-0.8660254037844384,-0.5000000000000004,36,16,0,0,0,0.0,0.0,1,1,0,0,0,0,"August, 2019"
2019-2020,2,2019-08-18,Chelsea,Leicester,1,1,D,1,1,3,0,2,1,1,3,19,12,0,1,7,1,August,-0.8660254037844384,-0.5000000000000004,14,24,2,2,1,1.0,0.4,0,4,-4,0,0,0,"August, 2019"
2019-2020,2,2019-08-19,Wolves,Man United,1,1,D,1,1,2,1,2,3,2,0,13,9,1,3,4,2,August,-0.8660254037844384,-0.5000000000000004,48,28,2,1,2,1.2,2.4,0,0,0,4,0,4,"August, 2019"
2019-2020,3,2019-08-23,Aston Villa,Everton,2,0,H,3,0,2,2,1,1,2,2,17,9,0,4,8,4,August,-0.8660254037844384,-0.5000000000000004,1,18,1,0,4,1.0,2.8,2,5,-3,1,0,1,"August, 2019"
2019-2020,3,2019-08-24,Liverpool,Arsenal,3,1,H,3,0,3,1,1,2,1,2,1,2,6,6,1,0,August,-0.8660254037844384,-0.5000000000000004,25,0,3,2,0,3.2,1.2,6,2,4,3,1,2,"August, 2019"
2019-2020,3,2019-08-24,Sheffield United,Leicester,1,2,A,0,3,2,0,3,1,1,3,8,16,4,2,8,2,August,-0.8660254037844384,-0.5000000000000004,36,24,0,0,0,0.0,0.0,2,1,1,1,1,0,"August, 2019"
2019-2020,3,2019-08-24,Watford,West Ham,1,3,A,0,3,2,0,3,2,2,1,20,18,0,1,2,1,August,-0.8660254037844384,-0.5000000000000004,43,45,2,1,2,1.2,1.4,0,4,-4,1,6,-5,"August, 2019"
2019-2020,3,2019-08-24,Brighton,Southampton,0,2,A,0,3,1,2,2,2,3,0,5,19,4,0,14,4,August,-0.8660254037844384,-0.5000000000000004,10,38,0,3,1,1.0,1.25,4,1,3,1,5,-4,"August, 2019"
2019-2020,3,2019-08-24,Norwich,Chelsea,2,3,A,0,3,0,0,5,3,0,2,12,16,3,1,4,2,August,-0.8660254037844384,-0.5000000000000004,31,14,0,1,4,0.4,1.4,4,5,-1,1,5,-4,"August, 2019"
2019-2020,3,2019-08-24,Man United,Crystal Palace,1,2,A,0,3,3,2,0,0,1,4,4,17,4,1,13,3,August,-0.8660254037844384,-0.5000000000000004,28,16,4,1,0,2.4,0.6,5,1,4,0,1,-1,"August, 2019"
2019-2020,3,2019-08-25,Bournemouth,Man City,1,3,A,0,3,2,1,2,5,0,0,8,4,4,4,4,0,August,-0.8660254037844384,-0.5000000000000004,7,27,0,0,5,0.4,2.4,3,2,1,7,2,5,"August, 2019"
2019-2020,3,2019-08-25,Tottenham,Newcastle,0,1,A,0,3,3,2,0,0,1,4,6,19,4,0,13,4,August,-0.8660254037844384,-0.5000000000000004,42,30,4,0,1,1.4,1.2,5,3,2,1,4,-3,"August, 2019"
2019-2020,3,2019-08-25,Wolves,Burnley,1,1,D,1,1,2,1,2,2,2,1,19,14,2,3,5,1,August,-0.8660254037844384,-0.5000000000000004,48,11,3,0,1,1.25,0.75,1,1,0,4,2,2,"August, 2019"
2019-2020,4,2019-08-31,Burnley,Liverpool,0,3,A,0,3,2,2,1,3,1,1,10,2,4,9,8,5,August,-0.8660254037844384,-0.5000000000000004,11,25,0,1,4,1.2,2.4,5,3,2,9,3,6,"August, 2019"
2019-2020,4,2019-08-31,West Ham,Norwich,2,0,H,3,0,2,2,1,0,0,5,16,18,4,3,2,1,August,-0.8660254037844384,-0.5000000000000004,45,31,2,2,1,1.8,1.6,4,7,-3,6,8,-2,"August, 2019"
2019-2020,4,2019-08-31,Man City,Brighton,4,0,H,3,0,5,0,0,1,2,2,3,11,7,4,8,3,August,-0.8660254037844384,-0.5000000000000004,27,10,4,0,0,2.75,0.5,10,3,7,4,3,1,"August, 2019"
2019-2020,4,2019-08-31,Newcastle,Watford,1,1,D,1,1,0,1,4,2,0,3,19,20,3,0,1,3,August,-0.8660254037844384,-0.5000000000000004,30,43,1,1,3,0.8,1.6,2,4,-2,1,7,-6,"August, 2019"
2019-2020,4,2019-08-31,Crystal Palace,Aston Villa,1,0,H,3,0,0,1,4,2,2,1,11,17,4,3,6,1,August,-0.8660254037844384,-0.5000000000000004,16,1,2,1,2,0.6,0.6,2,2,0,4,5,-1,"August, 2019"
2019-2020,4,2019-08-31,Chelsea,Sheffield United,2,2,D,1,1,3,0,2,2,0,3,14,9,4,4,5,0,August,-0.8660254037844384,-0.5000000000000004,14,36,2,0,0,2.5,0.0,4,7,-3,3,3,0,"August, 2019"
2019-2020,4,2019-08-31,Southampton,Man United,1,1,D,1,1,2,3,0,3,2,0,18,5,3,4,13,1,August,-0.8660254037844384,-0.5000000000000004,38,28,0,3,2,0.8,1.2,3,5,-2,6,3,3,"August, 2019"
2019-2020,4,2019-08-31,Leicester,Bournemouth,3,1,H,3,0,1,1,3,2,1,2,6,12,5,4,6,1,August,-0.8660254037844384,-0.5000000000000004,24,7,1,3,1,1.2,1.2,3,2,1,4,5,-1,"August, 2019"
2019-2020,4,2019-09-01,Everton,Wolves,3,2,H,3,0,1,2,2,2,1,2,12,17,4,3,5,1,September,-1.0,-1.8369701987210287e-16,18,48,2,2,1,1.6,1.2,1,2,-1,2,2,0,"September, 2019"
2019-2020,4,2019-09-01,Arsenal,Tottenham,2,2,D,1,1,2,1,2,3,2,0,7,11,6,4,4,2,September,-1.0,-1.8369701987210287e-16,0,42,2,1,2,1.4,1.2,4,4,0,5,4,1,"September, 2019"
2019-2020,5,2019-09-14,Wolves,Chelsea,2,5,A,0,3,2,1,2,3,0,2,17,13,3,5,4,2,September,-1.0,-1.8369701987210287e-16,48,14,2,1,2,1.0,1.4,4,5,-1,6,9,-3,"September, 2019"
2019-2020,5,2019-09-14,Liverpool,Newcastle,3,1,H,3,0,3,1,1,0,1,4,1,14,12,4,13,8,September,-1.0,-1.8369701987210287e-16,25,30,3,2,0,2.4,1.0,12,3,9,3,5,-2,"September, 2019"
2019-2020,5,2019-09-14,Brighton,Burnley,1,1,D,1,1,1,2,2,2,2,1,15,12,4,4,3,0,September,-1.0,-1.8369701987210287e-16,10,11,0,2,2,0.25,1.0,4,7,-3,5,6,-1,"September, 2019"
2019-2020,5,2019-09-14,Man United,Leicester,1,0,H,3,0,3,2,0,1,1,3,8,3,5,8,5,3,September,-1.0,-1.8369701987210287e-16,28,24,4,1,0,2.0,0.6,7,4,3,6,3,3,"September, 2019"
2019-2020,5,2019-09-14,Sheffield United,Southampton,0,1,A,0,3,2,0,3,2,3,0,10,14,5,4,4,1,September,-1.0,-1.8369701987210287e-16,36,38,0,0,0,0.0,0.0,5,5,0,4,6,-2,"September, 2019"
2019-2020,5,2019-09-14,Tottenham,Crystal Palace,4,0,H,3,0,3,2,0,0,1,4,10,5,5,7,5,2,September,-1.0,-1.8369701987210287e-16,42,16,5,0,0,1.2,0.0,7,6,1,3,2,1,"September, 2019"
2019-2020,5,2019-09-14,Norwich,Man City,3,2,H,3,0,0,0,5,5,0,0,18,2,3,10,16,7,September,-1.0,-1.8369701987210287e-16,31,27,1,2,2,0.8,2.2,6,10,-4,14,3,11,"September, 2019"
2019-2020,5,2019-09-15,Bournemouth,Everton,3,1,H,3,0,2,1,2,1,2,2,16,8,4,7,8,3,September,-1.0,-1.8369701987210287e-16,7,18,1,1,3,1.6,2.6,5,8,-3,4,4,0,"September, 2019"
2019-2020,5,2019-09-15,Watford,Arsenal,2,2,D,1,1,2,0,3,2,1,2,20,7,1,7,13,6,September,-1.0,-1.8369701987210287e-16,43,0,2,0,3,0.8,1.6,2,8,-6,6,6,0,"September, 2019"
2019-2020,5,2019-09-16,Aston Villa,West Ham,0,0,D,1,1,2,2,1,2,2,1,18,9,3,7,9,4,September,-1.0,-1.8369701987210287e-16,1,45,1,2,2,0.4,1.0,4,6,-2,6,7,-1,"September, 2019"
2019-2020,6,2019-09-20,Southampton,Bournemouth,1,3,A,0,3,2,3,0,2,1,2,10,9,7,7,1,0,September,-1.0,-1.8369701987210287e-16,38,7,1,4,0,1.2,1.0,5,6,-1,8,9,-1,"September, 2019"
2019-2020,6,2019-09-21,Leicester,Tottenham,2,1,H,3,0,1,1,3,3,2,0,6,4,8,8,2,0,September,-1.0,-1.8369701987210287e-16,24,42,1,0,4,1.6,3.4,6,4,2,11,6,5,"September, 2019"
2019-2020,6,2019-09-21,Burnley,Norwich,2,0,H,3,0,2,2,1,0,0,5,14,13,5,6,1,1,September,-1.0,-1.8369701987210287e-16,11,31,0,0,0,0.0,0.0,6,7,-1,9,12,-3,"September, 2019"
2019-2020,6,2019-09-21,Everton,Sheffield United,0,2,A,0,3,1,2,2,2,0,3,11,15,7,5,4,2,September,-1.0,-1.8369701987210287e-16,18,36,1,1,0,1.5,0.5,5,7,-2,5,6,-1,"September, 2019"
2019-2020,6,2019-09-21,Man City,Watford,8,0,H,3,0,5,0,0,2,0,3,3,20,10,2,17,8,September,-1.0,-1.8369701987210287e-16,27,43,5,0,0,3.8,0.6,16,6,10,4,10,-6,"September, 2019"
2019-2020,6,2019-09-21,Newcastle,Brighton,0,0,D,1,1,0,1,4,1,2,2,18,16,4,5,2,1,September,-1.0,-1.8369701987210287e-16,30,10,0,2,2,0.25,0.75,4,8,-4,5,8,-3,"September, 2019"
2019-2020,6,2019-09-22,Crystal Palace,Wolves,1,1,D,1,1,0,1,4,2,1,2,13,19,7,3,6,4,September,-1.0,-1.8369701987210287e-16,16,48,1,0,1,1.0,0.5,3,6,-3,6,10,-4,"September, 2019"
2019-2020,6,2019-09-22,West Ham,Man United,2,0,H,3,0,2,2,1,3,2,0,11,6,8,8,5,0,September,-1.0,-1.8369701987210287e-16,45,28,1,1,3,0.8,1.8,6,7,-1,8,4,4,"September, 2019"
2019-2020,6,2019-09-22,Arsenal,Aston Villa,3,2,H,3,0,2,1,2,2,2,1,11,18,8,4,7,4,September,-1.0,-1.8369701987210287e-16,0,1,5,0,0,3.2,0.2,8,8,0,4,6,-2,"September, 2019"
2019-2020,6,2019-09-22,Chelsea,Liverpool,1,2,A,0,3,3,0,2,3,1,1,11,1,8,15,10,7,September,-1.0,-1.8369701987210287e-16,14,25,1,3,1,0.8,1.0,11,11,0,15,4,11,"September, 2019"
2019-2020,7,2019-09-28,Everton,Man City,1,3,A,0,3,1,2,2,5,0,0,15,2,7,13,13,6,September,-1.0,-1.8369701987210287e-16,18,27,1,1,3,1.4,1.8,5,9,-4,24,6,18,"September, 2019"
2019-2020,7,2019-09-28,Wolves,Watford,2,0,H,3,0,2,1,2,2,0,3,19,20,4,2,1,2,September,-1.0,-1.8369701987210287e-16,48,43,1,0,1,1.0,1.5,7,11,-4,4,18,-14,"September, 2019"
2019-2020,7,2019-09-28,Tottenham,Southampton,2,1,H,3,0,3,2,0,2,3,0,10,13,8,7,3,1,September,-1.0,-1.8369701987210287e-16,42,38,3,1,1,2.4,1.4,12,8,4,6,9,-3,"September, 2019"
2019-2020,7,2019-09-28,Crystal Palace,Norwich,2,0,H,3,0,0,1,4,0,0,5,12,15,8,6,3,2,September,-1.0,-1.8369701987210287e-16,16,31,2,2,1,1.6,1.2,4,7,-3,9,14,-5,"September, 2019"
2019-2020,7,2019-09-28,Aston Villa,Burnley,2,2,D,1,1,2,2,1,2,2,1,18,9,4,8,9,4,September,-1.0,-1.8369701987210287e-16,1,11,1,2,1,1.75,1.25,6,9,-3,8,7,1,"September, 2019"
2019-2020,7,2019-09-28,Bournemouth,West Ham,2,2,D,1,1,2,1,2,2,2,1,6,5,10,11,1,1,September,-1.0,-1.8369701987210287e-16,7,45,3,2,0,2.2,1.4,11,10,1,8,7,1,"September, 2019"
2019-2020,7,2019-09-28,Sheffield United,Liverpool,0,1,A,0,3,2,0,3,3,1,1,10,1,8,18,9,10,September,-1.0,-1.8369701987210287e-16,36,25,0,1,1,0.5,2.5,7,6,1,17,5,12,"September, 2019"
2019-2020,7,2019-09-28,Chelsea,Brighton,2,0,H,3,0,3,0,2,1,2,2,11,15,8,6,4,2,September,-1.0,-1.8369701987210287e-16,14,10,4,0,0,2.75,0.25,12,13,-1,5,8,-3,"September, 2019"
2019-2020,7,2019-09-29,Leicester,Newcastle,5,0,H,3,0,1,1,3,0,1,4,5,19,11,5,14,6,September,-1.0,-1.8369701987210287e-16,24,30,3,0,2,1.4,1.0,8,5,3,4,8,-4,"September, 2019"
2019-2020,7,2019-09-30,Man United,Arsenal,1,1,D,1,1,3,2,0,2,1,2,11,8,8,11,3,3,September,-1.0,-1.8369701987210287e-16,28,0,2,1,2,1.4,1.6,8,6,2,11,10,1,"September, 2019"
2019-2020,8,2019-10-05,Watford,Sheffield United,0,0,D,1,1,2,0,3,2,0,3,20,14,2,8,6,6,October,-0.8660254037844386,0.5,43,36,0,0,2,0.0,1.0,4,20,-16,7,7,0,"October, 2019"
2019-2020,8,2019-10-05,West Ham,Crystal Palace,1,2,A,0,3,2,2,1,0,1,4,6,10,12,11,4,1,October,-0.8660254037844386,0.5,45,16,2,3,0,2.0,1.2,10,9,1,6,7,-1,"October, 2019"
2019-2020,8,2019-10-05,Norwich,Aston Villa,1,5,A,0,3,0,0,5,2,2,1,17,18,6,5,1,1,October,-0.8660254037844386,0.5,31,1,1,0,4,0.8,1.8,9,16,-7,8,11,-3,"October, 2019"
2019-2020,8,2019-10-05,Burnley,Everton,1,0,H,3,0,2,2,1,1,2,2,11,16,9,7,5,2,October,-0.8660254037844386,0.5,11,18,2,0,3,1.0,2.2,10,9,1,6,12,-6,"October, 2019"
2019-2020,8,2019-10-05,Brighton,Tottenham,3,0,H,3,0,1,2,2,3,2,0,16,6,6,11,10,5,October,-0.8660254037844386,0.5,10,42,0,1,3,0.5,1.5,5,10,-5,14,9,5,"October, 2019"
2019-2020,8,2019-10-05,Liverpool,Leicester,2,1,H,3,0,3,1,1,1,1,3,1,3,21,14,2,7,October,-0.8660254037844386,0.5,25,24,3,1,1,1.8,1.6,18,5,13,13,5,8,"October, 2019"
2019-2020,8,2019-10-06,Arsenal,Bournemouth,1,0,H,3,0,2,1,2,2,1,2,6,10,12,11,4,1,October,-0.8660254037844386,0.5,0,7,3,1,1,2.8,1.4,12,11,1,13,12,1,"October, 2019"
2019-2020,8,2019-10-06,Man City,Wolves,0,2,A,0,3,5,0,0,2,1,2,2,15,16,7,13,9,October,-0.8660254037844386,0.5,27,48,4,1,0,2.6,1.0,27,7,20,9,11,-2,"October, 2019"
2019-2020,8,2019-10-06,Southampton,Chelsea,1,4,A,0,3,2,3,0,3,0,2,16,9,7,11,7,4,October,-0.8660254037844386,0.5,38,14,0,1,4,0.8,2.2,7,11,-4,14,13,1,"October, 2019"
2019-2020,8,2019-10-06,Newcastle,Man United,1,0,H,3,0,0,1,4,3,2,0,19,12,5,9,7,4,October,-0.8660254037844386,0.5,30,28,1,1,3,1.4,2.4,4,13,-9,9,7,2,"October, 2019"
2019-2020,9,2019-10-19,Chelsea,Newcastle,1,0,H,3,0,3,0,2,0,1,4,5,17,14,8,12,6,October,-0.8660254037844386,0.5,14,30,4,0,1,2.4,1.4,18,14,4,5,13,-8,"October, 2019"
2019-2020,9,2019-10-19,Crystal Palace,Man City,0,2,A,0,3,0,1,4,5,0,0,6,4,14,16,2,2,October,-0.8660254037844386,0.5,16,27,1,1,3,0.8,3.0,8,8,0,27,9,18,"October, 2019"
2019-2020,9,2019-10-19,Wolves,Southampton,1,1,D,1,1,2,1,2,2,3,0,12,18,10,7,6,3,October,-0.8660254037844386,0.5,48,38,1,0,3,1.0,2.25,11,11,0,8,15,-7,"October, 2019"
2019-2020,9,2019-10-19,Tottenham,Watford,1,1,D,1,1,3,2,0,2,0,3,11,20,11,3,9,8,October,-0.8660254037844386,0.5,42,43,3,1,1,2.0,0.8,14,12,2,4,20,-16,"October, 2019"
2019-2020,9,2019-10-19,Bournemouth,Norwich,0,0,D,1,1,2,1,2,0,0,5,11,19,11,6,8,5,October,-0.8660254037844386,0.5,7,31,1,0,1,2.0,1.5,13,13,0,10,21,-11,"October, 2019"
2019-2020,9,2019-10-19,Aston Villa,Brighton,2,1,H,3,0,2,2,1,1,2,2,16,15,8,9,1,1,October,-0.8660254037844386,0.5,1,10,0,0,0,0.0,0.0,13,12,1,8,10,-2,"October, 2019"
2019-2020,9,2019-10-19,Everton,West Ham,2,0,H,3,0,1,2,2,2,2,1,18,8,7,12,10,5,October,-0.8660254037844386,0.5,18,45,2,1,2,1.6,1.2,6,13,-7,11,11,0,"October, 2019"
2019-2020,9,2019-10-19,Leicester,Burnley,2,1,H,3,0,1,1,3,2,2,1,5,7,14,12,2,2,October,-0.8660254037844386,0.5,24,11,2,1,2,0.8,0.8,14,7,7,11,9,2,"October, 2019"
2019-2020,9,2019-10-20,Man United,Liverpool,1,1,D,1,1,3,2,0,3,1,1,14,1,9,24,13,15,October,-0.8660254037844386,0.5,28,25,1,3,1,0.8,1.0,9,8,1,20,6,14,"October, 2019"
2019-2020,9,2019-10-21,Sheffield United,Arsenal,1,0,H,3,0,2,0,3,2,1,2,15,5,9,15,10,6,October,-0.8660254037844386,0.5,36,0,1,0,1,0.5,1.5,7,7,0,13,11,2,"October, 2019"
2019-2020,10,2019-10-25,Southampton,Leicester,0,9,A,0,3,2,3,0,1,1,3,17,3,8,17,14,9,October,-0.8660254037844386,0.5,38,24,2,1,2,1.4,1.4,9,16,-7,16,8,8,"October, 2019"
2019-2020,10,2019-10-26,Burnley,Chelsea,2,4,A,0,3,2,2,1,3,0,2,11,4,12,17,7,5,October,-0.8660254037844386,0.5,11,14,1,2,2,1.4,2.2,12,11,1,19,14,5,"October, 2019"
2019-2020,10,2019-10-26,West Ham,Sheffield United,1,1,D,1,1,2,2,1,2,0,3,12,10,12,12,2,0,October,-0.8660254037844386,0.5,45,36,1,0,1,0.5,1.5,11,13,-2,8,7,1,"October, 2019"
2019-2020,10,2019-10-26,Man City,Aston Villa,3,0,H,3,0,5,0,0,2,2,1,3,12,19,11,9,8,October,-0.8660254037844386,0.5,27,1,4,1,0,2.6,0.4,29,9,20,15,13,2,"October, 2019"
2019-2020,10,2019-10-26,Brighton,Everton,3,2,H,3,0,1,2,2,1,2,2,16,15,9,10,1,1,October,-0.8660254037844386,0.5,10,18,1,1,2,0.75,1.5,9,12,-3,8,13,-5,"October, 2019"
2019-2020,10,2019-10-26,Watford,Bournemouth,0,0,D,1,1,2,0,3,2,1,2,20,10,4,12,10,8,October,-0.8660254037844386,0.5,43,7,1,3,1,1.8,2.2,5,21,-16,13,13,0,"October, 2019"
2019-2020,10,2019-10-27,Newcastle,Wolves,1,1,D,1,1,0,1,4,2,1,2,17,13,8,11,4,3,October,-0.8660254037844386,0.5,30,48,2,2,1,2.0,1.4,5,14,-9,12,12,0,"October, 2019"
2019-2020,10,2019-10-27,Arsenal,Crystal Palace,2,2,D,1,1,2,1,2,0,1,4,5,6,15,14,1,1,October,-0.8660254037844386,0.5,0,16,2,1,2,2.2,2.2,13,12,1,8,10,-2,"October, 2019"
2019-2020,10,2019-10-27,Liverpool,Tottenham,2,1,H,3,0,3,1,1,3,2,0,1,10,25,12,9,13,October,-0.8660254037844386,0.5,25,42,3,1,1,1.8,1.6,21,7,14,15,13,2,"October, 2019"
2019-2020,10,2019-10-27,Norwich,Man United,1,3,A,0,3,0,0,5,3,2,0,19,15,7,10,4,3,October,-0.8660254037844386,0.5,31,28,1,0,4,0.4,2.2,10,21,-11,10,9,1,"October, 2019"
2019-2020,11,2019-11-02,Watford,Chelsea,1,2,A,0,3,2,0,3,3,0,2,20,4,5,20,16,15,November,-0.5000000000000004,0.8660254037844384,43,14,1,0,4,2.0,2.8,5,21,-16,23,16,7,"November, 2019"
2019-2020,11,2019-11-02,West Ham,Newcastle,2,3,A,0,3,2,2,1,0,1,4,12,17,13,9,5,4,November,-0.5000000000000004,0.8660254037844384,45,30,2,0,3,1.6,1.6,12,14,-2,6,15,-9,"November, 2019"
2019-2020,11,2019-11-02,Sheffield United,Burnley,3,0,H,3,0,2,0,3,2,2,1,10,14,13,12,4,1,November,-0.5000000000000004,0.8660254037844384,36,11,0,0,0,0.0,0.0,9,8,1,14,15,-1,"November, 2019"
2019-2020,11,2019-11-02,Man City,Southampton,2,1,H,3,0,5,0,0,2,3,0,2,18,22,8,16,14,November,-0.5000000000000004,0.8660254037844384,27,38,5,0,0,3.0,0.6,32,9,23,9,25,-16,"November, 2019"
2019-2020,11,2019-11-02,Brighton,Norwich,2,0,H,3,0,1,2,2,0,0,5,14,19,12,7,5,5,November,-0.5000000000000004,0.8660254037844384,10,31,0,0,0,0.0,0.0,12,14,-2,11,24,-13,"November, 2019"
2019-2020,11,2019-11-02,Arsenal,Wolves,1,1,D,1,1,2,1,2,2,1,2,5,12,16,12,7,4,November,-0.5000000000000004,0.8660254037844384,0,48,2,2,1,1.6,1.0,15,14,1,13,13,0,"November, 2019"
2019-2020,11,2019-11-02,Bournemouth,Man United,1,0,H,3,0,2,1,2,3,2,0,9,7,13,13,2,0,November,-0.5000000000000004,0.8660254037844384,7,28,0,1,4,0.6,2.0,13,13,0,13,10,3,"November, 2019"
2019-2020,11,2019-11-02,Aston Villa,Liverpool,1,2,A,0,3,2,2,1,3,1,1,15,1,11,28,14,17,November,-0.5000000000000004,0.8660254037844384,1,25,1,1,3,1.0,2.6,15,16,-1,23,8,15,"November, 2019"
2019-2020,11,2019-11-03,Crystal Palace,Leicester,0,2,A,0,3,0,1,4,1,1,3,9,4,15,20,5,5,November,-0.5000000000000004,0.8660254037844384,16,24,4,1,0,3.0,0.6,10,12,-2,25,8,17,"November, 2019"
2019-2020,11,2019-11-03,Everton,Tottenham,1,1,D,1,1,1,2,2,3,2,0,17,13,10,12,4,2,November,-0.5000000000000004,0.8660254037844384,18,42,0,1,4,1.2,3.6,10,16,-6,16,15,1,"November, 2019"
2019-2020,12,2019-11-08,Norwich,Watford,0,2,A,0,3,0,0,5,2,0,3,19,20,7,5,1,2,November,-0.5000000000000004,0.8660254037844384,31,43,1,0,1,2.0,2.0,11,26,-15,6,23,-17,"November, 2019"
2019-2020,12,2019-11-09,Leicester,Arsenal,2,0,H,3,0,1,1,3,2,1,2,4,6,23,17,2,6,November,-0.5000000000000004,0.8660254037844384,24,0,2,0,3,2.0,1.8,27,8,19,16,15,1,"November, 2019"
2019-2020,12,2019-11-09,Tottenham,Sheffield United,1,1,D,1,1,3,2,0,2,0,3,14,6,13,16,8,3,November,-0.5000000000000004,0.8660254037844384,42,36,1,0,1,1.5,1.0,17,16,1,12,8,4,"November, 2019"
2019-2020,12,2019-11-09,Southampton,Everton,1,2,A,0,3,2,3,0,1,2,2,19,17,8,11,2,3,November,-0.5000000000000004,0.8660254037844384,38,18,2,1,2,1.6,1.6,10,27,-17,11,17,-6,"November, 2019"
2019-2020,12,2019-11-09,Burnley,West Ham,3,0,H,3,0,2,2,1,2,2,1,14,13,12,13,1,1,November,-0.5000000000000004,0.8660254037844384,11,45,2,1,2,1.8,1.4,14,18,-4,14,17,-3,"November, 2019"
2019-2020,12,2019-11-09,Chelsea,Crystal Palace,2,0,H,3,0,3,0,2,0,1,4,4,9,23,15,5,8,November,-0.5000000000000004,0.8660254037844384,14,16,3,0,2,1.6,1.2,25,17,8,10,14,-4,"November, 2019"
2019-2020,12,2019-11-09,Newcastle,Bournemouth,2,1,H,3,0,0,1,4,2,1,2,15,7,12,16,8,4,November,-0.5000000000000004,0.8660254037844384,30,7,1,2,2,1.4,1.8,9,17,-8,14,13,1,"November, 2019"
2019-2020,12,2019-11-10,Man United,Brighton,3,1,H,3,0,3,2,0,1,2,2,14,8,13,15,6,2,November,-0.5000000000000004,0.8660254037844384,28,10,2,0,2,1.25,1.25,13,11,2,14,14,0,"November, 2019"
2019-2020,12,2019-11-10,Wolves,Aston Villa,2,1,H,3,0,2,1,2,2,2,1,15,17,13,11,2,2,November,-0.5000000000000004,0.8660254037844384,48,1,1,2,2,1.2,1.4,14,14,0,16,18,-2,"November, 2019"
2019-2020,12,2019-11-10,Liverpool,Man City,3,1,H,3,0,3,1,1,5,0,0,1,4,31,25,3,6,November,-0.5000000000000004,0.8660254037844384,25,27,1,2,2,1.2,2.2,25,9,16,34,10,24,"November, 2019"
2019-2020,13,2019-11-23,Man City,Chelsea,2,1,H,3,0,5,0,0,3,0,2,4,3,25,26,1,1,November,-0.5000000000000004,0.8660254037844384,27,14,3,0,2,1.8,0.8,35,13,22,27,17,10,"November, 2019"
2019-2020,13,2019-11-23,Watford,Burnley,0,3,A,0,3,2,0,3,2,2,1,20,11,8,15,9,7,November,-0.5000000000000004,0.8660254037844384,43,11,2,1,2,1.2,1.0,8,23,-15,17,18,-1,"November, 2019"
2019-2020,13,2019-11-23,Everton,Norwich,0,2,A,0,3,1,2,2,0,0,5,15,20,14,7,5,7,November,-0.5000000000000004,0.8660254037844384,18,31,2,2,1,1.8,1.0,13,18,-5,11,28,-17,"November, 2019"
2019-2020,13,2019-11-23,Crystal Palace,Liverpool,1,2,A,0,3,0,1,4,3,1,1,13,1,15,34,12,19,November,-0.5000000000000004,0.8660254037844384,16,25,1,0,4,1.2,2.0,10,16,-6,28,10,18,"November, 2019"
2019-2020,13,2019-11-23,Brighton,Leicester,0,2,A,0,3,1,2,2,1,1,3,12,2,15,26,10,11,November,-0.5000000000000004,0.8660254037844384,10,24,0,1,3,0.5,1.75,15,17,-2,29,8,21,"November, 2019"
2019-2020,13,2019-11-23,Arsenal,Southampton,2,2,D,1,1,2,1,2,2,3,0,7,19,17,8,12,9,November,-0.5000000000000004,0.8660254037844384,0,38,3,1,1,2.0,1.2,16,17,-1,11,29,-18,"November, 2019"
2019-2020,13,2019-11-23,West Ham,Tottenham,2,3,A,0,3,2,2,1,3,2,0,16,14,13,14,2,1,November,-0.5000000000000004,0.8660254037844384,45,42,2,1,2,1.0,1.0,14,20,-6,18,17,1,"November, 2019"
2019-2020,13,2019-11-23,Bournemouth,Wolves,1,2,A,0,3,2,1,2,2,1,2,10,9,16,16,1,0,November,-0.5000000000000004,0.8660254037844384,7,48,0,1,1,0.5,1.5,15,15,0,16,15,1,"November, 2019"
2019-2020,13,2019-11-24,Sheffield United,Man United,3,3,D,1,1,2,0,3,3,2,0,8,10,17,16,2,1,November,-0.5000000000000004,0.8660254037844384,36,28,0,0,2,0.5,2.0,13,9,4,16,12,4,"November, 2019"
2019-2020,13,2019-11-25,Aston Villa,Newcastle,2,0,H,3,0,2,2,1,0,1,4,17,14,11,15,3,4,November,-0.5000000000000004,0.8660254037844384,1,30,0,3,2,0.2,0.6,17,20,-3,11,18,-7,"November, 2019"
2019-2020,14,2019-11-30,Tottenham,Bournemouth,3,2,H,3,0,3,2,0,2,1,2,11,12,17,16,1,1,November,-0.5000000000000004,0.8660254037844384,42,7,4,0,1,2.8,0.4,21,19,2,16,17,-1,"November, 2019"
2019-2020,14,2019-11-30,Liverpool,Brighton,2,1,H,3,0,3,1,1,1,2,2,1,15,37,15,14,22,November,-0.5000000000000004,0.8660254037844384,25,10,4,0,0,2.75,0.25,30,11,19,15,19,-4,"November, 2019"
2019-2020,14,2019-11-30,Southampton,Watford,2,1,H,3,0,2,3,0,2,0,3,19,20,9,8,1,1,November,-0.5000000000000004,0.8660254037844384,38,43,1,3,1,1.6,1.8,13,31,-18,8,26,-18,"November, 2019"
2019-2020,14,2019-11-30,Burnley,Crystal Palace,0,2,A,0,3,2,2,1,0,1,4,7,14,18,15,7,3,November,-0.5000000000000004,0.8660254037844384,11,16,2,0,3,0.8,1.2,20,18,2,11,18,-7,"November, 2019"
2019-2020,14,2019-11-30,Newcastle,Man City,2,2,D,1,1,0,1,4,5,0,0,14,3,15,28,11,13,November,-0.5000000000000004,0.8660254037844384,30,27,1,1,3,1.0,1.6,11,20,-9,37,14,23,"November, 2019"
2019-2020,14,2019-11-30,Chelsea,West Ham,0,1,A,0,3,3,0,2,2,2,1,4,17,26,13,13,13,November,-0.5000000000000004,0.8660254037844384,14,45,2,2,1,1.0,0.6,28,19,9,16,23,-7,"November, 2019"
2019-2020,14,2019-12-01,Leicester,Everton,2,1,H,3,0,1,1,3,1,2,2,3,17,29,14,14,15,December,-2.4492935982947064e-16,1.0,24,18,2,0,3,1.4,1.6,31,8,23,13,20,-7,"December, 2019"
2019-2020,14,2019-12-01,Man United,Aston Villa,2,2,D,1,1,3,2,0,2,2,1,11,16,17,14,5,3,December,-2.4492935982947064e-16,1.0,28,1,4,1,0,2.0,0.6,19,15,4,19,20,-1,"December, 2019"
2019-2020,14,2019-12-01,Norwich,Arsenal,2,2,D,1,1,0,0,5,2,1,2,19,9,10,18,10,8,December,-2.4492935982947064e-16,1.0,31,0,0,1,4,0.6,2.2,13,28,-15,18,19,-1,"December, 2019"
2019-2020,14,2019-12-01,Wolves,Sheffield United,1,1,D,1,1,2,1,2,2,0,3,6,8,19,18,2,1,December,-2.4492935982947064e-16,1.0,48,36,0,0,0,0.0,0.0,18,16,2,16,12,4,"December, 2019"
2019-2020,15,2019-12-03,Burnley,Man City,1,4,A,0,3,2,2,1,5,0,0,11,3,18,29,8,11,December,-2.4492935982947064e-16,1.0,11,27,0,1,4,0.4,2.4,20,20,0,39,16,23,"December, 2019"
2019-2020,15,2019-12-03,Crystal Palace,Bournemouth,1,0,H,3,0,0,1,4,2,1,2,11,12,18,16,1,2,December,-2.4492935982947064e-16,1.0,16,7,2,2,1,2.4,1.8,13,18,-5,18,20,-2,"December, 2019"
2019-2020,15,2019-12-04,Chelsea,Aston Villa,2,1,H,3,0,3,0,2,2,2,1,4,15,26,15,11,11,December,-2.4492935982947064e-16,1.0,14,1,4,0,1,2.2,0.4,28,20,8,21,22,-1,"December, 2019"
2019-2020,15,2019-12-04,Leicester,Watford,2,0,H,3,0,1,1,3,2,0,3,3,20,32,8,17,24,December,-2.4492935982947064e-16,1.0,24,43,3,0,2,1.8,0.8,33,9,24,9,28,-19,"December, 2019"
2019-2020,15,2019-12-04,Man United,Tottenham,2,1,H,3,0,3,2,0,3,2,0,10,6,18,20,4,2,December,-2.4492935982947064e-16,1.0,28,42,2,0,3,0.6,1.4,21,17,4,24,21,3,"December, 2019"
2019-2020,15,2019-12-04,Southampton,Norwich,2,1,H,3,0,2,3,0,0,0,5,18,19,12,11,1,1,December,-2.4492935982947064e-16,1.0,38,31,2,1,2,1.4,0.8,15,32,-17,15,30,-15,"December, 2019"
2019-2020,15,2019-12-04,Wolves,West Ham,2,0,H,3,0,2,1,2,2,2,1,8,13,20,16,5,4,December,-2.4492935982947064e-16,1.0,48,45,3,1,1,1.6,0.8,19,17,2,17,23,-6,"December, 2019"
2019-2020,15,2019-12-04,Liverpool,Everton,5,2,H,3,0,3,1,1,1,2,2,1,18,40,14,17,26,December,-2.4492935982947064e-16,1.0,25,18,2,3,0,1.0,0.4,32,12,20,14,22,-8,"December, 2019"
2019-2020,15,2019-12-05,Sheffield United,Newcastle,0,2,A,0,3,2,0,3,0,1,4,9,14,19,16,5,3,December,-2.4492935982947064e-16,1.0,36,30,1,0,1,1.0,1.0,17,13,4,13,22,-9,"December, 2019"
2019-2020,15,2019-12-05,Arsenal,Brighton,1,2,A,0,3,2,1,2,1,2,2,10,16,19,15,6,4,December,-2.4492935982947064e-16,1.0,0,10,1,2,1,1.25,1.0,20,21,-1,16,21,-5,"December, 2019"
2019-2020,16,2019-12-07,Man City,Man United,1,2,A,0,3,5,0,0,3,2,0,3,8,32,21,5,11,December,-2.4492935982947064e-16,1.0,27,28,3,1,1,1.8,1.0,43,17,26,23,18,5,"December, 2019"
2019-2020,16,2019-12-07,Watford,Crystal Palace,0,0,D,1,1,2,0,3,0,1,4,20,8,8,21,12,13,December,-2.4492935982947064e-16,1.0,43,16,2,1,2,1.0,1.0,9,30,-21,14,18,-4,"December, 2019"
2019-2020,16,2019-12-07,Tottenham,Burnley,5,0,H,3,0,3,2,0,2,2,1,8,12,20,18,4,2,December,-2.4492935982947064e-16,1.0,42,11,3,1,1,1.6,0.6,25,23,2,21,24,-3,"December, 2019"
2019-2020,16,2019-12-07,Bournemouth,Liverpool,0,3,A,0,3,2,1,2,3,1,1,15,1,16,43,14,27,December,-2.4492935982947064e-16,1.0,7,25,0,1,4,0.4,3.2,18,21,-3,37,14,23,"December, 2019"
2019-2020,16,2019-12-07,Everton,Chelsea,3,1,H,3,0,1,2,2,3,0,2,18,4,14,29,14,15,December,-2.4492935982947064e-16,1.0,18,14,1,2,2,0.4,1.0,16,27,-11,30,21,9,"December, 2019"
2019-2020,16,2019-12-08,Aston Villa,Leicester,1,4,A,0,3,2,2,1,1,1,3,17,2,15,35,15,20,December,-2.4492935982947064e-16,1.0,1,24,2,1,2,2.0,1.2,22,24,-2,35,9,26,"December, 2019"
2019-2020,16,2019-12-08,Newcastle,Southampton,2,1,H,3,0,0,1,4,2,3,0,11,18,19,15,7,4,December,-2.4492935982947064e-16,1.0,30,38,2,2,1,1.8,1.2,15,22,-7,17,33,-16,"December, 2019"
2019-2020,16,2019-12-08,Norwich,Sheffield United,1,2,A,0,3,0,0,5,2,0,3,19,10,11,19,9,8,December,-2.4492935982947064e-16,1.0,31,36,0,0,0,0.0,0.0,16,32,-16,17,15,2,"December, 2019"
2019-2020,16,2019-12-08,Brighton,Wolves,2,2,D,1,1,1,2,2,2,1,2,12,7,18,23,5,5,December,-2.4492935982947064e-16,1.0,10,48,1,1,0,0.5,0.0,18,22,-4,21,17,4,"December, 2019"
2019-2020,16,2019-12-09,West Ham,Arsenal,1,3,A,0,3,2,2,1,2,1,2,16,11,16,19,5,3,December,-2.4492935982947064e-16,1.0,45,0,1,1,3,0.6,2.0,17,25,-8,21,23,-2,"December, 2019"
2019-2020,17,2019-12-14,Southampton,West Ham,0,1,A,0,3,2,3,0,2,2,1,18,16,15,16,2,1,December,-2.4492935982947064e-16,1.0,38,45,1,0,4,1.0,2.6,18,35,-17,18,28,-10,"December, 2019"
2019-2020,17,2019-12-14,Sheffield United,Aston Villa,2,0,H,3,0,2,0,3,2,2,1,8,17,22,15,9,7,December,-2.4492935982947064e-16,1.0,36,1,0,1,1,1.0,2.5,19,16,3,23,28,-5,"December, 2019"
2019-2020,17,2019-12-14,Leicester,Norwich,1,1,D,1,1,1,1,3,0,0,5,2,19,38,11,17,27,December,-2.4492935982947064e-16,1.0,24,31,2,0,0,1.5,0.5,39,10,29,17,34,-17,"December, 2019"
2019-2020,17,2019-12-14,Chelsea,Bournemouth,0,1,A,0,3,3,0,2,2,1,2,4,15,29,16,11,13,December,-2.4492935982947064e-16,1.0,14,7,3,0,2,1.2,1.6,31,24,7,18,24,-6,"December, 2019"
2019-2020,17,2019-12-14,Burnley,Newcastle,1,0,H,3,0,2,2,1,0,1,4,13,11,18,22,2,4,December,-2.4492935982947064e-16,1.0,11,30,1,2,2,1.2,1.6,21,29,-8,17,23,-6,"December, 2019"
2019-2020,17,2019-12-14,Liverpool,Watford,2,0,H,3,0,3,1,1,2,0,3,1,20,46,9,19,37,December,-2.4492935982947064e-16,1.0,25,43,4,1,0,3.4,0.6,40,14,26,9,30,-21,"December, 2019"
2019-2020,17,2019-12-15,Man United,Everton,1,1,D,1,1,3,2,0,1,2,2,6,16,24,17,10,7,December,-2.4492935982947064e-16,1.0,28,18,3,1,1,1.8,1.2,25,19,6,19,28,-9,"December, 2019"
2019-2020,17,2019-12-15,Wolves,Tottenham,1,2,A,0,3,2,1,2,3,2,0,7,8,24,23,1,1,December,-2.4492935982947064e-16,1.0,48,42,1,2,2,1.8,2.0,23,19,4,30,23,7,"December, 2019"
2019-2020,17,2019-12-15,Arsenal,Man City,0,3,A,0,3,2,1,2,5,0,0,9,3,22,32,6,10,December,-2.4492935982947064e-16,1.0,0,27,0,1,4,0.8,2.6,24,24,0,44,19,25,"December, 2019"
2019-2020,17,2019-12-16,Crystal Palace,Brighton,1,1,D,1,1,0,1,4,1,2,2,10,13,22,19,3,3,December,-2.4492935982947064e-16,1.0,16,10,1,1,2,1.25,1.75,14,18,-4,20,24,-4,"December, 2019"
2019-2020,18,2019-12-21,Man City,Leicester,3,1,H,3,0,5,0,0,1,1,3,3,2,35,39,1,4,December,-2.4492935982947064e-16,1.0,27,24,4,0,1,2.2,0.8,47,19,28,40,11,29,"December, 2019"
2019-2020,18,2019-12-21,Norwich,Wolves,1,2,A,0,3,0,0,5,2,1,2,19,9,12,24,10,12,December,-2.4492935982947064e-16,1.0,31,48,1,1,0,2.0,1.5,18,35,-17,24,21,3,"December, 2019"
2019-2020,18,2019-12-21,Newcastle,Crystal Palace,1,0,H,3,0,0,1,4,0,1,4,12,11,22,23,1,1,December,-2.4492935982947064e-16,1.0,30,16,2,2,1,0.6,0.4,17,24,-7,15,19,-4,"December, 2019"
2019-2020,18,2019-12-21,Brighton,Sheffield United,0,1,A,0,3,1,2,2,2,0,3,13,7,20,25,6,5,December,-2.4492935982947064e-16,1.0,10,36,0,0,0,0.0,0.0,21,25,-4,21,16,5,"December, 2019"
2019-2020,18,2019-12-21,Bournemouth,Burnley,0,1,A,0,3,2,1,2,2,2,1,14,12,19,21,2,2,December,-2.4492935982947064e-16,1.0,7,11,2,0,3,1.2,2.2,19,24,-5,22,29,-7,"December, 2019"
2019-2020,18,2019-12-21,Aston Villa,Southampton,1,3,A,0,3,2,2,1,2,3,0,17,18,15,15,1,0,December,-2.4492935982947064e-16,1.0,1,38,0,3,2,1.0,2.4,23,30,-7,18,36,-18,"December, 2019"
2019-2020,18,2019-12-21,Everton,Arsenal,0,0,D,1,1,1,2,2,2,1,2,16,10,18,22,6,4,December,-2.4492935982947064e-16,1.0,18,0,1,0,4,1.0,3.0,20,29,-9,24,27,-3,"December, 2019"
2019-2020,18,2019-12-22,Watford,Man United,2,0,H,3,0,2,0,3,3,2,0,20,8,9,25,12,16,December,-2.4492935982947064e-16,1.0,43,28,0,0,5,0.8,2.2,9,32,-23,26,20,6,"December, 2019"
2019-2020,18,2019-12-22,Tottenham,Chelsea,0,2,A,0,3,3,2,0,3,0,2,7,4,26,29,3,3,December,-2.4492935982947064e-16,1.0,42,14,3,0,2,1.8,1.2,32,24,8,31,25,6,"December, 2019"
2019-2020,19,2019-12-26,Leicester,Liverpool,0,4,A,0,3,1,1,3,3,1,1,2,1,39,49,1,10,December,-2.4492935982947064e-16,1.0,24,25,0,1,4,1.2,2.0,41,14,27,42,14,28,"December, 2019"
2019-2020,19,2019-12-26,Sheffield United,Watford,1,1,D,1,1,2,0,3,2,0,3,6,20,28,12,14,16,December,-2.4492935982947064e-16,1.0,36,43,2,1,0,0.6666666666666666,0.0,22,16,6,11,32,-21,"December, 2019"
2019-2020,19,2019-12-26,Everton,Burnley,1,0,H,3,0,1,2,2,2,2,1,16,12,19,24,4,5,December,-2.4492935982947064e-16,1.0,18,11,2,0,3,1.6,1.0,20,29,-9,23,29,-6,"December, 2019"
2019-2020,19,2019-12-26,Crystal Palace,West Ham,2,1,H,3,0,0,1,4,2,2,1,12,17,23,19,5,4,December,-2.4492935982947064e-16,1.0,16,45,1,3,1,1.6,1.6,15,20,-5,19,28,-9,"December, 2019"
2019-2020,19,2019-12-26,Man United,Newcastle,4,1,H,3,0,3,2,0,0,1,4,9,10,25,25,1,0,December,-2.4492935982947064e-16,1.0,28,30,3,0,2,1.8,1.0,26,22,4,18,24,-6,"December, 2019"
2019-2020,19,2019-12-26,Bournemouth,Arsenal,1,1,D,1,1,2,1,2,2,1,2,14,11,19,23,3,4,December,-2.4492935982947064e-16,1.0,7,0,1,0,4,0.8,2.4,19,25,-6,24,27,-3,"December, 2019"
2019-2020,19,2019-12-26,Aston Villa,Norwich,1,0,H,3,0,2,2,1,0,0,5,18,19,15,12,1,3,December,-2.4492935982947064e-16,1.0,1,31,4,0,1,2.4,0.8,24,33,-9,19,37,-18,"December, 2019"
2019-2020,19,2019-12-26,Chelsea,Southampton,0,2,A,0,3,3,0,2,2,3,0,4,18,32,18,14,14,December,-2.4492935982947064e-16,1.0,14,38,4,1,0,2.2,0.6,33,25,8,21,37,-16,"December, 2019"
2019-2020,19,2019-12-26,Tottenham,Brighton,2,1,H,3,0,3,2,0,1,2,2,7,13,26,20,6,6,December,-2.4492935982947064e-16,1.0,42,10,3,1,1,1.2,1.0,32,26,6,21,26,-5,"December, 2019"
2019-2020,19,2019-12-27,Wolves,Man City,3,2,H,3,0,2,1,2,5,0,0,8,3,27,38,5,11,December,-2.4492935982947064e-16,1.0,48,27,1,1,3,0.8,1.8,26,22,4,50,20,30,"December, 2019"
2019-2020,20,2019-12-28,Burnley,Man United,0,2,A,0,3,2,2,1,3,2,0,13,8,24,28,5,4,December,-2.4492935982947064e-16,1.0,11,28,0,2,3,0.8,1.8,23,30,-7,30,23,7,"December, 2019"
2019-2020,20,2019-12-28,West Ham,Leicester,1,2,A,0,3,2,2,1,1,1,3,17,2,19,39,15,20,December,-2.4492935982947064e-16,1.0,45,24,1,3,1,1.6,1.4,20,30,-10,41,18,23,"December, 2019"
2019-2020,20,2019-12-28,Watford,Aston Villa,3,0,H,3,0,2,0,3,2,2,1,19,18,13,18,1,5,December,-2.4492935982947064e-16,1.0,43,1,2,1,2,1.2,2.0,12,33,-21,25,33,-8,"December, 2019"
2019-2020,20,2019-12-28,Norwich,Tottenham,2,2,D,1,1,0,0,5,3,2,0,20,6,12,29,14,17,December,-2.4492935982947064e-16,1.0,31,42,1,1,3,0.4,1.8,19,38,-19,34,27,7,"December, 2019"
2019-2020,20,2019-12-28,Newcastle,Everton,1,2,A,0,3,0,1,4,1,2,2,10,14,25,22,4,3,December,-2.4492935982947064e-16,1.0,30,18,1,1,3,0.8,1.6,19,28,-9,21,29,-8,"December, 2019"
2019-2020,20,2019-12-28,Brighton,Bournemouth,2,0,H,3,0,1,2,2,2,1,2,15,16,20,20,1,0,December,-2.4492935982947064e-16,1.0,10,7,0,1,3,0.75,2.75,22,28,-6,20,26,-6,"December, 2019"
2019-2020,20,2019-12-28,Southampton,Crystal Palace,1,1,D,1,1,2,3,0,0,1,4,15,9,21,26,6,5,December,-2.4492935982947064e-16,1.0,38,16,3,1,1,1.6,0.8,23,37,-14,17,21,-4,"December, 2019"
2019-2020,20,2019-12-29,Arsenal,Chelsea,1,2,A,0,3,2,1,2,3,0,2,12,4,24,32,8,8,December,-2.4492935982947064e-16,1.0,0,14,1,2,2,1.4,1.6,25,28,-3,33,27,6,"December, 2019"
2019-2020,20,2019-12-29,Liverpool,Wolves,1,0,H,3,0,3,1,1,2,1,2,1,7,52,30,6,22,December,-2.4492935982947064e-16,1.0,25,48,5,0,0,2.4,0.2,46,14,32,29,24,5,"December, 2019"
2019-2020,20,2019-12-29,Man City,Sheffield United,2,0,H,3,0,5,0,0,2,0,3,3,8,38,29,5,9,December,-2.4492935982947064e-16,1.0,27,36,1,1,0,0.5,0.0,52,23,29,23,17,6,"December, 2019"
2019-2020,21,2020-01-01,Man City,Everton,2,1,H,3,0,5,0,0,1,2,2,3,10,41,25,7,16,January,0.4999999999999999,0.8660254037844387,27,18,4,1,0,2.4,0.8,54,23,31,23,30,-7,"January, 2020"
2019-2020,21,2020-01-01,West Ham,Bournemouth,4,0,H,3,0,2,2,1,2,1,2,18,17,19,20,1,1,January,0.4999999999999999,0.8660254037844387,45,7,0,3,2,1.4,2.0,21,32,-11,20,28,-8,"January, 2020"
2019-2020,21,2020-01-01,Norwich,Crystal Palace,1,1,D,1,1,0,0,5,0,1,4,20,9,13,27,11,14,January,0.4999999999999999,0.8660254037844387,31,16,1,1,3,0.6,1.4,21,40,-19,18,22,-4,"January, 2020"
2019-2020,21,2020-01-01,Watford,Wolves,2,1,H,3,0,2,0,3,2,1,2,19,7,16,30,12,14,January,0.4999999999999999,0.8660254037844387,43,48,1,0,2,1.0,1.3333333333333333,15,33,-18,29,25,4,"January, 2020"
2019-2020,21,2020-01-01,Arsenal,Man United,2,0,H,3,0,2,1,2,3,2,0,13,5,24,31,8,7,January,0.4999999999999999,0.8660254037844387,0,28,1,2,2,1.4,1.6,26,30,-4,32,23,9,"January, 2020"
2019-2020,21,2020-01-01,Newcastle,Leicester,0,3,A,0,3,0,1,4,1,1,3,11,2,25,42,9,17,January,0.4999999999999999,0.8660254037844387,30,24,2,0,3,1.0,2.2,20,30,-10,43,19,24,"January, 2020"
2019-2020,21,2020-01-01,Burnley,Aston Villa,1,2,A,0,3,2,2,1,2,2,1,14,18,24,18,4,6,January,0.4999999999999999,0.8660254037844387,11,1,1,3,1,1.4,1.8,23,32,-9,25,36,-11,"January, 2020"
2019-2020,21,2020-01-01,Brighton,Chelsea,1,1,D,1,1,1,2,2,3,0,2,14,4,23,35,10,12,January,0.4999999999999999,0.8660254037844387,10,14,0,0,5,0.2,2.6,24,28,-4,35,28,7,"January, 2020"
2019-2020,21,2020-01-01,Southampton,Tottenham,1,0,H,3,0,2,3,0,3,2,0,15,6,22,30,9,8,January,0.4999999999999999,0.8660254037844387,38,42,1,1,3,1.4,2.4,24,38,-14,36,29,7,"January, 2020"
2019-2020,21,2020-01-02,Liverpool,Sheffield United,2,0,H,3,0,3,1,1,2,0,3,1,8,55,29,7,26,January,0.4999999999999999,0.8660254037844387,25,36,2,1,0,2.0,0.3333333333333333,47,14,33,23,19,4,"January, 2020"
2019-2020,22,2020-01-10,Sheffield United,West Ham,1,0,H,3,0,2,0,3,2,2,1,8,16,29,22,8,7,January,0.4999999999999999,0.8660254037844387,36,45,1,1,1,1.3333333333333333,0.6666666666666666,23,21,2,25,32,-7,"January, 2020"
2019-2020,22,2020-01-11,Crystal Palace,Arsenal,1,1,D,1,1,0,1,4,2,1,2,9,10,28,27,1,1,January,0.4999999999999999,0.8660254037844387,16,0,1,2,2,2.0,2.6,19,23,-4,28,30,-2,"January, 2020"
2019-2020,22,2020-01-11,Chelsea,Burnley,3,0,H,3,0,3,0,2,2,2,1,4,15,36,24,11,12,January,0.4999999999999999,0.8660254037844387,14,11,3,1,1,2.8,1.6,36,29,7,24,34,-10,"January, 2020"
2019-2020,22,2020-01-11,Everton,Brighton,1,0,H,3,0,1,2,2,1,2,2,11,14,25,24,3,1,January,0.4999999999999999,0.8660254037844387,18,10,2,1,2,1.6,1.2,24,32,-8,25,29,-4,"January, 2020"
2019-2020,22,2020-01-11,Leicester,Southampton,1,2,A,0,3,1,1,3,2,3,0,2,12,45,25,10,20,January,0.4999999999999999,0.8660254037844387,24,38,3,1,1,3.2,0.8,46,19,27,25,38,-13,"January, 2020"
2019-2020,22,2020-01-11,Man United,Norwich,4,0,H,3,0,3,2,0,0,0,5,6,20,31,14,14,17,January,0.4999999999999999,0.8660254037844387,28,31,4,0,1,2.0,0.6,32,25,7,22,41,-19,"January, 2020"
2019-2020,22,2020-01-11,Wolves,Newcastle,1,1,D,1,1,2,1,2,0,1,4,8,13,30,25,5,5,January,0.4999999999999999,0.8660254037844387,48,30,1,3,1,1.4,1.4,30,27,3,20,33,-13,"January, 2020"
2019-2020,22,2020-01-11,Tottenham,Liverpool,0,1,A,0,3,3,2,0,3,1,1,8,1,30,58,7,28,January,0.4999999999999999,0.8660254037844387,42,25,1,1,3,1.8,1.8,36,30,6,49,14,35,"January, 2020"
2019-2020,22,2020-01-12,Aston Villa,Man City,1,6,A,0,3,2,2,1,5,0,0,18,3,21,44,15,23,January,0.4999999999999999,0.8660254037844387,1,27,0,1,4,0.4,2.4,27,37,-10,56,24,32,"January, 2020"
2019-2020,22,2020-01-12,Bournemouth,Watford,0,3,A,0,3,2,1,2,2,0,3,18,19,20,19,1,1,January,0.4999999999999999,0.8660254037844387,7,43,1,3,1,1.8,1.4,20,32,-12,17,34,-17,"January, 2020"
2019-2020,23,2020-01-18,Watford,Tottenham,0,0,D,1,1,2,0,3,3,2,0,17,8,22,30,9,8,January,0.4999999999999999,0.8660254037844387,43,42,1,2,2,1.0,1.4,20,34,-14,36,31,5,"January, 2020"
2019-2020,23,2020-01-18,Arsenal,Sheffield United,1,1,D,1,1,2,1,2,2,0,3,10,6,28,32,4,4,January,0.4999999999999999,0.8660254037844387,0,36,1,0,2,1.0,0.6666666666666666,29,31,-2,24,21,3,"January, 2020"
2019-2020,23,2020-01-18,Brighton,Aston Villa,1,1,D,1,1,1,2,2,2,2,1,14,18,24,21,4,3,January,0.4999999999999999,0.8660254037844387,10,1,0,0,1,1.0,2.0,25,30,-5,28,43,-15,"January, 2020"
2019-2020,23,2020-01-18,Man City,Crystal Palace,2,2,D,1,1,5,0,0,0,1,4,2,10,47,29,8,18,January,0.4999999999999999,0.8660254037844387,27,16,3,1,1,2.4,0.8,62,25,37,20,24,-4,"January, 2020"
2019-2020,23,2020-01-18,Norwich,Bournemouth,1,0,H,3,0,0,0,5,2,1,2,20,19,14,20,1,6,January,0.4999999999999999,0.8660254037844387,31,7,1,1,1,1.0,1.3333333333333333,22,45,-23,20,35,-15,"January, 2020"
2019-2020,23,2020-01-18,Southampton,Wolves,2,3,A,0,3,2,3,0,2,1,2,12,8,28,31,4,3,January,0.4999999999999999,0.8660254037844387,38,48,3,1,1,2.0,1.0,27,39,-12,31,28,3,"January, 2020"
2019-2020,23,2020-01-18,West Ham,Everton,1,1,D,1,1,2,2,1,1,2,2,17,11,22,28,6,6,January,0.4999999999999999,0.8660254037844387,45,18,2,0,3,1.2,2.0,25,33,-8,25,32,-7,"January, 2020"
2019-2020,23,2020-01-18,Newcastle,Chelsea,1,0,H,3,0,0,1,4,3,0,2,13,4,26,39,9,13,January,0.4999999999999999,0.8660254037844387,30,14,1,0,4,1.2,1.6,21,34,-13,39,29,10,"January, 2020"
2019-2020,23,2020-01-19,Burnley,Leicester,2,1,H,3,0,2,2,1,1,1,3,15,3,24,45,12,21,January,0.4999999999999999,0.8660254037844387,11,24,1,1,3,0.8,1.2,24,37,-13,47,21,26,"January, 2020"
2019-2020,23,2020-01-19,Liverpool,Man United,2,0,H,3,0,3,1,1,3,2,0,1,5,61,34,4,27,January,0.4999999999999999,0.8660254037844387,25,28,1,3,1,1.0,0.8,50,14,36,36,25,11,"January, 2020"
2019-2020,24,2020-01-21,Chelsea,Arsenal,2,2,D,1,1,3,0,2,2,1,2,4,13,39,29,9,10,January,0.4999999999999999,0.8660254037844387,14,0,2,2,1,1.4,1.4,39,30,9,30,32,-2,"January, 2020"
2019-2020,24,2020-01-21,Sheffield United,Man City,0,1,A,0,3,2,0,3,5,0,0,7,2,33,48,5,15,January,0.4999999999999999,0.8660254037844387,36,27,0,1,2,0.0,1.0,25,22,3,64,27,37,"January, 2020"
2019-2020,24,2020-01-21,Everton,Newcastle,2,2,D,1,1,1,2,2,0,1,4,12,13,29,29,1,0,January,0.4999999999999999,0.8660254037844387,18,30,3,1,1,1.4,1.0,26,33,-7,22,34,-12,"January, 2020"
2019-2020,24,2020-01-21,Aston Villa,Watford,2,1,H,3,0,2,2,1,2,0,3,18,17,22,23,1,1,January,0.4999999999999999,0.8660254037844387,1,43,1,1,3,1.2,1.8,29,44,-15,20,34,-14,"January, 2020"
2019-2020,24,2020-01-21,Bournemouth,Brighton,3,1,H,3,0,2,1,2,1,2,2,19,15,20,25,4,5,January,0.4999999999999999,0.8660254037844387,7,10,3,1,1,2.2,1.0,20,36,-16,26,31,-5,"January, 2020"
2019-2020,24,2020-01-21,Crystal Palace,Southampton,0,2,A,0,3,0,1,4,2,3,0,9,13,30,28,4,2,January,0.4999999999999999,0.8660254037844387,16,38,1,2,2,0.8,1.2,22,26,-4,29,42,-13,"January, 2020"
2019-2020,24,2020-01-22,Leicester,West Ham,4,1,H,3,0,1,1,3,2,2,1,3,17,45,23,14,22,January,0.4999999999999999,0.8660254037844387,24,45,1,3,1,1.2,1.4,48,23,25,26,34,-8,"January, 2020"
2019-2020,24,2020-01-22,Tottenham,Norwich,2,1,H,3,0,3,2,0,0,0,5,8,20,31,17,12,14,January,0.4999999999999999,0.8660254037844387,42,31,3,1,1,2.0,0.6,36,31,5,23,45,-22,"January, 2020"
2019-2020,24,2020-01-22,Man United,Burnley,0,2,A,0,3,3,2,0,2,2,1,5,14,34,27,9,7,January,0.4999999999999999,0.8660254037844387,28,11,3,2,0,1.8,0.8,36,27,9,26,38,-12,"January, 2020"
2019-2020,24,2020-01-23,Wolves,Liverpool,1,2,A,0,3,2,1,2,3,1,1,7,1,34,64,6,30,January,0.4999999999999999,0.8660254037844387,48,25,0,0,5,0.2,2.0,34,30,4,52,14,38,"January, 2020"
2019-2020,24,2020-01-29,West Ham,Liverpool,0,2,A,0,3,2,2,1,3,1,1,17,1,23,67,16,44,January,0.4999999999999999,0.8660254037844387,45,25,0,1,4,0.6,3.4,27,38,-11,54,15,39,"January, 2020"
2019-2020,25,2020-02-01,Man United,Wolves,0,0,D,1,1,3,2,0,2,1,2,6,8,34,34,2,0,February,0.8660254037844386,0.5000000000000001,28,48,2,2,1,2.4,1.0,36,29,7,35,32,3,"February, 2020"
2019-2020,25,2020-02-01,West Ham,Brighton,3,3,D,1,1,2,2,1,1,2,2,18,16,23,25,2,2,February,0.8660254037844386,0.5000000000000001,45,10,0,2,3,0.8,2.0,27,40,-13,27,34,-7,"February, 2020"
2019-2020,25,2020-02-01,Watford,Everton,2,3,A,0,3,2,0,3,1,2,2,19,12,23,30,7,7,February,0.8660254037844386,0.5000000000000001,43,18,2,1,2,1.2,1.2,21,36,-15,28,35,-7,"February, 2020"
2019-2020,25,2020-02-01,Newcastle,Norwich,0,0,D,1,1,0,1,4,0,0,5,14,20,30,17,6,13,February,0.8660254037844386,0.5000000000000001,30,31,2,1,2,2.2,1.8,24,36,-12,24,47,-23,"February, 2020"
2019-2020,25,2020-02-01,Crystal Palace,Sheffield United,0,1,A,0,3,0,1,4,2,0,3,11,8,30,33,3,3,February,0.8660254037844386,0.5000000000000001,16,36,0,0,1,0.0,1.0,22,28,-6,25,23,2,"February, 2020"
2019-2020,25,2020-02-01,Bournemouth,Aston Villa,2,1,H,3,0,2,1,2,2,2,1,18,16,23,25,2,2,February,0.8660254037844386,0.5000000000000001,7,1,2,0,1,1.3333333333333333,1.0,23,37,-14,31,45,-14,"February, 2020"
2019-2020,25,2020-02-01,Leicester,Chelsea,2,2,D,1,1,1,1,3,3,0,2,3,4,48,40,1,8,February,0.8660254037844386,0.5000000000000001,24,14,1,3,1,0.6,0.6,52,24,28,41,32,9,"February, 2020"
2019-2020,25,2020-02-01,Liverpool,Southampton,4,0,H,3,0,3,1,1,2,3,0,1,9,70,31,8,39,February,0.8660254037844386,0.5000000000000001,25,38,5,0,0,2.6,0.4,56,15,41,31,42,-11,"February, 2020"
2019-2020,25,2020-02-02,Burnley,Arsenal,0,0,D,1,1,2,2,1,2,1,2,14,12,30,30,2,0,February,0.8660254037844386,0.5000000000000001,11,0,0,0,5,0.6,2.8,28,38,-10,32,34,-2,"February, 2020"
2019-2020,25,2020-02-02,Tottenham,Man City,2,0,H,3,0,3,2,0,5,0,0,8,2,34,51,6,17,February,0.8660254037844386,0.5000000000000001,42,27,0,1,4,0.8,2.2,38,32,6,65,27,38,"February, 2020"
2019-2020,26,2020-02-08,Everton,Crystal Palace,3,1,H,3,0,1,2,2,0,1,4,9,14,33,30,5,3,February,0.8660254037844386,0.5000000000000001,18,16,2,3,0,1.4,0.6,31,37,-6,22,29,-7,"February, 2020"
2019-2020,26,2020-02-08,Brighton,Watford,1,1,D,1,1,1,2,2,2,0,3,15,19,26,23,4,3,February,0.8660254037844386,0.5000000000000001,10,43,2,2,1,0.8,0.4,30,37,-7,23,39,-16,"February, 2020"
2019-2020,26,2020-02-09,Sheffield United,Bournemouth,2,1,H,3,0,2,0,3,2,1,2,6,16,36,26,10,10,February,0.8660254037844386,0.5000000000000001,36,7,0,1,0,1.0,1.0,26,23,3,25,38,-13,"February, 2020"
2019-2020,26,2020-02-14,Wolves,Leicester,0,0,D,1,1,2,1,2,1,1,3,9,3,35,49,6,14,February,0.8660254037844386,0.5000000000000001,48,24,2,2,1,1.6,1.6,35,32,3,54,26,28,"February, 2020"
2019-2020,26,2020-02-15,Southampton,Burnley,1,2,A,0,3,2,3,0,2,2,1,13,11,31,31,2,0,February,0.8660254037844386,0.5000000000000001,38,11,0,3,2,0.4,1.2,31,46,-15,28,38,-10,"February, 2020"
2019-2020,26,2020-02-15,Norwich,Liverpool,0,1,A,0,3,0,0,5,3,1,1,20,1,18,73,19,55,February,0.8660254037844386,0.5000000000000001,31,25,0,1,4,1.8,3.6,24,47,-23,60,15,45,"February, 2020"
2019-2020,26,2020-02-16,Aston Villa,Tottenham,2,3,A,0,3,2,2,1,3,2,0,17,6,25,37,11,12,February,0.8660254037844386,0.5000000000000001,1,42,1,0,4,0.8,2.0,32,47,-15,40,32,8,"February, 2020"
2019-2020,26,2020-02-16,Arsenal,Newcastle,4,0,H,3,0,2,1,2,0,1,4,11,12,31,31,1,0,February,0.8660254037844386,0.5000000000000001,0,30,4,0,1,1.4,0.6,32,34,-2,24,36,-12,"February, 2020"
2019-2020,26,2020-02-17,Chelsea,Man United,0,2,A,0,3,3,0,2,3,2,0,4,9,41,35,5,6,February,0.8660254037844386,0.5000000000000001,14,28,1,2,2,1.0,1.8,43,34,9,36,29,7,"February, 2020"
2019-2020,26,2020-02-19,Man City,West Ham,2,0,H,3,0,5,0,0,2,2,1,2,18,51,24,16,27,February,0.8660254037844386,0.5000000000000001,27,45,5,0,0,3.2,0.4,65,29,36,30,43,-13,"February, 2020"
2019-2020,27,2020-02-22,Leicester,Man City,0,1,A,0,3,1,1,3,5,0,0,3,2,50,54,1,4,February,0.8660254037844386,0.5000000000000001,24,27,1,0,4,0.8,2.4,54,26,28,67,29,38,"February, 2020"
2019-2020,27,2020-02-22,Southampton,Aston Villa,2,0,H,3,0,2,3,0,2,2,1,13,17,31,25,4,6,February,0.8660254037844386,0.5000000000000001,38,1,3,2,0,3.0,1.2,32,48,-16,34,50,-16,"February, 2020"
2019-2020,27,2020-02-22,Sheffield United,Brighton,1,1,D,1,1,2,0,3,1,2,2,6,15,39,27,9,12,February,0.8660254037844386,0.5000000000000001,36,10,1,0,0,1.0,0.0,28,24,4,31,38,-7,"February, 2020"
2019-2020,27,2020-02-22,Crystal Palace,Newcastle,1,0,H,3,0,0,1,4,0,1,4,14,13,30,31,1,1,February,0.8660254037844386,0.5000000000000001,16,30,1,2,2,0.4,0.6,23,32,-9,24,40,-16,"February, 2020"
2019-2020,27,2020-02-22,Burnley,Bournemouth,3,0,H,3,0,2,2,1,2,1,2,11,16,34,26,5,8,February,0.8660254037844386,0.5000000000000001,11,7,4,0,1,2.2,0.8,30,39,-9,26,40,-14,"February, 2020"
2019-2020,27,2020-02-22,Chelsea,Tottenham,2,1,H,3,0,3,0,2,3,2,0,4,5,41,40,1,1,February,0.8660254037844386,0.5000000000000001,14,42,3,0,2,1.6,1.4,43,36,7,43,34,9,"February, 2020"
2019-2020,27,2020-02-23,Man United,Watford,3,0,H,3,0,3,2,0,2,0,3,7,19,38,24,12,14,February,0.8660254037844386,0.5000000000000001,28,43,4,0,1,1.8,1.2,38,29,9,24,40,-16,"February, 2020"
2019-2020,27,2020-02-23,Wolves,Norwich,3,0,H,3,0,2,1,2,0,0,5,9,20,36,18,11,18,February,0.8660254037844386,0.5000000000000001,48,31,1,1,1,1.6666666666666667,1.6666666666666667,35,32,3,24,48,-24,"February, 2020"
2019-2020,27,2020-02-23,Arsenal,Everton,3,2,H,3,0,2,1,2,1,2,2,11,10,34,36,1,2,February,0.8660254037844386,0.5000000000000001,0,18,3,1,1,2.4,0.8,36,34,2,34,38,-4,"February, 2020"
2019-2020,27,2020-02-24,Liverpool,West Ham,3,2,H,3,0,3,1,1,2,2,1,1,18,76,24,17,52,February,0.8660254037844386,0.5000000000000001,25,45,4,1,0,3.0,0.6,61,15,46,30,45,-15,"February, 2020"
2019-2020,28,2020-02-28,Norwich,Leicester,1,0,H,3,0,0,0,5,1,1,3,20,3,18,50,17,32,February,0.8660254037844386,0.5000000000000001,31,24,0,1,2,0.6666666666666666,1.3333333333333333,24,51,-27,54,27,27,"February, 2020"
2019-2020,28,2020-02-29,West Ham,Southampton,3,1,H,3,0,2,2,1,2,3,0,18,13,24,34,5,10,February,0.8660254037844386,0.5000000000000001,45,38,4,0,1,2.2,0.8,32,48,-16,34,48,-14,"February, 2020"
2019-2020,28,2020-02-29,Newcastle,Burnley,0,0,D,1,1,0,1,4,2,2,1,14,10,31,37,4,6,February,0.8660254037844386,0.5000000000000001,30,11,2,1,2,1.0,0.8,24,41,-17,33,39,-6,"February, 2020"
2019-2020,28,2020-02-29,Watford,Liverpool,3,0,H,3,0,2,0,3,3,1,1,19,1,24,79,18,55,February,0.8660254037844386,0.5000000000000001,43,25,0,1,4,0.6,3.6,24,43,-19,64,17,47,"February, 2020"
2019-2020,28,2020-02-29,Brighton,Crystal Palace,0,1,A,0,3,1,2,2,0,1,4,15,13,28,33,2,5,February,0.8660254037844386,0.5000000000000001,10,16,2,2,1,1.6,1.2,32,39,-7,24,32,-8,"February, 2020"
2019-2020,28,2020-02-29,Bournemouth,Chelsea,2,2,D,1,1,2,1,2,3,0,2,16,4,26,44,12,18,February,0.8660254037844386,0.5000000000000001,7,14,3,0,2,1.6,0.6,26,43,-17,45,37,8,"February, 2020"
2019-2020,28,2020-03-01,Everton,Man United,1,1,D,1,1,1,2,2,3,2,0,11,5,36,41,6,5,March,1.0,6.123233995736766e-17,18,28,1,1,3,1.2,1.8,36,41,-5,41,29,12,"March, 2020"
2019-2020,28,2020-03-01,Tottenham,Wolves,2,3,A,0,3,3,2,0,2,1,2,6,8,40,39,2,1,March,1.0,6.123233995736766e-17,42,48,3,1,1,1.8,1.4,44,36,8,38,32,6,"March, 2020"
2019-2020,29,2020-03-07,Burnley,Tottenham,1,1,D,1,1,2,2,1,3,2,0,11,8,38,40,3,2,March,1.0,6.123233995736766e-17,11,42,1,1,3,0.6,2.2,33,39,-6,46,39,7,"March, 2020"
2019-2020,29,2020-03-07,Southampton,Newcastle,0,1,A,0,3,2,3,0,0,1,4,13,14,34,32,1,2,March,1.0,6.123233995736766e-17,38,30,0,2,3,0.8,2.0,35,51,-16,24,41,-17,"March, 2020"
2019-2020,29,2020-03-07,Sheffield United,Norwich,1,0,H,3,0,2,0,3,0,0,5,9,20,40,21,11,19,March,1.0,6.123233995736766e-17,36,31,1,0,0,2.0,1.0,29,25,4,25,51,-26,"March, 2020"
2019-2020,29,2020-03-07,Wolves,Brighton,0,0,D,1,1,2,1,2,1,2,2,7,15,42,28,8,14,March,1.0,6.123233995736766e-17,48,10,0,2,1,0.6666666666666666,1.0,41,34,7,32,40,-8,"March, 2020"
2019-2020,29,2020-03-07,Arsenal,West Ham,1,0,H,3,0,2,1,2,2,2,1,10,16,37,27,6,10,March,1.0,6.123233995736766e-17,0,45,3,1,1,2.0,0.8,39,36,3,35,49,-14,"March, 2020"
2019-2020,29,2020-03-07,Liverpool,Bournemouth,2,1,H,3,0,3,1,1,2,1,2,1,18,79,27,17,52,March,1.0,6.123233995736766e-17,25,7,5,0,0,3.4,0.0,64,20,44,28,45,-17,"March, 2020"
2019-2020,29,2020-03-07,Crystal Palace,Watford,1,0,H,3,0,0,1,4,2,0,3,12,17,36,27,5,9,March,1.0,6.123233995736766e-17,16,43,1,2,2,0.8,1.0,25,32,-7,27,43,-16,"March, 2020"
2019-2020,29,2020-03-08,Chelsea,Everton,4,0,H,3,0,3,0,2,1,2,2,4,12,45,37,8,8,March,1.0,6.123233995736766e-17,14,18,1,2,2,0.6,1.0,47,39,8,37,42,-5,"March, 2020"
2019-2020,29,2020-03-08,Man United,Man City,2,0,H,3,0,3,2,0,5,0,0,7,2,42,57,5,15,March,1.0,6.123233995736766e-17,28,27,2,0,3,1.4,2.0,42,30,12,68,29,39,"March, 2020"
2019-2020,29,2020-03-09,Leicester,Aston Villa,4,0,H,3,0,1,1,3,2,2,1,3,19,50,25,16,25,March,1.0,6.123233995736766e-17,24,1,3,1,1,2.0,1.2,54,28,26,34,52,-18,"March, 2020"
2019-2020,30,2020-06-17,Aston Villa,Sheffield United,0,0,D,1,1,2,2,1,2,0,3,19,7,25,43,12,18,June,1.2246467991473532e-16,-1.0,1,36,1,1,1,1.6666666666666667,1.3333333333333333,34,56,-22,30,25,5,"June, 2020"
2019-2020,30,2020-06-17,Man City,Arsenal,3,0,H,3,0,5,0,0,2,1,2,2,9,57,40,7,17,June,1.2246467991473532e-16,-1.0,27,0,5,0,0,2.8,0.4,68,31,37,40,36,4,"June, 2020"
2019-2020,30,2020-06-19,Tottenham,Man United,1,1,D,1,1,3,2,0,3,2,0,8,5,41,45,3,4,June,1.2246467991473532e-16,-1.0,42,28,2,0,3,1.2,0.8,47,40,7,44,30,14,"June, 2020"
2019-2020,30,2020-06-19,Norwich,Southampton,0,3,A,0,3,0,0,5,2,3,0,20,14,21,34,6,13,June,1.2246467991473532e-16,-1.0,31,38,2,0,3,1.0,1.8,25,52,-27,35,52,-17,"June, 2020"
2019-2020,30,2020-06-20,West Ham,Wolves,0,2,A,0,3,2,2,1,2,1,2,17,7,27,43,10,16,June,1.2246467991473532e-16,-1.0,45,48,1,1,3,0.6,1.4,35,50,-15,41,34,7,"June, 2020"
2019-2020,30,2020-06-20,Bournemouth,Crystal Palace,0,2,A,0,3,2,1,2,0,1,4,18,11,27,39,7,12,June,1.2246467991473532e-16,-1.0,7,16,1,2,2,1.8,2.2,29,47,-18,26,32,-6,"June, 2020"
2019-2020,30,2020-06-20,Watford,Leicester,1,1,D,1,1,2,0,3,1,1,3,17,3,27,53,14,26,June,1.2246467991473532e-16,-1.0,43,24,2,0,3,0.8,1.6,27,44,-17,58,28,30,"June, 2020"
2019-2020,30,2020-06-20,Brighton,Arsenal,2,1,H,3,0,1,2,2,2,1,2,15,9,29,40,6,11,June,1.2246467991473532e-16,-1.0,10,0,2,2,1,1.2,1.2,32,40,-8,40,39,1,"June, 2020"
2019-2020,30,2020-06-21,Newcastle,Sheffield United,3,0,H,3,0,0,1,4,2,0,3,14,7,35,44,7,9,June,1.2246467991473532e-16,-1.0,30,36,2,0,1,1.3333333333333333,0.6666666666666666,25,41,-16,30,25,5,"June, 2020"
2019-2020,30,2020-06-21,Aston Villa,Chelsea,1,2,A,0,3,2,2,1,3,0,2,19,4,26,48,15,22,June,1.2246467991473532e-16,-1.0,1,14,0,0,5,0.4,2.6,34,56,-22,51,39,12,"June, 2020"
2019-2020,30,2020-06-21,Everton,Liverpool,0,0,D,1,1,1,2,2,3,1,1,13,1,37,82,12,45,June,1.2246467991473532e-16,-1.0,18,25,0,3,2,0.6,1.4,37,46,-9,66,21,45,"June, 2020"
2019-2020,30,2020-06-22,Man City,Burnley,5,0,H,3,0,5,0,0,2,2,1,2,11,60,39,9,21,June,1.2246467991473532e-16,-1.0,27,11,4,1,0,2.8,0.4,71,31,40,34,40,-6,"June, 2020"
2019-2020,31,2020-06-23,Leicester,Brighton,0,0,D,1,1,1,1,3,1,2,2,3,15,54,32,12,22,June,1.2246467991473532e-16,-1.0,24,10,4,1,0,1.8,0.4,59,29,30,34,41,-7,"June, 2020"
2019-2020,31,2020-06-23,Tottenham,West Ham,2,0,H,3,0,3,2,0,2,2,1,8,17,42,27,9,15,June,1.2246467991473532e-16,-1.0,42,45,3,1,1,1.6,1.2,48,41,7,35,52,-17,"June, 2020"
2019-2020,31,2020-06-24,Liverpool,Crystal Palace,4,0,H,3,0,3,1,1,0,1,4,1,9,83,42,8,41,June,1.2246467991473532e-16,-1.0,25,16,5,0,0,2.2,1.0,66,21,45,28,32,-4,"June, 2020"
2019-2020,31,2020-06-24,Norwich,Everton,0,1,A,0,3,0,0,5,1,2,2,20,13,21,38,7,17,June,1.2246467991473532e-16,-1.0,31,18,1,2,2,1.0,1.6,25,55,-30,37,46,-9,"June, 2020"
2019-2020,31,2020-06-24,Wolves,Bournemouth,1,0,H,3,0,2,1,2,2,1,2,6,18,46,27,12,19,June,1.2246467991473532e-16,-1.0,48,7,2,1,0,1.6666666666666667,0.6666666666666666,43,34,9,29,49,-20,"June, 2020"
2019-2020,31,2020-06-24,Man United,Sheffield United,3,0,H,3,0,3,2,0,2,0,3,5,8,46,44,3,2,June,1.2246467991473532e-16,-1.0,28,36,2,1,0,2.333333333333333,1.3333333333333333,45,31,14,30,28,2,"June, 2020"
2019-2020,31,2020-06-24,Newcastle,Aston Villa,1,1,D,1,1,0,1,4,2,2,1,13,19,38,26,6,12,June,1.2246467991473532e-16,-1.0,30,1,1,3,1,0.4,0.6,28,41,-13,35,58,-23,"June, 2020"
2019-2020,31,2020-06-25,Burnley,Watford,1,0,H,3,0,2,2,1,2,0,3,12,16,39,28,4,11,June,1.2246467991473532e-16,-1.0,11,43,3,1,1,1.4,0.8,34,45,-11,28,45,-17,"June, 2020"
2019-2020,31,2020-06-25,Southampton,Arsenal,0,2,A,0,3,2,3,0,2,1,2,14,12,37,40,2,3,June,1.2246467991473532e-16,-1.0,38,0,1,2,2,1.6,2.0,38,52,-14,41,41,0,"June, 2020"
2019-2020,31,2020-06-25,Chelsea,Man City,2,1,H,3,0,3,0,2,5,0,0,4,2,51,63,2,12,June,1.2246467991473532e-16,-1.0,14,27,1,0,4,0.6,2.0,53,40,13,76,31,45,"June, 2020"
2019-2020,32,2020-06-27,Aston Villa,Wolves,0,1,A,0,3,2,2,1,2,1,2,19,6,27,49,13,22,June,1.2246467991473532e-16,-1.0,1,48,2,1,2,1.2,1.2,36,59,-23,44,34,10,"June, 2020"
2019-2020,32,2020-06-28,Watford,Southampton,1,3,A,0,3,2,0,3,2,3,0,16,14,28,37,2,9,June,1.2246467991473532e-16,-1.0,43,38,1,3,1,1.4,1.2,28,46,-18,38,54,-16,"June, 2020"
2019-2020,32,2020-06-29,Crystal Palace,Burnley,0,1,A,0,3,0,1,4,2,2,1,10,11,42,42,1,0,June,1.2246467991473532e-16,-1.0,16,11,4,0,1,1.6,0.4,28,36,-8,35,45,-10,"June, 2020"
2019-2020,32,2020-06-30,Brighton,Man United,0,3,A,0,3,1,2,2,3,2,0,15,6,33,49,9,16,June,1.2246467991473532e-16,-1.0,10,28,2,0,3,1.2,1.6,34,41,-7,48,31,17,"June, 2020"
2019-2020,32,2020-07-01,Everton,Leicester,2,1,H,3,0,1,2,2,1,1,3,13,3,41,55,10,14,July,-0.4999999999999998,-0.8660254037844388,18,24,2,0,3,1.0,1.4,38,46,-8,59,29,30,"July, 2020"
2019-2020,32,2020-07-01,Arsenal,Norwich,4,0,H,3,0,2,1,2,0,0,5,10,20,43,21,10,22,July,-0.4999999999999998,-0.8660254037844388,0,31,3,2,0,2.0,0.8,43,41,2,25,56,-31,"July, 2020"
2019-2020,32,2020-07-01,Bournemouth,Newcastle,1,4,A,0,3,2,1,2,0,1,4,18,14,27,39,4,12,July,-0.4999999999999998,-0.8660254037844388,7,30,1,2,2,1.4,1.6,29,50,-21,29,42,-13,"July, 2020"
2019-2020,32,2020-07-01,West Ham,Chelsea,3,2,H,3,0,2,2,1,3,0,2,17,4,27,54,13,27,July,-0.4999999999999998,-0.8660254037844388,45,14,2,2,1,0.6,0.6,35,54,-19,55,41,14,"July, 2020"
2019-2020,32,2020-07-02,Man City,Liverpool,4,0,H,3,0,5,0,0,3,1,1,2,1,63,86,1,23,July,-0.4999999999999998,-0.8660254037844388,27,25,2,1,2,2.2,1.6,77,33,44,70,21,49,"July, 2020"
2019-2020,32,2020-07-02,Sheffield United,Tottenham,3,1,H,3,0,2,0,3,3,2,0,10,8,44,45,2,1,July,-0.4999999999999998,-0.8660254037844388,36,42,1,1,1,1.0,1.3333333333333333,30,31,-1,50,41,9,"July, 2020"
2019-2020,33,2020-07-04,Norwich,Brighton,0,1,A,0,3,0,0,5,1,2,2,20,15,21,33,5,12,July,-0.4999999999999998,-0.8660254037844388,31,10,0,0,1,0.0,2.0,25,60,-35,34,44,-10,"July, 2020"
2019-2020,33,2020-07-04,Leicester,Crystal Palace,3,0,H,3,0,1,1,3,0,1,4,3,12,55,42,9,13,July,-0.4999999999999998,-0.8660254037844388,24,16,1,0,4,0.6,2.6,60,31,29,28,37,-9,"July, 2020"
2019-2020,33,2020-07-04,Man United,Bournemouth,5,2,H,3,0,3,2,0,2,1,2,5,19,52,27,14,25,July,-0.4999999999999998,-0.8660254037844388,28,7,4,0,1,1.8,0.6,51,31,20,30,54,-24,"July, 2020"
2019-2020,33,2020-07-04,Wolves,Arsenal,0,2,A,0,3,2,1,2,2,1,2,6,8,52,46,2,6,July,-0.4999999999999998,-0.8660254037844388,48,0,1,3,1,1.2,1.4,45,34,11,47,41,6,"July, 2020"
2019-2020,33,2020-07-04,Chelsea,Watford,3,0,H,3,0,3,0,2,2,0,3,5,17,54,28,12,26,July,-0.4999999999999998,-0.8660254037844388,14,43,4,0,1,2.4,1.6,57,44,13,29,49,-20,"July, 2020"
2019-2020,33,2020-07-05,Burnley,Sheffield United,1,1,D,1,1,2,2,1,2,0,3,10,8,45,47,2,2,July,-0.4999999999999998,-0.8660254037844388,11,36,0,0,1,0.0,3.0,36,45,-9,33,32,1,"July, 2020"
2019-2020,33,2020-07-05,Newcastle,West Ham,2,2,D,1,1,0,1,4,2,2,1,12,16,42,30,4,12,July,-0.4999999999999998,-0.8660254037844388,30,45,3,0,2,1.8,1.8,33,43,-10,38,56,-18,"July, 2020"
2019-2020,33,2020-07-05,Liverpool,Aston Villa,2,0,H,3,0,3,1,1,2,2,1,1,18,86,27,17,59,July,-0.4999999999999998,-0.8660254037844388,25,1,4,0,1,2.6,0.8,70,25,45,36,60,-24,"July, 2020"
2019-2020,33,2020-07-05,Southampton,Man City,1,0,H,3,0,2,3,0,5,0,0,14,2,40,66,12,26,July,-0.4999999999999998,-0.8660254037844388,38,27,0,0,5,0.8,2.8,41,55,-14,81,33,48,"July, 2020"
2019-2020,33,2020-07-06,Tottenham,Everton,1,0,H,3,0,3,2,0,1,2,2,10,11,45,44,1,1,July,-0.4999999999999998,-0.8660254037844388,42,18,3,2,0,3.2,1.0,51,44,7,40,47,-7,"July, 2020"
2019-2020,34,2020-07-07,Arsenal,Leicester,1,1,D,1,1,2,1,2,1,1,3,7,4,49,58,3,9,July,-0.4999999999999998,-0.8660254037844388,0,24,2,0,3,1.6,2.4,49,41,8,63,31,32,"July, 2020"
2019-2020,34,2020-07-07,Crystal Palace,Chelsea,2,3,A,0,3,0,1,4,3,0,2,14,4,42,57,10,15,July,-0.4999999999999998,-0.8660254037844388,16,14,1,0,4,0.8,1.8,28,40,-12,60,44,16,"July, 2020"
2019-2020,34,2020-07-07,Watford,Norwich,2,1,H,3,0,2,0,3,0,0,5,17,20,28,21,3,7,July,-0.4999999999999998,-0.8660254037844388,43,31,2,0,1,2.0,1.3333333333333333,29,52,-23,25,61,-36,"July, 2020"
2019-2020,34,2020-07-08,Man City,Newcastle,5,0,H,3,0,5,0,0,0,1,4,2,12,66,43,10,23,July,-0.4999999999999998,-0.8660254037844388,27,30,3,1,1,1.8,1.2,81,34,47,35,45,-10,"July, 2020"
2019-2020,34,2020-07-08,Sheffield United,Wolves,1,0,H,3,0,2,0,3,2,1,2,9,6,48,52,3,4,July,-0.4999999999999998,-0.8660254037844388,36,48,0,1,0,1.0,1.0,34,33,1,45,36,9,"July, 2020"
2019-2020,34,2020-07-08,West Ham,Burnley,0,1,A,0,3,2,2,1,2,2,1,16,10,31,46,6,15,July,-0.4999999999999998,-0.8660254037844388,45,11,1,1,3,1.0,2.2,40,58,-18,37,46,-9,"July, 2020"
2019-2020,34,2020-07-08,Brighton,Liverpool,1,3,A,0,3,1,2,2,3,1,1,15,1,36,89,14,53,July,-0.4999999999999998,-0.8660254037844388,10,25,0,0,5,0.4,2.6,35,44,-9,72,25,47,"July, 2020"
2019-2020,34,2020-07-09,Bournemouth,Tottenham,0,0,D,1,1,2,1,2,3,2,0,19,10,27,48,9,21,July,-0.4999999999999998,-0.8660254037844388,7,42,1,0,4,0.8,2.6,32,59,-27,52,44,8,"July, 2020"
2019-2020,34,2020-07-09,Everton,Southampton,1,1,D,1,1,1,2,2,2,3,0,11,12,44,43,1,1,July,-0.4999999999999998,-0.8660254037844388,18,38,2,1,2,1.4,1.8,40,48,-8,42,55,-13,"July, 2020"
2019-2020,34,2020-07-09,Aston Villa,Man United,0,3,A,0,3,2,2,1,3,2,0,19,5,27,55,14,28,July,-0.4999999999999998,-0.8660254037844388,1,28,0,2,3,0.8,1.6,36,62,-26,56,33,23,"July, 2020"
2019-2020,35,2020-07-11,Brighton,Man City,0,5,A,0,3,1,2,2,5,0,0,15,2,36,69,13,33,July,-0.4999999999999998,-0.8660254037844388,10,27,0,0,5,0.4,3.0,36,47,-11,86,34,52,"July, 2020"
2019-2020,35,2020-07-11,Sheffield United,Chelsea,3,0,H,3,0,2,0,3,3,0,2,7,3,51,60,4,9,July,-0.4999999999999998,-0.8660254037844388,36,14,0,1,2,0.6666666666666666,2.333333333333333,35,33,2,63,46,17,"July, 2020"
2019-2020,35,2020-07-11,Watford,Newcastle,2,1,H,3,0,2,0,3,0,1,4,17,13,31,43,4,12,July,-0.4999999999999998,-0.8660254037844388,43,30,2,2,1,1.4,0.8,31,53,-22,35,50,-15,"July, 2020"
2019-2020,35,2020-07-11,Norwich,West Ham,0,4,A,0,3,0,0,5,2,2,1,20,16,21,31,4,10,July,-0.4999999999999998,-0.8660254037844388,31,45,1,2,2,1.4,1.8,26,63,-37,40,59,-19,"July, 2020"
2019-2020,35,2020-07-11,Liverpool,Burnley,1,1,D,1,1,3,1,1,2,2,1,1,10,92,49,9,43,July,-0.4999999999999998,-0.8660254037844388,25,11,4,1,0,2.6,1.0,75,26,49,38,46,-8,"July, 2020"
2019-2020,35,2020-07-12,Wolves,Everton,3,0,H,3,0,2,1,2,1,2,2,7,11,52,45,4,7,July,-0.4999999999999998,-0.8660254037844388,48,18,1,2,2,1.6,1.6,45,37,8,41,49,-8,"July, 2020"
2019-2020,35,2020-07-12,Aston Villa,Crystal Palace,2,0,H,3,0,2,2,1,0,1,4,19,14,27,42,5,15,July,-0.4999999999999998,-0.8660254037844388,1,16,2,1,2,0.6,0.6,36,65,-29,30,43,-13,"July, 2020"
2019-2020,35,2020-07-12,Tottenham,Arsenal,2,1,H,3,0,3,2,0,2,1,2,10,8,49,50,2,1,July,-0.4999999999999998,-0.8660254037844388,42,0,1,2,2,1.2,1.8,52,44,8,50,42,8,"July, 2020"
2019-2020,35,2020-07-12,Bournemouth,Leicester,4,1,H,3,0,2,1,2,1,1,3,19,4,28,59,15,31,July,-0.4999999999999998,-0.8660254037844388,7,24,1,2,2,1.2,1.6,32,59,-27,64,32,32,"July, 2020"
2019-2020,35,2020-07-13,Man United,Southampton,2,2,D,1,1,3,2,0,2,3,0,5,12,58,44,7,14,July,-0.4999999999999998,-0.8660254037844388,28,38,2,3,0,1.4,1.0,59,33,26,43,56,-13,"July, 2020"
2019-2020,36,2020-07-14,Chelsea,Norwich,1,0,H,3,0,3,0,2,0,0,5,3,20,60,21,17,39,July,-0.4999999999999998,-0.8660254037844388,14,31,4,1,0,1.8,0.8,63,49,14,26,67,-41,"July, 2020"
2019-2020,36,2020-07-15,Newcastle,Tottenham,1,3,A,0,3,0,1,4,3,2,0,13,8,43,52,5,9,July,-0.4999999999999998,-0.8660254037844388,30,42,1,0,4,0.4,1.2,36,52,-16,54,45,9,"July, 2020"
2019-2020,36,2020-07-15,Arsenal,Liverpool,2,1,H,3,0,2,1,2,3,1,1,10,1,50,93,9,43,July,-0.4999999999999998,-0.8660254037844388,0,25,0,2,3,1.2,3.2,51,44,7,76,27,49,"July, 2020"
2019-2020,36,2020-07-15,Burnley,Wolves,1,1,D,1,1,2,2,1,2,1,2,10,6,50,55,4,5,July,-0.4999999999999998,-0.8660254037844388,11,48,1,1,3,0.8,1.2,39,47,-8,48,37,11,"July, 2020"
2019-2020,36,2020-07-15,Man City,Bournemouth,2,1,H,3,0,5,0,0,2,1,2,2,18,72,31,16,41,July,-0.4999999999999998,-0.8660254037844388,27,7,5,0,0,2.6,0.6,91,34,57,36,60,-24,"July, 2020"
2019-2020,36,2020-07-16,Everton,Aston Villa,1,1,D,1,1,1,2,2,2,2,1,11,19,45,30,8,15,July,-0.4999999999999998,-0.8660254037844388,18,1,3,0,2,2.4,1.2,41,52,-11,38,65,-27,"July, 2020"
2019-2020,36,2020-07-16,Leicester,Sheffield United,2,0,H,3,0,1,1,3,2,0,3,4,8,59,54,4,5,July,-0.4999999999999998,-0.8660254037844388,24,36,1,0,0,2.0,1.0,65,36,29,38,33,5,"July, 2020"
2019-2020,36,2020-07-16,Crystal Palace,Man United,0,2,A,0,3,0,1,4,3,2,0,14,5,42,59,9,17,July,-0.4999999999999998,-0.8660254037844388,16,28,1,1,3,1.0,2.2,30,45,-15,61,35,26,"July, 2020"
2019-2020,36,2020-07-16,Southampton,Brighton,1,1,D,1,1,2,3,0,1,2,2,12,15,45,36,3,9,July,-0.4999999999999998,-0.8660254037844388,38,10,2,3,0,1.4,0.8,45,58,-13,36,52,-16,"July, 2020"
2019-2020,36,2020-07-17,West Ham,Watford,3,1,H,3,0,2,2,1,2,0,3,16,17,34,34,1,0,July,-0.4999999999999998,-0.8660254037844388,45,43,3,0,2,1.8,1.2,44,59,-15,33,54,-21,"July, 2020"
2019-2020,37,2020-07-18,Norwich,Burnley,0,2,A,0,3,0,0,5,2,2,1,20,10,21,51,10,30,July,-0.4999999999999998,-0.8660254037844388,31,11,0,0,1,0.0,2.0,26,68,-42,40,48,-8,"July, 2020"
2019-2020,37,2020-07-19,Tottenham,Leicester,3,0,H,3,0,3,2,0,1,1,3,7,4,55,62,3,7,July,-0.4999999999999998,-0.8660254037844388,42,24,3,0,2,2.4,1.8,57,46,11,67,36,31,"July, 2020"
2019-2020,37,2020-07-19,Bournemouth,Southampton,0,2,A,0,3,2,1,2,2,3,0,18,12,31,46,6,15,July,-0.4999999999999998,-0.8660254037844388,7,38,1,3,1,1.6,1.4,37,62,-25,46,59,-13,"July, 2020"
2019-2020,37,2020-07-20,Wolves,Crystal Palace,2,0,H,3,0,2,1,2,0,1,4,7,14,56,42,7,14,July,-0.4999999999999998,-0.8660254037844388,48,16,1,1,1,0.6666666666666666,1.0,49,38,11,30,47,-17,"July, 2020"
2019-2020,37,2020-07-20,Sheffield United,Everton,0,1,A,0,3,2,0,3,1,2,2,8,12,54,46,4,8,July,-0.4999999999999998,-0.8660254037844388,36,18,1,1,1,1.0,1.0,38,35,3,42,53,-11,"July, 2020"
2019-2020,37,2020-07-20,Brighton,Newcastle,0,0,D,1,1,1,2,2,0,1,4,16,13,37,43,3,6,July,-0.4999999999999998,-0.8660254037844388,10,30,2,3,0,0.6,0.2,37,53,-16,37,55,-18,"July, 2020"
2019-2020,37,2020-07-21,Watford,Man City,0,4,A,0,3,2,0,3,5,0,0,17,2,34,75,15,41,July,-0.4999999999999998,-0.8660254037844388,43,27,0,0,5,0.6,4.4,34,57,-23,93,35,58,"July, 2020"
2019-2020,37,2020-07-21,Aston Villa,Arsenal,1,0,H,3,0,2,2,1,2,1,2,18,10,31,53,8,22,July,-0.4999999999999998,-0.8660254037844388,1,0,0,0,5,0.4,3.4,39,66,-27,53,45,8,"July, 2020"
2019-2020,37,2020-07-22,Man United,West Ham,1,1,D,1,1,3,2,0,2,2,1,5,16,62,37,11,25,July,-0.4999999999999998,-0.8660254037844388,28,45,2,1,2,1.4,1.2,63,35,28,47,60,-13,"July, 2020"
2019-2020,37,2020-07-22,Liverpool,Chelsea,5,3,H,3,0,3,1,1,3,0,2,1,4,93,63,3,30,July,-0.4999999999999998,-0.8660254037844388,25,14,2,2,1,1.2,0.8,77,29,48,64,49,15,"July, 2020"
2019-2020,38,2020-07-26,West Ham,Aston Villa,1,1,D,1,1,2,2,1,2,2,1,16,18,38,34,2,4,July,-0.4999999999999998,-0.8660254037844388,45,1,1,3,1,0.6,0.4,48,61,-13,40,66,-26,"July, 2020"
2019-2020,38,2020-07-26,Southampton,Sheffield United,3,1,H,3,0,2,3,0,2,0,3,11,9,49,54,2,5,July,-0.4999999999999998,-0.8660254037844388,38,36,1,0,0,1.0,0.0,48,59,-11,38,36,2,"July, 2020"
2019-2020,38,2020-07-26,Newcastle,Liverpool,1,3,A,0,3,0,1,4,3,1,1,13,1,44,96,12,52,July,-0.4999999999999998,-0.8660254037844388,30,25,0,1,4,0.8,2.6,37,55,-18,82,32,50,"July, 2020"
2019-2020,38,2020-07-26,Man City,Norwich,5,0,H,3,0,5,0,0,0,0,5,2,20,78,21,18,57,July,-0.4999999999999998,-0.8660254037844388,27,31,2,2,1,2.2,0.8,97,35,62,26,70,-44,"July, 2020"
2019-2020,38,2020-07-26,Leicester,Man United,0,2,A,0,3,1,1,3,3,2,0,5,4,62,63,1,1,July,-0.4999999999999998,-0.8660254037844388,24,28,0,1,4,0.6,1.6,67,39,28,64,36,28,"July, 2020"
2019-2020,38,2020-07-26,Everton,Bournemouth,1,3,A,0,3,1,2,2,2,1,2,11,19,49,31,8,18,July,-0.4999999999999998,-0.8660254037844388,18,7,2,1,2,1.6,1.6,43,53,-10,37,64,-27,"July, 2020"
2019-2020,38,2020-07-26,Crystal Palace,Tottenham,1,1,D,1,1,0,1,4,3,2,0,14,7,42,58,7,16,July,-0.4999999999999998,-0.8660254037844388,16,42,0,0,5,0.0,1.8,30,49,-19,60,46,14,"July, 2020"
2019-2020,38,2020-07-26,Chelsea,Wolves,2,0,H,3,0,3,0,2,2,1,2,4,6,63,59,2,4,July,-0.4999999999999998,-0.8660254037844388,14,48,3,1,1,2.4,1.2,67,54,13,51,38,13,"July, 2020"
2019-2020,38,2020-07-26,Burnley,Brighton,1,2,A,0,3,2,2,1,1,2,2,10,16,54,38,6,16,July,-0.4999999999999998,-0.8660254037844388,11,10,2,3,0,1.0,0.4,42,48,-6,37,53,-16,"July, 2020"
2019-2020,38,2020-07-26,Arsenal,Watford,3,2,H,3,0,2,1,2,2,0,3,10,18,53,34,8,19,July,-0.4999999999999998,-0.8660254037844388,0,43,3,1,1,1.8,0.8,53,46,7,34,61,-27,"July, 2020"
2020-2021,1,2020-09-12,Fulham,Arsenal,0,3,A,0,3,0,1,4,5,0,0,8,1,0,0,7,0,September,-1.0,-1.8369701987210287e-16,19,0,0,0,5,0.6,3.0,0,0,0,0,0,0,"September, 2020"
2020-2021,1,2020-09-12,Crystal Palace,Southampton,1,0,H,3,0,2,0,3,2,0,3,6,15,0,0,9,0,September,-1.0,-1.8369701987210287e-16,16,38,1,2,2,0.8,1.4,0,0,0,0,0,0,"September, 2020"
2020-2021,1,2020-09-12,Liverpool,Leeds,4,3,H,3,0,5,0,0,4,0,1,10,8,0,0,2,0,September,-1.0,-1.8369701987210287e-16,25,23,4,1,0,2.6,0.8,0,0,0,0,0,0,"September, 2020"
2020-2021,1,2020-09-12,West Ham,Newcastle,0,2,A,0,3,3,1,1,3,0,2,16,12,0,0,4,0,September,-1.0,-1.8369701987210287e-16,45,30,2,1,2,2.2,1.6,0,0,0,0,0,0,"September, 2020"
2020-2021,1,2020-09-13,Tottenham,Everton,0,1,A,0,3,3,0,2,2,1,2,14,10,0,0,4,0,September,-1.0,-1.8369701987210287e-16,42,18,3,2,0,2.8,1.0,0,0,0,0,0,0,"September, 2020"
2020-2021,1,2020-09-13,West Brom,Leicester,0,3,A,0,3,0,1,4,1,1,3,15,10,0,0,5,0,September,-1.0,-1.8369701987210287e-16,44,24,1,2,2,1.2,1.8,0,0,0,0,0,0,"September, 2020"
2020-2021,1,2020-09-14,Brighton,Chelsea,1,3,A,0,3,2,1,2,3,0,2,8,10,0,0,2,0,September,-1.0,-1.8369701987210287e-16,10,14,0,1,4,0.4,2.4,0,0,0,0,0,0,"September, 2020"
2020-2021,1,2020-09-14,Sheffield United,Wolves,0,2,A,0,3,2,0,3,1,1,3,12,13,0,0,1,0,September,-1.0,-1.8369701987210287e-16,36,48,1,1,0,1.0,0.5,0,0,0,0,0,0,"September, 2020"
2020-2021,2,2020-09-19,Everton,West Brom,5,2,H,3,0,2,1,2,0,1,4,8,20,3,0,12,3,September,-1.0,-1.8369701987210287e-16,18,44,2,2,1,1.2,0.6,1,0,1,0,3,-3,"September, 2020"
2020-2021,2,2020-09-19,Leeds,Fulham,4,3,H,3,0,4,0,1,0,1,4,13,19,0,0,6,0,September,-1.0,-1.8369701987210287e-16,23,19,2,0,3,1.0,1.2,3,4,-1,0,3,-3,"September, 2020"
2020-2021,2,2020-09-19,Man United,Crystal Palace,1,3,A,0,3,2,1,2,2,0,3,13,8,0,3,5,3,September,-1.0,-1.8369701987210287e-16,28,16,3,1,1,1.8,1.0,0,0,0,1,0,1,"September, 2020"
2020-2021,2,2020-09-19,Arsenal,West Ham,2,1,H,3,0,5,0,0,3,1,1,3,18,3,0,15,3,September,-1.0,-1.8369701987210287e-16,0,45,4,0,1,2.2,0.8,3,0,3,0,2,-2,"September, 2020"
2020-2021,2,2020-09-20,Newcastle,Brighton,0,3,A,0,3,3,0,2,2,1,2,7,14,3,0,7,3,September,-1.0,-1.8369701987210287e-16,30,10,0,4,1,0.2,0.4,2,0,2,1,3,-2,"September, 2020"
2020-2021,2,2020-09-20,Southampton,Tottenham,2,5,A,0,3,2,0,3,3,0,2,13,14,0,0,1,0,September,-1.0,-1.8369701987210287e-16,38,42,2,1,2,1.2,1.4,0,1,-1,0,1,-1,"September, 2020"
2020-2021,2,2020-09-20,Chelsea,Liverpool,0,2,A,0,3,3,0,2,5,0,0,6,9,3,3,3,0,September,-1.0,-1.8369701987210287e-16,14,25,1,1,3,1.2,2.0,3,1,2,4,3,1,"September, 2020"
2020-2021,2,2020-09-20,Leicester,Burnley,4,2,H,3,0,1,1,3,1,0,4,5,13,3,0,8,3,September,-1.0,-1.8369701987210287e-16,24,11,2,1,2,1.2,1.2,3,0,3,0,0,0,"September, 2020"
2020-2021,2,2020-09-21,Aston Villa,Sheffield United,1,0,H,3,0,2,1,2,2,0,3,12,16,0,0,4,0,September,-1.0,-1.8369701987210287e-16,1,36,1,2,1,1.25,1.0,0,0,0,0,2,-2,"September, 2020"
2020-2021,2,2020-09-21,Wolves,Man City,1,3,A,0,3,1,1,3,3,0,2,7,13,3,0,6,3,September,-1.0,-1.8369701987210287e-16,48,27,2,1,2,1.2,1.6,2,0,2,0,0,0,"September, 2020"
2020-2021,3,2020-09-26,West Brom,Chelsea,3,3,D,1,1,0,1,4,3,0,2,20,11,0,3,9,3,September,-1.0,-1.8369701987210287e-16,44,14,0,1,4,0.4,2.2,2,8,-6,3,3,0,"September, 2020"
2020-2021,3,2020-09-26,Burnley,Southampton,0,1,A,0,3,1,0,4,2,0,3,16,20,0,0,4,0,September,-1.0,-1.8369701987210287e-16,11,38,2,3,0,1.4,0.6,2,4,-2,2,6,-4,"September, 2020"
2020-2021,3,2020-09-26,Brighton,Man United,2,3,A,0,3,2,1,2,2,1,2,8,15,3,0,7,3,September,-1.0,-1.8369701987210287e-16,10,28,2,0,3,1.2,2.0,4,3,1,1,3,-2,"September, 2020"
2020-2021,3,2020-09-26,Crystal Palace,Everton,1,2,A,0,3,2,0,3,2,1,2,5,2,6,6,3,0,September,-1.0,-1.8369701987210287e-16,16,18,0,2,3,0.4,1.6,4,1,3,6,2,4,"September, 2020"
2020-2021,3,2020-09-27,Man City,Leicester,2,5,A,0,3,3,0,2,1,1,3,10,2,3,6,8,3,September,-1.0,-1.8369701987210287e-16,27,24,4,0,1,2.2,0.8,3,1,2,7,2,5,"September, 2020"
2020-2021,3,2020-09-27,West Ham,Wolves,4,0,H,3,0,3,1,1,1,1,3,18,12,0,3,6,3,September,-1.0,-1.8369701987210287e-16,45,48,1,0,4,0.4,1.6,1,4,-3,3,3,0,"September, 2020"
2020-2021,3,2020-09-27,Sheffield United,Leeds,0,1,A,0,3,2,0,3,4,0,1,19,10,0,3,9,3,September,-1.0,-1.8369701987210287e-16,36,23,0,0,0,0.0,0.0,0,3,-3,7,7,0,"September, 2020"
2020-2021,3,2020-09-27,Tottenham,Newcastle,1,1,D,1,1,3,0,2,3,0,2,8,14,3,3,6,0,September,-1.0,-1.8369701987210287e-16,42,30,4,0,1,1.4,0.6,5,3,2,2,3,-1,"September, 2020"
2020-2021,3,2020-09-28,Liverpool,Arsenal,3,1,H,3,0,5,0,0,5,0,0,5,3,6,6,2,0,September,-1.0,-1.8369701987210287e-16,25,0,2,2,1,2.6,1.6,6,3,3,5,1,4,"September, 2020"
2020-2021,3,2020-09-28,Fulham,Aston Villa,0,3,A,0,3,0,1,4,2,1,2,19,11,0,3,8,3,September,-1.0,-1.8369701987210287e-16,19,1,3,1,1,1.2,0.6,3,7,-4,1,0,1,"September, 2020"
2020-2021,4,2020-10-03,Newcastle,Burnley,3,1,H,3,0,3,0,2,1,0,4,11,18,4,0,7,4,October,-0.8660254037844386,0.5,30,11,2,2,1,1.0,0.6,3,4,-1,2,5,-3,"October, 2020"
2020-2021,4,2020-10-03,Leeds,Man City,1,1,D,1,1,4,0,1,3,0,2,7,12,6,3,5,3,October,-0.8660254037844386,0.5,23,27,3,1,1,2.2,0.8,8,7,1,5,6,-1,"October, 2020"
2020-2021,4,2020-10-03,Chelsea,Crystal Palace,4,0,H,3,0,3,0,2,2,0,3,9,6,4,6,3,2,October,-0.8660254037844386,0.5,14,16,5,0,0,2.2,0.8,6,6,0,5,3,2,"October, 2020"
2020-2021,4,2020-10-03,Everton,Brighton,4,2,H,3,0,2,1,2,2,1,2,3,12,9,3,9,6,October,-0.8660254037844386,0.5,18,10,3,0,2,1.6,1.0,8,3,5,6,6,0,"October, 2020"
2020-2021,4,2020-10-04,Leicester,West Ham,0,3,A,0,3,1,1,3,3,1,1,2,12,9,3,10,6,October,-0.8660254037844386,0.5,24,45,2,2,1,1.8,1.4,12,4,8,5,4,1,"October, 2020"
2020-2021,4,2020-10-04,Southampton,West Brom,2,0,H,3,0,2,0,3,0,1,4,15,17,3,1,2,2,October,-0.8660254037844386,0.5,38,44,4,0,1,1.8,0.8,3,6,-3,5,11,-6,"October, 2020"
2020-2021,4,2020-10-04,Arsenal,Sheffield United,2,1,H,3,0,5,0,0,2,0,3,9,18,6,0,9,6,October,-0.8660254037844386,0.5,0,36,1,1,2,1.0,0.75,6,4,2,0,4,-4,"October, 2020"
2020-2021,4,2020-10-04,Wolves,Fulham,1,0,H,3,0,1,1,3,0,1,4,16,20,3,0,4,3,October,-0.8660254037844386,0.5,48,19,2,2,1,1.0,1.4,3,7,-4,3,10,-7,"October, 2020"
2020-2021,4,2020-10-04,Man United,Tottenham,1,6,A,0,3,2,1,2,3,0,2,15,13,3,4,2,1,October,-0.8660254037844386,0.5,28,42,2,1,2,0.8,1.4,4,5,-1,6,4,2,"October, 2020"
2020-2021,4,2020-10-04,Aston Villa,Liverpool,7,2,H,3,0,2,1,2,5,0,0,10,3,6,9,7,3,October,-0.8660254037844386,0.5,1,25,0,0,5,0.6,3.0,4,0,4,9,4,5,"October, 2020"
2020-2021,5,2020-10-17,Newcastle,Man United,1,4,A,0,3,3,0,2,2,1,2,9,16,7,3,7,4,October,-0.8660254037844386,0.5,30,28,2,0,3,1.0,1.8,6,5,1,5,11,-6,"October, 2020"
2020-2021,5,2020-10-17,Man City,Arsenal,1,0,H,3,0,3,0,2,5,0,0,14,5,4,9,9,5,October,-0.8660254037844386,0.5,27,0,5,0,0,2.8,0.2,6,7,-1,8,5,3,"October, 2020"
2020-2021,5,2020-10-17,Everton,Liverpool,2,2,D,1,1,2,1,2,5,0,0,1,5,12,9,4,3,October,-0.8660254037844386,0.5,18,25,0,3,2,0.4,1.2,12,5,7,11,11,0,"October, 2020"
2020-2021,5,2020-10-17,Chelsea,Southampton,3,3,D,1,1,3,0,2,2,0,3,7,11,7,6,4,1,October,-0.8660254037844386,0.5,14,38,3,1,1,2.0,1.0,10,6,4,5,6,-1,"October, 2020"
2020-2021,5,2020-10-18,Sheffield United,Fulham,1,1,D,1,1,2,0,3,0,1,4,19,20,0,0,1,0,October,-0.8660254037844386,0.5,36,19,1,0,1,1.0,0.5,1,6,-5,3,11,-8,"October, 2020"
2020-2021,5,2020-10-18,Crystal Palace,Brighton,1,1,D,1,1,2,0,3,2,1,2,13,16,6,3,3,3,October,-0.8660254037844386,0.5,16,10,2,1,2,1.4,1.6,5,7,-2,8,10,-2,"October, 2020"
2020-2021,5,2020-10-18,Tottenham,West Ham,3,3,D,1,1,3,0,2,3,1,1,7,13,7,6,6,1,October,-0.8660254037844386,0.5,42,45,3,1,1,1.4,0.8,12,5,7,8,4,4,"October, 2020"
2020-2021,5,2020-10-18,Leicester,Aston Villa,0,1,A,0,3,1,1,3,2,1,2,4,3,9,9,1,0,October,-0.8660254037844386,0.5,24,1,4,1,0,2.6,0.8,12,7,5,11,2,9,"October, 2020"
2020-2021,5,2020-10-19,West Brom,Burnley,0,0,D,1,1,0,1,4,1,0,4,18,20,1,0,2,1,October,-0.8660254037844386,0.5,44,11,2,2,1,2.0,1.2,5,13,-8,3,8,-5,"October, 2020"
2020-2021,5,2020-10-19,Leeds,Wolves,0,1,A,0,3,4,0,1,1,1,3,9,15,7,6,6,1,October,-0.8660254037844386,0.5,23,48,1,0,1,2.5,2.0,9,8,1,4,7,-3,"October, 2020"
2020-2021,6,2020-10-23,Aston Villa,Leeds,0,3,A,0,3,2,1,2,4,0,1,2,10,12,7,8,5,October,-0.8660254037844386,0.5,1,23,1,2,2,0.6,0.8,12,2,10,9,9,0,"October, 2020"
2020-2021,6,2020-10-24,Liverpool,Sheffield United,2,1,H,3,0,5,0,0,2,0,3,4,19,10,1,15,9,October,-0.8660254037844386,0.5,25,36,3,1,0,2.0,0.25,13,13,0,2,7,-5,"October, 2020"
2020-2021,6,2020-10-24,Man United,Chelsea,0,0,D,1,1,2,1,2,3,0,2,15,10,6,8,5,2,October,-0.8660254037844386,0.5,28,14,3,2,0,2.2,0.8,9,12,-3,13,9,4,"October, 2020"
2020-2021,6,2020-10-24,West Ham,Man City,1,1,D,1,1,3,1,1,3,0,2,10,11,7,7,1,0,October,-0.8660254037844386,0.5,45,27,0,0,5,0.2,3.2,11,7,4,7,7,0,"October, 2020"
2020-2021,6,2020-10-24,Fulham,Crystal Palace,1,2,A,0,3,0,1,4,2,0,3,20,14,1,7,6,6,October,-0.8660254037844386,0.5,19,16,2,1,2,1.8,1.6,4,12,-8,6,8,-2,"October, 2020"
2020-2021,6,2020-10-25,Southampton,Everton,2,0,H,3,0,2,0,3,2,1,2,13,1,7,13,12,6,October,-0.8660254037844386,0.5,38,18,1,2,2,1.2,1.4,8,9,-1,14,7,7,"October, 2020"
2020-2021,6,2020-10-25,Wolves,Newcastle,1,1,D,1,1,1,1,3,3,0,2,10,14,9,7,4,2,October,-0.8660254037844386,0.5,48,30,1,4,0,1.4,1.2,5,7,-2,7,9,-2,"October, 2020"
2020-2021,6,2020-10-25,Arsenal,Leicester,0,1,A,0,3,5,0,0,1,1,3,10,9,9,9,1,0,October,-0.8660254037844386,0.5,0,24,1,1,3,1.0,2.0,8,6,2,12,8,4,"October, 2020"
2020-2021,6,2020-10-26,Brighton,West Brom,1,1,D,1,1,2,1,2,0,1,4,16,17,4,2,1,2,October,-0.8660254037844386,0.5,10,44,1,0,1,1.5,1.5,9,11,-2,5,13,-8,"October, 2020"
2020-2021,6,2020-10-26,Burnley,Tottenham,0,1,A,0,3,1,0,4,3,0,2,18,11,1,8,7,7,October,-0.8660254037844386,0.5,11,42,1,1,3,0.6,2.2,3,8,-5,15,8,7,"October, 2020"
2020-2021,7,2020-10-30,Wolves,Crystal Palace,2,0,H,3,0,1,1,3,2,0,3,9,8,10,10,1,0,October,-0.8660254037844386,0.5,48,16,2,1,1,1.0,0.75,6,8,-2,8,9,-1,"October, 2020"
2020-2021,7,2020-10-31,Liverpool,West Ham,2,1,H,3,0,5,0,0,3,1,1,2,13,13,8,11,5,October,-0.8660254037844386,0.5,25,45,4,1,0,2.8,0.8,15,14,1,12,8,4,"October, 2020"
2020-2021,7,2020-10-31,Burnley,Chelsea,0,3,A,0,3,1,0,4,3,0,2,18,11,1,9,7,8,October,-0.8660254037844386,0.5,11,14,0,1,4,1.0,3.0,3,9,-6,13,9,4,"October, 2020"
2020-2021,7,2020-10-31,Sheffield United,Man City,0,1,A,0,3,2,0,3,3,0,2,19,13,1,8,6,7,October,-0.8660254037844386,0.5,36,27,0,1,3,0.0,1.0,3,9,-6,8,8,0,"October, 2020"
2020-2021,7,2020-11-01,Aston Villa,Southampton,3,4,A,0,3,2,1,2,2,0,3,5,10,12,10,5,2,November,-0.5000000000000004,0.8660254037844384,1,38,0,1,4,1.0,3.2,12,5,7,10,9,1,"November, 2020"
2020-2021,7,2020-11-01,Newcastle,Everton,2,1,H,3,0,3,0,2,2,1,2,14,2,8,13,12,5,November,-0.5000000000000004,0.8660254037844384,30,18,1,2,2,1.4,1.6,8,10,-2,14,9,5,"November, 2020"
2020-2021,7,2020-11-01,Man United,Arsenal,0,1,A,0,3,2,1,2,5,0,0,15,13,7,9,2,2,November,-0.5000000000000004,0.8660254037844384,28,0,1,2,2,1.0,1.6,9,12,-3,8,7,1,"November, 2020"
2020-2021,7,2020-11-01,Tottenham,Brighton,2,1,H,3,0,3,0,2,2,1,2,9,16,11,5,7,6,November,-0.5000000000000004,0.8660254037844384,42,10,3,1,1,1.2,1.2,16,8,8,10,12,-2,"November, 2020"
2020-2021,7,2020-11-02,Fulham,West Brom,2,0,H,3,0,0,1,4,0,1,4,19,17,1,3,2,2,November,-0.5000000000000004,0.8660254037844384,19,44,2,3,0,1.6,0.8,5,14,-9,6,14,-8,"November, 2020"
2020-2021,7,2020-11-02,Leeds,Leicester,1,4,A,0,3,4,0,1,1,1,3,12,8,10,12,4,2,November,-0.5000000000000004,0.8660254037844384,23,24,3,1,1,2.0,1.8,12,9,3,13,8,5,"November, 2020"
2020-2021,8,2020-11-06,Brighton,Burnley,0,0,D,1,1,2,1,2,1,0,4,16,20,5,1,4,4,November,-0.5000000000000004,0.8660254037844384,10,11,1,2,2,0.8,1.2,11,14,-3,3,12,-9,"November, 2020"
2020-2021,8,2020-11-06,Southampton,Newcastle,2,0,H,3,0,2,0,3,3,0,2,5,11,13,11,6,2,November,-0.5000000000000004,0.8660254037844384,38,30,0,1,4,0.4,1.8,14,12,2,10,11,-1,"November, 2020"
2020-2021,8,2020-11-07,West Ham,Fulham,1,0,H,3,0,3,1,1,0,1,4,15,17,8,4,2,4,November,-0.5000000000000004,0.8660254037844384,45,19,3,0,2,2.0,1.2,13,10,3,7,14,-7,"November, 2020"
2020-2021,8,2020-11-07,Chelsea,Sheffield United,4,1,H,3,0,3,0,2,2,0,3,8,20,12,1,12,11,November,-0.5000000000000004,0.8660254037844384,14,36,2,1,1,1.75,1.25,16,9,7,3,10,-7,"November, 2020"
2020-2021,8,2020-11-07,Crystal Palace,Leeds,4,1,H,3,0,2,0,3,4,0,1,14,12,10,10,2,0,November,-0.5000000000000004,0.8660254037844384,16,23,1,0,1,1.0,1.0,8,11,-3,13,13,0,"November, 2020"
2020-2021,8,2020-11-07,Everton,Man United,1,3,A,0,3,2,1,2,2,1,2,5,15,13,7,10,6,November,-0.5000000000000004,0.8660254037844384,18,28,1,2,2,1.4,1.2,15,11,4,9,13,-4,"November, 2020"
2020-2021,8,2020-11-08,West Brom,Tottenham,0,1,A,0,3,0,1,4,3,0,2,18,5,3,14,13,11,November,-0.5000000000000004,0.8660254037844384,44,42,1,3,1,0.8,1.4,6,16,-10,18,9,9,"November, 2020"
2020-2021,8,2020-11-08,Leicester,Wolves,1,0,H,3,0,1,1,3,1,1,3,5,8,15,13,3,2,November,-0.5000000000000004,0.8660254037844384,24,48,1,3,1,1.0,0.8,17,9,8,8,8,0,"November, 2020"
2020-2021,8,2020-11-08,Man City,Liverpool,1,1,D,1,1,3,0,2,5,0,0,12,4,11,16,8,5,November,-0.5000000000000004,0.8660254037844384,27,25,2,1,2,2.0,1.6,9,8,1,17,15,2,"November, 2020"
2020-2021,8,2020-11-08,Arsenal,Aston Villa,0,3,A,0,3,5,0,0,2,1,2,10,9,12,12,1,0,November,-0.5000000000000004,0.8660254037844384,0,1,4,0,1,2.8,0.6,9,7,2,15,9,6,"November, 2020"
2020-2021,9,2020-11-21,Tottenham,Man City,2,0,H,3,0,3,0,2,3,0,2,3,10,17,12,7,5,November,-0.5000000000000004,0.8660254037844384,42,27,1,1,3,1.0,1.4,19,9,10,10,9,1,"November, 2020"
2020-2021,9,2020-11-21,Man United,West Brom,1,0,H,3,0,2,1,2,0,1,4,14,18,10,3,4,7,November,-0.5000000000000004,0.8660254037844384,28,44,2,1,2,0.8,0.6,12,14,-2,6,17,-11,"November, 2020"
2020-2021,9,2020-11-21,Newcastle,Chelsea,0,2,A,0,3,3,0,2,3,0,2,13,5,11,15,8,4,November,-0.5000000000000004,0.8660254037844384,30,14,2,0,3,1.2,1.0,10,13,-3,20,10,10,"November, 2020"
2020-2021,9,2020-11-21,Aston Villa,Brighton,1,2,A,0,3,2,1,2,2,1,2,6,16,15,6,10,9,November,-0.5000000000000004,0.8660254037844384,1,10,1,1,0,1.5,1.0,18,9,9,11,14,-3,"November, 2020"
2020-2021,9,2020-11-22,Fulham,Everton,2,3,A,0,3,0,1,4,2,1,2,17,7,4,13,10,9,November,-0.5000000000000004,0.8660254037844384,19,18,1,0,4,0.8,2.2,7,15,-8,16,14,2,"November, 2020"
2020-2021,9,2020-11-22,Sheffield United,West Ham,0,1,A,0,3,2,0,3,3,1,1,20,13,1,11,7,10,November,-0.5000000000000004,0.8660254037844384,36,45,2,1,1,1.25,0.5,4,14,-10,14,10,4,"November, 2020"
2020-2021,9,2020-11-22,Leeds,Arsenal,0,0,D,1,1,4,0,1,5,0,0,15,13,10,12,2,2,November,-0.5000000000000004,0.8660254037844384,23,0,1,1,3,1.2,3.2,14,17,-3,9,10,-1,"November, 2020"
2020-2021,9,2020-11-22,Liverpool,Leicester,3,0,H,3,0,5,0,0,1,1,3,4,3,17,18,1,1,November,-0.5000000000000004,0.8660254037844384,25,24,4,1,0,2.2,0.8,18,16,2,18,9,9,"November, 2020"
2020-2021,9,2020-11-23,Burnley,Crystal Palace,1,0,H,3,0,1,0,4,2,0,3,19,9,2,13,10,11,November,-0.5000000000000004,0.8660254037844384,11,16,1,0,4,0.4,1.6,3,12,-9,12,12,0,"November, 2020"
2020-2021,9,2020-11-23,Wolves,Southampton,1,1,D,1,1,1,1,3,2,0,3,12,5,13,16,7,3,November,-0.5000000000000004,0.8660254037844384,48,38,2,1,2,1.6,2.0,8,9,-1,16,12,4,"November, 2020"
2020-2021,10,2020-11-27,Crystal Palace,Newcastle,0,2,A,0,3,2,0,3,3,0,2,11,15,13,11,4,2,November,-0.5000000000000004,0.8660254037844384,16,30,2,2,1,0.6,0.4,12,13,-1,10,15,-5,"November, 2020"
2020-2021,10,2020-11-28,Everton,Leeds,0,1,A,0,3,2,1,2,4,0,1,6,15,16,11,9,5,November,-0.5000000000000004,0.8660254037844384,18,23,3,2,0,1.6,0.2,19,16,3,14,17,-3,"November, 2020"
2020-2021,10,2020-11-28,West Brom,Sheffield United,1,0,H,3,0,0,1,4,2,0,3,19,20,3,1,1,2,November,-0.5000000000000004,0.8660254037844384,44,36,0,0,0,0.0,0.0,6,18,-12,4,15,-11,"November, 2020"
2020-2021,10,2020-11-28,Brighton,Liverpool,1,1,D,1,1,2,1,2,5,0,0,16,2,9,20,14,11,November,-0.5000000000000004,0.8660254037844384,10,25,0,0,5,0.4,2.2,13,15,-2,21,16,5,"November, 2020"
2020-2021,10,2020-11-28,Man City,Burnley,5,0,H,3,0,3,0,2,1,0,4,14,17,12,5,3,7,November,-0.5000000000000004,0.8660254037844384,27,11,4,1,0,3.2,0.4,10,11,-1,4,12,-8,"November, 2020"
2020-2021,10,2020-11-29,Southampton,Man United,2,3,A,0,3,2,0,3,2,1,2,5,13,17,13,8,4,November,-0.5000000000000004,0.8660254037844384,38,28,0,4,1,1.4,1.6,17,13,4,13,14,-1,"November, 2020"
2020-2021,10,2020-11-29,Chelsea,Tottenham,0,0,D,1,1,3,0,2,3,0,2,3,2,18,20,1,2,November,-0.5000000000000004,0.8660254037844384,14,42,3,0,2,1.6,1.4,22,10,12,21,9,12,"November, 2020"
2020-2021,10,2020-11-29,Arsenal,Wolves,1,2,A,0,3,5,0,0,1,1,3,14,11,13,14,3,1,November,-0.5000000000000004,0.8660254037844384,0,48,2,2,1,1.6,1.0,9,10,-1,9,10,-1,"November, 2020"
2020-2021,10,2020-11-30,Leicester,Fulham,1,2,A,0,3,1,1,3,0,1,4,4,19,18,4,15,14,November,-0.5000000000000004,0.8660254037844384,24,19,1,2,2,0.8,1.2,18,12,6,9,18,-9,"November, 2020"
2020-2021,10,2020-11-30,West Ham,Aston Villa,2,1,H,3,0,3,1,1,2,1,2,11,9,14,15,2,1,November,-0.5000000000000004,0.8660254037844384,45,1,1,3,1,0.8,0.6,15,10,5,19,11,8,"November, 2020"
2020-2021,11,2020-12-05,West Ham,Man United,1,3,A,0,3,3,1,1,2,1,2,6,10,17,16,4,1,December,-2.4492935982947064e-16,1.0,45,28,2,2,1,1.4,0.8,17,11,6,16,16,0,"December, 2020"
2020-2021,11,2020-12-05,Chelsea,Leeds,3,1,H,3,0,3,0,2,4,0,1,3,12,19,14,9,5,December,-2.4492935982947064e-16,1.0,14,23,3,1,1,1.4,1.0,22,10,12,15,17,-2,"December, 2020"
2020-2021,11,2020-12-05,Burnley,Everton,1,1,D,1,1,1,0,4,2,1,2,19,8,5,16,11,11,December,-2.4492935982947064e-16,1.0,11,18,2,0,3,0.8,1.8,4,17,-13,19,17,2,"December, 2020"
2020-2021,11,2020-12-05,Man City,Fulham,2,0,H,3,0,3,0,2,0,1,4,11,17,15,7,6,8,December,-2.4492935982947064e-16,1.0,27,19,5,0,0,3.2,0.4,15,11,4,11,19,-8,"December, 2020"
2020-2021,11,2020-12-06,West Brom,Crystal Palace,1,5,A,0,3,0,1,4,2,0,3,18,15,6,13,3,7,December,-2.4492935982947064e-16,1.0,44,16,2,1,2,0.8,1.2,7,18,-11,12,15,-3,"December, 2020"
2020-2021,11,2020-12-06,Sheffield United,Leicester,1,2,A,0,3,2,0,3,1,1,3,20,6,1,18,14,17,December,-2.4492935982947064e-16,1.0,36,24,0,0,2,0.5,2.0,4,16,-12,19,14,5,"December, 2020"
2020-2021,11,2020-12-06,Tottenham,Arsenal,2,0,H,3,0,3,0,2,5,0,0,2,15,21,13,13,8,December,-2.4492935982947064e-16,1.0,42,0,2,2,1,1.6,1.6,21,9,12,10,12,-2,"December, 2020"
2020-2021,11,2020-12-06,Liverpool,Wolves,4,0,H,3,0,5,0,0,1,1,3,4,10,21,17,6,4,December,-2.4492935982947064e-16,1.0,25,48,5,0,0,2.0,0.2,22,17,5,11,11,0,"December, 2020"
2020-2021,11,2020-12-07,Brighton,Southampton,1,2,A,0,3,2,1,2,2,0,3,16,8,10,17,8,7,December,-2.4492935982947064e-16,1.0,10,38,0,3,2,0.8,1.4,14,16,-2,19,16,3,"December, 2020"
2020-2021,12,2020-12-11,Leeds,West Ham,1,2,A,0,3,4,0,1,3,1,1,14,8,14,17,6,3,December,-2.4492935982947064e-16,1.0,23,45,4,1,0,2.0,0.6,16,20,-4,18,14,4,"December, 2020"
2020-2021,12,2020-12-12,Man United,Man City,0,0,D,1,1,2,1,2,3,0,2,7,9,19,18,2,1,December,-2.4492935982947064e-16,1.0,28,27,3,0,2,1.6,1.6,19,17,2,17,11,6,"December, 2020"
2020-2021,12,2020-12-12,Wolves,Aston Villa,0,1,A,0,3,1,1,3,2,1,2,10,12,17,15,2,2,December,-2.4492935982947064e-16,1.0,48,1,3,1,1,1.2,0.8,11,15,-4,20,13,7,"December, 2020"
2020-2021,12,2020-12-12,Newcastle,West Brom,2,1,H,3,0,3,0,2,0,1,4,13,19,14,6,6,8,December,-2.4492935982947064e-16,1.0,30,44,1,2,2,0.8,1.0,12,15,-3,8,23,-15,"December, 2020"
2020-2021,12,2020-12-12,Everton,Chelsea,1,0,H,3,0,2,1,2,3,0,2,10,3,17,22,7,5,December,-2.4492935982947064e-16,1.0,18,14,2,2,1,1.0,1.0,20,18,2,25,11,14,"December, 2020"
2020-2021,12,2020-12-13,Arsenal,Burnley,0,1,A,0,3,5,0,0,1,0,4,15,18,13,6,3,7,December,-2.4492935982947064e-16,1.0,0,11,4,1,0,2.6,0.6,10,14,-4,5,18,-13,"December, 2020"
2020-2021,12,2020-12-13,Fulham,Liverpool,1,1,D,1,1,0,1,4,5,0,0,17,2,7,24,15,17,December,-2.4492935982947064e-16,1.0,19,25,0,0,5,0.8,2.8,11,21,-10,26,17,9,"December, 2020"
2020-2021,12,2020-12-13,Leicester,Brighton,3,0,H,3,0,1,1,3,2,1,2,5,16,21,10,11,11,December,-2.4492935982947064e-16,1.0,24,10,3,2,0,1.4,0.4,21,15,6,15,18,-3,"December, 2020"
2020-2021,12,2020-12-13,Southampton,Sheffield United,3,0,H,3,0,2,0,3,2,0,3,6,20,20,1,14,19,December,-2.4492935982947064e-16,1.0,38,36,2,0,0,2.0,0.5,21,17,4,5,18,-13,"December, 2020"
2020-2021,12,2020-12-13,Crystal Palace,Tottenham,1,1,D,1,1,2,0,3,3,0,2,13,1,16,24,12,8,December,-2.4492935982947064e-16,1.0,16,42,0,1,4,0.2,1.8,17,16,1,23,9,14,"December, 2020"
2020-2021,13,2020-12-15,Man City,West Brom,1,1,D,1,1,3,0,2,0,1,4,10,19,19,6,9,13,December,-2.4492935982947064e-16,1.0,27,44,5,0,0,3.0,0.8,17,11,6,9,25,-16,"December, 2020"
2020-2021,13,2020-12-15,Wolves,Chelsea,2,1,H,3,0,1,1,3,3,0,2,13,5,17,22,8,5,December,-2.4492935982947064e-16,1.0,48,14,1,1,3,1.2,2.2,11,16,-5,25,12,13,"December, 2020"
2020-2021,13,2020-12-16,Arsenal,Southampton,1,1,D,1,1,5,0,0,2,0,3,15,4,13,23,11,10,December,-2.4492935982947064e-16,1.0,0,38,3,1,1,2.2,1.4,10,15,-5,24,17,7,"December, 2020"
2020-2021,13,2020-12-16,Leeds,Newcastle,5,2,H,3,0,4,0,1,3,0,2,14,13,14,17,1,3,December,-2.4492935982947064e-16,1.0,23,30,1,1,3,1.0,1.8,17,22,-5,14,16,-2,"December, 2020"
2020-2021,13,2020-12-16,Leicester,Everton,0,2,A,0,3,1,1,3,2,1,2,3,8,24,20,5,4,December,-2.4492935982947064e-16,1.0,24,18,2,0,3,1.2,1.4,24,15,9,21,18,3,"December, 2020"
2020-2021,13,2020-12-16,Fulham,Brighton,0,0,D,1,1,0,1,4,2,1,2,18,16,8,10,2,2,December,-2.4492935982947064e-16,1.0,19,10,1,1,0,3.0,2.0,12,22,-10,15,21,-6,"December, 2020"
2020-2021,13,2020-12-16,Liverpool,Tottenham,2,1,H,3,0,5,0,0,3,0,2,2,1,25,25,1,0,December,-2.4492935982947064e-16,1.0,25,42,4,1,0,1.8,1.0,27,18,9,24,10,14,"December, 2020"
2020-2021,13,2020-12-16,West Ham,Crystal Palace,1,1,D,1,1,3,1,1,2,0,3,8,12,20,17,4,3,December,-2.4492935982947064e-16,1.0,45,16,1,2,2,1.4,1.6,20,15,5,18,17,1,"December, 2020"
2020-2021,13,2020-12-17,Aston Villa,Burnley,0,0,D,1,1,2,1,2,1,0,4,11,18,18,9,7,9,December,-2.4492935982947064e-16,1.0,1,11,2,2,1,2.0,1.4,21,13,8,6,18,-12,"December, 2020"
2020-2021,13,2020-12-17,Sheffield United,Man United,2,3,A,0,3,2,0,3,2,1,2,20,9,1,20,11,19,December,-2.4492935982947064e-16,1.0,36,28,0,1,3,1.0,2.5,5,21,-16,19,17,2,"December, 2020"
2020-2021,14,2020-12-19,Newcastle,Fulham,1,1,D,1,1,3,0,2,0,1,4,14,18,17,9,4,8,December,-2.4492935982947064e-16,1.0,30,19,3,1,1,1.2,0.2,16,21,-5,12,22,-10,"December, 2020"
2020-2021,14,2020-12-19,Everton,Arsenal,2,1,H,3,0,2,1,2,5,0,0,6,15,23,14,9,9,December,-2.4492935982947064e-16,1.0,18,0,1,1,3,0.8,2.0,23,18,5,11,16,-5,"December, 2020"
2020-2021,14,2020-12-19,Crystal Palace,Liverpool,0,7,A,0,3,2,0,3,5,0,0,12,1,18,28,11,10,December,-2.4492935982947064e-16,1.0,16,25,0,0,5,1.0,2.8,19,18,1,29,19,10,"December, 2020"
2020-2021,14,2020-12-19,Southampton,Man City,0,1,A,0,3,2,0,3,3,0,2,3,9,24,20,6,4,December,-2.4492935982947064e-16,1.0,38,27,1,0,4,0.8,2.4,25,18,7,18,12,6,"December, 2020"
2020-2021,14,2020-12-20,Brighton,Sheffield United,1,1,D,1,1,2,1,2,2,0,3,16,20,11,1,4,10,December,-2.4492935982947064e-16,1.0,10,36,0,1,1,0.5,1.0,15,21,-6,7,24,-17,"December, 2020"
2020-2021,14,2020-12-20,Tottenham,Leicester,0,2,A,0,3,3,0,2,1,1,3,3,4,25,24,1,1,December,-2.4492935982947064e-16,1.0,42,24,4,0,1,2.8,1.4,25,12,13,24,17,7,"December, 2020"
2020-2021,14,2020-12-20,Man United,Leeds,6,2,H,3,0,2,1,2,4,0,1,7,14,23,17,7,6,December,-2.4492935982947064e-16,1.0,28,23,3,1,1,1.6,1.2,22,19,3,22,24,-2,"December, 2020"
2020-2021,14,2020-12-20,West Brom,Aston Villa,0,3,A,0,3,0,1,4,2,1,2,19,11,7,19,8,12,December,-2.4492935982947064e-16,1.0,44,1,2,1,2,1.2,1.2,10,26,-16,21,13,8,"December, 2020"
2020-2021,14,2020-12-21,Burnley,Wolves,2,1,H,3,0,1,0,4,1,1,3,18,11,10,20,7,10,December,-2.4492935982947064e-16,1.0,11,48,1,2,2,1.0,1.0,6,18,-12,13,17,-4,"December, 2020"
2020-2021,14,2020-12-21,Chelsea,West Ham,3,0,H,3,0,3,0,2,3,1,1,8,10,22,21,2,1,December,-2.4492935982947064e-16,1.0,14,45,1,2,2,1.0,1.0,26,14,12,21,16,5,"December, 2020"
2020-2021,15,2020-12-26,Man City,Newcastle,2,0,H,3,0,3,0,2,3,0,2,9,12,23,18,3,5,December,-2.4492935982947064e-16,1.0,27,30,3,1,1,2.6,1.2,19,12,7,17,22,-5,"December, 2020"
2020-2021,15,2020-12-26,Sheffield United,Everton,0,1,A,0,3,2,0,3,2,1,2,20,5,2,26,15,24,December,-2.4492935982947064e-16,1.0,36,18,1,1,2,0.75,1.0,8,25,-17,25,19,6,"December, 2020"
2020-2021,15,2020-12-26,Arsenal,Chelsea,3,1,H,3,0,5,0,0,3,0,2,15,5,14,25,10,11,December,-2.4492935982947064e-16,1.0,0,14,1,2,2,1.8,1.8,12,18,-6,29,14,15,"December, 2020"
2020-2021,15,2020-12-26,Fulham,Southampton,0,0,D,1,1,0,1,4,2,0,3,18,8,10,24,10,14,December,-2.4492935982947064e-16,1.0,19,38,1,1,3,0.8,2.0,13,23,-10,25,19,6,"December, 2020"
2020-2021,15,2020-12-26,Aston Villa,Crystal Palace,3,0,H,3,0,2,1,2,2,0,3,9,13,22,18,4,4,December,-2.4492935982947064e-16,1.0,1,16,2,1,2,0.8,0.6,24,13,11,19,25,-6,"December, 2020"
2020-2021,15,2020-12-26,Leicester,Man United,2,2,D,1,1,1,1,3,2,1,2,2,3,27,26,1,1,December,-2.4492935982947064e-16,1.0,24,28,0,1,4,0.6,1.6,26,17,9,28,21,7,"December, 2020"
2020-2021,15,2020-12-27,Leeds,Burnley,1,0,H,3,0,4,0,1,1,0,4,15,16,17,13,1,4,December,-2.4492935982947064e-16,1.0,23,11,0,0,0,0.0,0.0,24,30,-6,8,19,-11,"December, 2020"
2020-2021,15,2020-12-27,West Ham,Brighton,2,2,D,1,1,3,1,1,2,1,2,10,17,21,12,7,9,December,-2.4492935982947064e-16,1.0,45,10,0,3,2,1.4,2.0,21,19,2,16,22,-6,"December, 2020"
2020-2021,15,2020-12-27,Liverpool,West Brom,1,1,D,1,1,5,0,0,0,1,4,1,19,31,7,18,24,December,-2.4492935982947064e-16,1.0,25,44,2,3,0,1.2,0.8,36,19,17,10,29,-19,"December, 2020"
2020-2021,15,2020-12-27,Wolves,Tottenham,1,1,D,1,1,1,1,3,3,0,2,12,8,20,25,4,5,December,-2.4492935982947064e-16,1.0,48,42,2,1,2,2.0,1.8,14,19,-5,25,14,11,"December, 2020"
2020-2021,16,2020-12-28,Crystal Palace,Leicester,1,1,D,1,1,2,0,3,1,1,3,14,3,18,28,11,10,December,-2.4492935982947064e-16,1.0,16,24,3,0,2,2.0,1.2,19,28,-9,28,19,9,"December, 2020"
2020-2021,16,2020-12-28,Chelsea,Aston Villa,1,1,D,1,1,3,0,2,2,1,2,8,7,25,25,1,0,December,-2.4492935982947064e-16,1.0,14,1,5,0,0,2.4,0.6,30,17,13,27,13,14,"December, 2020"
2020-2021,16,2020-12-29,Man United,Wolves,1,0,H,3,0,2,1,2,1,1,3,4,12,27,21,8,6,December,-2.4492935982947064e-16,1.0,28,48,1,3,1,1.6,0.8,30,23,7,15,20,-5,"December, 2020"
2020-2021,16,2020-12-29,West Brom,Leeds,0,5,A,0,3,0,1,4,4,0,1,19,13,8,20,6,12,December,-2.4492935982947064e-16,1.0,44,23,0,1,1,0.5,1.5,11,30,-19,25,30,-5,"December, 2020"
2020-2021,16,2020-12-29,Burnley,Sheffield United,1,0,H,3,0,1,0,4,2,0,3,17,20,13,2,3,11,December,-2.4492935982947064e-16,1.0,11,36,0,1,1,0.5,2.0,8,20,-12,8,26,-18,"December, 2020"
2020-2021,16,2020-12-29,Brighton,Arsenal,0,1,A,0,3,2,1,2,5,0,0,16,15,13,17,1,4,December,-2.4492935982947064e-16,1.0,10,0,3,2,0,1.6,1.0,18,24,-6,15,19,-4,"December, 2020"
2020-2021,16,2020-12-29,Southampton,West Ham,0,0,D,1,1,2,0,3,3,1,1,9,10,25,22,1,3,December,-2.4492935982947064e-16,1.0,38,45,0,0,5,0.4,2.4,25,19,6,23,21,2,"December, 2020"
2020-2021,16,2020-12-30,Newcastle,Liverpool,0,0,D,1,1,3,0,2,5,0,0,15,1,18,32,14,14,December,-2.4492935982947064e-16,1.0,30,25,0,0,5,0.8,3.0,17,24,-7,37,20,17,"December, 2020"
2020-2021,17,2021-01-01,Everton,West Ham,0,1,A,0,3,2,1,2,3,1,1,4,10,29,23,6,6,January,0.4999999999999999,0.8660254037844387,18,45,2,1,2,1.4,1.4,26,19,7,23,21,2,"January, 2021"
2020-2021,17,2021-01-01,Man United,Aston Villa,2,1,H,3,0,2,1,2,2,1,2,2,5,30,26,3,4,January,0.4999999999999999,0.8660254037844387,28,1,4,1,0,2.0,0.6,31,23,8,28,14,14,"January, 2021"
2020-2021,17,2021-01-02,Brighton,Wolves,3,3,D,1,1,2,1,2,1,1,3,17,13,13,21,4,8,January,0.4999999999999999,0.8660254037844387,10,48,1,3,0,0.75,0.5,18,25,-7,15,21,-6,"January, 2021"
2020-2021,17,2021-01-02,Tottenham,Leeds,3,0,H,3,0,3,0,2,4,0,1,7,11,26,23,4,3,January,0.4999999999999999,0.8660254037844387,42,23,4,1,0,1.8,0.8,26,15,11,30,30,0,"January, 2021"
2020-2021,17,2021-01-02,Crystal Palace,Sheffield United,2,0,H,3,0,2,0,3,2,0,3,15,20,19,2,5,17,January,0.4999999999999999,0.8660254037844387,16,36,0,0,2,0.0,1.0,20,29,-9,8,27,-19,"January, 2021"
2020-2021,17,2021-01-02,West Brom,Arsenal,0,4,A,0,3,0,1,4,5,0,0,19,14,8,20,5,12,January,0.4999999999999999,0.8660254037844387,44,0,1,1,3,0.8,1.4,11,35,-24,16,19,-3,"January, 2021"
2020-2021,17,2021-01-03,Chelsea,Man City,1,3,A,0,3,3,0,2,3,0,2,6,8,26,26,2,0,January,0.4999999999999999,0.8660254037844387,14,27,2,0,3,1.0,2.0,31,18,13,21,12,9,"January, 2021"
2020-2021,17,2021-01-03,Newcastle,Leicester,1,2,A,0,3,3,0,2,1,1,3,15,4,19,29,11,10,January,0.4999999999999999,0.8660254037844387,30,24,2,0,3,0.6,2.2,17,24,-7,29,20,9,"January, 2021"
2020-2021,17,2021-01-04,Southampton,Liverpool,1,0,H,3,0,2,0,3,5,0,0,9,1,26,33,8,7,January,0.4999999999999999,0.8660254037844387,38,25,0,0,5,0.4,2.8,25,19,6,37,20,17,"January, 2021"
2020-2021,18,2021-01-12,Sheffield United,Newcastle,1,0,H,3,0,2,0,3,3,0,2,20,15,2,19,5,17,January,0.4999999999999999,0.8660254037844387,36,30,1,0,3,0.5,1.75,8,29,-21,18,26,-8,"January, 2021"
2020-2021,18,2021-01-12,Burnley,Man United,0,1,A,0,3,1,0,4,2,1,2,16,2,16,33,14,17,January,0.4999999999999999,0.8660254037844387,11,28,1,1,3,0.8,1.4,9,20,-11,33,24,9,"January, 2021"
2020-2021,18,2021-01-12,Wolves,Everton,1,2,A,0,3,1,1,3,2,1,2,13,7,22,29,6,7,January,0.4999999999999999,0.8660254037844387,48,18,2,2,1,2.0,1.2,18,24,-6,26,20,6,"January, 2021"
2020-2021,18,2021-01-13,Man City,Brighton,1,0,H,3,0,3,0,2,2,1,2,6,17,29,14,11,15,January,0.4999999999999999,0.8660254037844387,27,10,5,0,0,3.6,0.4,24,13,11,21,28,-7,"January, 2021"
2020-2021,18,2021-01-13,Tottenham,Fulham,1,1,D,1,1,3,0,2,0,1,4,6,18,29,11,12,18,January,0.4999999999999999,0.8660254037844387,42,19,4,0,1,2.0,1.0,29,15,14,13,23,-10,"January, 2021"
2020-2021,18,2021-01-14,Arsenal,Crystal Palace,0,0,D,1,1,5,0,0,2,0,3,11,13,23,22,2,1,January,0.4999999999999999,0.8660254037844387,0,16,1,3,1,2.2,1.8,20,19,1,22,29,-7,"January, 2021"
2020-2021,19,2021-01-16,West Ham,Burnley,1,0,H,3,0,3,1,1,1,0,4,10,17,26,16,7,10,January,0.4999999999999999,0.8660254037844387,45,11,1,0,4,0.8,2.2,24,21,3,9,21,-12,"January, 2021"
2020-2021,19,2021-01-16,Leicester,Southampton,2,0,H,3,0,1,1,3,2,0,3,4,8,32,29,4,3,January,0.4999999999999999,0.8660254037844387,24,38,2,1,2,2.6,1.0,31,21,10,26,19,7,"January, 2021"
2020-2021,19,2021-01-16,Fulham,Chelsea,0,1,A,0,3,0,1,4,3,0,2,18,10,12,26,8,14,January,0.4999999999999999,0.8660254037844387,19,14,0,0,5,0.4,2.4,14,24,-10,32,21,11,"January, 2021"
2020-2021,19,2021-01-16,Leeds,Brighton,0,1,A,0,3,4,0,1,2,1,2,12,17,23,14,5,9,January,0.4999999999999999,0.8660254037844387,23,10,0,0,0,0.0,0.0,30,33,-3,21,29,-8,"January, 2021"
2020-2021,19,2021-01-16,Wolves,West Brom,2,3,A,0,3,1,1,3,0,1,4,14,19,22,8,5,14,January,0.4999999999999999,0.8660254037844387,48,44,1,1,2,1.25,2.25,19,26,-7,11,39,-28,"January, 2021"
2020-2021,19,2021-01-17,Sheffield United,Tottenham,1,3,A,0,3,2,0,3,3,0,2,20,6,5,30,14,25,January,0.4999999999999999,0.8660254037844387,36,42,2,1,1,1.5,1.25,9,29,-20,30,16,14,"January, 2021"
2020-2021,19,2021-01-17,Liverpool,Man United,0,0,D,1,1,5,0,0,2,1,2,3,1,33,36,2,3,January,0.4999999999999999,0.8660254037844387,25,28,2,2,1,1.4,0.8,37,21,16,34,24,10,"January, 2021"
2020-2021,19,2021-01-17,Man City,Crystal Palace,4,0,H,3,0,3,0,2,2,0,3,5,13,32,23,8,9,January,0.4999999999999999,0.8660254037844387,27,16,2,2,1,1.8,1.2,25,13,12,22,29,-7,"January, 2021"
2020-2021,19,2021-01-18,Arsenal,Newcastle,3,0,H,3,0,5,0,0,3,0,2,11,15,24,19,4,5,January,0.4999999999999999,0.8660254037844387,0,30,4,0,1,2.0,0.6,20,19,1,18,27,-9,"January, 2021"
2020-2021,19,2021-01-19,West Ham,West Brom,2,1,H,3,0,3,1,1,0,1,4,9,19,29,11,10,18,January,0.4999999999999999,0.8660254037844387,45,44,2,2,1,1.8,1.4,25,21,4,14,41,-27,"January, 2021"
2020-2021,19,2021-01-19,Leicester,Chelsea,2,0,H,3,0,1,1,3,3,0,2,3,8,35,29,5,6,January,0.4999999999999999,0.8660254037844387,24,14,1,4,0,0.8,0.6,33,21,12,33,21,12,"January, 2021"
2020-2021,19,2021-01-20,Man City,Aston Villa,2,0,H,3,0,3,0,2,2,1,2,3,11,35,26,8,9,January,0.4999999999999999,0.8660254037844387,27,1,4,1,0,3.2,0.6,29,13,16,29,16,13,"January, 2021"
2020-2021,19,2021-01-20,Fulham,Man United,1,2,A,0,3,0,1,4,2,1,2,18,3,12,37,15,25,January,0.4999999999999999,0.8660254037844387,19,28,0,1,4,0.8,2.6,14,25,-11,34,24,10,"January, 2021"
2020-2021,19,2021-01-21,Liverpool,Burnley,0,1,A,0,3,5,0,0,1,0,4,4,17,34,16,13,18,January,0.4999999999999999,0.8660254037844387,25,11,4,1,0,2.6,1.0,37,21,16,9,22,-13,"January, 2021"
2020-2021,19,2021-01-23,Aston Villa,Newcastle,2,0,H,3,0,2,1,2,3,0,2,11,15,26,19,4,7,January,0.4999999999999999,0.8660254037844387,1,30,1,3,1,0.8,0.6,29,18,11,18,30,-12,"January, 2021"
2020-2021,20,2021-01-26,Crystal Palace,West Ham,2,3,A,0,3,2,0,3,3,1,1,13,7,23,32,6,9,January,0.4999999999999999,0.8660254037844387,16,45,2,2,1,1.6,1.4,22,33,-11,27,22,5,"January, 2021"
2020-2021,20,2021-01-26,Newcastle,Leeds,1,2,A,0,3,3,0,2,4,0,1,16,12,19,23,4,4,January,0.4999999999999999,0.8660254037844387,30,23,2,1,2,1.6,1.8,18,32,-14,30,34,-4,"January, 2021"
2020-2021,20,2021-01-26,Southampton,Arsenal,1,3,A,0,3,2,0,3,5,0,0,10,11,29,27,1,2,January,0.4999999999999999,0.8660254037844387,38,0,1,2,2,1.2,1.8,26,21,5,23,19,4,"January, 2021"
2020-2021,20,2021-01-26,West Brom,Man City,0,5,A,0,3,0,1,4,3,0,2,19,2,11,38,17,27,January,0.4999999999999999,0.8660254037844387,44,27,0,1,4,0.8,2.8,15,43,-28,31,13,18,"January, 2021"
2020-2021,20,2021-01-27,Man United,Sheffield United,1,2,A,0,3,2,1,2,2,0,3,2,20,40,5,18,35,January,0.4999999999999999,0.8660254037844387,28,36,4,1,0,2.6,1.2,36,25,11,10,32,-22,"January, 2021"
2020-2021,20,2021-01-27,Brighton,Fulham,0,0,D,1,1,2,1,2,0,1,4,17,18,17,12,1,5,January,0.4999999999999999,0.8660254037844387,10,19,0,2,1,1.3333333333333333,2.0,22,29,-7,15,27,-12,"January, 2021"
2020-2021,20,2021-01-27,Everton,Leicester,1,1,D,1,1,2,1,2,1,1,3,7,3,32,38,4,6,January,0.4999999999999999,0.8660254037844387,18,24,3,0,2,1.4,1.0,28,21,7,35,21,14,"January, 2021"
2020-2021,20,2021-01-27,Burnley,Aston Villa,3,2,H,3,0,1,0,4,2,1,2,15,9,19,29,6,10,January,0.4999999999999999,0.8660254037844387,11,1,1,3,1,1.0,1.0,10,22,-12,31,18,13,"January, 2021"
2020-2021,20,2021-01-27,Chelsea,Wolves,0,0,D,1,1,3,0,2,1,1,3,10,14,29,22,4,7,January,0.4999999999999999,0.8660254037844387,14,48,2,1,2,2.0,1.4,33,23,10,21,29,-8,"January, 2021"
2020-2021,20,2021-01-28,Tottenham,Liverpool,1,3,A,0,3,3,0,2,5,0,0,6,5,33,34,1,1,January,0.4999999999999999,0.8660254037844387,42,25,0,0,5,0.8,1.8,33,17,16,37,22,15,"January, 2021"
2020-2021,21,2021-01-30,Southampton,Aston Villa,0,1,A,0,3,2,0,3,2,1,2,11,10,29,29,1,0,January,0.4999999999999999,0.8660254037844387,38,1,4,1,0,2.8,1.4,27,24,3,33,21,12,"January, 2021"
2020-2021,21,2021-01-30,Everton,Newcastle,0,2,A,0,3,2,1,2,3,0,2,7,16,33,19,9,14,January,0.4999999999999999,0.8660254037844387,18,30,1,2,2,1.6,1.8,29,22,7,19,34,-15,"January, 2021"
2020-2021,21,2021-01-30,Crystal Palace,Wolves,1,0,H,3,0,2,0,3,1,1,3,14,13,23,23,1,0,January,0.4999999999999999,0.8660254037844387,16,48,1,1,3,0.6,1.2,24,36,-12,21,29,-8,"January, 2021"
2020-2021,21,2021-01-30,Man City,Sheffield United,1,0,H,3,0,3,0,2,2,0,3,1,20,41,8,19,33,January,0.4999999999999999,0.8660254037844387,27,36,4,1,0,1.0,0.0,36,13,23,12,33,-21,"January, 2021"
2020-2021,21,2021-01-30,West Brom,Fulham,2,2,D,1,1,0,1,4,0,1,4,19,18,11,13,1,2,January,0.4999999999999999,0.8660254037844387,44,19,0,2,3,0.6,1.8,15,48,-33,15,27,-12,"January, 2021"
2020-2021,21,2021-01-30,Arsenal,Man United,0,0,D,1,1,5,0,0,2,1,2,9,2,30,40,7,10,January,0.4999999999999999,0.8660254037844387,0,28,3,2,0,1.6,0.6,26,20,6,37,27,10,"January, 2021"
2020-2021,21,2021-01-31,West Ham,Liverpool,1,3,A,0,3,3,1,1,5,0,0,5,4,35,37,1,2,January,0.4999999999999999,0.8660254037844387,45,25,0,1,4,0.8,2.4,30,24,6,40,23,17,"January, 2021"
2020-2021,21,2021-01-31,Brighton,Tottenham,1,0,H,3,0,2,1,2,3,0,2,17,6,18,33,11,15,January,0.4999999999999999,0.8660254037844387,10,42,1,0,4,1.2,1.4,22,29,-7,34,20,14,"January, 2021"
2020-2021,21,2021-01-31,Chelsea,Burnley,2,0,H,3,0,3,0,2,1,0,4,10,15,30,22,5,8,January,0.4999999999999999,0.8660254037844387,14,11,4,1,0,3.2,0.8,33,23,10,13,24,-11,"January, 2021"
2020-2021,21,2021-01-31,Leicester,Leeds,1,3,A,0,3,1,1,3,4,0,1,3,12,39,26,9,13,January,0.4999999999999999,0.8660254037844387,24,23,2,1,2,2.4,1.6,36,22,14,32,35,-3,"January, 2021"
2020-2021,22,2021-02-02,Newcastle,Crystal Palace,1,2,A,0,3,3,0,2,2,0,3,15,14,22,26,1,4,February,0.8660254037844386,0.5000000000000001,30,16,2,1,2,0.6,0.4,21,34,-13,25,36,-11,"February, 2021"
2020-2021,22,2021-02-02,Man United,Southampton,9,0,H,3,0,2,1,2,2,0,3,2,11,41,29,9,12,February,0.8660254037844386,0.5000000000000001,28,38,2,3,0,2.2,1.8,37,27,10,27,25,2,"February, 2021"
2020-2021,22,2021-02-02,Wolves,Arsenal,2,1,H,3,0,1,1,3,5,0,0,14,10,23,31,4,8,February,0.8660254037844386,0.5000000000000001,48,0,2,2,1,1.4,1.2,21,30,-9,26,20,6,"February, 2021"
2020-2021,22,2021-02-02,Sheffield United,West Brom,2,1,H,3,0,2,0,3,0,1,4,20,19,8,12,1,4,February,0.8660254037844386,0.5000000000000001,36,44,0,0,1,0.0,1.0,12,34,-22,17,50,-33,"February, 2021"
2020-2021,22,2021-02-03,Burnley,Man City,0,2,A,0,3,1,0,4,3,0,2,15,1,22,44,14,22,February,0.8660254037844386,0.5000000000000001,11,27,0,0,5,0.2,4.0,13,26,-13,37,13,24,"February, 2021"
2020-2021,22,2021-02-03,Fulham,Leicester,0,2,A,0,3,0,1,4,1,1,3,18,4,14,39,14,25,February,0.8660254037844386,0.5000000000000001,19,24,3,1,1,1.6,1.0,17,29,-12,37,25,12,"February, 2021"
2020-2021,22,2021-02-03,Leeds,Everton,1,2,A,0,3,4,0,1,2,1,2,11,8,29,33,3,4,February,0.8660254037844386,0.5000000000000001,23,18,1,1,3,0.4,1.6,35,36,-1,29,24,5,"February, 2021"
2020-2021,22,2021-02-03,Aston Villa,West Ham,1,3,A,0,3,2,1,2,3,1,1,9,6,32,35,3,3,February,0.8660254037844386,0.5000000000000001,1,45,0,3,2,0.6,1.2,34,21,13,31,27,4,"February, 2021"
2020-2021,22,2021-02-03,Liverpool,Brighton,0,1,A,0,3,5,0,0,2,1,2,4,17,40,21,13,19,February,0.8660254037844386,0.5000000000000001,25,10,4,1,0,1.6,0.6,43,24,19,23,29,-6,"February, 2021"
2020-2021,22,2021-02-04,Tottenham,Chelsea,0,1,A,0,3,3,0,2,3,0,2,7,8,33,33,1,0,February,0.8660254037844386,0.5000000000000001,42,14,1,1,3,0.8,1.4,34,21,13,35,23,12,"February, 2021"
2020-2021,23,2021-02-06,Man United,Everton,3,3,D,1,1,2,1,2,2,1,2,2,7,44,36,5,8,February,0.8660254037844386,0.5000000000000001,28,18,2,2,1,1.4,1.6,46,27,19,31,25,6,"February, 2021"
2020-2021,23,2021-02-06,Fulham,West Ham,0,0,D,1,1,0,1,4,3,1,1,18,5,14,38,13,24,February,0.8660254037844386,0.5000000000000001,19,45,1,0,4,0.6,2.0,17,31,-14,34,28,6,"February, 2021"
2020-2021,23,2021-02-06,Burnley,Brighton,1,1,D,1,1,1,0,4,2,1,2,17,15,22,24,2,2,February,0.8660254037844386,0.5000000000000001,11,10,2,2,1,1.2,0.8,13,28,-15,24,29,-5,"February, 2021"
2020-2021,23,2021-02-06,Aston Villa,Arsenal,1,0,H,3,0,2,1,2,5,0,0,9,10,32,31,1,1,February,0.8660254037844386,0.5000000000000001,1,0,2,0,3,1.2,1.8,35,24,11,27,22,5,"February, 2021"
2020-2021,23,2021-02-06,Newcastle,Southampton,3,2,H,3,0,3,0,2,2,0,3,17,12,22,29,5,7,February,0.8660254037844386,0.5000000000000001,30,38,3,1,1,1.2,0.8,22,36,-14,27,34,-7,"February, 2021"
2020-2021,23,2021-02-07,Tottenham,West Brom,2,0,H,3,0,3,0,2,0,1,4,9,19,33,12,10,21,February,0.8660254037844386,0.5000000000000001,42,44,2,2,1,1.4,0.6,34,22,12,18,52,-34,"February, 2021"
2020-2021,23,2021-02-07,Wolves,Leicester,0,0,D,1,1,1,1,3,1,1,3,14,3,26,42,11,16,February,0.8660254037844386,0.5000000000000001,48,24,1,2,2,0.8,1.2,23,31,-8,39,25,14,"February, 2021"
2020-2021,23,2021-02-07,Liverpool,Man City,1,4,A,0,3,5,0,0,3,0,2,4,1,40,47,3,7,February,0.8660254037844386,0.5000000000000001,25,27,1,2,2,1.0,1.6,43,25,18,39,13,26,"February, 2021"
2020-2021,23,2021-02-07,Sheffield United,Chelsea,1,2,A,0,3,2,0,3,3,0,2,20,8,11,36,12,25,February,0.8660254037844386,0.5000000000000001,36,14,1,1,3,1.2,2.2,14,35,-21,36,23,13,"February, 2021"
2020-2021,23,2021-02-08,Leeds,Crystal Palace,2,0,H,3,0,4,0,1,2,0,3,11,13,29,29,2,0,February,0.8660254037844386,0.5000000000000001,23,16,1,0,2,1.0,2.0,36,38,-2,27,37,-10,"February, 2021"
2020-2021,24,2021-02-13,Brighton,Aston Villa,0,0,D,1,1,2,1,2,2,1,2,16,9,25,35,7,10,February,0.8660254037844386,0.5000000000000001,10,1,1,1,1,1.3333333333333333,1.3333333333333333,25,30,-5,36,24,12,"February, 2021"
2020-2021,24,2021-02-13,Man City,Tottenham,3,0,H,3,0,3,0,2,3,0,2,1,8,50,36,7,14,February,0.8660254037844386,0.5000000000000001,27,42,2,1,2,0.8,1.2,43,14,29,36,22,14,"February, 2021"
2020-2021,24,2021-02-13,Leicester,Liverpool,3,1,H,3,0,1,1,3,5,0,0,3,4,43,40,1,3,February,0.8660254037844386,0.5000000000000001,24,25,0,1,4,0.6,2.4,39,25,14,44,29,15,"February, 2021"
2020-2021,24,2021-02-13,Crystal Palace,Burnley,0,3,A,0,3,2,0,3,1,0,4,13,17,29,23,4,6,February,0.8660254037844386,0.5000000000000001,16,11,3,0,2,1.4,0.6,27,39,-12,14,29,-15,"February, 2021"
2020-2021,24,2021-02-14,Southampton,Wolves,1,2,A,0,3,2,0,3,1,1,3,12,14,29,27,2,2,February,0.8660254037844386,0.5000000000000001,38,48,1,2,2,1.4,1.6,29,37,-8,23,31,-8,"February, 2021"
2020-2021,24,2021-02-14,West Brom,Man United,1,1,D,1,1,0,1,4,2,1,2,19,3,12,45,16,33,February,0.8660254037844386,0.5000000000000001,44,28,1,1,3,0.4,1.0,18,54,-36,49,30,19,"February, 2021"
2020-2021,24,2021-02-14,Arsenal,Leeds,4,2,H,3,0,5,0,0,4,0,1,11,10,31,32,1,1,February,0.8660254037844386,0.5000000000000001,0,23,3,1,1,3.0,1.0,27,23,4,38,38,0,"February, 2021"
2020-2021,24,2021-02-14,Everton,Fulham,0,2,A,0,3,2,1,2,0,1,4,7,18,37,15,11,22,February,0.8660254037844386,0.5000000000000001,18,19,4,0,1,2.6,1.2,34,28,6,17,31,-14,"February, 2021"
2020-2021,24,2021-02-15,West Ham,Sheffield United,3,0,H,3,0,3,1,1,2,0,3,6,20,39,11,14,28,February,0.8660254037844386,0.5000000000000001,45,36,2,1,2,0.6,1.0,34,28,6,15,37,-22,"February, 2021"
2020-2021,24,2021-02-15,Chelsea,Newcastle,2,0,H,3,0,3,0,2,3,0,2,6,17,39,25,11,14,February,0.8660254037844386,0.5000000000000001,14,30,4,0,1,1.4,0.6,38,24,14,25,38,-13,"February, 2021"
2020-2021,24,2021-02-17,Everton,Man City,1,3,A,0,3,2,1,2,3,0,2,7,1,37,53,6,16,February,0.8660254037844386,0.5000000000000001,18,27,0,0,5,0.8,2.6,34,30,4,46,14,32,"February, 2021"
2020-2021,24,2021-02-17,Burnley,Fulham,1,1,D,1,1,1,0,4,0,1,4,16,18,26,18,2,8,February,0.8660254037844386,0.5000000000000001,11,19,1,1,2,1.25,2.25,17,29,-12,19,31,-12,"February, 2021"
2020-2021,25,2021-02-19,Wolves,Leeds,1,0,H,3,0,1,1,3,4,0,1,12,11,30,32,1,2,February,0.8660254037844386,0.5000000000000001,48,23,2,0,1,1.6666666666666667,1.6666666666666667,25,32,-7,40,42,-2,"February, 2021"
2020-2021,25,2021-02-20,Southampton,Chelsea,1,1,D,1,1,2,0,3,3,0,2,13,4,29,42,9,13,February,0.8660254037844386,0.5000000000000001,38,14,1,2,2,1.2,2.0,30,39,-9,40,24,16,"February, 2021"
2020-2021,25,2021-02-20,Burnley,West Brom,0,0,D,1,1,1,0,4,0,1,4,15,19,27,13,4,14,February,0.8660254037844386,0.5000000000000001,11,44,1,2,2,0.8,1.6,18,30,-12,19,55,-36,"February, 2021"
2020-2021,25,2021-02-20,Liverpool,Everton,0,2,A,0,3,5,0,0,2,1,2,6,7,40,37,1,3,February,0.8660254037844386,0.5000000000000001,25,18,2,3,0,1.6,0.8,45,32,13,35,33,2,"February, 2021"
2020-2021,25,2021-02-20,Fulham,Sheffield United,1,0,H,3,0,0,1,4,2,0,3,18,20,19,11,2,8,February,0.8660254037844386,0.5000000000000001,19,36,1,1,1,0.6666666666666666,1.0,20,32,-12,15,40,-25,"February, 2021"
2020-2021,25,2021-02-21,West Ham,Tottenham,2,1,H,3,0,3,1,1,3,0,2,5,9,42,36,4,6,February,0.8660254037844386,0.5000000000000001,45,42,1,1,3,1.2,1.8,37,28,9,36,25,11,"February, 2021"
2020-2021,25,2021-02-21,Aston Villa,Leicester,1,2,A,0,3,2,1,2,1,1,3,8,3,36,46,5,10,February,0.8660254037844386,0.5000000000000001,1,24,1,1,3,1.0,2.4,36,24,12,42,26,16,"February, 2021"
2020-2021,25,2021-02-21,Arsenal,Man City,0,1,A,0,3,5,0,0,3,0,2,10,1,34,56,9,22,February,0.8660254037844386,0.5000000000000001,0,27,0,0,5,0.2,2.4,31,25,6,49,15,34,"February, 2021"
2020-2021,25,2021-02-21,Man United,Newcastle,3,1,H,3,0,2,1,2,3,0,2,3,17,46,25,14,21,February,0.8660254037844386,0.5000000000000001,28,30,4,0,1,2.6,1.0,50,31,19,25,40,-15,"February, 2021"
2020-2021,25,2021-02-22,Brighton,Crystal Palace,1,2,A,0,3,2,1,2,2,0,3,16,14,26,29,2,3,February,0.8660254037844386,0.5000000000000001,10,16,2,2,1,1.4,1.0,25,30,-5,27,42,-15,"February, 2021"
2020-2021,25,2021-02-23,Leeds,Southampton,3,0,H,3,0,4,0,1,2,0,3,12,14,32,30,2,2,February,0.8660254037844386,0.5000000000000001,23,38,1,2,2,1.0,1.2,40,43,-3,31,40,-9,"February, 2021"
2020-2021,26,2021-02-27,Newcastle,Wolves,1,1,D,1,1,3,0,2,1,1,3,17,12,25,33,5,8,February,0.8660254037844386,0.5000000000000001,30,48,0,4,1,1.0,1.2,26,43,-17,26,32,-6,"February, 2021"
2020-2021,26,2021-02-27,Leeds,Aston Villa,0,1,A,0,3,4,0,1,2,1,2,10,8,35,36,2,1,February,0.8660254037844386,0.5000000000000001,23,1,2,2,1,1.2,0.6,43,43,0,37,26,11,"February, 2021"
2020-2021,26,2021-02-27,West Brom,Brighton,1,0,H,3,0,0,1,4,2,1,2,19,16,14,26,3,12,February,0.8660254037844386,0.5000000000000001,44,10,1,1,1,1.3333333333333333,1.3333333333333333,19,55,-36,26,32,-6,"February, 2021"
2020-2021,26,2021-02-27,Man City,West Ham,2,1,H,3,0,3,0,2,3,1,1,1,4,59,45,3,14,February,0.8660254037844386,0.5000000000000001,27,45,4,1,0,2.6,0.2,50,15,35,39,29,10,"February, 2021"
2020-2021,26,2021-02-28,Crystal Palace,Fulham,0,0,D,1,1,2,0,3,0,1,4,13,18,32,22,5,10,February,0.8660254037844386,0.5000000000000001,16,19,3,1,1,1.8,1.4,29,43,-14,21,32,-11,"February, 2021"
2020-2021,26,2021-02-28,Leicester,Arsenal,1,3,A,0,3,1,1,3,5,0,0,3,11,49,34,8,15,February,0.8660254037844386,0.5000000000000001,24,0,3,1,1,1.6,0.8,44,27,17,31,26,5,"February, 2021"
2020-2021,26,2021-02-28,Tottenham,Burnley,4,0,H,3,0,3,0,2,1,0,4,10,15,36,28,5,8,February,0.8660254037844386,0.5000000000000001,42,11,3,1,1,1.8,0.6,37,27,10,18,30,-12,"February, 2021"
2020-2021,26,2021-02-28,Chelsea,Man United,0,0,D,1,1,3,0,2,2,1,2,5,2,43,49,3,6,February,0.8660254037844386,0.5000000000000001,14,28,0,3,2,0.6,1.8,41,25,16,53,32,21,"February, 2021"
2020-2021,26,2021-02-28,Sheffield United,Liverpool,0,2,A,0,3,2,0,3,5,0,0,20,6,11,40,14,29,February,0.8660254037844386,0.5000000000000001,36,25,0,1,4,0.4,2.0,15,41,-26,45,34,11,"February, 2021"
2020-2021,26,2021-03-01,Everton,Southampton,1,0,H,3,0,2,1,2,2,0,3,7,14,40,30,7,10,March,1.0,6.123233995736766e-17,18,38,2,1,2,1.2,1.4,37,33,4,31,43,-12,"March, 2021"
2020-2021,26,2021-03-02,Man City,Wolves,4,1,H,3,0,3,0,2,1,1,3,1,12,62,34,11,28,March,1.0,6.123233995736766e-17,27,48,2,1,2,1.8,1.4,52,16,36,27,33,-6,"March, 2021"
2020-2021,26,2021-03-03,Crystal Palace,Man United,0,0,D,1,1,2,0,3,2,1,2,13,2,33,50,11,17,March,1.0,6.123233995736766e-17,16,28,2,1,2,1.2,1.4,29,43,-14,53,32,21,"March, 2021"
2020-2021,26,2021-03-03,Sheffield United,Aston Villa,1,0,H,3,0,2,0,3,2,1,2,20,9,11,39,11,28,March,1.0,6.123233995736766e-17,36,1,1,2,2,0.8,1.2,15,43,-28,38,26,12,"March, 2021"
2020-2021,26,2021-03-03,Burnley,Leicester,1,1,D,1,1,1,0,4,1,1,3,15,3,28,49,12,21,March,1.0,6.123233995736766e-17,11,24,1,1,3,1.2,1.8,18,34,-16,45,30,15,"March, 2021"
2020-2021,26,2021-03-04,Fulham,Tottenham,0,1,A,0,3,0,1,4,3,0,2,18,8,23,39,10,16,March,1.0,6.123233995736766e-17,19,42,0,1,4,1.0,2.2,21,32,-11,41,27,14,"March, 2021"
2020-2021,26,2021-03-04,West Brom,Everton,0,1,A,0,3,0,1,4,2,1,2,19,7,17,43,12,26,March,1.0,6.123233995736766e-17,44,18,0,2,3,0.8,2.2,20,55,-35,38,33,5,"March, 2021"
2020-2021,26,2021-03-04,Liverpool,Chelsea,0,1,A,0,3,5,0,0,3,0,2,7,6,43,44,1,1,March,1.0,6.123233995736766e-17,25,14,4,1,0,2.4,1.0,47,34,13,41,25,16,"March, 2021"
2020-2021,27,2021-03-06,Burnley,Arsenal,1,1,D,1,1,1,0,4,5,0,0,15,10,29,37,5,8,March,1.0,6.123233995736766e-17,11,0,1,1,3,0.8,1.6,19,35,-16,34,27,7,"March, 2021"
2020-2021,27,2021-03-06,Sheffield United,Southampton,0,2,A,0,3,2,0,3,2,0,3,20,14,14,30,6,16,March,1.0,6.123233995736766e-17,36,38,0,0,3,0.3333333333333333,2.333333333333333,16,43,-27,31,44,-13,"March, 2021"
2020-2021,27,2021-03-06,Aston Villa,Wolves,0,0,D,1,1,2,1,2,1,1,3,9,12,39,34,3,5,March,1.0,6.123233995736766e-17,1,48,2,1,2,1.0,1.0,38,27,11,28,37,-9,"March, 2021"
2020-2021,27,2021-03-06,Brighton,Leicester,1,2,A,0,3,2,1,2,1,1,3,16,3,26,50,13,24,March,1.0,6.123233995736766e-17,10,24,0,2,3,0.4,1.6,26,33,-7,46,31,15,"March, 2021"
2020-2021,27,2021-03-07,Tottenham,Crystal Palace,4,1,H,3,0,3,0,2,2,0,3,8,13,42,34,5,8,March,1.0,6.123233995736766e-17,42,16,3,2,0,1.8,0.4,42,27,15,29,43,-14,"March, 2021"
2020-2021,27,2021-03-07,Man City,Man United,0,2,A,0,3,3,0,2,2,1,2,1,3,65,51,2,14,March,1.0,6.123233995736766e-17,27,28,2,1,2,1.2,1.0,56,17,39,53,32,21,"March, 2021"
2020-2021,27,2021-03-07,Liverpool,Fulham,0,1,A,0,3,5,0,0,0,1,4,7,18,43,23,11,20,March,1.0,6.123233995736766e-17,25,19,4,1,0,2.4,0.8,47,35,12,21,33,-12,"March, 2021"
2020-2021,27,2021-03-07,West Brom,Newcastle,0,0,D,1,1,0,1,4,3,0,2,19,17,17,26,2,9,March,1.0,6.123233995736766e-17,44,30,2,1,2,1.0,1.0,20,56,-36,27,44,-17,"March, 2021"
2020-2021,27,2021-03-08,Chelsea,Everton,2,0,H,3,0,3,0,2,2,1,2,4,5,47,46,1,1,March,1.0,6.123233995736766e-17,14,18,1,1,3,1.0,1.2,42,25,17,39,33,6,"March, 2021"
2020-2021,27,2021-03-08,West Ham,Leeds,2,0,H,3,0,3,1,1,4,0,1,7,11,45,35,4,10,March,1.0,6.123233995736766e-17,45,23,1,1,3,1.0,1.8,40,31,9,43,44,-1,"March, 2021"
2020-2021,27,2021-03-10,Man City,Southampton,5,2,H,3,0,3,0,2,2,0,3,1,14,65,33,13,32,March,1.0,6.123233995736766e-17,27,38,4,0,1,2.4,0.8,56,19,37,33,44,-11,"March, 2021"
2020-2021,28,2021-03-12,Newcastle,Aston Villa,1,1,D,1,1,3,0,2,2,1,2,16,9,27,40,7,13,March,1.0,6.123233995736766e-17,30,1,0,3,2,0.4,1.2,27,44,-17,38,27,11,"March, 2021"
2020-2021,28,2021-03-13,Leeds,Chelsea,0,0,D,1,1,4,0,1,3,0,2,11,4,35,50,7,15,March,1.0,6.123233995736766e-17,23,14,1,1,3,1.2,1.6,43,46,-3,44,25,19,"March, 2021"
2020-2021,28,2021-03-13,Crystal Palace,West Brom,1,0,H,3,0,2,0,3,0,1,4,13,19,34,18,6,16,March,1.0,6.123233995736766e-17,16,44,3,1,1,1.8,0.4,30,47,-17,20,56,-36,"March, 2021"
2020-2021,28,2021-03-13,Everton,Burnley,1,2,A,0,3,2,1,2,1,0,4,6,15,46,30,9,16,March,1.0,6.123233995736766e-17,18,11,3,1,1,1.8,0.6,39,35,4,20,36,-16,"March, 2021"
2020-2021,28,2021-03-13,Fulham,Man City,0,3,A,0,3,0,1,4,3,0,2,18,1,26,68,17,42,March,1.0,6.123233995736766e-17,19,27,0,0,5,0.4,3.2,22,33,-11,61,21,40,"March, 2021"
2020-2021,28,2021-03-14,Man United,West Ham,1,0,H,3,0,2,1,2,3,1,1,3,5,54,48,2,6,March,1.0,6.123233995736766e-17,28,45,2,1,2,1.4,1.6,55,32,23,42,31,11,"March, 2021"
2020-2021,28,2021-03-14,Arsenal,Tottenham,2,1,H,3,0,5,0,0,3,0,2,10,7,38,45,3,7,March,1.0,6.123233995736766e-17,0,42,1,2,2,1.6,1.8,35,28,7,46,28,18,"March, 2021"
2020-2021,28,2021-03-14,Southampton,Brighton,1,2,A,0,3,2,0,3,2,1,2,14,17,33,26,3,7,March,1.0,6.123233995736766e-17,38,10,3,2,0,1.6,0.8,35,49,-14,27,35,-8,"March, 2021"
2020-2021,28,2021-03-14,Leicester,Sheffield United,5,0,H,3,0,1,1,3,2,0,3,3,20,53,14,17,39,March,1.0,6.123233995736766e-17,24,36,3,0,0,2.0,0.6666666666666666,48,32,16,16,45,-29,"March, 2021"
2020-2021,28,2021-03-15,Wolves,Liverpool,0,1,A,0,3,1,1,3,5,0,0,13,8,35,43,5,8,March,1.0,6.123233995736766e-17,48,25,0,0,5,0.2,2.2,28,37,-9,47,36,11,"March, 2021"
2020-2021,29,2021-03-19,Fulham,Leeds,1,2,A,0,3,0,1,4,4,0,1,18,12,26,36,6,10,March,1.0,6.123233995736766e-17,19,23,2,0,3,1.6,1.8,22,36,-14,43,46,-3,"March, 2021"
2020-2021,29,2021-03-20,Brighton,Newcastle,3,0,H,3,0,2,1,2,3,0,2,16,17,29,28,1,1,March,1.0,6.123233995736766e-17,10,30,2,3,0,1.0,0.2,29,36,-7,28,45,-17,"March, 2021"
2020-2021,29,2021-03-21,Aston Villa,Tottenham,0,2,A,0,3,2,1,2,3,0,2,10,8,41,45,2,4,March,1.0,6.123233995736766e-17,1,42,1,0,4,1.0,2.2,39,28,11,47,30,17,"March, 2021"
2020-2021,29,2021-03-21,West Ham,Arsenal,3,3,D,1,1,3,1,1,5,0,0,5,10,48,41,5,7,March,1.0,6.123233995736766e-17,45,0,1,0,4,0.8,1.8,42,32,10,37,29,8,"March, 2021"
2020-2021,30,2021-04-03,Leeds,Sheffield United,2,1,H,3,0,4,0,1,2,0,3,11,20,39,14,9,25,April,0.8660254037844388,-0.4999999999999998,23,36,1,0,0,1.0,0.0,45,47,-2,16,50,-34,"April, 2021"
2020-2021,30,2021-04-03,Leicester,Man City,0,2,A,0,3,1,1,3,3,0,2,3,1,56,71,2,15,April,0.8660254037844388,-0.4999999999999998,24,27,2,0,3,1.6,1.6,53,32,21,64,21,43,"April, 2021"
2020-2021,30,2021-04-03,Chelsea,West Brom,2,5,A,0,3,3,0,2,0,1,4,4,19,51,18,15,33,April,0.8660254037844388,-0.4999999999999998,14,44,4,1,0,2.4,0.6,44,25,19,20,57,-37,"April, 2021"
2020-2021,30,2021-04-03,Arsenal,Liverpool,0,3,A,0,3,5,0,0,5,0,0,9,7,42,46,2,4,April,0.8660254037844388,-0.4999999999999998,0,25,1,1,3,1.2,2.6,40,32,8,48,36,12,"April, 2021"
2020-2021,30,2021-04-04,Man United,Brighton,2,1,H,3,0,2,1,2,2,1,2,2,16,57,32,14,25,April,0.8660254037844388,-0.4999999999999998,28,10,4,0,1,2.6,1.4,56,32,24,32,36,-4,"April, 2021"
2020-2021,30,2021-04-04,Aston Villa,Fulham,3,1,H,3,0,2,1,2,0,1,4,11,18,41,26,7,15,April,0.8660254037844388,-0.4999999999999998,1,19,1,1,3,1.0,1.2,39,30,9,23,38,-15,"April, 2021"
2020-2021,30,2021-04-04,Newcastle,Tottenham,2,2,D,1,1,3,0,2,3,0,2,17,7,28,48,10,20,April,0.8660254037844388,-0.4999999999999998,30,42,1,1,3,0.8,1.4,28,48,-20,49,30,19,"April, 2021"
2020-2021,30,2021-04-04,Southampton,Burnley,3,2,H,3,0,2,0,3,1,0,4,14,15,33,33,1,0,April,0.8660254037844388,-0.4999999999999998,38,11,1,2,2,0.6,1.2,36,51,-15,22,37,-15,"April, 2021"
2020-2021,30,2021-04-05,Everton,Crystal Palace,1,1,D,1,1,2,1,2,2,0,3,8,12,46,37,4,9,April,0.8660254037844388,-0.4999999999999998,18,16,3,2,0,1.4,0.4,40,37,3,31,47,-16,"April, 2021"
2020-2021,30,2021-04-05,Wolves,West Ham,2,3,A,0,3,1,1,3,3,1,1,14,7,35,49,7,14,April,0.8660254037844388,-0.4999999999999998,48,45,4,0,1,1.6,0.8,28,38,-10,45,35,10,"April, 2021"
2020-2021,31,2021-04-09,Fulham,Wolves,0,1,A,0,3,0,1,4,1,1,3,18,14,26,35,4,9,April,0.8660254037844388,-0.4999999999999998,19,48,1,1,3,1.2,1.0,24,41,-17,30,41,-11,"April, 2021"
2020-2021,31,2021-04-10,Man City,Leeds,1,2,A,0,3,3,0,2,4,0,1,1,11,74,42,10,32,April,0.8660254037844388,-0.4999999999999998,27,23,1,2,2,1.0,1.6,66,21,45,47,48,-1,"April, 2021"
2020-2021,31,2021-04-10,Liverpool,Aston Villa,2,1,H,3,0,5,0,0,2,1,2,7,10,49,44,3,5,April,0.8660254037844388,-0.4999999999999998,25,1,4,0,1,3.0,2.0,51,36,15,42,31,11,"April, 2021"
2020-2021,31,2021-04-10,Crystal Palace,Chelsea,1,4,A,0,3,2,0,3,3,0,2,13,6,38,51,7,13,April,0.8660254037844388,-0.4999999999999998,16,14,0,0,5,0.6,2.6,32,48,-16,46,30,16,"April, 2021"
2020-2021,31,2021-04-11,Tottenham,Man United,1,3,A,0,3,3,0,2,2,1,2,7,2,49,60,5,11,April,0.8660254037844388,-0.4999999999999998,42,28,2,1,2,2.2,1.0,51,32,19,58,33,25,"April, 2021"
2020-2021,31,2021-04-11,Sheffield United,Arsenal,0,3,A,0,3,2,0,3,5,0,0,20,11,14,42,9,28,April,0.8660254037844388,-0.4999999999999998,36,0,2,1,2,0.8,1.2,17,52,-35,40,35,5,"April, 2021"
2020-2021,31,2021-04-11,Burnley,Newcastle,1,2,A,0,3,1,0,4,3,0,2,15,17,33,29,2,4,April,0.8660254037844388,-0.4999999999999998,11,30,1,1,3,0.6,1.4,24,40,-16,30,50,-20,"April, 2021"
2020-2021,31,2021-04-11,West Ham,Leicester,3,2,H,3,0,3,1,1,1,1,3,6,3,52,56,3,4,April,0.8660254037844388,-0.4999999999999998,45,24,1,2,2,1.6,1.8,48,37,11,53,34,19,"April, 2021"
2020-2021,31,2021-04-12,West Brom,Southampton,3,0,H,3,0,0,1,4,2,0,3,19,14,21,36,5,15,April,0.8660254037844388,-0.4999999999999998,44,38,1,0,4,0.8,1.6,25,59,-34,39,53,-14,"April, 2021"
2020-2021,31,2021-04-12,Brighton,Everton,0,0,D,1,1,2,1,2,2,1,2,16,8,32,47,8,15,April,0.8660254037844388,-0.4999999999999998,10,18,2,0,3,1.4,2.0,33,38,-5,41,38,3,"April, 2021"
2020-2021,32,2021-04-16,Everton,Tottenham,2,2,D,1,1,2,1,2,3,0,2,8,7,48,49,1,1,April,0.8660254037844388,-0.4999999999999998,18,42,1,2,2,1.2,2.0,41,38,3,52,35,17,"April, 2021"
2020-2021,32,2021-04-17,Newcastle,West Ham,3,2,H,3,0,3,0,2,3,1,1,17,4,32,55,13,23,April,0.8660254037844388,-0.4999999999999998,30,45,2,1,2,1.4,1.8,32,51,-19,51,39,12,"April, 2021"
2020-2021,32,2021-04-17,Wolves,Sheffield United,1,0,H,3,0,1,1,3,2,0,3,12,20,38,14,8,24,April,0.8660254037844388,-0.4999999999999998,48,36,1,1,1,1.0,0.6666666666666666,31,41,-10,17,55,-38,"April, 2021"
2020-2021,32,2021-04-18,Arsenal,Fulham,1,1,D,1,1,5,0,0,0,1,4,9,18,45,26,9,19,April,0.8660254037844388,-0.4999999999999998,0,19,5,0,0,3.4,0.6,43,35,8,24,42,-18,"April, 2021"
2020-2021,32,2021-04-18,Man United,Burnley,3,1,H,3,0,2,1,2,1,0,4,2,17,63,33,15,30,April,0.8660254037844388,-0.4999999999999998,28,11,3,1,1,1.4,0.8,61,34,27,25,42,-17,"April, 2021"
2020-2021,32,2021-04-19,Leeds,Liverpool,1,1,D,1,1,4,0,1,5,0,0,10,6,45,52,4,7,April,0.8660254037844388,-0.4999999999999998,23,25,0,1,4,1.4,2.6,49,49,0,53,37,16,"April, 2021"
2020-2021,32,2021-04-20,Chelsea,Brighton,0,0,D,1,1,3,0,2,2,1,2,5,16,54,33,11,21,April,0.8660254037844388,-0.4999999999999998,14,10,4,1,0,2.2,0.6,50,31,19,33,38,-5,"April, 2021"
2020-2021,32,2021-04-21,Aston Villa,Man City,1,2,A,0,3,2,1,2,3,0,2,11,1,44,74,10,30,April,0.8660254037844388,-0.4999999999999998,1,27,0,1,4,0.2,3.0,43,33,10,67,23,44,"April, 2021"
2020-2021,32,2021-04-21,Tottenham,Southampton,2,1,H,3,0,3,0,2,2,0,3,7,14,50,36,7,14,April,0.8660254037844388,-0.4999999999999998,42,38,3,0,2,2.2,1.4,54,37,17,39,56,-17,"April, 2021"
2020-2021,32,2021-04-22,Leicester,West Brom,3,0,H,3,0,1,1,3,0,1,4,3,19,56,24,16,32,April,0.8660254037844388,-0.4999999999999998,24,44,3,1,1,2.0,0.8,55,37,18,28,59,-31,"April, 2021"
2020-2021,33,2021-04-23,Arsenal,Everton,0,1,A,0,3,5,0,0,2,1,2,9,8,46,49,1,3,April,0.8660254037844388,-0.4999999999999998,0,18,2,1,2,1.2,1.0,44,36,8,43,40,3,"April, 2021"
2020-2021,33,2021-04-24,Liverpool,Newcastle,1,1,D,1,1,5,0,0,3,0,2,7,15,53,35,8,18,April,0.8660254037844388,-0.4999999999999998,25,30,4,1,0,2.6,0.8,54,38,16,35,53,-18,"April, 2021"
2020-2021,33,2021-04-24,West Ham,Chelsea,0,1,A,0,3,3,1,1,3,0,2,5,4,55,55,1,0,April,0.8660254037844388,-0.4999999999999998,45,14,2,1,2,0.8,1.4,53,42,11,50,31,19,"April, 2021"
2020-2021,33,2021-04-24,Sheffield United,Brighton,1,0,H,3,0,2,0,3,2,1,2,20,16,14,34,4,20,April,0.8660254037844388,-0.4999999999999998,36,10,1,2,0,1.0,0.6666666666666666,17,56,-39,33,38,-5,"April, 2021"
2020-2021,33,2021-04-25,Wolves,Burnley,0,4,A,0,3,1,1,3,1,0,4,12,17,41,33,5,8,April,0.8660254037844388,-0.4999999999999998,48,11,1,2,2,0.8,1.2,32,41,-9,26,45,-19,"April, 2021"
2020-2021,33,2021-04-25,Leeds,Man United,0,0,D,1,1,4,0,1,2,1,2,10,2,46,66,8,20,April,0.8660254037844388,-0.4999999999999998,23,28,1,1,3,1.0,2.0,50,50,0,64,35,29,"April, 2021"
2020-2021,33,2021-04-25,Aston Villa,West Brom,2,2,D,1,1,2,1,2,0,1,4,11,19,44,24,8,20,April,0.8660254037844388,-0.4999999999999998,1,44,2,1,2,1.0,0.6,44,35,9,28,62,-34,"April, 2021"
2020-2021,33,2021-04-26,Leicester,Crystal Palace,2,1,H,3,0,1,1,3,2,0,3,3,13,59,38,10,21,April,0.8660254037844388,-0.4999999999999998,24,16,2,1,2,1.4,1.2,58,37,21,33,52,-19,"April, 2021"
2020-2021,34,2021-04-30,Southampton,Leicester,1,1,D,1,1,2,0,3,1,1,3,15,3,36,62,12,26,April,0.8660254037844388,-0.4999999999999998,38,24,2,0,3,1.0,3.0,40,58,-18,60,38,22,"April, 2021"
2020-2021,34,2021-05-01,Crystal Palace,Man City,0,2,A,0,3,2,0,3,3,0,2,13,1,38,77,12,39,May,0.4999999999999999,-0.8660254037844387,16,27,1,1,3,1.2,2.6,34,54,-20,69,24,45,"May, 2021"
2020-2021,34,2021-05-01,Brighton,Leeds,2,0,H,3,0,2,1,2,4,0,1,17,9,34,47,8,13,May,0.4999999999999999,-0.8660254037844387,10,23,1,0,0,1.0,0.0,33,39,-6,50,50,0,"May, 2021"
2020-2021,34,2021-05-01,Chelsea,Fulham,2,0,H,3,0,3,0,2,0,1,4,4,18,58,27,14,31,May,0.4999999999999999,-0.8660254037844387,14,19,5,0,0,2.0,0.4,51,31,20,25,43,-18,"May, 2021"
2020-2021,34,2021-05-01,Everton,Aston Villa,1,2,A,0,3,2,1,2,2,1,2,8,11,52,45,3,7,May,0.4999999999999999,-0.8660254037844387,18,1,2,1,2,2.0,1.4,44,40,4,46,37,9,"May, 2021"
2020-2021,34,2021-05-02,Newcastle,Arsenal,0,2,A,0,3,3,0,2,5,0,0,17,11,36,46,6,10,May,0.4999999999999999,-0.8660254037844387,30,0,0,0,5,0.2,2.4,36,54,-18,44,37,7,"May, 2021"
2020-2021,34,2021-05-02,Tottenham,Sheffield United,4,0,H,3,0,3,0,2,2,0,3,7,20,53,17,13,36,May,0.4999999999999999,-0.8660254037844387,42,36,2,1,2,1.6,1.4,56,38,18,18,56,-38,"May, 2021"
2020-2021,34,2021-05-03,West Brom,Wolves,1,1,D,1,1,0,1,4,1,1,3,19,12,25,41,7,16,May,0.4999999999999999,-0.8660254037844387,44,48,3,1,1,2.4,1.4,30,64,-34,32,45,-13,"May, 2021"
2020-2021,34,2021-05-03,Burnley,West Ham,1,2,A,0,3,1,0,4,3,1,1,16,6,36,55,10,19,May,0.4999999999999999,-0.8660254037844387,11,45,3,0,2,1.6,1.0,30,45,-15,53,43,10,"May, 2021"
2020-2021,35,2021-05-07,Leicester,Newcastle,2,4,A,0,3,1,1,3,3,0,2,3,17,63,36,14,27,May,0.4999999999999999,-0.8660254037844387,24,30,4,0,1,2.4,0.4,61,39,22,36,56,-20,"May, 2021"
2020-2021,35,2021-05-08,Liverpool,Southampton,2,0,H,3,0,5,0,0,2,0,3,7,16,54,37,9,17,May,0.4999999999999999,-0.8660254037844387,25,38,4,0,1,2.4,0.6,55,39,16,41,59,-18,"May, 2021"
2020-2021,35,2021-05-08,Man City,Chelsea,1,2,A,0,3,3,0,2,3,0,2,1,4,80,61,3,19,May,0.4999999999999999,-0.8660254037844387,27,14,3,0,2,2.4,1.2,71,24,47,53,31,22,"May, 2021"
2020-2021,35,2021-05-08,Sheffield United,Crystal Palace,0,2,A,0,3,2,0,3,2,0,3,20,14,17,38,6,21,May,0.4999999999999999,-0.8660254037844387,36,16,2,0,1,0.6666666666666666,0.6666666666666666,18,60,-42,34,56,-22,"May, 2021"
2020-2021,35,2021-05-08,Leeds,Tottenham,3,1,H,3,0,4,0,1,3,0,2,11,6,47,56,5,9,May,0.4999999999999999,-0.8660254037844387,23,42,0,1,4,0.6,2.0,50,52,-2,60,38,22,"May, 2021"
2020-2021,35,2021-05-09,Wolves,Brighton,2,1,H,3,0,1,1,3,2,1,2,12,15,42,37,3,5,May,0.4999999999999999,-0.8660254037844387,48,10,0,4,1,1.0,1.2,33,46,-13,35,39,-4,"May, 2021"
2020-2021,35,2021-05-09,Aston Villa,Man United,1,3,A,0,3,2,1,2,2,1,2,11,2,48,67,9,19,May,0.4999999999999999,-0.8660254037844387,1,28,0,1,4,0.6,1.8,48,38,10,64,35,29,"May, 2021"
2020-2021,35,2021-05-09,West Ham,Everton,0,1,A,0,3,3,1,1,2,1,2,5,8,58,52,3,6,May,0.4999999999999999,-0.8660254037844387,45,18,2,1,2,1.0,1.2,55,44,11,45,42,3,"May, 2021"
2020-2021,35,2021-05-09,Arsenal,West Brom,3,1,H,3,0,5,0,0,0,1,4,10,19,49,26,9,23,May,0.4999999999999999,-0.8660254037844387,0,44,3,1,1,1.8,0.8,46,37,9,31,65,-34,"May, 2021"
2020-2021,35,2021-05-10,Fulham,Burnley,0,2,A,0,3,0,1,4,1,0,4,18,17,27,36,1,9,May,0.4999999999999999,-0.8660254037844387,19,11,2,2,1,2.0,1.2,25,45,-20,31,47,-16,"May, 2021"
2020-2021,35,2021-05-11,Man United,Leicester,1,2,A,0,3,2,1,2,1,1,3,2,4,70,63,2,7,May,0.4999999999999999,-0.8660254037844387,28,24,4,1,0,1.6,0.6,67,36,31,63,43,20,"May, 2021"
2020-2021,35,2021-05-11,Southampton,Crystal Palace,3,1,H,3,0,2,0,3,2,0,3,17,13,37,41,4,4,May,0.4999999999999999,-0.8660254037844387,38,16,2,2,1,1.2,0.6,41,61,-20,36,56,-20,"May, 2021"
2020-2021,35,2021-05-12,Chelsea,Arsenal,0,1,A,0,3,3,0,2,5,0,0,4,9,64,52,5,12,May,0.4999999999999999,-0.8660254037844387,14,0,2,1,2,1.6,2.0,55,32,23,49,38,11,"May, 2021"
2020-2021,35,2021-05-13,Man United,Liverpool,2,4,A,0,3,2,1,2,5,0,0,2,6,70,57,4,13,May,0.4999999999999999,-0.8660254037844387,28,25,0,3,2,0.4,1.2,68,38,30,57,39,18,"May, 2021"
2020-2021,35,2021-05-13,Aston Villa,Everton,0,0,D,1,1,2,1,2,2,1,2,11,9,48,55,2,7,May,0.4999999999999999,-0.8660254037844387,1,18,2,1,2,1.2,1.8,49,41,8,46,42,4,"May, 2021"
2020-2021,36,2021-05-14,Newcastle,Man City,3,4,A,0,3,3,0,2,3,0,2,16,1,39,80,15,41,May,0.4999999999999999,-0.8660254037844387,30,27,1,1,3,1.0,2.4,40,58,-18,72,26,46,"May, 2021"
2020-2021,36,2021-05-15,Burnley,Leeds,0,4,A,0,3,1,0,4,4,0,1,15,10,39,50,5,11,May,0.4999999999999999,-0.8660254037844387,11,23,0,0,1,0.0,1.0,33,47,-14,53,53,0,"May, 2021"
2020-2021,36,2021-05-15,Southampton,Fulham,3,1,H,3,0,2,0,3,0,1,4,14,18,40,27,4,13,May,0.4999999999999999,-0.8660254037844387,38,19,3,1,1,1.8,0.6,44,62,-18,25,47,-22,"May, 2021"
2020-2021,36,2021-05-15,Brighton,West Ham,1,1,D,1,1,2,1,2,3,1,1,17,6,37,58,11,21,May,0.4999999999999999,-0.8660254037844387,10,45,1,4,0,1.8,1.6,36,41,-5,55,45,10,"May, 2021"
2020-2021,36,2021-05-16,Crystal Palace,Aston Villa,3,2,H,3,0,2,0,3,2,1,2,14,11,41,49,3,8,May,0.4999999999999999,-0.8660254037844387,16,1,2,0,3,0.6,1.4,37,59,-22,49,41,8,"May, 2021"
2020-2021,36,2021-05-16,Tottenham,Wolves,2,0,H,3,0,3,0,2,1,1,3,7,12,56,45,5,11,May,0.4999999999999999,-0.8660254037844387,42,48,2,1,2,1.8,2.0,61,41,20,35,47,-12,"May, 2021"
2020-2021,36,2021-05-16,West Brom,Liverpool,1,2,A,0,3,0,1,4,5,0,0,19,5,26,60,14,34,May,0.4999999999999999,-0.8660254037844387,44,25,0,3,2,0.8,1.2,32,68,-36,61,41,20,"May, 2021"
2020-2021,36,2021-05-16,Everton,Sheffield United,0,1,A,0,3,2,1,2,2,0,3,8,20,56,17,12,39,May,0.4999999999999999,-0.8660254037844387,18,36,3,1,1,1.0,0.6,46,42,4,18,62,-44,"May, 2021"
2020-2021,37,2021-05-18,Chelsea,Leicester,2,1,H,3,0,3,0,2,1,1,3,4,3,64,66,1,2,May,0.4999999999999999,-0.8660254037844387,14,24,0,3,2,0.6,1.2,55,33,22,65,44,21,"May, 2021"
2020-2021,37,2021-05-18,Southampton,Leeds,0,2,A,0,3,2,0,3,4,0,1,14,10,43,53,4,10,May,0.4999999999999999,-0.8660254037844387,38,23,2,2,1,1.2,1.4,47,63,-16,57,53,4,"May, 2021"
2020-2021,37,2021-05-18,Man United,Fulham,1,1,D,1,1,2,1,2,0,1,4,2,18,70,27,16,43,May,0.4999999999999999,-0.8660254037844387,28,19,4,1,0,2.8,1.0,70,42,28,26,50,-24,"May, 2021"
2020-2021,37,2021-05-18,Brighton,Man City,3,2,H,3,0,2,1,2,3,0,2,17,1,38,83,16,45,May,0.4999999999999999,-0.8660254037844387,10,27,0,0,5,0.2,3.2,37,42,-5,76,29,47,"May, 2021"
2020-2021,37,2021-05-19,Everton,Wolves,1,0,H,3,0,2,1,2,1,1,3,9,12,56,45,3,11,May,0.4999999999999999,-0.8660254037844387,18,48,2,1,2,1.6,2.2,46,43,3,35,49,-14,"May, 2021"
2020-2021,37,2021-05-19,Newcastle,Sheffield United,1,0,H,3,0,3,0,2,2,0,3,17,20,39,20,3,19,May,0.4999999999999999,-0.8660254037844387,30,36,3,0,2,1.4,0.6,43,62,-19,19,62,-43,"May, 2021"
2020-2021,37,2021-05-19,Tottenham,Aston Villa,1,2,A,0,3,3,0,2,2,1,2,6,11,59,49,5,10,May,0.4999999999999999,-0.8660254037844387,42,1,5,0,0,2.6,0.8,63,41,22,51,44,7,"May, 2021"
2020-2021,37,2021-05-19,Crystal Palace,Arsenal,1,3,A,0,3,2,0,3,5,0,0,13,10,44,55,3,11,May,0.4999999999999999,-0.8660254037844387,16,0,1,4,0,1.6,1.4,40,61,-21,50,38,12,"May, 2021"
2020-2021,37,2021-05-19,Burnley,Liverpool,0,3,A,0,3,1,0,4,5,0,0,17,5,39,63,12,24,May,0.4999999999999999,-0.8660254037844387,11,25,1,1,3,1.0,2.2,33,51,-18,63,42,21,"May, 2021"
2020-2021,37,2021-05-19,West Brom,West Ham,1,3,A,0,3,0,1,4,3,1,1,19,7,26,59,12,33,May,0.4999999999999999,-0.8660254037844387,44,45,1,2,2,1.6,1.6,33,70,-37,56,46,10,"May, 2021"
2020-2021,38,2021-05-23,Wolves,Man United,1,2,A,0,3,1,1,3,2,1,2,12,2,45,71,10,26,May,0.4999999999999999,-0.8660254037844387,48,28,1,3,1,0.8,0.8,35,50,-15,71,43,28,"May, 2021"
2020-2021,38,2021-05-23,West Ham,Southampton,3,0,H,3,0,3,1,1,2,0,3,7,15,62,43,8,19,May,0.4999999999999999,-0.8660254037844387,45,38,4,1,0,1.8,0.4,59,47,12,47,65,-18,"May, 2021"
2020-2021,38,2021-05-23,Sheffield United,Burnley,1,0,H,3,0,2,0,3,1,0,4,20,17,20,39,3,19,May,0.4999999999999999,-0.8660254037844387,36,11,1,1,1,1.3333333333333333,0.6666666666666666,19,63,-44,33,54,-21,"May, 2021"
2020-2021,38,2021-05-23,Man City,Everton,5,0,H,3,0,3,0,2,2,1,2,1,10,83,59,9,24,May,0.4999999999999999,-0.8660254037844387,27,18,5,0,0,2.6,0.8,78,32,46,47,43,4,"May, 2021"
2020-2021,38,2021-05-23,Liverpool,Crystal Palace,2,0,H,3,0,5,0,0,2,0,3,4,14,66,44,10,22,May,0.4999999999999999,-0.8660254037844387,25,16,5,0,0,3.8,0.8,66,42,24,41,64,-23,"May, 2021"
2020-2021,38,2021-05-23,Aston Villa,Chelsea,2,1,H,3,0,2,1,2,3,0,2,11,3,52,67,8,15,May,0.4999999999999999,-0.8660254037844387,1,14,0,1,4,0.6,2.2,53,45,8,57,34,23,"May, 2021"
2020-2021,38,2021-05-23,Leeds,West Brom,3,1,H,3,0,4,0,1,0,1,4,10,19,56,26,9,30,May,0.4999999999999999,-0.8660254037844387,23,44,2,1,0,2.6666666666666665,0.3333333333333333,59,53,6,34,73,-39,"May, 2021"
2020-2021,38,2021-05-23,Fulham,Newcastle,0,2,A,0,3,0,1,4,3,0,2,18,15,28,42,3,14,May,0.4999999999999999,-0.8660254037844387,19,30,1,2,2,0.4,1.2,27,51,-24,44,62,-18,"May, 2021"
2020-2021,38,2021-05-23,Arsenal,Brighton,2,0,H,3,0,5,0,0,2,1,2,9,16,58,41,7,17,May,0.4999999999999999,-0.8660254037844387,0,10,1,2,2,1.0,1.2,53,39,14,40,44,-4,"May, 2021"
2020-2021,38,2021-05-23,Leicester,Tottenham,2,4,A,0,3,1,1,3,3,0,2,5,8,66,59,3,7,May,0.4999999999999999,-0.8660254037844387,24,42,2,0,3,1.0,1.8,66,46,20,64,43,21,"May, 2021"
2021-2022,1,2021-08-13,Brentford,Arsenal,2,0,H,3,0,2,1,2,3,0,2,3,1,0,0,2,0,August,-0.8660254037844384,-0.5000000000000004,9,0,0,0,0,0.0,0.0,0,0,0,0,0,0,"August, 2021"
2021-2022,1,2021-08-14,Watford,Aston Villa,3,2,H,3,0,0,1,4,1,2,2,13,7,0,0,6,0,August,-0.8660254037844384,-0.5000000000000004,43,1,3,0,2,2.0,1.6,0,0,0,0,0,0,"August, 2021"
2021-2022,1,2021-08-14,Norwich,Liverpool,0,3,A,0,3,0,1,4,4,1,0,11,8,0,0,3,0,August,-0.8660254037844384,-0.5000000000000004,31,25,0,1,4,1.6,2.8,0,0,0,0,0,0,"August, 2021"
2021-2022,1,2021-08-14,Leicester,Wolves,1,0,H,3,0,3,1,1,0,2,3,7,15,0,0,8,0,August,-0.8660254037844384,-0.5000000000000004,24,48,1,3,1,0.8,0.8,0,0,0,0,0,0,"August, 2021"
2021-2022,1,2021-08-14,Everton,Southampton,3,1,H,3,0,2,1,2,0,1,4,6,12,0,0,6,0,August,-0.8660254037844384,-0.5000000000000004,18,38,2,1,2,1.0,1.2,0,0,0,0,0,0,"August, 2021"
2021-2022,1,2021-08-14,Chelsea,Crystal Palace,3,0,H,3,0,2,2,1,3,1,1,5,6,0,0,1,0,August,-0.8660254037844384,-0.5000000000000004,14,16,5,0,0,2.8,0.6,0,0,0,0,0,0,"August, 2021"
2021-2022,1,2021-08-14,Burnley,Brighton,1,2,A,0,3,1,1,3,3,2,0,5,4,0,0,1,0,August,-0.8660254037844384,-0.5000000000000004,11,10,1,3,1,1.2,1.0,0,0,0,0,0,0,"August, 2021"
2021-2022,1,2021-08-14,Man United,Leeds,5,1,H,3,0,1,1,3,1,1,3,12,8,0,0,4,0,August,-0.8660254037844384,-0.5000000000000004,28,23,3,2,0,2.0,0.8,0,0,0,0,0,0,"August, 2021"
2021-2022,1,2021-08-15,Newcastle,West Ham,2,4,A,0,3,3,0,2,1,1,3,10,12,0,0,2,0,August,-0.8660254037844384,-0.5000000000000004,30,45,3,1,1,2.0,1.6,0,0,0,0,0,0,"August, 2021"
2021-2022,1,2021-08-15,Tottenham,Man City,1,0,H,3,0,4,1,0,4,1,0,11,10,0,0,1,0,August,-0.8660254037844384,-0.5000000000000004,42,27,2,1,2,1.2,1.2,0,0,0,0,0,0,"August, 2021"
2021-2022,2,2021-08-21,Brighton,Watford,2,0,H,3,0,3,2,0,0,1,4,10,9,3,3,1,0,August,-0.8660254037844384,-0.5000000000000004,10,43,2,2,1,1.0,0.6,2,1,1,3,2,1,"August, 2021"
2021-2022,2,2021-08-21,Man City,Norwich,5,0,H,3,0,4,1,0,0,1,4,14,19,0,0,5,0,August,-0.8660254037844384,-0.5000000000000004,27,31,2,2,1,1.8,0.8,0,1,-1,0,3,-3,"August, 2021"
2021-2022,2,2021-08-21,Leeds,Everton,2,2,D,1,1,1,1,3,2,1,2,20,6,0,3,14,3,August,-0.8660254037844384,-0.5000000000000004,23,18,1,1,3,0.6,1.8,1,5,-4,3,1,2,"August, 2021"
2021-2022,2,2021-08-21,Aston Villa,Newcastle,2,0,H,3,0,1,2,2,3,0,2,11,14,0,0,3,0,August,-0.8660254037844384,-0.5000000000000004,1,30,2,3,0,1.2,0.4,2,3,-1,2,4,-2,"August, 2021"
2021-2022,2,2021-08-21,Liverpool,Burnley,2,0,H,3,0,4,1,0,1,1,3,3,12,3,0,9,3,August,-0.8660254037844384,-0.5000000000000004,25,11,3,1,1,2.2,0.8,3,0,3,1,2,-1,"August, 2021"
2021-2022,2,2021-08-21,Crystal Palace,Brentford,0,0,D,1,1,3,1,1,2,1,2,17,6,0,3,11,3,August,-0.8660254037844384,-0.5000000000000004,16,9,0,0,0,0.0,0.0,0,3,-3,2,0,2,"August, 2021"
2021-2022,2,2021-08-22,Southampton,Man United,1,1,D,1,1,0,1,4,1,1,3,16,6,0,3,10,3,August,-0.8660254037844384,-0.5000000000000004,38,28,0,2,3,1.4,3.6,1,3,-2,5,1,4,"August, 2021"
2021-2022,2,2021-08-22,Wolves,Tottenham,0,1,A,0,3,0,2,3,4,1,0,16,11,0,3,5,3,August,-0.8660254037844384,-0.5000000000000004,48,42,2,1,2,1.6,1.6,0,1,-1,1,0,1,"August, 2021"
2021-2022,2,2021-08-22,Arsenal,Chelsea,0,2,A,0,3,3,0,2,2,2,1,16,8,0,3,8,3,August,-0.8660254037844384,-0.5000000000000004,0,14,3,1,1,1.8,1.0,0,2,-2,3,0,3,"August, 2021"
2021-2022,2,2021-08-23,West Ham,Leicester,4,1,H,3,0,1,1,3,3,1,1,9,11,3,3,2,0,August,-0.8660254037844384,-0.5000000000000004,45,24,2,1,2,2.0,2.0,4,2,2,1,0,1,"August, 2021"
2021-2022,3,2021-08-28,Norwich,Leicester,1,2,A,0,3,0,1,4,3,1,1,19,12,0,3,7,3,August,-0.8660254037844384,-0.5000000000000004,31,24,1,1,2,0.75,1.0,0,8,-8,2,4,-2,"August, 2021"
2021-2022,3,2021-08-28,West Ham,Crystal Palace,2,2,D,1,1,1,1,3,3,1,1,3,14,6,1,11,5,August,-0.8660254037844384,-0.5000000000000004,45,16,1,2,2,1.4,1.6,8,3,5,0,3,-3,"August, 2021"
2021-2022,3,2021-08-28,Newcastle,Southampton,2,2,D,1,1,3,0,2,0,1,4,18,13,0,1,5,1,August,-0.8660254037844384,-0.5000000000000004,30,38,4,0,1,1.8,1.2,2,6,-4,2,4,-2,"August, 2021"
2021-2022,3,2021-08-28,Liverpool,Chelsea,1,1,D,1,1,4,1,0,2,2,1,5,4,6,6,1,0,August,-0.8660254037844384,-0.5000000000000004,25,14,4,0,1,2.2,1.0,5,0,5,5,0,5,"August, 2021"
2021-2022,3,2021-08-28,Aston Villa,Brentford,1,1,D,1,1,1,2,2,2,1,2,10,9,3,4,1,1,August,-0.8660254037844384,-0.5000000000000004,1,9,0,0,0,0.0,0.0,4,3,1,2,0,2,"August, 2021"
2021-2022,3,2021-08-28,Man City,Arsenal,5,0,H,3,0,4,1,0,3,0,2,9,19,3,0,10,3,August,-0.8660254037844384,-0.5000000000000004,27,0,5,0,0,2.2,0.2,5,1,4,0,4,-4,"August, 2021"
2021-2022,3,2021-08-28,Brighton,Everton,0,2,A,0,3,3,2,0,2,1,2,5,9,6,4,4,2,August,-0.8660254037844384,-0.5000000000000004,10,18,2,1,2,1.2,1.4,4,1,3,5,3,2,"August, 2021"
2021-2022,3,2021-08-29,Burnley,Leeds,1,1,D,1,1,1,1,3,1,1,3,18,16,0,1,2,1,August,-0.8660254037844384,-0.5000000000000004,11,23,0,0,2,0.0,2.5,1,4,-3,3,7,-4,"August, 2021"
2021-2022,3,2021-08-29,Tottenham,Watford,1,0,H,3,0,4,1,0,0,1,4,6,12,6,3,6,3,August,-0.8660254037844384,-0.5000000000000004,42,43,2,2,1,1.2,0.8,2,0,2,3,4,-1,"August, 2021"
2021-2022,3,2021-08-29,Wolves,Man United,0,1,A,0,3,0,2,3,1,1,3,18,10,0,4,8,4,August,-0.8660254037844384,-0.5000000000000004,48,28,1,2,2,0.8,1.0,0,2,-2,6,2,4,"August, 2021"
2021-2022,4,2021-09-11,Chelsea,Aston Villa,3,0,H,3,0,2,2,1,1,2,2,6,12,7,4,6,3,September,-1.0,-1.8369701987210287e-16,14,1,3,1,1,2.0,1.0,6,1,5,5,4,1,"September, 2021"
2021-2022,4,2021-09-11,Watford,Wolves,0,2,A,0,3,0,1,4,0,2,3,14,19,3,0,5,3,September,-1.0,-1.8369701987210287e-16,43,48,2,0,2,1.25,1.25,3,5,-2,0,3,-3,"September, 2021"
2021-2022,4,2021-09-11,Man United,Newcastle,4,1,H,3,0,1,1,3,3,0,2,5,18,7,1,13,6,September,-1.0,-1.8369701987210287e-16,28,30,4,0,1,2.6,0.8,7,2,5,4,8,-4,"September, 2021"
2021-2022,4,2021-09-11,Southampton,West Ham,0,0,D,1,1,0,1,4,1,1,3,15,5,2,7,10,5,September,-1.0,-1.8369701987210287e-16,38,45,0,1,4,0.2,2.0,4,6,-2,10,5,5,"September, 2021"
2021-2022,4,2021-09-11,Brentford,Brighton,0,1,A,0,3,2,1,2,3,2,0,10,8,5,6,2,1,September,-1.0,-1.8369701987210287e-16,9,10,0,0,0,0.0,0.0,3,1,2,4,3,1,"September, 2021"
2021-2022,4,2021-09-11,Arsenal,Norwich,1,0,H,3,0,3,0,2,0,1,4,20,19,0,0,1,0,September,-1.0,-1.8369701987210287e-16,0,31,3,2,0,2.0,0.6,0,9,-9,1,10,-9,"September, 2021"
2021-2022,4,2021-09-11,Crystal Palace,Tottenham,3,0,H,3,0,3,1,1,4,1,0,14,1,2,9,13,7,September,-1.0,-1.8369701987210287e-16,16,42,0,2,3,0.6,2.4,2,5,-3,3,0,3,"September, 2021"
2021-2022,4,2021-09-11,Leicester,Man City,0,1,A,0,3,3,1,1,4,1,0,9,8,6,6,1,0,September,-1.0,-1.8369701987210287e-16,24,27,1,0,4,1.2,1.8,4,5,-1,10,1,9,"September, 2021"
2021-2022,4,2021-09-12,Leeds,Liverpool,0,3,A,0,3,1,1,3,4,1,0,17,7,2,7,10,5,September,-1.0,-1.8369701987210287e-16,23,25,0,2,3,1.6,2.6,4,8,-4,6,1,5,"September, 2021"
2021-2022,4,2021-09-13,Everton,Burnley,3,1,H,3,0,2,1,2,1,1,3,8,18,7,1,10,6,September,-1.0,-1.8369701987210287e-16,18,11,2,1,2,1.0,0.8,7,3,4,2,5,-3,"September, 2021"
2021-2022,5,2021-09-17,Newcastle,Leeds,1,1,D,1,1,3,0,2,1,1,3,19,17,1,2,2,1,September,-1.0,-1.8369701987210287e-16,30,23,2,1,2,1.8,1.8,5,12,-7,4,11,-7,"September, 2021"
2021-2022,5,2021-09-18,Aston Villa,Everton,3,0,H,3,0,1,2,2,2,1,2,14,5,4,10,9,6,September,-1.0,-1.8369701987210287e-16,1,18,2,2,1,1.2,1.0,5,7,-2,10,4,6,"September, 2021"
2021-2022,5,2021-09-18,Wolves,Brentford,0,2,A,0,3,0,2,3,2,1,2,13,10,3,5,3,2,September,-1.0,-1.8369701987210287e-16,48,9,0,0,0,0.0,0.0,2,3,-1,3,2,1,"September, 2021"
2021-2022,5,2021-09-18,Burnley,Arsenal,0,1,A,0,3,1,1,3,3,0,2,19,17,1,3,2,2,September,-1.0,-1.8369701987210287e-16,11,0,1,2,2,0.8,1.2,3,8,-5,1,9,-8,"September, 2021"
2021-2022,5,2021-09-18,Liverpool,Crystal Palace,3,0,H,3,0,4,1,0,3,1,1,3,12,10,5,9,5,September,-1.0,-1.8369701987210287e-16,25,16,5,0,0,3.8,0.8,9,1,8,5,5,0,"September, 2021"
2021-2022,5,2021-09-18,Man City,Southampton,0,0,D,1,1,4,1,0,0,1,4,5,14,9,3,9,6,September,-1.0,-1.8369701987210287e-16,27,38,4,0,1,2.2,1.0,11,1,10,4,6,-2,"September, 2021"
2021-2022,5,2021-09-18,Norwich,Watford,1,3,A,0,3,0,1,4,0,1,4,20,16,0,3,4,3,September,-1.0,-1.8369701987210287e-16,31,43,1,0,3,1.25,2.0,1,11,-10,3,7,-4,"September, 2021"
2021-2022,5,2021-09-19,Tottenham,Chelsea,0,3,A,0,3,4,1,0,2,2,1,7,5,9,10,2,1,September,-1.0,-1.8369701987210287e-16,42,14,0,1,4,0.2,1.4,3,3,0,9,1,8,"September, 2021"
2021-2022,5,2021-09-19,West Ham,Man United,1,2,A,0,3,1,1,3,1,1,3,8,4,8,10,4,2,September,-1.0,-1.8369701987210287e-16,45,28,1,1,3,1.0,1.4,10,5,5,11,3,8,"September, 2021"
2021-2022,5,2021-09-19,Brighton,Leicester,2,1,H,3,0,3,2,0,3,1,1,6,12,9,6,6,3,September,-1.0,-1.8369701987210287e-16,10,24,0,1,4,0.4,1.8,5,3,2,4,6,-2,"September, 2021"
2021-2022,6,2021-09-25,Chelsea,Man City,0,1,A,0,3,2,2,1,4,1,0,1,5,13,10,4,3,September,-1.0,-1.8369701987210287e-16,14,27,2,0,3,1.2,2.6,12,1,11,11,1,10,"September, 2021"
2021-2022,6,2021-09-25,Man United,Aston Villa,0,1,A,0,3,1,1,3,1,2,2,4,10,13,7,6,6,September,-1.0,-1.8369701987210287e-16,28,1,4,1,0,2.2,0.8,13,4,9,8,7,1,"September, 2021"
2021-2022,6,2021-09-25,Everton,Norwich,2,0,H,3,0,2,1,2,0,1,4,6,20,10,0,14,10,September,-1.0,-1.8369701987210287e-16,18,31,3,1,1,1.4,0.6,10,7,3,2,14,-12,"September, 2021"
2021-2022,6,2021-09-25,Leeds,West Ham,1,2,A,0,3,1,1,3,1,1,3,17,9,3,8,8,5,September,-1.0,-1.8369701987210287e-16,23,45,3,0,2,1.8,1.4,5,12,-7,11,7,4,"September, 2021"
2021-2022,6,2021-09-25,Leicester,Burnley,2,2,D,1,1,3,1,1,1,1,3,12,19,6,1,7,5,September,-1.0,-1.8369701987210287e-16,24,11,3,1,1,2.0,1.4,5,8,-3,3,9,-6,"September, 2021"
2021-2022,6,2021-09-25,Watford,Newcastle,1,1,D,1,1,0,1,4,3,0,2,12,19,6,2,7,4,September,-1.0,-1.8369701987210287e-16,43,30,2,2,1,1.2,1.0,6,8,-2,6,13,-7,"September, 2021"
2021-2022,6,2021-09-25,Brentford,Liverpool,3,3,D,1,1,2,1,2,4,1,0,10,1,8,13,9,5,September,-1.0,-1.8369701987210287e-16,9,25,0,0,0,0.0,0.0,5,2,3,12,1,11,"September, 2021"
2021-2022,6,2021-09-26,Southampton,Wolves,0,1,A,0,3,0,1,4,0,2,3,15,16,4,3,1,1,September,-1.0,-1.8369701987210287e-16,38,48,1,2,2,1.6,1.6,4,6,-2,2,5,-3,"September, 2021"
2021-2022,6,2021-09-26,Arsenal,Tottenham,3,1,H,3,0,3,0,2,4,1,0,14,10,6,9,4,3,September,-1.0,-1.8369701987210287e-16,0,42,1,2,2,1.2,1.6,2,9,-7,3,6,-3,"September, 2021"
2021-2022,6,2021-09-27,Crystal Palace,Brighton,1,1,D,1,1,3,1,1,3,2,0,15,6,5,12,9,7,September,-1.0,-1.8369701987210287e-16,16,10,2,2,1,1.2,1.0,5,8,-3,7,4,3,"September, 2021"
2021-2022,7,2021-10-02,Brighton,Arsenal,0,0,D,1,1,3,2,0,3,0,2,6,11,13,9,5,4,October,-0.8660254037844386,0.5,10,0,2,1,2,1.0,1.2,8,5,3,5,10,-5,"October, 2021"
2021-2022,7,2021-10-02,Wolves,Newcastle,2,1,H,3,0,0,2,3,3,0,2,14,19,6,3,5,3,October,-0.8660254037844386,0.5,48,30,0,5,0,1.0,1.0,3,5,-2,7,14,-7,"October, 2021"
2021-2022,7,2021-10-02,Leeds,Watford,1,0,H,3,0,1,1,3,0,1,4,19,12,3,7,7,4,October,-0.8660254037844386,0.5,23,43,2,0,0,2.5,1.0,6,14,-8,7,9,-2,"October, 2021"
2021-2022,7,2021-10-02,Man United,Everton,1,1,D,1,1,1,1,3,2,1,2,4,5,13,13,1,0,October,-0.8660254037844386,0.5,28,18,1,3,1,1.6,2.0,13,5,8,12,7,5,"October, 2021"
2021-2022,7,2021-10-02,Burnley,Norwich,0,0,D,1,1,1,1,3,0,1,4,19,20,2,0,1,2,October,-0.8660254037844386,0.5,11,31,2,0,0,2.0,0.0,5,11,-6,2,16,-14,"October, 2021"
2021-2022,7,2021-10-02,Chelsea,Southampton,3,1,H,3,0,2,2,1,0,1,4,5,16,13,4,11,9,October,-0.8660254037844386,0.5,14,38,1,3,1,1.6,1.4,12,2,10,4,7,-3,"October, 2021"
2021-2022,7,2021-10-03,Crystal Palace,Leicester,2,2,D,1,1,3,1,1,3,1,1,15,13,6,7,2,1,October,-0.8660254037844386,0.5,16,24,1,1,3,1.2,1.8,6,9,-3,7,10,-3,"October, 2021"
2021-2022,7,2021-10-03,Tottenham,Aston Villa,2,1,H,3,0,4,1,0,1,2,2,12,8,9,10,4,1,October,-0.8660254037844386,0.5,42,1,4,0,1,2.2,1.0,4,9,-5,9,7,2,"October, 2021"
2021-2022,7,2021-10-03,West Ham,Brentford,1,2,A,0,3,1,1,3,2,1,2,8,11,11,9,3,2,October,-0.8660254037844386,0.5,45,9,0,0,0,0.0,0.0,13,8,5,8,5,3,"October, 2021"
2021-2022,7,2021-10-03,Liverpool,Man City,2,2,D,1,1,4,1,0,4,1,0,2,6,14,13,4,1,October,-0.8660254037844386,0.5,25,27,1,1,3,1.2,2.4,15,4,11,12,1,11,"October, 2021"
2021-2022,8,2021-10-16,Southampton,Leeds,1,0,H,3,0,0,1,4,1,1,3,17,16,4,6,1,2,October,-0.8660254037844386,0.5,38,23,2,1,2,1.0,1.6,5,10,-5,7,14,-7,"October, 2021"
2021-2022,8,2021-10-16,Brentford,Chelsea,0,1,A,0,3,2,1,2,2,2,1,7,3,12,16,4,4,October,-0.8660254037844386,0.5,9,14,0,0,0,0.0,0.0,10,6,4,15,3,12,"October, 2021"
2021-2022,8,2021-10-16,Norwich,Brighton,0,0,D,1,1,0,1,4,3,2,0,20,6,1,14,14,13,October,-0.8660254037844386,0.5,31,10,0,0,2,0.0,1.5,2,16,-14,8,5,3,"October, 2021"
2021-2022,8,2021-10-16,Watford,Liverpool,0,5,A,0,3,0,1,4,4,1,0,15,2,7,15,13,8,October,-0.8660254037844386,0.5,43,25,1,0,4,0.6,3.0,7,10,-3,17,6,11,"October, 2021"
2021-2022,8,2021-10-16,Leicester,Man United,4,2,H,3,0,3,1,1,1,1,3,13,4,8,14,9,6,October,-0.8660254037844386,0.5,24,28,1,1,3,0.8,1.4,9,12,-3,14,6,8,"October, 2021"
2021-2022,8,2021-10-16,Aston Villa,Wolves,2,3,A,0,3,1,2,2,0,2,3,10,12,10,9,2,1,October,-0.8660254037844386,0.5,1,48,2,1,2,1.0,1.0,10,9,1,5,6,-1,"October, 2021"
2021-2022,8,2021-10-16,Man City,Burnley,2,0,H,3,0,4,1,0,1,1,3,3,18,14,3,15,11,October,-0.8660254037844386,0.5,27,11,5,0,0,3.4,0.2,14,3,11,5,11,-6,"October, 2021"
2021-2022,8,2021-10-17,Everton,West Ham,0,1,A,0,3,2,1,2,1,1,3,6,10,14,11,4,3,October,-0.8660254037844386,0.5,18,45,3,1,1,1.2,0.4,13,8,5,14,10,4,"October, 2021"
2021-2022,8,2021-10-17,Newcastle,Tottenham,2,3,A,0,3,3,0,2,4,1,0,18,10,3,12,8,9,October,-0.8660254037844386,0.5,30,42,1,2,2,1.0,1.4,8,16,-8,6,10,-4,"October, 2021"
2021-2022,8,2021-10-18,Arsenal,Crystal Palace,2,2,D,1,1,3,0,2,3,1,1,13,14,10,7,1,3,October,-0.8660254037844386,0.5,0,16,1,3,1,1.6,1.4,5,10,-5,8,11,-3,"October, 2021"
2021-2022,9,2021-10-22,Arsenal,Aston Villa,3,1,H,3,0,3,0,2,1,2,2,12,13,11,10,1,1,October,-0.8660254037844386,0.5,0,1,2,0,3,1.4,1.4,7,12,-5,12,12,0,"October, 2021"
2021-2022,9,2021-10-23,Brighton,Man City,1,4,A,0,3,3,2,0,4,1,0,4,3,15,17,1,2,October,-0.8660254037844386,0.5,10,27,1,0,4,0.8,3.2,8,5,3,16,3,13,"October, 2021"
2021-2022,9,2021-10-23,Southampton,Burnley,2,2,D,1,1,0,1,4,1,1,3,16,19,7,3,3,4,October,-0.8660254037844386,0.5,38,11,2,1,2,1.2,1.6,6,10,-4,5,13,-8,"October, 2021"
2021-2022,9,2021-10-23,Leeds,Wolves,1,1,D,1,1,1,1,3,0,2,3,17,11,6,12,6,6,October,-0.8660254037844386,0.5,23,48,1,0,3,1.25,1.5,7,15,-8,8,8,0,"October, 2021"
2021-2022,9,2021-10-23,Everton,Watford,2,5,A,0,3,2,1,2,0,1,4,8,16,14,7,8,7,October,-0.8660254037844386,0.5,18,43,2,1,2,1.2,1.2,13,9,4,7,15,-8,"October, 2021"
2021-2022,9,2021-10-23,Chelsea,Norwich,7,0,H,3,0,2,2,1,0,1,4,1,20,19,2,19,17,October,-0.8660254037844386,0.5,14,31,4,1,0,1.4,0.6,16,3,13,2,16,-14,"October, 2021"
2021-2022,9,2021-10-23,Crystal Palace,Newcastle,1,1,D,1,1,3,1,1,3,0,2,14,19,8,3,5,5,October,-0.8660254037844386,0.5,16,30,3,0,2,0.8,0.8,10,13,-3,10,19,-9,"October, 2021"
2021-2022,9,2021-10-24,Brentford,Leicester,1,2,A,0,3,2,1,2,3,1,1,11,12,12,11,1,1,October,-0.8660254037844386,0.5,9,24,0,0,0,0.0,0.0,10,7,3,13,14,-1,"October, 2021"
2021-2022,9,2021-10-24,West Ham,Tottenham,1,0,H,3,0,1,1,3,4,1,0,7,5,14,15,2,1,October,-0.8660254037844386,0.5,45,42,2,1,2,1.6,1.8,15,10,5,9,12,-3,"October, 2021"
2021-2022,9,2021-10-24,Man United,Liverpool,0,5,A,0,3,1,1,3,4,1,0,7,3,14,18,4,4,October,-0.8660254037844386,0.5,28,25,0,3,2,0.6,1.4,16,10,6,22,6,16,"October, 2021"
2021-2022,10,2021-10-30,Newcastle,Chelsea,0,3,A,0,3,3,0,2,2,2,1,19,2,4,22,17,18,October,-0.8660254037844386,0.5,30,14,1,0,4,0.4,1.4,11,20,-9,23,3,20,"October, 2021"
2021-2022,10,2021-10-30,Watford,Southampton,0,1,A,0,3,0,1,4,0,1,4,15,16,10,8,1,2,October,-0.8660254037844386,0.5,43,38,0,3,2,1.2,1.8,12,17,-5,8,12,-4,"October, 2021"
2021-2022,10,2021-10-30,Tottenham,Man United,0,3,A,0,3,4,1,0,1,1,3,7,8,15,14,1,1,October,-0.8660254037844386,0.5,42,28,1,1,3,1.8,1.6,9,13,-4,16,15,1,"October, 2021"
2021-2022,10,2021-10-30,Liverpool,Brighton,2,2,D,1,1,4,1,0,3,2,0,2,6,21,15,4,6,October,-0.8660254037844386,0.5,25,10,3,1,1,1.4,0.8,27,6,21,9,9,0,"October, 2021"
2021-2022,10,2021-10-30,Burnley,Brentford,3,1,H,3,0,1,1,3,2,1,2,18,12,4,12,6,8,October,-0.8660254037844386,0.5,11,9,0,0,0,0.0,0.0,7,15,-8,11,9,2,"October, 2021"
2021-2022,10,2021-10-30,Man City,Crystal Palace,0,2,A,0,3,4,1,0,3,1,1,3,15,20,9,12,11,October,-0.8660254037844386,0.5,27,16,4,1,0,2.6,0.6,20,4,16,11,14,-3,"October, 2021"
2021-2022,10,2021-10-30,Leicester,Arsenal,0,2,A,0,3,3,1,1,3,0,2,9,10,14,14,1,0,October,-0.8660254037844386,0.5,24,0,3,1,1,1.6,0.8,15,15,0,10,13,-3,"October, 2021"
2021-2022,10,2021-10-31,Norwich,Leeds,1,2,A,0,3,0,1,4,1,1,3,20,18,2,7,2,5,October,-0.8660254037844386,0.5,31,23,0,0,0,0.0,0.0,2,23,-21,8,16,-8,"October, 2021"
2021-2022,10,2021-10-31,Aston Villa,West Ham,1,4,A,0,3,1,2,2,1,1,3,15,4,10,17,11,7,October,-0.8660254037844386,0.5,1,45,0,2,3,0.6,1.6,13,15,-2,16,10,6,"October, 2021"
2021-2022,10,2021-11-01,Wolves,Everton,2,1,H,3,0,0,2,3,2,1,2,11,9,13,14,2,1,November,-0.5000000000000004,0.8660254037844384,48,18,2,0,3,1.8,1.4,9,9,0,15,14,1,"November, 2021"
2021-2022,11,2021-11-05,Southampton,Aston Villa,1,0,H,3,0,0,1,4,1,2,2,14,15,11,10,1,1,November,-0.5000000000000004,0.8660254037844384,38,1,4,0,1,2.6,1.4,9,12,-3,14,19,-5,"November, 2021"
2021-2022,11,2021-11-06,Man United,Man City,0,2,A,0,3,1,1,3,4,1,0,5,3,17,20,2,3,November,-0.5000000000000004,0.8660254037844384,28,27,3,1,1,1.2,0.6,19,15,4,20,6,14,"November, 2021"
2021-2022,11,2021-11-06,Brentford,Norwich,1,2,A,0,3,2,1,2,0,1,4,13,20,12,2,7,10,November,-0.5000000000000004,0.8660254037844384,9,31,0,0,0,0.0,0.0,12,12,0,3,25,-22,"November, 2021"
2021-2022,11,2021-11-06,Chelsea,Burnley,1,1,D,1,1,2,2,1,1,1,3,1,18,25,7,17,18,November,-0.5000000000000004,0.8660254037844384,14,11,4,1,0,2.8,0.8,26,3,23,10,16,-6,"November, 2021"
2021-2022,11,2021-11-06,Crystal Palace,Wolves,2,0,H,3,0,3,1,1,0,2,3,14,7,12,16,7,4,November,-0.5000000000000004,0.8660254037844384,16,48,2,1,2,0.8,1.0,13,14,-1,11,10,1,"November, 2021"
2021-2022,11,2021-11-06,Brighton,Newcastle,1,1,D,1,1,3,2,0,3,0,2,7,20,16,4,13,12,November,-0.5000000000000004,0.8660254037844384,10,30,2,3,0,1.4,0.2,11,11,0,11,23,-12,"November, 2021"
2021-2022,11,2021-11-07,West Ham,Liverpool,3,2,H,3,0,1,1,3,4,1,0,4,3,20,22,1,2,November,-0.5000000000000004,0.8660254037844384,45,25,0,1,4,1.0,2.2,20,11,9,29,8,21,"November, 2021"
2021-2022,11,2021-11-07,Leeds,Leicester,1,1,D,1,1,1,1,3,3,1,1,17,12,10,14,5,4,November,-0.5000000000000004,0.8660254037844384,23,24,3,0,2,1.8,2.2,10,17,-7,15,17,-2,"November, 2021"
2021-2022,11,2021-11-07,Everton,Tottenham,0,0,D,1,1,2,1,2,4,1,0,11,10,14,15,1,1,November,-0.5000000000000004,0.8660254037844384,18,42,1,3,1,1.2,1.2,16,16,0,9,16,-7,"November, 2021"
2021-2022,11,2021-11-07,Arsenal,Watford,1,0,H,3,0,3,0,2,0,1,4,7,16,17,10,9,7,November,-0.5000000000000004,0.8660254037844384,0,43,4,1,0,2.2,0.8,12,13,-1,12,18,-6,"November, 2021"
2021-2022,12,2021-11-20,Leicester,Chelsea,0,3,A,0,3,3,1,1,2,2,1,12,1,15,26,11,11,November,-0.5000000000000004,0.8660254037844384,24,14,1,3,1,1.2,1.0,16,18,-2,27,4,23,"November, 2021"
2021-2022,12,2021-11-20,Aston Villa,Brighton,2,0,H,3,0,1,2,2,3,2,0,16,7,10,17,9,7,November,-0.5000000000000004,0.8660254037844384,1,10,1,2,1,1.0,1.0,14,20,-6,12,12,0,"November, 2021"
2021-2022,12,2021-11-20,Burnley,Crystal Palace,3,3,D,1,1,1,1,3,3,1,1,18,10,8,15,8,7,November,-0.5000000000000004,0.8660254037844384,11,16,3,0,2,1.2,1.0,11,17,-6,15,14,1,"November, 2021"
2021-2022,12,2021-11-20,Newcastle,Brentford,3,3,D,1,1,3,0,2,2,1,2,19,15,5,12,4,7,November,-0.5000000000000004,0.8660254037844384,30,9,0,0,0,0.0,0.0,12,24,-12,13,14,-1,"November, 2021"
2021-2022,12,2021-11-20,Norwich,Southampton,2,1,H,3,0,0,1,4,0,1,4,20,13,5,14,7,9,November,-0.5000000000000004,0.8660254037844384,31,38,1,0,4,0.8,2.4,5,26,-21,10,12,-2,"November, 2021"
2021-2022,12,2021-11-20,Watford,Man United,4,1,H,3,0,0,1,4,1,1,3,17,6,10,17,11,7,November,-0.5000000000000004,0.8660254037844384,43,28,1,0,4,0.8,1.6,12,19,-7,19,17,2,"November, 2021"
2021-2022,12,2021-11-20,Wolves,West Ham,1,0,H,3,0,0,2,3,1,1,3,9,3,16,23,6,7,November,-0.5000000000000004,0.8660254037844384,48,45,3,0,2,1.8,1.4,11,12,-1,23,13,10,"November, 2021"
2021-2022,12,2021-11-20,Liverpool,Arsenal,4,0,H,3,0,4,1,0,3,0,2,4,5,22,20,1,2,November,-0.5000000000000004,0.8660254037844384,25,0,4,0,1,3.0,1.0,31,11,20,13,13,0,"November, 2021"
2021-2022,12,2021-11-21,Tottenham,Leeds,2,1,H,3,0,4,1,0,1,1,3,10,17,16,11,7,5,November,-0.5000000000000004,0.8660254037844384,42,23,3,1,1,1.8,1.2,9,16,-7,11,18,-7,"November, 2021"
2021-2022,12,2021-11-21,Man City,Everton,3,0,H,3,0,4,1,0,2,1,2,3,11,23,15,8,8,November,-0.5000000000000004,0.8660254037844384,27,18,5,0,0,3.0,0.6,22,6,16,16,16,0,"November, 2021"
2021-2022,13,2021-11-27,Arsenal,Newcastle,2,0,H,3,0,3,0,2,3,0,2,5,20,20,6,15,14,November,-0.5000000000000004,0.8660254037844384,0,30,5,0,0,2.4,0.0,13,17,-4,15,27,-12,"November, 2021"
2021-2022,13,2021-11-27,Crystal Palace,Aston Villa,1,2,A,0,3,3,1,1,1,2,2,10,15,16,13,5,3,November,-0.5000000000000004,0.8660254037844384,16,1,2,0,3,0.8,1.6,18,17,1,16,20,-4,"November, 2021"
2021-2022,13,2021-11-27,Liverpool,Southampton,4,0,H,3,0,4,1,0,0,1,4,3,14,25,14,11,11,November,-0.5000000000000004,0.8660254037844384,25,38,4,0,1,2.2,0.6,35,11,24,11,14,-3,"November, 2021"
2021-2022,13,2021-11-27,Norwich,Wolves,0,0,D,1,1,0,1,4,0,2,3,19,6,8,19,13,11,November,-0.5000000000000004,0.8660254037844384,31,48,1,1,2,1.25,2.0,7,27,-20,12,12,0,"November, 2021"
2021-2022,13,2021-11-27,Brighton,Leeds,0,0,D,1,1,3,2,0,1,1,3,9,17,17,11,8,6,November,-0.5000000000000004,0.8660254037844384,10,23,2,0,0,1.5,0.0,12,14,-2,12,20,-8,"November, 2021"
2021-2022,13,2021-11-28,Brentford,Everton,1,0,H,3,0,2,1,2,2,1,2,15,12,13,15,3,2,November,-0.5000000000000004,0.8660254037844384,9,18,0,0,0,0.0,0.0,16,17,-1,16,19,-3,"November, 2021"
2021-2022,13,2021-11-28,Leicester,Watford,4,2,H,3,0,3,1,1,0,1,4,14,16,15,13,2,2,November,-0.5000000000000004,0.8660254037844384,24,43,3,1,1,1.6,0.6,16,21,-5,16,20,-4,"November, 2021"
2021-2022,13,2021-11-28,Man City,West Ham,2,1,H,3,0,4,1,0,1,1,3,3,4,26,23,1,3,November,-0.5000000000000004,0.8660254037844384,27,45,4,1,0,2.2,0.4,25,6,19,23,14,9,"November, 2021"
2021-2022,13,2021-11-28,Chelsea,Man United,1,1,D,1,1,2,2,1,1,1,3,1,10,29,17,9,12,November,-0.5000000000000004,0.8660254037844384,14,28,0,3,2,0.2,1.4,30,4,26,20,21,-1,"November, 2021"
2021-2022,14,2021-11-30,Leeds,Crystal Palace,1,0,H,3,0,1,1,3,3,1,1,17,11,12,16,6,4,November,-0.5000000000000004,0.8660254037844384,23,16,2,0,2,1.25,1.5,12,20,-8,19,19,0,"November, 2021"
2021-2022,14,2021-11-30,Newcastle,Norwich,1,1,D,1,1,3,0,2,0,1,4,20,19,6,9,1,3,November,-0.5000000000000004,0.8660254037844384,30,31,1,2,2,1.8,1.6,15,29,-14,7,27,-20,"November, 2021"
2021-2022,14,2021-12-01,Southampton,Leicester,2,2,D,1,1,0,1,4,3,1,1,16,10,14,18,6,4,December,-2.4492935982947064e-16,1.0,38,24,2,1,2,1.0,2.8,11,18,-7,20,23,-3,"December, 2021"
2021-2022,14,2021-12-01,Watford,Chelsea,1,2,A,0,3,0,1,4,2,2,1,17,1,13,30,16,17,December,-2.4492935982947064e-16,1.0,43,14,1,0,4,1.2,2.2,18,24,-6,31,5,26,"December, 2021"
2021-2022,14,2021-12-01,West Ham,Brighton,1,1,D,1,1,1,1,3,3,2,0,4,10,23,18,6,5,December,-2.4492935982947064e-16,1.0,45,10,0,5,0,1.8,1.8,24,16,8,12,14,-2,"December, 2021"
2021-2022,14,2021-12-01,Wolves,Burnley,0,0,D,1,1,0,2,3,1,1,3,6,19,20,9,13,11,December,-2.4492935982947064e-16,1.0,48,11,0,2,3,0.6,2.0,12,12,0,14,20,-6,"December, 2021"
2021-2022,14,2021-12-01,Aston Villa,Man City,1,2,A,0,3,1,2,2,4,1,0,13,2,16,29,11,13,December,-2.4492935982947064e-16,1.0,1,27,0,0,5,0.4,3.4,18,21,-3,27,7,20,"December, 2021"
2021-2022,14,2021-12-01,Everton,Liverpool,1,4,A,0,3,2,1,2,4,1,0,14,3,15,28,11,13,December,-2.4492935982947064e-16,1.0,18,25,1,3,1,1.2,1.4,16,20,-4,39,11,28,"December, 2021"
2021-2022,14,2021-12-02,Tottenham,Brentford,2,0,H,3,0,4,1,0,2,1,2,9,11,19,16,2,3,December,-2.4492935982947064e-16,1.0,42,9,0,0,0,0.0,0.0,11,17,-6,17,17,0,"December, 2021"
2021-2022,14,2021-12-02,Man United,Arsenal,3,2,H,3,0,1,1,3,3,0,2,10,5,18,23,5,5,December,-2.4492935982947064e-16,1.0,28,0,0,2,3,0.2,1.2,21,22,-1,15,17,-2,"December, 2021"
2021-2022,15,2021-12-04,Watford,Man City,1,3,A,0,3,0,1,4,4,1,0,17,3,13,32,14,19,December,-2.4492935982947064e-16,1.0,43,27,0,0,5,0.6,4.0,19,26,-7,29,8,21,"December, 2021"
2021-2022,15,2021-12-04,Wolves,Liverpool,0,1,A,0,3,0,2,3,4,1,0,8,3,21,31,5,10,December,-2.4492935982947064e-16,1.0,48,25,0,0,5,0.2,2.0,12,12,0,43,12,31,"December, 2021"
2021-2022,15,2021-12-04,West Ham,Chelsea,3,2,H,3,0,1,1,3,2,2,1,4,1,24,33,3,9,December,-2.4492935982947064e-16,1.0,45,14,2,0,3,0.8,1.6,25,17,8,33,6,27,"December, 2021"
2021-2022,15,2021-12-04,Newcastle,Burnley,1,0,H,3,0,3,0,2,1,1,3,20,18,7,10,2,3,December,-2.4492935982947064e-16,1.0,30,11,3,1,1,1.4,0.6,16,30,-14,14,20,-6,"December, 2021"
2021-2022,15,2021-12-04,Southampton,Brighton,1,1,D,1,1,0,1,4,3,2,0,16,9,15,19,7,4,December,-2.4492935982947064e-16,1.0,38,10,3,1,1,1.4,0.8,13,20,-7,13,15,-2,"December, 2021"
2021-2022,15,2021-12-05,Leeds,Brentford,2,2,D,1,1,1,1,3,2,1,2,16,12,15,16,4,1,December,-2.4492935982947064e-16,1.0,23,9,0,0,0,0.0,0.0,13,20,-7,17,19,-2,"December, 2021"
2021-2022,15,2021-12-05,Man United,Crystal Palace,1,0,H,3,0,1,1,3,3,1,1,7,12,21,16,5,5,December,-2.4492935982947064e-16,1.0,28,16,2,1,2,1.4,1.2,24,24,0,19,20,-1,"December, 2021"
2021-2022,15,2021-12-05,Tottenham,Norwich,3,0,H,3,0,4,1,0,0,1,4,7,20,22,10,13,12,December,-2.4492935982947064e-16,1.0,42,31,3,1,1,2.0,0.8,13,17,-4,8,28,-20,"December, 2021"
2021-2022,15,2021-12-05,Aston Villa,Leicester,2,1,H,3,0,1,2,2,3,1,1,13,10,16,19,3,3,December,-2.4492935982947064e-16,1.0,1,24,1,1,3,0.8,2.2,19,23,-4,22,25,-3,"December, 2021"
2021-2022,15,2021-12-06,Everton,Arsenal,2,1,H,3,0,2,1,2,3,0,2,16,7,15,23,9,8,December,-2.4492935982947064e-16,1.0,18,0,3,1,1,1.2,0.8,17,24,-7,17,20,-3,"December, 2021"
2021-2022,16,2021-12-10,Brentford,Watford,2,1,H,3,0,2,1,2,0,1,4,13,17,17,13,4,4,December,-2.4492935982947064e-16,1.0,9,43,0,0,0,0.0,0.0,19,21,-2,20,29,-9,"December, 2021"
2021-2022,16,2021-12-11,Norwich,Man United,0,1,A,0,3,0,1,4,1,1,3,20,7,10,24,13,14,December,-2.4492935982947064e-16,1.0,31,28,1,0,4,0.6,2.6,8,31,-23,25,24,1,"December, 2021"
2021-2022,16,2021-12-11,Liverpool,Aston Villa,1,0,H,3,0,4,1,0,1,2,2,3,11,34,19,8,15,December,-2.4492935982947064e-16,1.0,25,1,4,0,1,2.8,1.8,44,12,32,21,24,-3,"December, 2021"
2021-2022,16,2021-12-11,Arsenal,Southampton,3,0,H,3,0,3,0,2,0,1,4,7,16,23,16,9,7,December,-2.4492935982947064e-16,1.0,0,38,3,2,0,2.0,0.8,18,22,-4,14,21,-7,"December, 2021"
2021-2022,16,2021-12-11,Man City,Wolves,1,0,H,3,0,4,1,0,0,2,3,1,8,35,21,7,14,December,-2.4492935982947064e-16,1.0,27,48,3,0,2,2.4,1.4,32,9,23,12,13,-1,"December, 2021"
2021-2022,16,2021-12-11,Chelsea,Leeds,3,2,H,3,0,2,2,1,1,1,3,3,15,33,16,12,17,December,-2.4492935982947064e-16,1.0,14,23,3,2,0,1.6,0.8,35,9,26,15,22,-7,"December, 2021"
2021-2022,16,2021-12-12,Burnley,West Ham,0,0,D,1,1,1,1,3,1,1,3,18,4,10,27,14,17,December,-2.4492935982947064e-16,1.0,11,45,3,0,2,1.4,0.6,14,21,-7,28,19,9,"December, 2021"
2021-2022,16,2021-12-12,Leicester,Newcastle,4,0,H,3,0,3,1,1,3,0,2,11,19,19,10,8,9,December,-2.4492935982947064e-16,1.0,24,30,3,0,2,2.4,1.2,23,27,-4,17,30,-13,"December, 2021"
2021-2022,16,2021-12-12,Crystal Palace,Everton,3,1,H,3,0,3,1,1,2,1,2,14,13,16,18,1,2,December,-2.4492935982947064e-16,1.0,16,18,0,3,2,0.6,1.2,19,21,-2,19,25,-6,"December, 2021"
2021-2022,17,2021-12-14,Man City,Leeds,7,0,H,3,0,4,1,0,1,1,3,1,15,38,16,14,22,December,-2.4492935982947064e-16,1.0,27,23,1,2,2,1.2,1.4,33,9,24,17,25,-8,"December, 2021"
2021-2022,17,2021-12-14,Norwich,Aston Villa,0,2,A,0,3,0,1,4,1,2,2,20,13,10,19,7,9,December,-2.4492935982947064e-16,1.0,31,1,1,0,4,0.8,2.4,8,32,-24,21,25,-4,"December, 2021"
2021-2022,17,2021-12-15,Crystal Palace,Southampton,2,2,D,1,1,3,1,1,0,1,4,13,15,19,16,2,3,December,-2.4492935982947064e-16,1.0,16,38,1,2,2,0.8,1.4,22,22,0,14,24,-10,"December, 2021"
2021-2022,17,2021-12-15,Arsenal,West Ham,2,0,H,3,0,3,0,2,1,1,3,6,4,26,28,2,2,December,-2.4492935982947064e-16,1.0,0,45,3,1,1,1.8,1.2,21,22,-1,28,19,9,"December, 2021"
2021-2022,17,2021-12-15,Brighton,Wolves,0,1,A,0,3,3,2,0,0,2,3,12,10,20,21,2,1,December,-2.4492935982947064e-16,1.0,10,48,0,4,1,1.2,1.4,14,16,-2,12,14,-2,"December, 2021"
2021-2022,17,2021-12-16,Chelsea,Everton,1,1,D,1,1,2,2,1,2,1,2,3,14,36,18,11,18,December,-2.4492935982947064e-16,1.0,14,18,2,0,3,1.4,1.2,38,11,27,20,28,-8,"December, 2021"
2021-2022,17,2021-12-16,Liverpool,Newcastle,3,1,H,3,0,4,1,0,3,0,2,2,19,37,10,17,27,December,-2.4492935982947064e-16,1.0,25,30,3,2,0,2.0,1.0,45,12,33,17,34,-17,"December, 2021"
2021-2022,18,2021-12-18,Leeds,Arsenal,1,4,A,0,3,1,1,3,3,0,2,16,4,16,29,12,13,December,-2.4492935982947064e-16,1.0,23,0,1,1,3,1.2,3.0,17,32,-15,23,22,1,"December, 2021"
2021-2022,18,2021-12-19,Newcastle,Man City,0,4,A,0,3,3,0,2,4,1,0,19,1,10,41,18,31,December,-2.4492935982947064e-16,1.0,30,27,1,1,3,1.4,2.8,18,37,-19,40,9,31,"December, 2021"
2021-2022,18,2021-12-19,Wolves,Chelsea,0,0,D,1,1,0,2,3,2,2,1,8,3,24,37,5,13,December,-2.4492935982947064e-16,1.0,48,14,1,2,2,1.0,1.8,13,14,-1,39,12,27,"December, 2021"
2021-2022,18,2021-12-19,Tottenham,Liverpool,2,2,D,1,1,4,1,0,4,1,0,7,2,25,40,5,15,December,-2.4492935982947064e-16,1.0,42,25,0,0,5,0.8,2.0,16,17,-1,48,13,35,"December, 2021"
2021-2022,19,2021-12-26,West Ham,Southampton,2,3,A,0,3,1,1,3,0,1,4,6,15,28,17,9,11,December,-2.4492935982947064e-16,1.0,45,38,3,2,0,1.4,0.2,28,21,7,16,26,-10,"December, 2021"
2021-2022,19,2021-12-26,Brighton,Brentford,2,0,H,3,0,3,2,0,2,1,2,13,11,20,20,2,0,December,-2.4492935982947064e-16,1.0,10,9,1,0,0,1.0,0.0,14,17,-3,21,22,-1,"December, 2021"
2021-2022,19,2021-12-26,Aston Villa,Chelsea,1,3,A,0,3,1,2,2,2,2,1,9,3,22,38,6,16,December,-2.4492935982947064e-16,1.0,1,14,1,1,3,1.0,1.8,23,25,-2,39,12,27,"December, 2021"
2021-2022,19,2021-12-26,Tottenham,Crystal Palace,3,0,H,3,0,4,1,0,3,1,1,7,11,26,20,4,6,December,-2.4492935982947064e-16,1.0,42,16,2,2,1,2.0,1.2,18,19,-1,24,24,0,"December, 2021"
2021-2022,19,2021-12-26,Norwich,Arsenal,0,5,A,0,3,0,1,4,3,0,2,20,4,10,32,16,22,December,-2.4492935982947064e-16,1.0,31,0,0,2,3,0.6,1.8,8,34,-26,27,23,4,"December, 2021"
2021-2022,19,2021-12-26,Man City,Leicester,6,3,H,3,0,4,1,0,3,1,1,1,9,44,22,8,22,December,-2.4492935982947064e-16,1.0,27,24,4,0,1,1.8,1.2,44,9,35,27,27,0,"December, 2021"
2021-2022,19,2021-12-27,Newcastle,Man United,1,1,D,1,1,3,0,2,1,1,3,19,7,10,27,12,17,December,-2.4492935982947064e-16,1.0,30,28,1,0,4,1.0,3.0,18,41,-23,26,24,2,"December, 2021"
2021-2022,20,2021-12-28,Crystal Palace,Norwich,3,0,H,3,0,3,1,1,0,1,4,12,20,20,10,8,10,December,-2.4492935982947064e-16,1.0,16,31,3,2,0,1.6,0.6,24,27,-3,8,39,-31,"December, 2021"
2021-2022,20,2021-12-28,Southampton,Tottenham,1,1,D,1,1,0,1,4,4,1,0,14,5,20,29,9,9,December,-2.4492935982947064e-16,1.0,38,42,2,0,3,1.4,2.0,19,28,-9,21,19,2,"December, 2021"
2021-2022,20,2021-12-28,Watford,West Ham,1,4,A,0,3,0,1,4,1,1,3,17,6,13,28,11,15,December,-2.4492935982947064e-16,1.0,43,45,1,0,4,1.0,2.4,21,31,-10,30,24,6,"December, 2021"
2021-2022,20,2021-12-28,Leicester,Liverpool,1,0,H,3,0,3,1,1,4,1,0,11,2,22,41,9,19,December,-2.4492935982947064e-16,1.0,24,25,1,1,3,1.0,2.2,30,33,-3,50,15,35,"December, 2021"
2021-2022,20,2021-12-29,Chelsea,Brighton,1,1,D,1,1,2,2,1,3,2,0,3,11,41,23,8,18,December,-2.4492935982947064e-16,1.0,14,10,3,2,0,1.8,0.4,42,13,29,16,17,-1,"December, 2021"
2021-2022,20,2021-12-29,Brentford,Man City,0,1,A,0,3,2,1,2,4,1,0,14,1,20,47,13,27,December,-2.4492935982947064e-16,1.0,9,27,0,0,0,0.0,0.0,21,24,-3,50,12,38,"December, 2021"
2021-2022,20,2021-12-30,Man United,Burnley,3,1,H,3,0,1,1,3,1,1,3,7,18,28,11,11,17,December,-2.4492935982947064e-16,1.0,28,11,3,1,1,1.6,1.0,27,25,2,14,21,-7,"December, 2021"
2021-2022,21,2022-01-01,Crystal Palace,West Ham,2,3,A,0,3,3,1,1,1,1,3,11,6,23,31,5,8,January,0.4999999999999999,0.8660254037844387,16,45,2,2,1,1.8,1.6,27,27,0,34,25,9,"January, 2022"
2021-2022,21,2022-01-01,Arsenal,Man City,1,2,A,0,3,3,0,2,4,1,0,4,1,35,50,3,15,January,0.4999999999999999,0.8660254037844387,0,27,0,0,5,0.0,2.6,32,23,9,51,12,39,"January, 2022"
2021-2022,21,2022-01-01,Watford,Tottenham,0,1,A,0,3,0,1,4,4,1,0,17,7,13,30,10,17,January,0.4999999999999999,0.8660254037844387,43,42,1,2,2,0.8,1.0,22,35,-13,22,20,2,"January, 2022"
2021-2022,21,2022-01-02,Brentford,Aston Villa,2,1,H,3,0,2,1,2,1,2,2,14,12,20,22,2,2,January,0.4999999999999999,0.8660254037844387,9,1,0,1,0,1.0,1.0,21,25,-4,24,28,-4,"January, 2022"
2021-2022,21,2022-01-02,Everton,Brighton,2,3,A,0,3,2,1,2,3,2,0,15,10,19,24,5,5,January,0.4999999999999999,0.8660254037844387,18,10,3,1,1,1.8,1.0,21,29,-8,17,18,-1,"January, 2022"
2021-2022,21,2022-01-02,Leeds,Burnley,3,1,H,3,0,1,1,3,1,1,3,16,18,16,11,2,5,January,0.4999999999999999,0.8660254037844387,23,11,2,1,0,2.0,0.3333333333333333,18,36,-18,15,24,-9,"January, 2022"
2021-2022,21,2022-01-02,Chelsea,Liverpool,2,2,D,1,1,2,2,1,4,1,0,2,3,42,41,1,1,January,0.4999999999999999,0.8660254037844387,14,25,1,1,3,1.2,2.0,43,14,29,50,16,34,"January, 2022"
2021-2022,21,2022-01-03,Man United,Wolves,0,1,A,0,3,1,1,3,0,2,3,7,9,31,25,2,6,January,0.4999999999999999,0.8660254037844387,28,48,3,2,0,1.0,0.4,30,26,4,13,14,-1,"January, 2022"
2021-2022,21,2022-01-11,Southampton,Brentford,4,1,H,3,0,0,1,4,2,1,2,14,12,21,23,2,2,January,0.4999999999999999,0.8660254037844387,38,9,0,0,0,0.0,0.0,20,29,-9,23,26,-3,"January, 2022"
2021-2022,21,2022-01-12,West Ham,Norwich,2,0,H,3,0,1,1,3,0,1,4,5,20,34,10,15,24,January,0.4999999999999999,0.8660254037844387,45,31,3,2,0,2.4,0.8,37,27,10,8,42,-34,"January, 2022"
2021-2022,22,2022-01-14,Brighton,Crystal Palace,1,1,D,1,1,3,2,0,3,1,1,9,12,27,23,3,4,January,0.4999999999999999,0.8660254037844387,10,16,0,3,2,0.8,1.2,20,20,0,29,30,-1,"January, 2022"
2021-2022,22,2022-01-15,Newcastle,Watford,1,1,D,1,1,3,0,2,0,1,4,19,17,11,13,2,2,January,0.4999999999999999,0.8660254037844387,30,43,1,3,1,1.0,1.0,19,42,-23,22,36,-14,"January, 2022"
2021-2022,22,2022-01-15,Aston Villa,Man United,2,2,D,1,1,1,2,2,1,1,3,14,7,22,31,7,9,January,0.4999999999999999,0.8660254037844387,1,28,1,1,3,1.0,2.0,25,30,-5,30,27,3,"January, 2022"
2021-2022,22,2022-01-15,Wolves,Southampton,3,1,H,3,0,0,2,3,0,1,4,9,12,28,24,3,4,January,0.4999999999999999,0.8660254037844387,48,38,3,2,0,1.6,1.0,14,14,0,24,30,-6,"January, 2022"
2021-2022,22,2022-01-15,Man City,Chelsea,1,0,H,3,0,4,1,0,2,2,1,1,2,53,43,1,10,January,0.4999999999999999,0.8660254037844387,27,14,3,0,2,1.6,1.2,53,13,40,45,16,29,"January, 2022"
2021-2022,22,2022-01-15,Norwich,Everton,2,1,H,3,0,0,1,4,2,1,2,20,15,10,19,5,9,January,0.4999999999999999,0.8660254037844387,31,18,1,1,3,0.6,1.4,8,44,-36,23,32,-9,"January, 2022"
2021-2022,22,2022-01-16,Liverpool,Brentford,3,0,H,3,0,4,1,0,2,1,2,3,14,42,23,11,19,January,0.4999999999999999,0.8660254037844387,25,9,0,1,0,3.0,3.0,52,18,34,24,30,-6,"January, 2022"
2021-2022,22,2022-01-16,West Ham,Leeds,2,3,A,0,3,1,1,3,1,1,3,4,16,37,19,12,18,January,0.4999999999999999,0.8660254037844387,45,23,3,0,2,1.8,1.4,39,27,12,21,37,-16,"January, 2022"
2021-2022,22,2022-01-18,Brighton,Chelsea,1,1,D,1,1,3,2,0,2,2,1,9,3,28,43,6,15,January,0.4999999999999999,0.8660254037844387,10,14,0,3,2,0.6,1.4,21,21,0,45,17,28,"January, 2022"
2021-2022,22,2022-01-19,Leicester,Tottenham,2,3,A,0,3,3,1,1,4,1,0,10,6,25,33,4,8,January,0.4999999999999999,0.8660254037844387,24,42,2,0,3,1.4,2.2,31,33,-2,23,20,3,"January, 2022"
2021-2022,22,2022-01-19,Brentford,Man United,1,3,A,0,3,2,1,2,1,1,3,14,7,23,32,7,9,January,0.4999999999999999,0.8660254037844387,9,28,0,0,0,0.0,0.0,24,33,-9,32,29,3,"January, 2022"
2021-2022,23,2022-01-21,Watford,Norwich,0,3,A,0,3,0,1,4,0,1,4,17,18,14,13,1,1,January,0.4999999999999999,0.8660254037844387,43,31,4,0,1,2.2,1.2,23,37,-14,10,45,-35,"January, 2022"
2021-2022,23,2022-01-22,Southampton,Man City,1,1,D,1,1,0,1,4,4,1,0,13,1,24,56,12,32,January,0.4999999999999999,0.8660254037844387,38,27,1,1,3,0.8,1.6,25,33,-8,54,13,41,"January, 2022"
2021-2022,23,2022-01-22,Man United,West Ham,1,0,H,3,0,1,1,3,1,1,3,7,4,35,37,3,2,January,0.4999999999999999,0.8660254037844387,28,45,3,1,1,1.4,1.0,35,30,5,41,30,11,"January, 2022"
2021-2022,23,2022-01-22,Everton,Aston Villa,0,1,A,0,3,2,1,2,1,2,2,16,13,19,23,3,4,January,0.4999999999999999,0.8660254037844387,18,1,0,2,3,0.4,1.6,24,34,-10,27,32,-5,"January, 2022"
2021-2022,23,2022-01-22,Brentford,Wolves,1,2,A,0,3,2,1,2,0,2,3,14,8,23,31,6,8,January,0.4999999999999999,0.8660254037844387,9,48,1,0,0,2.0,0.0,25,36,-11,17,15,2,"January, 2022"
2021-2022,23,2022-01-22,Leeds,Newcastle,0,1,A,0,3,1,1,3,3,0,2,15,19,22,12,4,10,January,0.4999999999999999,0.8660254037844387,23,30,2,2,1,2.0,1.4,24,39,-15,20,43,-23,"January, 2022"
2021-2022,23,2022-01-23,Arsenal,Burnley,0,0,D,1,1,3,0,2,1,1,3,7,20,35,11,13,24,January,0.4999999999999999,0.8660254037844387,0,11,2,2,1,0.8,0.6,33,25,8,16,27,-11,"January, 2022"
2021-2022,23,2022-01-23,Crystal Palace,Liverpool,1,3,A,0,3,3,1,1,4,1,0,13,2,24,45,11,21,January,0.4999999999999999,0.8660254037844387,16,25,0,0,5,0.2,3.6,30,31,-1,55,18,37,"January, 2022"
2021-2022,23,2022-01-23,Leicester,Brighton,1,1,D,1,1,3,1,1,3,2,0,11,9,25,29,2,4,January,0.4999999999999999,0.8660254037844387,24,10,3,1,1,1.6,0.6,33,36,-3,22,22,0,"January, 2022"
2021-2022,23,2022-01-23,Chelsea,Tottenham,2,0,H,3,0,2,2,1,4,1,0,3,7,44,36,4,8,January,0.4999999999999999,0.8660254037844387,14,42,4,1,0,1.6,0.2,46,18,28,26,22,4,"January, 2022"
2021-2022,23,2022-02-05,Burnley,Watford,0,0,D,1,1,1,1,3,0,1,4,20,19,12,14,1,2,February,0.8660254037844386,0.5000000000000001,11,43,3,1,1,1.4,0.8,16,27,-11,23,40,-17,"February, 2022"
2021-2022,24,2022-02-08,Newcastle,Everton,3,1,H,3,0,3,0,2,2,1,2,19,16,15,19,3,4,February,0.8660254037844386,0.5000000000000001,30,18,3,1,1,2.0,1.4,21,43,-22,24,35,-11,"February, 2022"
2021-2022,24,2022-02-08,West Ham,Watford,1,0,H,3,0,1,1,3,0,1,4,5,19,37,15,14,22,February,0.8660254037844386,0.5000000000000001,45,43,4,0,1,2.8,1.2,41,31,10,23,40,-17,"February, 2022"
2021-2022,24,2022-02-08,Burnley,Man United,1,1,D,1,1,1,1,3,1,1,3,20,5,13,38,15,25,February,0.8660254037844386,0.5000000000000001,11,28,1,0,4,0.8,1.8,16,27,-11,36,30,6,"February, 2022"
2021-2022,24,2022-02-09,Man City,Brentford,2,0,H,3,0,4,1,0,2,1,2,1,14,57,23,13,34,February,0.8660254037844386,0.5000000000000001,27,9,1,0,0,1.0,0.0,55,14,41,26,38,-12,"February, 2022"
2021-2022,24,2022-02-09,Norwich,Crystal Palace,1,1,D,1,1,0,1,4,3,1,1,18,13,16,24,5,8,February,0.8660254037844386,0.5000000000000001,31,16,0,1,4,0.4,2.0,13,45,-32,31,34,-3,"February, 2022"
2021-2022,24,2022-02-09,Tottenham,Southampton,2,3,A,0,3,4,1,0,0,1,4,7,13,36,25,6,11,February,0.8660254037844386,0.5000000000000001,42,38,3,1,1,2.0,1.2,26,24,2,26,34,-8,"February, 2022"
2021-2022,24,2022-02-09,Aston Villa,Leeds,3,3,D,1,1,1,2,2,1,1,3,12,15,26,22,3,4,February,0.8660254037844386,0.5000000000000001,1,23,2,1,2,0.8,1.2,28,32,-4,24,40,-16,"February, 2022"
2021-2022,24,2022-02-10,Liverpool,Leicester,2,0,H,3,0,4,1,0,3,1,1,2,12,48,26,10,22,February,0.8660254037844386,0.5000000000000001,25,24,3,0,2,2.0,1.0,58,19,39,34,37,-3,"February, 2022"
2021-2022,24,2022-02-10,Wolves,Arsenal,0,1,A,0,3,0,2,3,3,0,2,8,6,34,36,2,2,February,0.8660254037844386,0.5000000000000001,48,0,3,1,1,1.6,1.2,19,16,3,33,25,8,"February, 2022"
2021-2022,25,2022-02-12,Norwich,Man City,0,4,A,0,3,0,1,4,4,1,0,18,1,17,60,17,43,February,0.8660254037844386,0.5000000000000001,31,27,1,1,3,0.8,2.8,14,46,-32,57,14,43,"February, 2022"
2021-2022,25,2022-02-12,Watford,Brighton,0,2,A,0,3,0,1,4,3,2,0,19,9,15,30,10,15,February,0.8660254037844386,0.5000000000000001,43,10,1,2,2,0.6,1.2,23,41,-18,23,23,0,"February, 2022"
2021-2022,25,2022-02-12,Everton,Leeds,3,0,H,3,0,2,1,2,1,1,3,16,15,19,23,1,4,February,0.8660254037844386,0.5000000000000001,18,23,2,2,1,1.8,1.0,25,38,-13,27,43,-16,"February, 2022"
2021-2022,25,2022-02-12,Brentford,Crystal Palace,0,0,D,1,1,2,1,2,3,1,1,14,13,23,25,1,2,February,0.8660254037844386,0.5000000000000001,9,16,0,1,0,0.0,0.0,26,40,-14,32,35,-3,"February, 2022"
2021-2022,25,2022-02-12,Man United,Southampton,1,1,D,1,1,1,1,3,0,1,4,6,10,39,28,4,11,February,0.8660254037844386,0.5000000000000001,28,38,2,3,0,3.2,1.2,37,31,6,29,36,-7,"February, 2022"
2021-2022,25,2022-02-13,Burnley,Liverpool,0,1,A,0,3,1,1,3,4,1,0,20,2,14,51,18,37,February,0.8660254037844386,0.5000000000000001,11,25,1,1,3,0.4,1.8,17,28,-11,60,19,41,"February, 2022"
2021-2022,25,2022-02-13,Newcastle,Aston Villa,1,0,H,3,0,3,0,2,1,2,2,17,11,18,27,6,9,February,0.8660254037844386,0.5000000000000001,30,1,0,2,3,0.4,1.6,24,44,-20,31,35,-4,"February, 2022"
2021-2022,25,2022-02-13,Tottenham,Wolves,0,2,A,0,3,4,1,0,0,2,3,7,8,36,34,1,2,February,0.8660254037844386,0.5000000000000001,42,48,3,1,1,1.6,1.0,28,27,1,19,17,2,"February, 2022"
2021-2022,25,2022-02-13,Leicester,West Ham,2,2,D,1,1,3,1,1,1,1,3,13,4,26,40,9,14,February,0.8660254037844386,0.5000000000000001,24,45,2,0,3,1.8,2.4,34,39,-5,42,31,11,"February, 2022"
2021-2022,25,2022-02-15,Man United,Brighton,2,0,H,3,0,1,1,3,3,2,0,5,9,40,33,4,7,February,0.8660254037844386,0.5000000000000001,28,10,5,0,0,2.6,1.0,38,32,6,25,23,2,"February, 2022"
2021-2022,26,2022-02-19,Man City,Tottenham,2,3,A,0,3,4,1,0,4,1,0,1,8,63,36,7,27,February,0.8660254037844386,0.5000000000000001,27,42,1,1,3,1.0,1.4,61,14,47,28,29,-1,"February, 2022"
2021-2022,26,2022-02-19,Southampton,Everton,2,0,H,3,0,0,1,4,2,1,2,10,16,29,22,6,7,February,0.8660254037844386,0.5000000000000001,38,18,1,1,3,1.0,1.4,30,37,-7,28,38,-10,"February, 2022"
2021-2022,26,2022-02-19,Liverpool,Norwich,3,1,H,3,0,4,1,0,0,1,4,2,20,54,17,18,37,February,0.8660254037844386,0.5000000000000001,25,31,4,1,0,2.8,1.2,61,19,42,14,50,-36,"February, 2022"
2021-2022,26,2022-02-19,Crystal Palace,Chelsea,0,1,A,0,3,3,1,1,2,2,1,13,3,26,47,10,21,February,0.8660254037844386,0.5000000000000001,16,14,0,0,5,0.6,3.2,32,35,-3,48,18,30,"February, 2022"
2021-2022,26,2022-02-19,Aston Villa,Watford,0,1,A,0,3,1,2,2,0,1,4,12,19,27,15,7,12,February,0.8660254037844386,0.5000000000000001,1,43,1,0,4,1.6,2.6,31,36,-5,23,43,-20,"February, 2022"
2021-2022,26,2022-02-19,Arsenal,Brentford,2,1,H,3,0,3,0,2,2,1,2,6,14,39,24,8,15,February,0.8660254037844386,0.5000000000000001,0,9,0,0,1,0.0,2.0,34,25,9,26,40,-14,"February, 2022"
2021-2022,26,2022-02-19,West Ham,Newcastle,1,1,D,1,1,1,1,3,3,0,2,5,17,41,21,12,20,February,0.8660254037844386,0.5000000000000001,45,30,1,1,3,2.0,2.4,44,33,11,25,44,-19,"February, 2022"
2021-2022,26,2022-02-19,Brighton,Burnley,0,3,A,0,3,3,2,0,1,1,3,9,20,33,14,11,19,February,0.8660254037844386,0.5000000000000001,10,11,2,3,0,1.2,0.8,25,25,0,17,29,-12,"February, 2022"
2021-2022,26,2022-02-20,Leeds,Man United,2,4,A,0,3,1,1,3,1,1,3,15,4,23,43,11,20,February,0.8660254037844386,0.5000000000000001,23,28,0,2,3,0.8,2.6,27,46,-19,40,32,8,"February, 2022"
2021-2022,26,2022-02-20,Wolves,Leicester,2,1,H,3,0,0,2,3,3,1,1,8,11,37,27,3,10,February,0.8660254037844386,0.5000000000000001,48,24,0,3,2,0.0,0.4,21,17,4,36,41,-5,"February, 2022"
2021-2022,26,2022-02-23,Watford,Crystal Palace,1,4,A,0,3,0,1,4,3,1,1,19,13,18,26,6,8,February,0.8660254037844386,0.5000000000000001,43,16,2,2,1,0.8,0.6,24,43,-19,32,36,-4,"February, 2022"
2021-2022,26,2022-02-23,Burnley,Tottenham,1,0,H,3,0,1,1,3,4,1,0,19,8,17,39,11,22,February,0.8660254037844386,0.5000000000000001,11,42,1,1,3,0.6,2.4,20,29,-9,31,31,0,"February, 2022"
2021-2022,26,2022-02-23,Liverpool,Leeds,6,0,H,3,0,4,1,0,1,1,3,2,15,57,23,13,34,February,0.8660254037844386,0.5000000000000001,25,23,3,2,0,2.6,1.4,64,20,44,29,50,-21,"February, 2022"
2021-2022,26,2022-02-24,Arsenal,Wolves,2,1,H,3,0,3,0,2,0,2,3,6,7,42,40,1,2,February,0.8660254037844386,0.5000000000000001,0,48,2,1,2,1.2,1.0,36,26,10,23,18,5,"February, 2022"
2021-2022,27,2022-02-25,Southampton,Norwich,2,0,H,3,0,0,1,4,0,1,4,10,20,32,17,10,15,February,0.8660254037844386,0.5000000000000001,38,31,3,0,2,1.8,0.8,32,37,-5,15,53,-38,"February, 2022"
2021-2022,27,2022-02-26,Leeds,Tottenham,0,4,A,0,3,1,1,3,4,1,0,15,8,23,39,7,16,February,0.8660254037844386,0.5000000000000001,23,42,1,0,4,1.0,1.8,29,56,-27,31,32,-1,"February, 2022"
2021-2022,27,2022-02-26,Brentford,Newcastle,0,2,A,0,3,2,1,2,3,0,2,14,17,24,22,3,2,February,0.8660254037844386,0.5000000000000001,9,30,0,1,0,3.0,3.0,27,42,-15,26,45,-19,"February, 2022"
2021-2022,27,2022-02-26,Crystal Palace,Burnley,1,1,D,1,1,3,1,1,1,1,3,11,18,29,20,7,9,February,0.8660254037844386,0.5000000000000001,16,11,1,1,3,1.0,1.6,36,37,-1,21,29,-8,"February, 2022"
2021-2022,27,2022-02-26,Man United,Watford,0,0,D,1,1,1,1,3,0,1,4,4,19,46,18,15,28,February,0.8660254037844386,0.5000000000000001,28,43,3,0,2,1.6,1.6,44,34,10,25,47,-22,"February, 2022"
2021-2022,27,2022-02-26,Brighton,Aston Villa,0,2,A,0,3,3,2,0,1,2,2,10,13,33,27,3,6,February,0.8660254037844386,0.5000000000000001,10,1,1,2,2,0.8,1.2,25,28,-3,31,37,-6,"February, 2022"
2021-2022,27,2022-02-26,Everton,Man City,0,1,A,0,3,2,1,2,4,1,0,17,1,22,63,16,41,February,0.8660254037844386,0.5000000000000001,18,27,0,0,5,0.6,3.2,28,40,-12,63,17,46,"February, 2022"
2021-2022,27,2022-02-27,West Ham,Wolves,1,0,H,3,0,1,1,3,0,2,3,6,8,42,40,2,2,February,0.8660254037844386,0.5000000000000001,45,48,2,0,3,1.4,1.4,45,34,11,24,20,4,"February, 2022"
2021-2022,27,2022-03-01,Burnley,Leicester,0,2,A,0,3,1,1,3,3,1,1,18,13,21,27,5,6,March,1.0,6.123233995736766e-17,11,24,1,2,2,1.6,2.0,22,30,-8,37,43,-6,"March, 2022"
2021-2022,28,2022-03-05,Liverpool,West Ham,1,0,H,3,0,4,1,0,1,1,3,2,5,60,45,3,15,March,1.0,6.123233995736766e-17,25,45,4,0,1,2.4,1.4,70,20,50,46,34,12,"March, 2022"
2021-2022,28,2022-03-05,Wolves,Crystal Palace,0,2,A,0,3,0,2,3,3,1,1,8,13,40,30,5,10,March,1.0,6.123233995736766e-17,48,16,2,1,2,1.0,0.8,24,21,3,37,38,-1,"March, 2022"
2021-2022,28,2022-03-05,Norwich,Brentford,1,3,A,0,3,0,1,4,2,1,2,20,15,17,24,5,7,March,1.0,6.123233995736766e-17,31,9,1,0,0,2.0,1.0,15,55,-40,27,44,-17,"March, 2022"
2021-2022,28,2022-03-05,Leicester,Leeds,1,0,H,3,0,3,1,1,1,1,3,12,16,30,23,4,7,March,1.0,6.123233995736766e-17,24,23,2,1,2,2.4,1.6,39,43,-4,29,60,-31,"March, 2022"
2021-2022,28,2022-03-05,Burnley,Chelsea,0,4,A,0,3,1,1,3,2,2,1,18,3,21,50,15,29,March,1.0,6.123233995736766e-17,11,14,0,1,4,0.6,2.6,22,32,-10,49,18,31,"March, 2022"
2021-2022,28,2022-03-05,Aston Villa,Southampton,4,0,H,3,0,1,2,2,0,1,4,13,9,30,35,4,5,March,1.0,6.123233995736766e-17,1,38,1,0,4,1.0,2.0,33,37,-4,34,37,-3,"March, 2022"
2021-2022,28,2022-03-05,Newcastle,Brighton,2,1,H,3,0,3,0,2,3,2,0,14,12,25,33,2,8,March,1.0,6.123233995736766e-17,30,10,0,3,2,0.2,1.4,28,45,-17,25,30,-5,"March, 2022"
2021-2022,28,2022-03-06,Watford,Arsenal,2,3,A,0,3,0,1,4,3,0,2,19,6,19,45,13,26,March,1.0,6.123233995736766e-17,43,0,0,1,4,0.8,1.8,25,47,-22,38,27,11,"March, 2022"
2021-2022,28,2022-03-06,Man City,Man United,4,1,H,3,0,4,1,0,1,1,3,1,5,66,47,4,19,March,1.0,6.123233995736766e-17,27,28,1,1,3,0.6,1.2,64,17,47,44,34,10,"March, 2022"
2021-2022,28,2022-03-07,Tottenham,Everton,5,0,H,3,0,4,1,0,2,1,2,7,17,42,22,10,20,March,1.0,6.123233995736766e-17,42,18,1,3,1,0.8,0.8,35,32,3,28,41,-13,"March, 2022"
2021-2022,28,2022-03-10,Wolves,Watford,4,0,H,3,0,0,2,3,0,1,4,8,19,40,19,11,21,March,1.0,6.123233995736766e-17,48,43,3,0,2,1.4,1.0,24,23,1,27,50,-23,"March, 2022"
2021-2022,28,2022-03-10,Leeds,Aston Villa,0,3,A,0,3,1,1,3,1,2,2,16,11,23,33,5,10,March,1.0,6.123233995736766e-17,23,1,1,2,2,1.2,1.2,29,61,-32,37,37,0,"March, 2022"
2021-2022,28,2022-03-10,Norwich,Chelsea,1,3,A,0,3,0,1,4,2,2,1,20,3,17,53,17,36,March,1.0,6.123233995736766e-17,31,14,0,0,5,0.6,2.8,16,58,-42,53,18,35,"March, 2022"
2021-2022,28,2022-03-10,Southampton,Newcastle,1,2,A,0,3,0,1,4,3,0,2,9,14,35,28,5,7,March,1.0,6.123233995736766e-17,38,30,1,1,3,1.4,1.6,34,41,-7,30,46,-16,"March, 2022"
2021-2022,29,2022-03-12,Man United,Tottenham,3,2,H,3,0,1,1,3,4,1,0,5,7,47,45,2,2,March,1.0,6.123233995736766e-17,28,42,3,1,1,2.0,1.8,45,38,7,40,32,8,"March, 2022"
2021-2022,29,2022-03-12,Brentford,Burnley,2,0,H,3,0,2,1,2,1,1,3,15,18,27,21,3,6,March,1.0,6.123233995736766e-17,9,11,0,0,1,1.0,3.0,30,45,-15,22,36,-14,"March, 2022"
2021-2022,29,2022-03-12,Brighton,Liverpool,0,2,A,0,3,3,2,0,4,1,0,13,2,33,63,11,30,March,1.0,6.123233995736766e-17,10,25,1,2,2,1.2,1.6,26,32,-6,71,20,51,"March, 2022"
2021-2022,29,2022-03-13,Chelsea,Newcastle,1,0,H,3,0,2,2,1,3,0,2,3,14,56,31,11,25,March,1.0,6.123233995736766e-17,14,30,4,0,1,1.6,0.2,56,19,37,32,47,-15,"March, 2022"
2021-2022,29,2022-03-13,Everton,Wolves,0,1,A,0,3,2,1,2,0,2,3,17,8,22,43,9,21,March,1.0,6.123233995736766e-17,18,48,3,0,2,1.4,1.6,28,46,-18,28,23,5,"March, 2022"
2021-2022,29,2022-03-13,Leeds,Norwich,2,1,H,3,0,1,1,3,0,1,4,16,20,23,17,4,6,March,1.0,6.123233995736766e-17,23,31,1,0,0,2.0,1.0,29,64,-35,17,61,-44,"March, 2022"
2021-2022,29,2022-03-13,Southampton,Watford,1,2,A,0,3,0,1,4,0,1,4,10,19,35,19,9,16,March,1.0,6.123233995736766e-17,38,43,3,2,0,1.6,0.8,35,43,-8,27,54,-27,"March, 2022"
2021-2022,29,2022-03-13,West Ham,Aston Villa,2,1,H,3,0,1,1,3,1,2,2,7,9,45,36,2,9,March,1.0,6.123233995736766e-17,45,1,3,2,0,2.0,0.8,46,35,11,40,37,3,"March, 2022"
2021-2022,29,2022-03-13,Arsenal,Leicester,2,0,H,3,0,3,0,2,3,1,1,6,12,48,33,6,15,March,1.0,6.123233995736766e-17,0,24,2,1,2,1.2,1.0,41,29,12,40,43,-3,"March, 2022"
2021-2022,29,2022-03-14,Crystal Palace,Man City,0,0,D,1,1,3,1,1,4,1,0,11,1,33,69,10,36,March,1.0,6.123233995736766e-17,16,27,1,1,3,0.8,2.0,39,38,1,68,18,50,"March, 2022"
2021-2022,29,2022-03-16,Brighton,Tottenham,0,2,A,0,3,3,2,0,4,1,0,13,8,33,45,5,12,March,1.0,6.123233995736766e-17,10,42,2,0,3,1.2,1.0,26,34,-8,42,35,7,"March, 2022"
2021-2022,29,2022-03-16,Arsenal,Liverpool,0,2,A,0,3,3,0,2,4,1,0,4,2,51,66,2,15,March,1.0,6.123233995736766e-17,0,25,1,0,4,0.8,2.8,43,29,14,73,20,53,"March, 2022"
2021-2022,29,2022-03-17,Everton,Newcastle,1,0,H,3,0,2,1,2,3,0,2,17,14,22,31,3,9,March,1.0,6.123233995736766e-17,18,30,1,1,3,1.2,2.0,28,47,-19,32,48,-16,"March, 2022"
2021-2022,30,2022-03-18,Wolves,Leeds,2,3,A,0,3,0,2,3,1,1,3,8,16,46,26,8,20,March,1.0,6.123233995736766e-17,48,23,3,1,1,1.4,1.2,29,23,6,31,65,-34,"March, 2022"
2021-2022,30,2022-03-19,Aston Villa,Arsenal,0,1,A,0,3,1,2,2,3,0,2,9,4,36,51,5,15,March,1.0,6.123233995736766e-17,1,0,3,0,2,1.6,1.2,41,39,2,43,31,12,"March, 2022"
2021-2022,30,2022-03-20,Leicester,Brentford,2,1,H,3,0,3,1,1,2,1,2,12,15,33,30,3,3,March,1.0,6.123233995736766e-17,24,9,1,0,0,2.0,1.0,40,45,-5,32,45,-13,"March, 2022"
2021-2022,30,2022-03-20,Tottenham,West Ham,3,1,H,3,0,4,1,0,1,1,3,7,6,48,48,1,0,March,1.0,6.123233995736766e-17,42,45,2,1,2,1.8,1.6,44,35,9,48,36,12,"March, 2022"
2021-2022,31,2022-04-02,Liverpool,Watford,2,0,H,3,0,4,1,0,0,1,4,2,18,69,22,16,47,April,0.8660254037844388,-0.4999999999999998,25,43,4,0,1,3.0,0.6,75,20,55,29,55,-26,"April, 2022"
2021-2022,31,2022-04-02,Brighton,Norwich,0,0,D,1,1,3,2,0,0,1,4,13,20,33,17,7,16,April,0.8660254037844388,-0.4999999999999998,10,31,2,1,0,1.0,0.0,26,36,-10,18,63,-45,"April, 2022"
2021-2022,31,2022-04-02,Burnley,Man City,0,2,A,0,3,1,1,3,4,1,0,19,2,21,70,17,49,April,0.8660254037844388,-0.4999999999999998,11,27,0,0,5,0.2,3.6,22,38,-16,68,18,50,"April, 2022"
2021-2022,31,2022-04-02,Chelsea,Brentford,1,4,A,0,3,2,2,1,2,1,2,3,15,59,30,12,29,April,0.8660254037844388,-0.4999999999999998,14,9,1,0,0,1.0,0.0,57,19,38,33,47,-14,"April, 2022"
2021-2022,31,2022-04-02,Leeds,Southampton,1,1,D,1,1,1,1,3,0,1,4,16,11,29,35,5,6,April,0.8660254037844388,-0.4999999999999998,23,38,2,1,2,1.2,0.6,34,67,-33,36,45,-9,"April, 2022"
2021-2022,31,2022-04-02,Wolves,Aston Villa,2,1,H,3,0,0,2,3,1,2,2,8,9,46,36,1,10,April,0.8660254037844388,-0.4999999999999998,48,1,3,1,1,1.2,0.8,31,26,5,41,40,1,"April, 2022"
2021-2022,31,2022-04-02,Man United,Leicester,1,1,D,1,1,1,1,3,3,1,1,6,10,50,36,4,14,April,0.8660254037844388,-0.4999999999999998,28,24,2,1,2,1.6,1.6,48,40,8,42,46,-4,"April, 2022"
2021-2022,31,2022-04-03,Tottenham,Newcastle,5,1,H,3,0,4,1,0,3,0,2,6,15,51,31,9,20,April,0.8660254037844388,-0.4999999999999998,42,30,2,2,1,1.8,1.4,47,36,11,32,49,-17,"April, 2022"
2021-2022,31,2022-04-03,West Ham,Everton,2,1,H,3,0,1,1,3,2,1,2,8,17,48,25,9,23,April,0.8660254037844388,-0.4999999999999998,45,18,2,1,2,0.6,0.8,49,39,10,29,47,-18,"April, 2022"
2021-2022,31,2022-04-04,Crystal Palace,Arsenal,3,0,H,3,0,3,1,1,3,0,2,12,5,34,54,7,20,April,0.8660254037844388,-0.4999999999999998,16,0,0,4,1,1.2,1.6,39,38,1,44,31,13,"April, 2022"
2021-2022,31,2022-04-06,Burnley,Everton,3,2,H,3,0,1,1,3,2,1,2,19,17,21,25,2,4,April,0.8660254037844388,-0.4999999999999998,11,18,2,1,2,1.0,1.2,22,40,-18,30,49,-19,"April, 2022"
2021-2022,32,2022-04-08,Newcastle,Wolves,1,0,H,3,0,3,0,2,0,2,3,15,8,31,49,7,18,April,0.8660254037844388,-0.4999999999999998,30,48,0,4,1,1.0,1.2,33,54,-21,33,27,6,"April, 2022"
2021-2022,32,2022-04-09,Everton,Man United,1,0,H,3,0,2,1,2,1,1,3,17,7,25,51,10,26,April,0.8660254037844388,-0.4999999999999998,18,28,0,4,1,1.4,1.8,32,52,-20,49,41,8,"April, 2022"
2021-2022,32,2022-04-09,Arsenal,Brighton,1,2,A,0,3,3,0,2,3,2,0,5,13,54,34,8,20,April,0.8660254037844388,-0.4999999999999998,0,10,2,1,2,1.0,0.8,44,34,10,26,36,-10,"April, 2022"
2021-2022,32,2022-04-09,Southampton,Chelsea,0,6,A,0,3,0,1,4,2,2,1,13,3,36,59,10,23,April,0.8660254037844388,-0.4999999999999998,38,14,1,2,2,1.6,2.2,37,46,-9,58,23,35,"April, 2022"
2021-2022,32,2022-04-09,Watford,Leeds,0,3,A,0,3,0,1,4,1,1,3,19,16,22,30,3,8,April,0.8660254037844388,-0.4999999999999998,43,23,0,0,3,0.6666666666666666,2.0,29,57,-28,35,68,-33,"April, 2022"
2021-2022,32,2022-04-09,Aston Villa,Tottenham,0,4,A,0,3,1,2,2,4,1,0,12,4,36,54,8,18,April,0.8660254037844388,-0.4999999999999998,1,42,1,0,4,1.2,2.2,42,42,0,52,37,15,"April, 2022"
2021-2022,32,2022-04-10,Man City,Liverpool,2,2,D,1,1,4,1,0,4,1,0,1,2,73,72,1,1,April,0.8660254037844388,-0.4999999999999998,27,25,2,2,1,2.4,1.4,70,18,52,77,20,57,"April, 2022"
2021-2022,32,2022-04-10,Norwich,Burnley,2,0,H,3,0,0,1,4,1,1,3,20,18,18,24,2,6,April,0.8660254037844388,-0.4999999999999998,31,11,0,1,2,0.0,1.3333333333333333,18,63,-45,25,42,-17,"April, 2022"
2021-2022,32,2022-04-10,Brentford,West Ham,2,0,H,3,0,2,1,2,1,1,3,15,6,33,51,9,18,April,0.8660254037844388,-0.4999999999999998,9,45,1,0,0,2.0,1.0,37,48,-11,51,40,11,"April, 2022"
2021-2022,32,2022-04-10,Leicester,Crystal Palace,2,1,H,3,0,3,1,1,3,1,1,10,9,37,37,1,0,April,0.8660254037844388,-0.4999999999999998,24,16,3,2,0,2.0,0.8,43,47,-4,42,38,4,"April, 2022"
2021-2022,33,2022-04-16,Tottenham,Brighton,0,1,A,0,3,4,1,0,3,2,0,4,11,57,37,7,20,April,0.8660254037844388,-0.4999999999999998,42,10,3,0,2,1.2,1.2,56,37,19,28,37,-9,"April, 2022"
2021-2022,33,2022-04-16,Man United,Norwich,3,2,H,3,0,1,1,3,0,1,4,7,20,51,21,13,30,April,0.8660254037844388,-0.4999999999999998,28,31,4,0,1,2.0,0.6,49,42,7,20,63,-43,"April, 2022"
2021-2022,33,2022-04-16,Southampton,Arsenal,1,0,H,3,0,0,1,4,3,0,2,14,5,36,54,9,18,April,0.8660254037844388,-0.4999999999999998,38,0,0,2,3,0.8,2.2,37,52,-15,45,36,9,"April, 2022"
2021-2022,33,2022-04-16,Watford,Brentford,1,2,A,0,3,0,1,4,2,1,2,19,14,22,36,5,14,April,0.8660254037844388,-0.4999999999999998,43,9,0,0,1,1.0,2.0,29,60,-31,39,48,-9,"April, 2022"
2021-2022,33,2022-04-17,Newcastle,Leicester,2,1,H,3,0,3,0,2,3,1,1,15,9,34,40,6,6,April,0.8660254037844388,-0.4999999999999998,30,24,1,0,4,1.0,3.2,34,54,-20,45,48,-3,"April, 2022"
2021-2022,33,2022-04-17,West Ham,Burnley,1,1,D,1,1,1,1,3,1,1,3,7,18,51,24,11,27,April,0.8660254037844388,-0.4999999999999998,45,11,2,1,2,0.6,1.0,51,42,9,25,44,-19,"April, 2022"
2021-2022,33,2022-04-19,Liverpool,Man United,4,0,H,3,0,4,1,0,1,1,3,2,5,73,54,3,19,April,0.8660254037844388,-0.4999999999999998,25,28,3,2,0,2.4,0.6,79,22,57,52,44,8,"April, 2022"
2021-2022,33,2022-04-20,Man City,Brighton,3,0,H,3,0,4,1,0,3,2,0,2,10,74,40,8,34,April,0.8660254037844388,-0.4999999999999998,27,10,4,0,1,3.2,0.8,72,20,52,29,37,-8,"April, 2022"
2021-2022,33,2022-04-20,Newcastle,Crystal Palace,1,0,H,3,0,3,0,2,3,1,1,14,13,37,37,1,0,April,0.8660254037844388,-0.4999999999999998,30,16,2,1,2,1.0,0.8,36,55,-19,43,40,3,"April, 2022"
2021-2022,33,2022-04-20,Chelsea,Arsenal,2,4,A,0,3,2,2,1,3,0,2,3,5,62,54,2,8,April,0.8660254037844388,-0.4999999999999998,14,0,2,1,2,1.4,1.4,64,23,41,45,37,8,"April, 2022"
2021-2022,33,2022-04-20,Everton,Leicester,1,1,D,1,1,2,1,2,3,1,1,17,9,28,40,8,12,April,0.8660254037844388,-0.4999999999999998,18,24,2,1,2,1.2,1.0,33,52,-19,46,50,-4,"April, 2022"
2021-2022,33,2022-04-21,Burnley,Southampton,2,0,H,3,0,1,1,3,0,1,4,18,13,25,39,5,14,April,0.8660254037844388,-0.4999999999999998,11,38,2,1,2,1.8,1.4,26,45,-19,38,52,-14,"April, 2022"
2021-2022,34,2022-04-23,Arsenal,Man United,3,1,H,3,0,3,0,2,1,1,3,5,6,57,54,1,3,April,0.8660254037844388,-0.4999999999999998,0,28,2,2,1,1.2,0.8,49,39,10,52,48,4,"April, 2022"
2021-2022,34,2022-04-23,Leicester,Aston Villa,0,0,D,1,1,3,1,1,1,2,2,9,15,41,36,6,5,April,0.8660254037844388,-0.4999999999999998,24,1,3,0,2,2.2,1.0,47,51,-4,42,46,-4,"April, 2022"
2021-2022,34,2022-04-23,Man City,Watford,5,1,H,3,0,4,1,0,0,1,4,1,19,77,22,18,55,April,0.8660254037844388,-0.4999999999999998,27,43,5,0,0,4.0,0.6,75,20,55,30,62,-32,"April, 2022"
2021-2022,34,2022-04-23,Norwich,Newcastle,0,3,A,0,3,0,1,4,3,0,2,20,11,21,40,9,19,April,0.8660254037844388,-0.4999999999999998,31,30,2,2,1,1.8,2.0,22,66,-44,37,55,-18,"April, 2022"
2021-2022,34,2022-04-23,Brentford,Tottenham,0,0,D,1,1,2,1,2,4,1,0,12,5,39,57,7,18,April,0.8660254037844388,-0.4999999999999998,9,42,0,0,1,0.0,2.0,41,49,-8,56,38,18,"April, 2022"
2021-2022,34,2022-04-24,Chelsea,West Ham,1,0,H,3,0,2,2,1,1,1,3,3,7,62,52,4,10,April,0.8660254037844388,-0.4999999999999998,14,45,2,0,3,1.6,1.4,66,27,39,52,43,9,"April, 2022"
2021-2022,34,2022-04-24,Liverpool,Everton,2,0,H,3,0,4,1,0,2,1,2,2,18,76,29,16,47,April,0.8660254037844388,-0.4999999999999998,25,18,2,2,1,2.2,1.4,83,22,61,34,53,-19,"April, 2022"
2021-2022,34,2022-04-24,Brighton,Southampton,2,2,D,1,1,3,2,0,0,1,4,12,13,40,39,1,1,April,0.8660254037844388,-0.4999999999999998,10,38,1,2,2,1.0,1.4,29,40,-11,38,54,-16,"April, 2022"
2021-2022,34,2022-04-24,Burnley,Wolves,1,0,H,3,0,1,1,3,0,2,3,18,8,28,49,10,21,April,0.8660254037844388,-0.4999999999999998,11,48,2,3,0,1.6,0.6,28,45,-17,33,28,5,"April, 2022"
2021-2022,34,2022-04-25,Crystal Palace,Leeds,0,0,D,1,1,3,1,1,1,1,3,14,16,37,33,2,4,April,0.8660254037844388,-0.4999999999999998,16,23,2,0,3,1.2,1.2,43,41,2,38,68,-30,"April, 2022"
2021-2022,34,2022-04-28,Man United,Chelsea,1,1,D,1,1,1,1,3,2,2,1,6,3,54,65,3,11,April,0.8660254037844388,-0.4999999999999998,28,14,2,3,0,1.4,0.2,53,51,2,67,27,40,"April, 2022"
2021-2022,35,2022-04-30,Newcastle,Liverpool,0,1,A,0,3,3,0,2,4,1,0,9,2,43,79,7,36,April,0.8660254037844388,-0.4999999999999998,30,25,0,2,3,0.8,2.0,40,55,-15,85,22,63,"April, 2022"
2021-2022,35,2022-04-30,Aston Villa,Norwich,2,0,H,3,0,1,2,2,0,1,4,15,20,37,21,5,16,April,0.8660254037844388,-0.4999999999999998,1,31,4,0,1,2.0,0.6,42,46,-4,22,69,-47,"April, 2022"
2021-2022,35,2022-04-30,Southampton,Crystal Palace,1,2,A,0,3,0,1,4,3,1,1,14,15,40,38,1,2,April,0.8660254037844388,-0.4999999999999998,38,16,2,2,1,1.6,1.0,40,56,-16,43,41,2,"April, 2022"
2021-2022,35,2022-04-30,Watford,Burnley,1,2,A,0,3,0,1,4,1,1,3,19,17,22,31,2,9,April,0.8660254037844388,-0.4999999999999998,43,11,1,2,2,0.6,1.0,31,67,-36,29,45,-16,"April, 2022"
2021-2022,35,2022-04-30,Wolves,Brighton,0,3,A,0,3,0,2,3,3,2,0,8,12,49,41,4,8,April,0.8660254037844388,-0.4999999999999998,48,10,2,3,0,1.6,1.2,33,29,4,31,42,-11,"April, 2022"
2021-2022,35,2022-04-30,Leeds,Man City,0,4,A,0,3,1,1,3,4,1,0,17,2,34,80,15,46,April,0.8660254037844388,-0.4999999999999998,23,27,2,2,1,1.2,2.2,38,68,-30,80,21,59,"April, 2022"
2021-2022,35,2022-05-01,West Ham,Arsenal,1,2,A,0,3,1,1,3,3,0,2,7,5,52,60,2,8,May,0.4999999999999999,-0.8660254037844387,45,0,0,1,4,1.0,2.2,52,44,8,52,40,12,"May, 2022"
2021-2022,35,2022-05-01,Tottenham,Leicester,3,1,H,3,0,4,1,0,3,1,1,5,11,58,42,6,16,May,0.4999999999999999,-0.8660254037844387,42,24,3,0,2,2.2,1.6,56,38,18,47,51,-4,"May, 2022"
2021-2022,35,2022-05-01,Everton,Chelsea,1,0,H,3,0,2,1,2,2,2,1,18,3,29,66,15,37,May,0.4999999999999999,-0.8660254037844387,18,14,2,1,2,1.0,1.6,34,55,-21,68,28,40,"May, 2022"
2021-2022,35,2022-05-02,Man United,Brentford,3,0,H,3,0,1,1,3,2,1,2,6,14,55,40,8,15,May,0.4999999999999999,-0.8660254037844387,28,9,1,0,0,3.0,1.0,54,52,2,41,49,-8,"May, 2022"
2021-2022,36,2022-05-07,Brentford,Southampton,3,0,H,3,0,2,1,2,0,1,4,14,15,40,40,1,0,May,0.4999999999999999,-0.8660254037844387,9,38,0,0,1,1.0,4.0,41,52,-11,41,58,-17,"May, 2022"
2021-2022,36,2022-05-07,Burnley,Aston Villa,1,3,A,0,3,1,1,3,1,2,2,16,14,34,40,2,6,May,0.4999999999999999,-0.8660254037844387,11,1,2,2,1,1.4,1.2,31,46,-15,44,46,-2,"May, 2022"
2021-2022,36,2022-05-07,Chelsea,Wolves,2,2,D,1,1,2,2,1,0,2,3,3,8,66,49,5,17,May,0.4999999999999999,-0.8660254037844387,14,48,2,2,1,1.6,0.8,68,29,39,33,32,1,"May, 2022"
2021-2022,36,2022-05-07,Crystal Palace,Watford,1,0,H,3,0,3,1,1,0,1,4,14,19,41,22,5,19,May,0.4999999999999999,-0.8660254037844387,16,43,2,1,2,1.4,1.0,45,42,3,32,69,-37,"May, 2022"
2021-2022,36,2022-05-07,Brighton,Man United,4,0,H,3,0,3,2,0,1,1,3,10,6,44,58,4,14,May,0.4999999999999999,-0.8660254037844387,10,28,0,0,5,0.8,2.6,34,42,-8,57,52,5,"May, 2022"
2021-2022,36,2022-05-07,Liverpool,Tottenham,1,1,D,1,1,4,1,0,4,1,0,2,5,82,61,3,21,May,0.4999999999999999,-0.8660254037844387,25,42,4,1,0,2.0,1.0,86,22,64,59,39,20,"May, 2022"
2021-2022,36,2022-05-08,Man City,Newcastle,5,0,H,3,0,4,1,0,3,0,2,2,13,83,43,11,40,May,0.4999999999999999,-0.8660254037844387,27,30,4,1,0,3.4,1.0,84,21,63,40,56,-16,"May, 2022"
2021-2022,36,2022-05-08,Norwich,West Ham,0,4,A,0,3,0,1,4,1,1,3,20,7,21,52,13,31,May,0.4999999999999999,-0.8660254037844387,31,45,0,2,3,0.8,2.4,22,71,-49,53,46,7,"May, 2022"
2021-2022,36,2022-05-08,Leicester,Everton,1,2,A,0,3,3,1,1,2,1,2,14,18,42,32,4,10,May,0.4999999999999999,-0.8660254037844387,24,18,1,2,2,1.0,1.4,48,54,-6,35,55,-20,"May, 2022"
2021-2022,36,2022-05-08,Arsenal,Leeds,2,1,H,3,0,3,0,2,1,1,3,4,17,63,34,13,29,May,0.4999999999999999,-0.8660254037844387,0,23,4,1,0,3.4,0.8,54,41,13,38,72,-34,"May, 2022"
2021-2022,36,2022-05-10,Aston Villa,Liverpool,1,2,A,0,3,1,2,2,4,1,0,11,2,43,83,9,40,May,0.4999999999999999,-0.8660254037844387,1,25,1,0,4,1.8,1.8,47,47,0,87,23,64,"May, 2022"
2021-2022,36,2022-05-11,Leeds,Chelsea,0,3,A,0,3,1,1,3,2,2,1,18,3,34,67,15,33,May,0.4999999999999999,-0.8660254037844387,23,14,0,2,3,0.8,1.6,39,74,-35,70,31,39,"May, 2022"
2021-2022,36,2022-05-11,Leicester,Norwich,3,0,H,3,0,3,1,1,0,1,4,14,20,42,21,6,21,May,0.4999999999999999,-0.8660254037844387,24,31,3,1,1,1.2,0.8,49,56,-7,22,75,-53,"May, 2022"
2021-2022,36,2022-05-11,Watford,Everton,0,0,D,1,1,0,1,4,2,1,2,19,16,22,35,3,13,May,0.4999999999999999,-0.8660254037844387,43,18,2,1,2,2.0,1.6,32,70,-38,37,56,-19,"May, 2022"
2021-2022,36,2022-05-11,Wolves,Man City,1,5,A,0,3,0,2,3,4,1,0,8,1,50,86,7,36,May,0.4999999999999999,-0.8660254037844387,48,27,2,0,3,1.4,2.0,35,34,1,89,21,68,"May, 2022"
2021-2022,36,2022-05-12,Tottenham,Arsenal,3,0,H,3,0,4,1,0,3,0,2,5,4,62,66,1,4,May,0.4999999999999999,-0.8660254037844387,42,0,2,1,2,1.6,1.6,60,40,20,56,42,14,"May, 2022"
2021-2022,37,2022-05-15,Wolves,Norwich,1,1,D,1,1,0,2,3,0,1,4,8,20,50,21,12,29,May,0.4999999999999999,-0.8660254037844387,48,31,2,2,1,1.6,1.0,36,39,-3,22,78,-56,"May, 2022"
2021-2022,37,2022-05-15,Everton,Brentford,2,3,A,0,3,2,1,2,2,1,2,16,13,36,43,3,7,May,0.4999999999999999,-0.8660254037844387,18,9,0,0,1,0.0,1.0,37,56,-19,44,52,-8,"May, 2022"
2021-2022,37,2022-05-15,West Ham,Man City,2,2,D,1,1,1,1,3,4,1,0,7,1,55,89,6,34,May,0.4999999999999999,-0.8660254037844387,45,27,0,1,4,0.6,2.4,57,46,11,94,22,72,"May, 2022"
2021-2022,37,2022-05-15,Watford,Leicester,1,5,A,0,3,0,1,4,3,1,1,19,11,23,45,8,22,May,0.4999999999999999,-0.8660254037844387,43,24,1,1,3,1.0,2.0,32,70,-38,52,56,-4,"May, 2022"
2021-2022,37,2022-05-15,Leeds,Brighton,1,1,D,1,1,1,1,3,3,2,0,18,9,34,47,9,13,May,0.4999999999999999,-0.8660254037844387,23,10,0,1,2,0.0,1.0,39,77,-38,38,42,-4,"May, 2022"
2021-2022,37,2022-05-15,Aston Villa,Crystal Palace,1,1,D,1,1,1,2,2,3,1,1,12,11,43,44,1,1,May,0.4999999999999999,-0.8660254037844387,1,16,3,0,2,1.8,1.0,48,49,-1,46,42,4,"May, 2022"
2021-2022,37,2022-05-15,Tottenham,Burnley,1,0,H,3,0,4,1,0,1,1,3,5,17,65,34,12,31,May,0.4999999999999999,-0.8660254037844387,42,11,3,1,1,2.2,0.4,63,40,23,32,49,-17,"May, 2022"
2021-2022,37,2022-05-16,Newcastle,Arsenal,2,0,H,3,0,3,0,2,3,0,2,14,5,43,66,9,23,May,0.4999999999999999,-0.8660254037844387,30,0,0,0,5,0.0,2.4,40,61,-21,56,45,11,"May, 2022"
2021-2022,37,2022-05-17,Southampton,Liverpool,1,2,A,0,3,0,1,4,4,1,0,15,2,40,86,13,46,May,0.4999999999999999,-0.8660254037844387,38,25,1,0,4,0.4,2.4,41,61,-20,89,24,65,"May, 2022"
2021-2022,37,2022-05-19,Everton,Crystal Palace,3,2,H,3,0,2,1,2,3,1,1,16,13,36,45,3,9,May,0.4999999999999999,-0.8660254037844387,18,16,2,2,1,1.4,1.2,39,59,-20,47,43,4,"May, 2022"
2021-2022,37,2022-05-19,Aston Villa,Burnley,1,1,D,1,1,1,2,2,1,1,3,14,18,44,34,4,10,May,0.4999999999999999,-0.8660254037844387,1,11,2,2,1,1.8,1.4,49,50,-1,32,50,-18,"May, 2022"
2021-2022,37,2022-05-19,Chelsea,Leicester,1,1,D,1,1,2,2,1,3,1,1,3,9,70,48,6,22,May,0.4999999999999999,-0.8660254037844387,14,24,2,2,1,1.6,1.2,73,31,42,57,57,0,"May, 2022"
2021-2022,38,2022-05-22,Norwich,Tottenham,0,5,A,0,3,0,1,4,4,1,0,20,5,22,68,15,46,May,0.4999999999999999,-0.8660254037844387,31,42,0,1,4,0.6,2.6,23,79,-56,64,40,24,"May, 2022"
2021-2022,38,2022-05-22,Man City,Aston Villa,3,2,H,3,0,4,1,0,1,2,2,2,14,90,45,12,45,May,0.4999999999999999,-0.8660254037844387,27,1,5,0,0,3.0,0.6,96,24,72,50,51,-1,"May, 2022"
2021-2022,38,2022-05-22,Liverpool,Wolves,3,1,H,3,0,4,1,0,0,2,3,2,10,89,51,8,38,May,0.4999999999999999,-0.8660254037844387,25,48,5,0,0,1.8,0.2,91,25,66,37,40,-3,"May, 2022"
2021-2022,38,2022-05-22,Leicester,Southampton,4,1,H,3,0,3,1,1,0,1,4,10,15,49,40,5,9,May,0.4999999999999999,-0.8660254037844387,24,38,2,2,1,3.0,1.0,58,58,0,42,63,-21,"May, 2022"
2021-2022,38,2022-05-22,Crystal Palace,Man United,1,0,H,3,0,3,1,1,1,1,3,13,6,45,58,7,13,May,0.4999999999999999,-0.8660254037844387,16,28,2,1,2,1.0,1.0,49,46,3,57,56,1,"May, 2022"
2021-2022,38,2022-05-22,Brighton,West Ham,3,1,H,3,0,3,2,0,1,1,3,10,7,48,56,3,8,May,0.4999999999999999,-0.8660254037844387,10,45,0,5,0,1.6,1.6,39,43,-4,59,48,11,"May, 2022"
2021-2022,38,2022-05-22,Burnley,Newcastle,1,2,A,0,3,1,1,3,3,0,2,18,12,35,46,6,11,May,0.4999999999999999,-0.8660254037844387,11,30,1,1,3,0.6,1.2,33,51,-18,42,61,-19,"May, 2022"
2021-2022,38,2022-05-22,Brentford,Leeds,1,2,A,0,3,2,1,2,1,1,3,11,18,46,35,7,11,May,0.4999999999999999,-0.8660254037844387,9,23,0,1,0,2.0,2.0,47,54,-7,40,78,-38,"May, 2022"
2021-2022,38,2022-05-22,Arsenal,Everton,5,1,H,3,0,3,0,2,2,1,2,5,16,66,39,11,27,May,0.4999999999999999,-0.8660254037844387,0,18,1,1,3,1.0,1.4,56,47,9,42,61,-19,"May, 2022"
2021-2022,38,2022-05-22,Chelsea,Watford,2,1,H,3,0,2,2,1,0,1,4,3,19,71,23,16,48,May,0.4999999999999999,-0.8660254037844387,14,43,5,0,0,2.4,0.6,74,32,42,33,75,-42,"May, 2022"
2022-2023,1,2022-08-05,Crystal Palace,Arsenal,0,2,A,0,3,2,2,1,3,0,2,7,1,0,0,6,0,August,-0.8660254037844384,-0.5000000000000004,16,0,1,3,1,1.4,1.2,0,0,0,0,0,0,"August, 2022"
2022-2023,1,2022-08-06,Tottenham,Southampton,4,1,H,3,0,2,0,3,0,1,4,15,14,0,0,1,0,August,-0.8660254037844384,-0.5000000000000004,42,38,2,1,2,2.0,1.6,0,0,0,0,0,0,"August, 2022"
2022-2023,1,2022-08-06,Everton,Chelsea,0,1,A,0,3,2,2,1,1,2,2,11,10,0,0,1,0,August,-0.8660254037844384,-0.5000000000000004,18,14,2,1,2,0.6,1.4,0,0,0,0,0,0,"August, 2022"
2022-2023,1,2022-08-06,Newcastle,Nott'm Forest,2,0,H,3,0,1,3,1,2,2,1,13,14,0,0,1,0,August,-0.8660254037844384,-0.5000000000000004,30,32,3,2,0,2.0,0.4,0,0,0,0,0,0,"August, 2022"
2022-2023,1,2022-08-06,Fulham,Liverpool,2,2,D,1,1,2,1,2,3,2,0,8,11,0,0,3,0,August,-0.8660254037844384,-0.5000000000000004,19,25,1,1,3,1.0,1.6,0,0,0,0,0,0,"August, 2022"
2022-2023,1,2022-08-06,Bournemouth,Aston Villa,2,0,H,3,0,1,0,4,2,1,2,5,4,0,0,1,0,August,-0.8660254037844384,-0.5000000000000004,7,1,3,0,1,1.5,1.0,0,0,0,0,0,0,"August, 2022"
2022-2023,1,2022-08-06,Leeds,Wolves,2,1,H,3,0,0,1,4,1,1,3,9,18,0,0,9,0,August,-0.8660254037844384,-0.5000000000000004,23,48,2,1,2,1.6,1.2,0,0,0,0,0,0,"August, 2022"
2022-2023,1,2022-08-07,Leicester,Brentford,2,2,D,1,1,1,2,2,4,0,1,11,9,0,0,2,0,August,-0.8660254037844384,-0.5000000000000004,24,9,2,0,0,2.0,1.0,0,0,0,0,0,0,"August, 2022"
2022-2023,1,2022-08-07,Man United,Brighton,1,2,A,0,3,4,0,1,2,1,2,13,11,0,0,2,0,August,-0.8660254037844384,-0.5000000000000004,28,10,4,0,1,2.0,1.4,0,0,0,0,0,0,"August, 2022"
2022-2023,1,2022-08-07,West Ham,Man City,0,2,A,0,3,2,0,3,3,1,1,13,12,0,0,1,0,August,-0.8660254037844384,-0.5000000000000004,45,27,0,2,3,1.0,1.8,0,0,0,0,0,0,"August, 2022"
2022-2023,2,2022-08-13,Brentford,Man United,4,0,H,3,0,4,0,1,4,0,1,11,16,1,0,5,1,August,-0.8660254037844384,-0.5000000000000004,9,28,0,0,2,0.5,3.0,2,2,0,1,2,-1,"August, 2022"
2022-2023,2,2022-08-13,Wolves,Fulham,0,0,D,1,1,1,1,3,2,1,2,16,11,0,1,5,1,August,-0.8660254037844384,-0.5000000000000004,48,19,3,1,1,0.8,1.2,1,2,-1,2,2,0,"August, 2022"
2022-2023,2,2022-08-13,Southampton,Leeds,2,2,D,1,1,0,1,4,0,1,4,20,6,0,3,14,3,August,-0.8660254037844384,-0.5000000000000004,38,23,2,1,2,0.8,1.4,1,4,-3,2,1,1,"August, 2022"
2022-2023,2,2022-08-13,Man City,Bournemouth,4,0,H,3,0,3,1,1,1,0,4,6,5,3,3,1,0,August,-0.8660254037844384,-0.5000000000000004,27,7,5,0,0,2.6,0.6,2,0,2,2,0,2,"August, 2022"
2022-2023,2,2022-08-13,Arsenal,Leicester,4,2,H,3,0,3,0,2,1,2,2,2,12,3,1,10,2,August,-0.8660254037844384,-0.5000000000000004,0,24,3,1,1,1.6,0.6,2,0,2,2,2,0,"August, 2022"
2022-2023,2,2022-08-13,Aston Villa,Everton,2,1,H,3,0,2,1,2,2,2,1,16,15,0,0,1,0,August,-0.8660254037844384,-0.5000000000000004,1,18,3,2,0,1.4,0.4,0,2,-2,0,1,-1,"August, 2022"
2022-2023,2,2022-08-13,Brighton,Newcastle,0,0,D,1,1,2,1,2,1,3,1,6,5,3,3,1,0,August,-0.8660254037844384,-0.5000000000000004,10,30,2,2,1,1.6,0.6,2,1,1,2,0,2,"August, 2022"
2022-2023,2,2022-08-14,Nott'm Forest,West Ham,1,0,H,3,0,2,2,1,2,0,3,18,19,0,0,1,0,August,-0.8660254037844384,-0.5000000000000004,32,45,1,1,3,0.4,1.0,0,2,-2,0,2,-2,"August, 2022"
2022-2023,2,2022-08-14,Chelsea,Tottenham,2,2,D,1,1,1,2,2,2,0,3,8,7,3,3,1,0,August,-0.8660254037844384,-0.5000000000000004,14,42,4,1,0,1.6,0.2,1,0,1,4,1,3,"August, 2022"
2022-2023,2,2022-08-15,Liverpool,Crystal Palace,1,1,D,1,1,3,2,0,2,2,1,13,18,1,0,5,1,August,-0.8660254037844384,-0.5000000000000004,25,16,5,0,0,3.8,0.2,2,2,0,0,2,-2,"August, 2022"
2022-2023,3,2022-08-20,Leicester,Southampton,1,2,A,0,3,1,2,2,0,1,4,15,18,1,1,3,0,August,-0.8660254037844384,-0.5000000000000004,24,38,2,2,1,2.0,1.2,4,6,-2,3,6,-3,"August, 2022"
2022-2023,3,2022-08-20,Fulham,Brentford,3,2,H,3,0,2,1,2,4,0,1,14,4,2,4,10,2,August,-0.8660254037844384,-0.5000000000000004,19,9,0,0,0,0.0,0.0,2,2,0,6,2,4,"August, 2022"
2022-2023,3,2022-08-20,Bournemouth,Arsenal,0,3,A,0,3,1,0,4,3,0,2,13,3,3,6,10,3,August,-0.8660254037844384,-0.5000000000000004,7,0,1,1,3,1.0,2.0,2,4,-2,6,2,4,"August, 2022"
2022-2023,3,2022-08-20,Crystal Palace,Aston Villa,3,1,H,3,0,2,2,1,2,1,2,15,9,1,3,6,2,August,-0.8660254037844384,-0.5000000000000004,16,1,1,1,3,1.0,2.0,1,3,-2,2,3,-1,"August, 2022"
2022-2023,3,2022-08-20,Everton,Nott'm Forest,1,1,D,1,1,2,2,1,2,2,1,18,10,0,3,8,3,August,-0.8660254037844384,-0.5000000000000004,18,32,4,0,1,1.6,0.2,1,3,-2,1,2,-1,"August, 2022"
2022-2023,3,2022-08-20,Tottenham,Wolves,1,0,H,3,0,2,0,3,1,1,3,4,14,4,1,10,3,August,-0.8660254037844384,-0.5000000000000004,42,48,2,1,2,1.2,1.2,6,3,3,1,2,-1,"August, 2022"
2022-2023,3,2022-08-21,Leeds,Chelsea,3,0,H,3,0,0,1,4,1,2,2,7,8,4,4,1,0,August,-0.8660254037844384,-0.5000000000000004,23,14,0,1,4,0.6,2.0,4,3,1,3,2,1,"August, 2022"
2022-2023,3,2022-08-21,West Ham,Brighton,0,2,A,0,3,2,0,3,2,1,2,19,8,0,4,11,4,August,-0.8660254037844384,-0.5000000000000004,45,10,0,4,1,1.6,2.0,0,3,-3,2,1,1,"August, 2022"
2022-2023,3,2022-08-21,Newcastle,Man City,3,3,D,1,1,1,3,1,3,1,1,8,5,4,6,3,2,August,-0.8660254037844384,-0.5000000000000004,30,27,0,0,5,0.6,4.0,2,0,2,6,0,6,"August, 2022"
2022-2023,3,2022-08-22,Man United,Liverpool,2,1,H,3,0,4,0,1,3,2,0,19,15,0,2,4,2,August,-0.8660254037844384,-0.5000000000000004,28,25,0,1,4,0.4,3.0,1,6,-5,3,3,0,"August, 2022"
2022-2023,4,2022-08-27,Man City,Crystal Palace,4,2,H,3,0,3,1,1,2,2,1,3,12,7,4,9,3,August,-0.8660254037844384,-0.5000000000000004,27,16,2,2,1,1.6,0.8,9,3,6,4,4,0,"August, 2022"
2022-2023,4,2022-08-27,Arsenal,Fulham,2,1,H,3,0,3,0,2,2,1,2,3,11,9,5,8,4,August,-0.8660254037844384,-0.5000000000000004,0,19,4,1,0,3.0,0.6,9,2,7,5,4,1,"August, 2022"
2022-2023,4,2022-08-27,Chelsea,Leicester,2,1,H,3,0,1,2,2,1,2,2,12,19,4,1,7,3,August,-0.8660254037844384,-0.5000000000000004,14,24,2,2,1,1.6,1.2,3,5,-2,5,8,-3,"August, 2022"
2022-2023,4,2022-08-27,Liverpool,Bournemouth,9,0,H,3,0,3,2,0,1,0,4,16,15,2,3,1,1,August,-0.8660254037844384,-0.5000000000000004,25,7,5,0,0,3.0,0.2,4,5,-1,2,7,-5,"August, 2022"
2022-2023,4,2022-08-27,Brentford,Everton,1,1,D,1,1,4,0,1,2,2,1,9,17,4,1,8,3,August,-0.8660254037844384,-0.5000000000000004,9,18,2,0,0,2.0,1.0,8,5,3,2,4,-2,"August, 2022"
2022-2023,4,2022-08-27,Southampton,Man United,0,1,A,0,3,0,1,4,4,0,1,11,14,4,3,3,1,August,-0.8660254037844384,-0.5000000000000004,38,28,0,3,2,1.2,3.2,5,7,-2,3,7,-4,"August, 2022"
2022-2023,4,2022-08-27,Brighton,Leeds,1,0,H,3,0,2,1,2,0,1,4,5,3,7,7,2,0,August,-0.8660254037844384,-0.5000000000000004,10,23,2,2,0,1.0,0.25,4,1,3,7,3,4,"August, 2022"
2022-2023,4,2022-08-28,Aston Villa,West Ham,0,1,A,0,3,2,1,2,2,0,3,15,20,3,0,5,3,August,-0.8660254037844384,-0.5000000000000004,1,45,0,1,4,1.0,2.4,3,6,-3,0,5,-5,"August, 2022"
2022-2023,4,2022-08-28,Wolves,Newcastle,1,1,D,1,1,1,1,3,1,3,1,19,10,1,5,9,4,August,-0.8660254037844384,-0.5000000000000004,48,30,1,3,1,1.0,1.0,1,3,-2,5,3,2,"August, 2022"
2022-2023,4,2022-08-28,Nott'm Forest,Tottenham,0,2,A,0,3,2,2,1,2,0,3,12,4,4,7,8,3,August,-0.8660254037844384,-0.5000000000000004,32,42,3,0,2,1.0,1.0,2,3,-1,7,3,4,"August, 2022"
2022-2023,5,2022-08-30,Crystal Palace,Brentford,1,1,D,1,1,2,2,1,4,0,1,12,10,4,5,2,1,August,-0.8660254037844384,-0.5000000000000004,16,9,0,2,0,0.0,0.0,6,8,-2,9,6,3,"August, 2022"
2022-2023,5,2022-08-30,Fulham,Brighton,2,1,H,3,0,2,1,2,2,1,2,11,4,5,10,7,5,August,-0.8660254037844384,-0.5000000000000004,19,10,1,3,0,1.5,1.0,6,6,0,5,1,4,"August, 2022"
2022-2023,5,2022-08-30,Southampton,Chelsea,2,1,H,3,0,0,1,4,1,2,2,13,7,4,7,6,3,August,-0.8660254037844384,-0.5000000000000004,38,14,1,2,2,1.4,2.6,5,8,-3,5,6,-1,"August, 2022"
2022-2023,5,2022-08-30,Leeds,Everton,1,1,D,1,1,0,1,4,2,2,1,6,18,7,2,12,5,August,-0.8660254037844384,-0.5000000000000004,23,18,1,2,2,1.0,1.6,7,4,3,3,5,-2,"August, 2022"
2022-2023,5,2022-08-31,West Ham,Tottenham,1,1,D,1,1,2,0,3,2,0,3,18,3,3,10,15,7,August,-0.8660254037844384,-0.5000000000000004,45,42,2,1,2,1.4,1.8,1,5,-4,9,3,6,"August, 2022"
2022-2023,5,2022-08-31,Liverpool,Newcastle,2,1,H,3,0,3,2,0,1,3,1,12,10,5,6,2,1,August,-0.8660254037844384,-0.5000000000000004,25,30,3,2,0,1.6,0.6,13,5,8,6,4,2,"August, 2022"
2022-2023,5,2022-08-31,Man City,Nott'm Forest,6,0,H,3,0,3,1,1,2,2,1,2,14,10,4,12,6,August,-0.8660254037844384,-0.5000000000000004,27,32,0,1,1,0.5,2.0,13,5,8,2,5,-3,"August, 2022"
2022-2023,5,2022-08-31,Arsenal,Aston Villa,2,1,H,3,0,3,0,2,2,1,2,1,16,12,3,15,9,August,-0.8660254037844384,-0.5000000000000004,0,1,2,0,3,0.8,1.2,11,3,8,3,7,-4,"August, 2022"
2022-2023,5,2022-08-31,Bournemouth,Wolves,0,0,D,1,1,1,0,4,1,1,3,18,19,3,2,1,1,August,-0.8660254037844384,-0.5000000000000004,7,48,0,1,3,0.5,1.5,2,16,-14,2,4,-2,"August, 2022"
2022-2023,5,2022-09-01,Leicester,Man United,0,1,A,0,3,1,2,2,4,0,1,20,12,1,6,8,5,September,-1.0,-1.8369701987210287e-16,24,28,2,2,1,1.8,1.6,6,10,-4,4,7,-3,"September, 2022"
2022-2023,6,2022-09-03,Everton,Liverpool,0,0,D,1,1,2,2,1,3,2,0,17,6,3,8,11,5,September,-1.0,-1.8369701987210287e-16,18,25,1,2,2,1.0,1.6,4,6,-2,15,6,9,"September, 2022"
2022-2023,6,2022-09-03,Brentford,Leeds,5,2,H,3,0,4,0,1,0,1,4,11,7,6,8,4,2,September,-1.0,-1.8369701987210287e-16,9,23,0,1,1,1.5,2.0,10,7,3,8,5,3,"September, 2022"
2022-2023,6,2022-09-03,Chelsea,West Ham,2,1,H,3,0,1,2,2,2,0,3,11,15,7,4,4,3,September,-1.0,-1.8369701987210287e-16,14,45,3,0,2,1.8,1.2,6,8,-2,2,6,-4,"September, 2022"
2022-2023,6,2022-09-03,Newcastle,Crystal Palace,0,0,D,1,1,1,3,1,2,2,1,12,13,6,5,1,1,September,-1.0,-1.8369701987210287e-16,30,16,2,1,2,1.0,0.8,7,6,1,7,9,-2,"September, 2022"
2022-2023,6,2022-09-03,Nott'm Forest,Bournemouth,2,3,A,0,3,2,2,1,1,0,4,16,17,4,4,1,0,September,-1.0,-1.8369701987210287e-16,32,7,0,0,0,0.0,0.0,2,11,-9,2,16,-14,"September, 2022"
2022-2023,6,2022-09-03,Tottenham,Fulham,2,1,H,3,0,2,0,3,2,1,2,3,9,11,8,6,3,September,-1.0,-1.8369701987210287e-16,42,19,4,1,0,2.0,0.8,10,4,6,8,7,1,"September, 2022"
2022-2023,6,2022-09-03,Wolves,Southampton,1,0,H,3,0,1,1,3,0,1,4,18,12,3,7,6,4,September,-1.0,-1.8369701987210287e-16,48,38,4,1,0,2.0,1.0,2,4,-2,7,9,-2,"September, 2022"
2022-2023,6,2022-09-03,Aston Villa,Man City,1,1,D,1,1,2,1,2,3,1,1,19,3,3,13,16,10,September,-1.0,-1.8369701987210287e-16,1,27,0,0,5,1.0,3.0,4,9,-5,19,5,14,"September, 2022"
2022-2023,6,2022-09-04,Man United,Arsenal,3,1,H,3,0,4,0,1,3,0,2,8,1,9,15,7,6,September,-1.0,-1.8369701987210287e-16,28,0,1,1,3,0.8,1.6,5,7,-2,13,4,9,"September, 2022"
2022-2023,6,2022-09-04,Brighton,Leicester,5,2,H,3,0,2,1,2,1,2,2,4,20,10,1,16,9,September,-1.0,-1.8369701987210287e-16,10,24,1,2,2,0.8,1.4,6,3,3,6,11,-5,"September, 2022"
2022-2023,8,2022-09-16,Aston Villa,Southampton,1,0,H,3,0,2,1,2,0,1,4,17,12,4,7,5,3,September,-1.0,-1.8369701987210287e-16,1,38,2,0,3,1.6,1.4,5,10,-5,7,10,-3,"September, 2022"
2022-2023,8,2022-09-16,Nott'm Forest,Fulham,2,3,A,0,3,2,2,1,2,1,2,19,10,4,8,9,4,September,-1.0,-1.8369701987210287e-16,32,19,0,0,0,0.0,0.0,4,14,-10,9,9,0,"September, 2022"
2022-2023,8,2022-09-17,Wolves,Man City,0,3,A,0,3,1,1,3,3,1,1,15,2,6,14,13,8,September,-1.0,-1.8369701987210287e-16,48,27,1,0,4,1.2,3.0,3,4,-1,20,6,14,"September, 2022"
2022-2023,8,2022-09-17,Newcastle,Bournemouth,1,1,D,1,1,1,3,1,1,0,4,11,14,7,7,3,0,September,-1.0,-1.8369701987210287e-16,30,7,3,2,0,2.4,1.4,7,6,1,5,18,-13,"September, 2022"
2022-2023,8,2022-09-17,Tottenham,Leicester,6,2,H,3,0,2,0,3,1,2,2,3,20,14,1,17,13,September,-1.0,-1.8369701987210287e-16,42,24,4,0,1,2.6,1.4,12,5,7,8,16,-8,"September, 2022"
2022-2023,8,2022-09-18,Brentford,Arsenal,0,3,A,0,3,4,0,1,3,0,2,9,3,9,15,6,6,September,-1.0,-1.8369701987210287e-16,9,0,1,0,1,1.5,1.0,15,9,6,14,7,7,"September, 2022"
2022-2023,8,2022-09-18,Everton,West Ham,1,0,H,3,0,2,2,1,2,0,3,17,18,4,4,1,0,September,-1.0,-1.8369701987210287e-16,18,45,1,1,3,0.6,1.0,4,6,-2,3,8,-5,"September, 2022"
2022-2023,9,2022-10-01,West Ham,Wolves,2,0,H,3,0,2,0,3,1,1,3,18,17,4,6,1,2,October,-0.8660254037844386,0.5,45,48,3,0,2,1.6,1.0,3,9,-6,3,7,-4,"October, 2022"
2022-2023,9,2022-10-01,Southampton,Everton,1,2,A,0,3,0,1,4,2,2,1,14,13,7,7,1,0,October,-0.8660254037844386,0.5,38,18,2,1,2,1.2,1.0,7,11,-4,5,6,-1,"October, 2022"
2022-2023,9,2022-10-01,Liverpool,Brighton,3,3,D,1,1,3,2,0,2,1,2,10,4,9,13,6,4,October,-0.8660254037844386,0.5,25,10,2,2,1,1.6,1.0,15,6,9,11,5,6,"October, 2022"
2022-2023,9,2022-10-01,Fulham,Newcastle,1,4,A,0,3,2,1,2,1,3,1,7,11,11,8,4,3,October,-0.8660254037844386,0.5,19,30,1,2,2,0.4,1.4,12,11,1,8,7,1,"October, 2022"
2022-2023,9,2022-10-01,Crystal Palace,Chelsea,1,2,A,0,3,2,2,1,1,2,2,16,8,6,10,8,4,October,-0.8660254037844386,0.5,16,14,0,0,5,0.6,3.0,7,9,-2,8,9,-1,"October, 2022"
2022-2023,9,2022-10-01,Bournemouth,Brentford,0,0,D,1,1,1,0,4,4,0,1,12,9,8,9,3,1,October,-0.8660254037844386,0.5,7,9,0,0,0,0.0,0.0,6,19,-13,15,12,3,"October, 2022"
2022-2023,9,2022-10-01,Arsenal,Tottenham,3,1,H,3,0,3,0,2,2,0,3,1,3,18,17,2,1,October,-0.8660254037844386,0.5,0,42,2,0,3,1.2,1.8,17,7,10,18,7,11,"October, 2022"
2022-2023,9,2022-10-02,Man City,Man United,6,3,H,3,0,3,1,1,4,0,1,2,6,17,12,4,5,October,-0.8660254037844386,0.5,27,28,2,1,2,1.2,1.0,23,6,17,8,8,0,"October, 2022"
2022-2023,9,2022-10-02,Leeds,Aston Villa,0,0,D,1,1,0,1,4,2,1,2,13,14,8,7,1,1,October,-0.8660254037844386,0.5,23,1,1,1,3,1.2,1.8,10,10,0,6,10,-4,"October, 2022"
2022-2023,9,2022-10-03,Leicester,Nott'm Forest,4,0,H,3,0,1,2,2,2,2,1,20,19,1,4,1,3,October,-0.8660254037844386,0.5,24,32,1,2,1,1.25,1.0,10,22,-12,6,17,-11,"October, 2022"
2022-2023,10,2022-10-08,Bournemouth,Leicester,2,1,H,3,0,1,0,4,1,2,2,13,19,9,4,6,5,October,-0.8660254037844386,0.5,7,24,2,1,2,2.0,1.8,6,19,-13,14,22,-8,"October, 2022"
2022-2023,10,2022-10-08,Chelsea,Wolves,3,0,H,3,0,1,2,2,1,1,3,5,18,13,6,13,7,October,-0.8660254037844386,0.5,14,48,1,3,1,1.0,0.8,10,10,0,3,9,-6,"October, 2022"
2022-2023,10,2022-10-08,Man City,Southampton,4,0,H,3,0,3,1,1,0,1,4,2,16,20,7,14,13,October,-0.8660254037844386,0.5,27,38,2,2,1,1.4,0.8,29,9,20,8,13,-5,"October, 2022"
2022-2023,10,2022-10-08,Newcastle,Brentford,5,1,H,3,0,1,3,1,4,0,1,8,11,11,10,3,1,October,-0.8660254037844386,0.5,30,9,1,1,0,2.5,1.5,12,8,4,15,12,3,"October, 2022"
2022-2023,10,2022-10-08,Brighton,Tottenham,0,1,A,0,3,2,1,2,2,0,3,6,3,14,17,3,3,October,-0.8660254037844386,0.5,10,42,2,0,3,0.8,1.2,14,8,6,19,10,9,"October, 2022"
2022-2023,10,2022-10-09,Everton,Man United,1,2,A,0,3,2,2,1,4,0,1,11,7,10,12,4,2,October,-0.8660254037844386,0.5,18,28,1,3,1,1.4,1.6,7,7,0,11,14,-3,"October, 2022"
2022-2023,10,2022-10-09,Arsenal,Liverpool,3,2,H,3,0,3,0,2,3,2,0,2,10,21,10,8,11,October,-0.8660254037844386,0.5,0,25,1,0,4,0.6,2.6,20,8,12,18,9,9,"October, 2022"
2022-2023,10,2022-10-09,Crystal Palace,Leeds,2,1,H,3,0,2,2,1,0,1,4,17,13,6,9,4,3,October,-0.8660254037844386,0.5,16,23,1,1,3,0.8,1.2,8,11,-3,10,10,0,"October, 2022"
2022-2023,10,2022-10-09,West Ham,Fulham,3,1,H,3,0,2,0,3,2,1,2,16,9,7,11,7,4,October,-0.8660254037844386,0.5,45,19,3,1,1,1.4,0.6,5,9,-4,13,15,-2,"October, 2022"
2022-2023,10,2022-10-10,Nott'm Forest,Aston Villa,1,1,D,1,1,2,2,1,2,1,2,20,16,4,8,4,4,October,-0.8660254037844386,0.5,32,1,0,3,2,0.6,1.4,6,21,-15,6,10,-4,"October, 2022"
2022-2023,11,2022-10-14,Brentford,Brighton,2,0,H,3,0,4,0,1,2,1,2,11,7,10,14,4,4,October,-0.8660254037844386,0.5,9,10,0,0,2,0.0,1.5,16,17,-1,14,9,5,"October, 2022"
2022-2023,11,2022-10-15,Leicester,Crystal Palace,0,0,D,1,1,1,2,2,2,2,1,20,15,4,9,5,5,October,-0.8660254037844386,0.5,24,16,3,2,0,2.0,1.0,15,24,-9,10,12,-2,"October, 2022"
2022-2023,11,2022-10-15,Fulham,Bournemouth,2,2,D,1,1,2,1,2,1,0,4,10,9,11,12,1,1,October,-0.8660254037844386,0.5,19,7,1,0,1,0.5,1.5,14,18,-4,8,20,-12,"October, 2022"
2022-2023,11,2022-10-15,Wolves,Nott'm Forest,1,0,H,3,0,1,1,3,2,2,1,18,20,6,5,2,1,October,-0.8660254037844386,0.5,48,32,0,0,0,0.0,0.0,3,12,-9,7,22,-15,"October, 2022"
2022-2023,11,2022-10-15,Tottenham,Everton,2,0,H,3,0,2,0,3,2,2,1,3,12,20,10,9,10,October,-0.8660254037844386,0.5,42,18,2,2,1,1.6,0.6,20,10,10,8,9,-1,"October, 2022"
2022-2023,11,2022-10-16,Liverpool,Man City,1,0,H,3,0,3,2,0,3,1,1,12,2,10,23,10,13,October,-0.8660254037844386,0.5,25,27,0,3,2,1.2,2.6,20,12,8,33,9,24,"October, 2022"
2022-2023,11,2022-10-16,Southampton,West Ham,1,1,D,1,1,0,1,4,2,0,3,18,13,7,10,5,3,October,-0.8660254037844386,0.5,38,45,1,2,2,0.8,1.6,8,17,-9,8,10,-2,"October, 2022"
2022-2023,11,2022-10-16,Aston Villa,Chelsea,0,2,A,0,3,2,1,2,1,2,2,16,4,9,16,12,7,October,-0.8660254037844386,0.5,1,14,1,1,3,1.0,2.0,7,11,-4,13,10,3,"October, 2022"
2022-2023,11,2022-10-16,Leeds,Arsenal,0,1,A,0,3,0,1,4,3,0,2,15,1,9,24,14,15,October,-0.8660254037844386,0.5,23,0,0,1,4,0.8,3.0,11,12,-1,23,10,13,"October, 2022"
2022-2023,11,2022-10-16,Man United,Newcastle,0,0,D,1,1,4,0,1,1,3,1,5,6,15,14,1,1,October,-0.8660254037844386,0.5,28,30,4,1,0,3.2,1.0,13,15,-2,17,9,8,"October, 2022"
2022-2023,12,2022-10-18,Brighton,Nott'm Forest,0,0,D,1,1,2,1,2,2,2,1,7,20,14,5,13,9,October,-0.8660254037844386,0.5,10,32,0,0,0,0.0,0.0,14,11,3,7,23,-16,"October, 2022"
2022-2023,12,2022-10-18,Crystal Palace,Wolves,2,1,H,3,0,2,2,1,1,1,3,13,17,10,9,4,1,October,-0.8660254037844386,0.5,16,48,3,0,2,1.0,0.8,10,12,-2,4,12,-8,"October, 2022"
2022-2023,12,2022-10-19,Bournemouth,Southampton,0,1,A,0,3,1,0,4,0,1,4,11,18,13,8,7,5,October,-0.8660254037844386,0.5,7,38,1,2,2,1.4,1.6,10,22,-12,9,18,-9,"October, 2022"
2022-2023,12,2022-10-19,Brentford,Chelsea,0,0,D,1,1,4,0,1,1,2,2,9,4,13,19,5,6,October,-0.8660254037844386,0.5,9,14,1,0,1,2.0,1.0,18,17,1,15,10,5,"October, 2022"
2022-2023,12,2022-10-19,Liverpool,West Ham,1,0,H,3,0,3,2,0,2,0,3,9,13,13,11,4,2,October,-0.8660254037844386,0.5,25,45,4,0,1,2.2,1.4,21,12,9,9,11,-2,"October, 2022"
2022-2023,12,2022-10-19,Newcastle,Everton,1,0,H,3,0,1,3,1,2,2,1,7,15,15,10,8,5,October,-0.8660254037844386,0.5,30,18,3,1,1,1.8,1.0,17,9,8,8,11,-3,"October, 2022"
2022-2023,12,2022-10-19,Man United,Tottenham,2,0,H,3,0,4,0,1,2,0,3,7,3,16,23,4,7,October,-0.8660254037844386,0.5,28,42,3,1,1,2.2,2.0,13,15,-2,22,10,12,"October, 2022"
2022-2023,12,2022-10-20,Leicester,Leeds,2,0,H,3,0,1,2,2,0,1,4,20,16,5,9,4,4,October,-0.8660254037844386,0.5,24,23,2,1,2,1.8,1.6,15,24,-9,11,13,-2,"October, 2022"
2022-2023,12,2022-10-20,Fulham,Aston Villa,3,0,H,3,0,2,1,2,2,1,2,12,17,12,9,5,3,October,-0.8660254037844386,0.5,19,1,2,1,2,1.2,1.6,16,20,-4,7,13,-6,"October, 2022"
2022-2023,13,2022-10-22,Nott'm Forest,Liverpool,1,0,H,3,0,2,2,1,3,2,0,20,7,6,16,13,10,October,-0.8660254037844386,0.5,32,25,1,2,2,1.4,2.4,7,23,-16,22,12,10,"October, 2022"
2022-2023,13,2022-10-22,Everton,Crystal Palace,3,0,H,3,0,2,2,1,2,2,1,15,11,10,13,4,3,October,-0.8660254037844386,0.5,18,16,3,1,1,2.0,1.6,8,12,-4,12,13,-1,"October, 2022"
2022-2023,13,2022-10-22,Man City,Brighton,3,1,H,3,0,3,1,1,2,1,2,2,8,23,15,6,8,October,-0.8660254037844386,0.5,27,10,4,0,1,3.0,0.8,33,10,23,14,11,3,"October, 2022"
2022-2023,13,2022-10-22,Chelsea,Man United,1,1,D,1,1,1,2,2,4,0,1,4,5,20,19,1,1,October,-0.8660254037844386,0.5,14,28,0,4,1,0.4,0.8,15,10,5,15,15,0,"October, 2022"
2022-2023,13,2022-10-23,Aston Villa,Brentford,4,0,H,3,0,2,1,2,4,0,1,17,10,9,14,7,5,October,-0.8660254037844386,0.5,1,9,0,1,1,1.0,1.5,7,16,-9,18,17,1,"October, 2022"
2022-2023,13,2022-10-23,Leeds,Fulham,2,3,A,0,3,0,1,4,2,1,2,17,9,9,15,8,6,October,-0.8660254037844386,0.5,23,19,4,0,1,2.2,1.6,11,15,-4,19,20,-1,"October, 2022"
2022-2023,13,2022-10-23,Southampton,Arsenal,1,1,D,1,1,0,1,4,3,0,2,16,1,11,27,15,16,October,-0.8660254037844386,0.5,38,0,1,1,3,0.6,1.8,10,18,-8,24,10,14,"October, 2022"
2022-2023,13,2022-10-23,Wolves,Leicester,0,4,A,0,3,1,1,3,1,2,2,18,20,9,8,2,1,October,-0.8660254037844386,0.5,48,24,1,2,2,0.4,0.6,5,14,-9,17,24,-7,"October, 2022"
2022-2023,13,2022-10-23,Tottenham,Newcastle,1,2,A,0,3,2,0,3,1,3,1,3,6,23,18,3,5,October,-0.8660254037844386,0.5,42,30,3,2,0,2.8,1.4,22,12,10,18,9,9,"October, 2022"
2022-2023,13,2022-10-24,West Ham,Bournemouth,2,0,H,3,0,2,0,3,1,0,4,17,13,11,13,4,2,October,-0.8660254037844386,0.5,45,7,1,2,2,1.6,1.4,9,12,-3,10,23,-13,"October, 2022"
2022-2023,14,2022-10-29,Leicester,Man City,0,1,A,0,3,1,2,2,3,1,1,17,2,11,26,15,15,October,-0.8660254037844386,0.5,24,27,1,0,4,1.6,2.4,21,24,-3,36,11,25,"October, 2022"
2022-2023,14,2022-10-29,Bournemouth,Tottenham,2,3,A,0,3,1,0,4,2,0,3,14,3,13,23,11,10,October,-0.8660254037844386,0.5,7,42,1,1,3,0.8,2.4,10,25,-15,23,14,9,"October, 2022"
2022-2023,14,2022-10-29,Brentford,Wolves,1,1,D,1,1,4,0,1,1,1,3,11,19,14,9,8,5,October,-0.8660254037844386,0.5,9,48,1,0,1,1.5,1.0,18,21,-3,5,18,-13,"October, 2022"
2022-2023,14,2022-10-29,Brighton,Chelsea,4,1,H,3,0,2,1,2,1,2,2,9,5,15,21,4,6,October,-0.8660254037844386,0.5,10,14,0,4,1,0.8,1.2,15,14,1,16,11,5,"October, 2022"
2022-2023,14,2022-10-29,Crystal Palace,Southampton,1,0,H,3,0,2,2,1,0,1,4,13,16,13,12,3,1,October,-0.8660254037844386,0.5,16,38,2,1,2,1.2,1.6,12,16,-4,11,19,-8,"October, 2022"
2022-2023,14,2022-10-29,Newcastle,Aston Villa,4,0,H,3,0,1,3,1,2,1,2,4,15,21,12,11,9,October,-0.8660254037844386,0.5,30,1,1,2,2,0.6,1.2,20,10,10,11,16,-5,"October, 2022"
2022-2023,14,2022-10-29,Fulham,Everton,0,0,D,1,1,2,1,2,2,2,1,8,13,18,13,5,5,October,-0.8660254037844386,0.5,19,18,2,0,3,1.4,1.8,22,22,0,11,12,-1,"October, 2022"
2022-2023,14,2022-10-29,Liverpool,Leeds,1,2,A,0,3,3,2,0,0,1,4,9,19,16,9,10,7,October,-0.8660254037844386,0.5,25,23,3,2,0,3.2,1.2,22,13,9,13,18,-5,"October, 2022"
2022-2023,14,2022-10-30,Arsenal,Nott'm Forest,5,0,H,3,0,3,0,2,2,2,1,2,20,28,9,18,19,October,-0.8660254037844386,0.5,0,32,4,0,1,1.4,0.6,25,11,14,8,23,-15,"October, 2022"
2022-2023,14,2022-10-30,Man United,West Ham,1,0,H,3,0,4,0,1,2,0,3,6,13,20,14,7,6,October,-0.8660254037844386,0.5,28,45,4,1,0,1.6,0.6,16,16,0,11,12,-1,"October, 2022"
2022-2023,15,2022-11-05,Everton,Leicester,0,2,A,0,3,2,2,1,1,2,2,13,18,14,11,5,3,November,-0.5000000000000004,0.8660254037844384,18,24,3,2,0,1.6,0.8,11,12,-1,21,25,-4,"November, 2022"
2022-2023,15,2022-11-05,Wolves,Brighton,2,3,A,0,3,1,1,3,2,1,2,19,8,10,18,11,8,November,-0.5000000000000004,0.8660254037844384,48,10,2,2,1,1.2,1.4,6,19,-13,19,15,4,"November, 2022"
2022-2023,15,2022-11-05,Man City,Fulham,2,1,H,3,0,3,1,1,2,1,2,2,7,29,19,5,10,November,-0.5000000000000004,0.8660254037844384,27,19,5,0,0,3.0,0.0,37,11,26,22,22,0,"November, 2022"
2022-2023,15,2022-11-05,Leeds,Bournemouth,4,3,H,3,0,0,1,4,1,0,4,15,14,12,13,1,1,November,-0.5000000000000004,0.8660254037844384,23,7,0,0,0,0.0,0.0,15,19,-4,12,28,-16,"November, 2022"
2022-2023,15,2022-11-05,Nott'm Forest,Brentford,2,2,D,1,1,2,2,1,4,0,1,20,11,9,15,9,6,November,-0.5000000000000004,0.8660254037844384,32,9,0,0,0,0.0,0.0,8,28,-20,19,22,-3,"November, 2022"
2022-2023,15,2022-11-06,Chelsea,Arsenal,0,1,A,0,3,1,2,2,3,0,2,7,2,21,31,5,10,November,-0.5000000000000004,0.8660254037844384,14,0,1,1,3,1.4,2.0,17,15,2,30,11,19,"November, 2022"
2022-2023,15,2022-11-06,Aston Villa,Man United,3,1,H,3,0,2,1,2,4,0,1,17,5,12,23,12,11,November,-0.5000000000000004,0.8660254037844384,1,28,1,1,3,1.0,2.0,11,20,-9,17,16,1,"November, 2022"
2022-2023,15,2022-11-06,Southampton,Newcastle,1,4,A,0,3,0,1,4,1,3,1,18,4,12,24,14,12,November,-0.5000000000000004,0.8660254037844384,38,30,1,1,3,1.4,1.6,11,20,-9,24,10,14,"November, 2022"
2022-2023,15,2022-11-06,West Ham,Crystal Palace,1,2,A,0,3,2,0,3,2,2,1,15,11,14,16,4,2,November,-0.5000000000000004,0.8660254037844384,45,16,2,2,1,2.0,1.8,11,13,-2,13,16,-3,"November, 2022"
2022-2023,15,2022-11-06,Tottenham,Liverpool,1,2,A,0,3,2,0,3,3,2,0,4,10,26,16,6,10,November,-0.5000000000000004,0.8660254037844384,42,25,0,2,3,1.0,1.8,26,16,10,23,15,8,"November, 2022"
2022-2023,16,2022-11-12,West Ham,Leicester,0,2,A,0,3,2,0,3,1,2,2,16,15,14,14,1,0,November,-0.5000000000000004,0.8660254037844384,45,24,3,1,1,2.6,1.8,12,15,-3,23,25,-2,"November, 2022"
2022-2023,16,2022-11-12,Wolves,Arsenal,0,2,A,0,3,1,1,3,3,0,2,20,1,10,34,19,24,November,-0.5000000000000004,0.8660254037844384,48,0,2,0,3,1.0,1.4,8,22,-14,31,11,20,"November, 2022"
2022-2023,16,2022-11-12,Newcastle,Chelsea,1,0,H,3,0,1,3,1,1,2,2,4,8,27,21,4,6,November,-0.5000000000000004,0.8660254037844384,30,14,1,0,4,0.2,1.6,28,11,17,17,16,1,"November, 2022"
2022-2023,16,2022-11-12,Tottenham,Leeds,4,3,H,3,0,2,0,3,0,1,4,4,13,26,15,9,11,November,-0.5000000000000004,0.8660254037844384,42,23,4,0,1,2.2,0.8,27,18,9,19,22,-3,"November, 2022"
2022-2023,16,2022-11-12,Liverpool,Southampton,3,1,H,3,0,3,2,0,0,1,4,8,18,19,12,10,7,November,-0.5000000000000004,0.8660254037844384,25,38,4,0,1,2.4,0.4,25,16,9,12,24,-12,"November, 2022"
2022-2023,16,2022-11-12,Bournemouth,Everton,3,0,H,3,0,1,0,4,2,2,1,17,16,13,14,1,1,November,-0.5000000000000004,0.8660254037844384,7,18,3,1,1,2.0,1.4,15,32,-17,11,14,-3,"November, 2022"
2022-2023,16,2022-11-12,Man City,Brentford,1,2,A,0,3,3,1,1,4,0,1,2,11,32,16,9,16,November,-0.5000000000000004,0.8660254037844384,27,9,2,0,0,1.5,0.0,39,12,27,21,24,-3,"November, 2022"
2022-2023,16,2022-11-12,Nott'm Forest,Crystal Palace,1,0,H,3,0,2,2,1,2,2,1,20,11,10,19,9,9,November,-0.5000000000000004,0.8660254037844384,32,16,0,0,0,0.0,0.0,10,30,-20,15,17,-2,"November, 2022"
2022-2023,16,2022-11-13,Brighton,Aston Villa,1,2,A,0,3,2,1,2,2,1,2,7,15,21,15,8,6,November,-0.5000000000000004,0.8660254037844384,10,1,1,2,2,0.6,1.2,22,17,5,14,21,-7,"November, 2022"
2022-2023,16,2022-11-13,Fulham,Man United,1,2,A,0,3,2,1,2,4,0,1,9,5,19,23,4,4,November,-0.5000000000000004,0.8660254037844384,19,28,0,2,3,1.0,2.4,23,24,-1,18,19,-1,"November, 2022"
2022-2023,17,2022-12-26,Southampton,Brighton,1,3,A,0,3,0,1,4,2,1,2,20,8,12,21,12,9,December,-2.4492935982947064e-16,1.0,38,10,1,3,1,1.4,1.4,13,27,-14,23,19,4,"December, 2022"
2022-2023,17,2022-12-26,Arsenal,West Ham,3,1,H,3,0,3,0,2,2,0,3,1,16,37,14,15,23,December,-2.4492935982947064e-16,1.0,0,45,4,1,0,2.0,1.0,33,11,22,12,17,-5,"December, 2022"
2022-2023,17,2022-12-26,Aston Villa,Liverpool,1,3,A,0,3,2,1,2,3,2,0,12,7,18,22,5,4,December,-2.4492935982947064e-16,1.0,1,25,1,0,4,1.8,1.8,16,22,-6,28,17,11,"December, 2022"
2022-2023,17,2022-12-26,Leicester,Newcastle,0,3,A,0,3,1,2,2,1,3,1,13,3,17,30,10,13,December,-2.4492935982947064e-16,1.0,24,30,3,0,2,2.4,1.4,25,25,0,29,11,18,"December, 2022"
2022-2023,17,2022-12-26,Everton,Wolves,1,2,A,0,3,2,2,1,1,1,3,17,20,14,10,3,4,December,-2.4492935982947064e-16,1.0,18,48,2,0,3,0.8,1.4,11,17,-6,8,24,-16,"December, 2022"
2022-2023,17,2022-12-26,Crystal Palace,Fulham,0,3,A,0,3,2,2,1,2,1,2,11,10,19,19,1,0,December,-2.4492935982947064e-16,1.0,16,19,3,2,0,1.6,0.6,15,18,-3,24,26,-2,"December, 2022"
2022-2023,17,2022-12-26,Brentford,Tottenham,2,2,D,1,1,4,0,1,2,0,3,10,4,19,29,6,10,December,-2.4492935982947064e-16,1.0,9,42,0,1,1,0.0,1.0,23,25,-2,31,21,10,"December, 2022"
2022-2023,17,2022-12-27,Chelsea,Bournemouth,2,0,H,3,0,1,2,2,1,0,4,9,14,21,16,5,5,December,-2.4492935982947064e-16,1.0,14,7,1,1,3,0.8,2.0,17,17,0,18,32,-14,"December, 2022"
2022-2023,17,2022-12-27,Man United,Nott'm Forest,3,0,H,3,0,4,0,1,2,2,1,5,19,26,13,14,13,December,-2.4492935982947064e-16,1.0,28,32,5,0,0,4.8,0.4,20,20,0,11,30,-19,"December, 2022"
2022-2023,17,2022-12-28,Leeds,Man City,1,3,A,0,3,0,1,4,3,1,1,15,3,15,32,12,17,December,-2.4492935982947064e-16,1.0,23,27,2,1,2,1.0,2.8,22,26,-4,40,14,26,"December, 2022"
2022-2023,18,2022-12-30,West Ham,Brentford,0,2,A,0,3,2,0,3,4,0,1,16,10,14,20,6,6,December,-2.4492935982947064e-16,1.0,45,9,0,0,2,0.5,2.0,13,20,-7,25,27,-2,"December, 2022"
2022-2023,18,2022-12-30,Liverpool,Leicester,2,1,H,3,0,3,2,0,1,2,2,6,13,25,17,7,8,December,-2.4492935982947064e-16,1.0,25,24,3,0,2,2.0,0.8,31,18,13,25,28,-3,"December, 2022"
2022-2023,18,2022-12-31,Newcastle,Leeds,0,0,D,1,1,1,3,1,0,1,4,3,15,33,15,12,18,December,-2.4492935982947064e-16,1.0,30,23,2,1,2,1.2,1.6,32,11,21,23,29,-6,"December, 2022"
2022-2023,18,2022-12-31,Brighton,Arsenal,2,4,A,0,3,2,1,2,3,0,2,8,1,24,40,7,16,December,-2.4492935982947064e-16,1.0,10,0,2,1,2,0.8,1.0,26,20,6,36,12,24,"December, 2022"
2022-2023,18,2022-12-31,Man City,Everton,1,1,D,1,1,3,1,1,2,2,1,2,16,35,14,14,21,December,-2.4492935982947064e-16,1.0,27,18,5,0,0,2.8,0.4,43,15,28,12,19,-7,"December, 2022"
2022-2023,18,2022-12-31,Bournemouth,Crystal Palace,0,2,A,0,3,1,0,4,2,2,1,14,11,16,19,3,3,December,-2.4492935982947064e-16,1.0,7,16,1,1,3,1.4,2.2,18,34,-16,15,21,-6,"December, 2022"
2022-2023,18,2022-12-31,Wolves,Man United,0,1,A,0,3,1,1,3,4,0,1,18,5,13,29,13,16,December,-2.4492935982947064e-16,1.0,48,28,1,1,3,0.4,0.8,10,25,-15,23,20,3,"December, 2022"
2022-2023,18,2022-12-31,Fulham,Southampton,2,1,H,3,0,2,1,2,0,1,4,10,20,22,12,10,10,December,-2.4492935982947064e-16,1.0,19,38,1,1,3,0.8,2.0,27,26,1,14,30,-16,"December, 2022"
2022-2023,18,2023-01-01,Tottenham,Aston Villa,0,2,A,0,3,2,0,3,2,1,2,5,12,30,18,7,12,January,0.4999999999999999,0.8660254037844387,42,1,4,0,1,2.4,1.0,33,23,10,17,25,-8,"January, 2023"
2022-2023,18,2023-01-01,Nott'm Forest,Chelsea,1,1,D,1,1,2,2,1,1,2,2,19,9,13,24,10,11,January,0.4999999999999999,0.8660254037844387,32,14,1,1,3,1.0,1.4,11,33,-22,19,17,2,"January, 2023"
2022-2023,19,2023-01-02,Brentford,Liverpool,3,1,H,3,0,4,0,1,3,2,0,10,6,23,28,4,5,January,0.4999999999999999,0.8660254037844387,9,25,0,1,1,1.5,3.0,27,27,0,33,19,14,"January, 2023"
2022-2023,19,2023-01-03,Arsenal,Newcastle,0,0,D,1,1,3,0,2,1,3,1,1,3,43,34,2,9,January,0.4999999999999999,0.8660254037844387,0,30,4,0,1,2.2,0.4,40,14,26,32,11,21,"January, 2023"
2022-2023,19,2023-01-03,Everton,Brighton,1,4,A,0,3,2,2,1,2,1,2,16,10,15,24,6,9,January,0.4999999999999999,0.8660254037844387,18,10,3,1,1,1.8,1.0,13,20,-7,28,24,4,"January, 2023"
2022-2023,19,2023-01-03,Leicester,Fulham,0,1,A,0,3,1,2,2,2,1,2,13,9,17,25,4,8,January,0.4999999999999999,0.8660254037844387,24,19,2,1,2,1.4,1.2,26,30,-4,29,27,2,"January, 2023"
2022-2023,19,2023-01-03,Man United,Bournemouth,3,0,H,3,0,4,0,1,1,0,4,4,15,32,16,11,16,January,0.4999999999999999,0.8660254037844387,28,7,4,0,1,2.6,1.0,24,20,4,18,36,-18,"January, 2023"
2022-2023,19,2023-01-04,Southampton,Nott'm Forest,0,1,A,0,3,0,1,4,2,2,1,20,18,12,14,2,2,January,0.4999999999999999,0.8660254037844387,38,32,1,2,2,1.4,1.4,15,32,-17,12,34,-22,"January, 2023"
2022-2023,19,2023-01-04,Leeds,West Ham,2,2,D,1,1,0,1,4,2,0,3,15,18,16,14,3,2,January,0.4999999999999999,0.8660254037844387,23,45,2,0,3,1.2,1.6,23,29,-6,13,22,-9,"January, 2023"
2022-2023,19,2023-01-04,Aston Villa,Wolves,1,1,D,1,1,2,1,2,1,1,3,12,19,21,13,7,8,January,0.4999999999999999,0.8660254037844387,1,48,1,1,3,0.8,1.2,19,25,-6,10,26,-16,"January, 2023"
2022-2023,19,2023-01-04,Crystal Palace,Tottenham,0,4,A,0,3,2,2,1,2,0,3,11,5,22,30,6,8,January,0.4999999999999999,0.8660254037844387,16,42,1,2,2,1.2,1.8,17,21,-4,33,25,8,"January, 2023"
2022-2023,19,2023-01-05,Chelsea,Man City,0,1,A,0,3,1,2,2,3,1,1,10,2,25,36,8,11,January,0.4999999999999999,0.8660254037844387,14,27,2,0,3,1.0,1.4,20,18,2,44,16,28,"January, 2023"
2022-2023,19,2023-01-12,Fulham,Chelsea,2,1,H,3,0,2,1,2,1,2,2,7,10,28,25,3,3,January,0.4999999999999999,0.8660254037844387,19,14,0,0,5,0.4,2.0,30,27,3,20,19,1,"January, 2023"
2022-2023,20,2023-01-13,Aston Villa,Leeds,2,1,H,3,0,2,1,2,0,1,4,11,14,22,17,3,5,January,0.4999999999999999,0.8660254037844387,1,23,2,2,1,1.4,1.2,20,26,-6,25,31,-6,"January, 2023"
2022-2023,20,2023-01-14,Wolves,West Ham,1,0,H,3,0,1,1,3,2,0,3,20,17,14,15,3,1,January,0.4999999999999999,0.8660254037844387,48,45,1,0,4,0.6,2.0,11,27,-16,15,24,-9,"January, 2023"
2022-2023,20,2023-01-14,Brentford,Bournemouth,2,0,H,3,0,4,0,1,1,0,4,9,17,26,16,8,10,January,0.4999999999999999,0.8660254037844387,9,7,0,1,0,0.0,0.0,30,28,2,18,39,-21,"January, 2023"
2022-2023,20,2023-01-14,Nott'm Forest,Leicester,2,0,H,3,0,2,2,1,1,2,2,15,13,17,17,2,0,January,0.4999999999999999,0.8660254037844387,32,24,1,2,2,0.8,1.8,13,34,-21,26,31,-5,"January, 2023"
2022-2023,20,2023-01-14,Everton,Southampton,1,2,A,0,3,2,2,1,0,1,4,18,20,15,12,2,3,January,0.4999999999999999,0.8660254037844387,18,38,3,0,2,1.2,1.2,14,24,-10,15,33,-18,"January, 2023"
2022-2023,20,2023-01-14,Brighton,Liverpool,3,0,H,3,0,2,1,2,3,2,0,8,7,27,28,1,1,January,0.4999999999999999,0.8660254037844387,10,25,1,3,1,1.4,1.6,32,25,7,34,22,12,"January, 2023"
2022-2023,20,2023-01-14,Man United,Man City,2,1,H,3,0,4,0,1,3,1,1,4,2,35,39,2,4,January,0.4999999999999999,0.8660254037844387,28,27,1,1,3,1.2,2.4,27,20,7,45,16,29,"January, 2023"
2022-2023,20,2023-01-15,Chelsea,Crystal Palace,1,0,H,3,0,1,2,2,2,2,1,10,12,25,22,2,3,January,0.4999999999999999,0.8660254037844387,14,16,5,0,0,2.8,0.4,21,21,0,17,25,-8,"January, 2023"
2022-2023,20,2023-01-15,Newcastle,Fulham,1,0,H,3,0,1,3,1,2,1,2,4,6,35,31,2,4,January,0.4999999999999999,0.8660254037844387,30,19,3,2,0,2.2,0.4,32,11,21,32,28,4,"January, 2023"
2022-2023,20,2023-01-15,Tottenham,Arsenal,0,2,A,0,3,2,0,3,3,0,2,5,1,33,44,4,11,January,0.4999999999999999,0.8660254037844387,42,0,2,0,3,1.6,1.6,37,25,12,40,14,26,"January, 2023"
2022-2023,20,2023-01-18,Crystal Palace,Man United,1,1,D,1,1,2,2,1,4,0,1,12,4,22,38,8,16,January,0.4999999999999999,0.8660254037844387,16,28,2,1,2,0.8,0.8,17,26,-9,29,21,8,"January, 2023"
2022-2023,20,2023-01-19,Man City,Tottenham,4,2,H,3,0,3,1,1,2,0,3,2,5,39,33,3,6,January,0.4999999999999999,0.8660254037844387,27,42,1,0,4,1.0,1.6,46,18,28,37,27,10,"January, 2023"
2022-2023,21,2023-01-21,Crystal Palace,Newcastle,0,0,D,1,1,2,2,1,1,3,1,12,4,23,38,8,15,January,0.4999999999999999,0.8660254037844387,16,30,1,2,2,0.6,1.0,18,27,-9,33,11,22,"January, 2023"
2022-2023,21,2023-01-21,West Ham,Everton,2,0,H,3,0,2,0,3,2,2,1,18,19,15,15,1,0,January,0.4999999999999999,0.8660254037844387,45,18,3,0,2,0.8,0.6,15,25,-10,15,26,-11,"January, 2023"
2022-2023,21,2023-01-21,Southampton,Aston Villa,0,1,A,0,3,0,1,4,2,1,2,20,11,15,25,9,10,January,0.4999999999999999,0.8660254037844387,38,1,2,0,3,1.0,1.8,17,34,-17,22,27,-5,"January, 2023"
2022-2023,21,2023-01-21,Bournemouth,Nott'm Forest,1,1,D,1,1,1,0,4,2,2,1,17,13,16,20,4,4,January,0.4999999999999999,0.8660254037844387,7,32,1,0,0,3.0,2.0,18,41,-23,15,34,-19,"January, 2023"
2022-2023,21,2023-01-21,Liverpool,Chelsea,0,0,D,1,1,3,2,0,1,2,2,9,10,28,28,1,0,January,0.4999999999999999,0.8660254037844387,25,14,2,2,1,2.0,1.4,34,25,9,22,21,1,"January, 2023"
2022-2023,21,2023-01-21,Leicester,Brighton,2,2,D,1,1,1,2,2,2,1,2,15,7,17,30,8,13,January,0.4999999999999999,0.8660254037844387,24,10,2,1,2,1.8,1.8,26,33,-7,35,25,10,"January, 2023"
2022-2023,21,2023-01-22,Leeds,Brentford,0,0,D,1,1,0,1,4,4,0,1,16,9,17,29,7,12,January,0.4999999999999999,0.8660254037844387,23,9,1,1,1,2.0,2.6666666666666665,26,33,-7,32,28,4,"January, 2023"
2022-2023,21,2023-01-22,Man City,Wolves,3,0,H,3,0,3,1,1,1,1,3,2,17,42,17,15,25,January,0.4999999999999999,0.8660254037844387,27,48,5,0,0,3.2,0.6,50,20,30,12,27,-15,"January, 2023"
2022-2023,21,2023-01-22,Arsenal,Man United,3,2,H,3,0,3,0,2,4,0,1,1,4,47,39,3,8,January,0.4999999999999999,0.8660254037844387,0,28,2,1,2,1.4,1.4,42,14,28,30,22,8,"January, 2023"
2022-2023,21,2023-01-23,Fulham,Tottenham,0,1,A,0,3,2,1,2,2,0,3,7,5,31,33,2,2,January,0.4999999999999999,0.8660254037844387,19,42,0,1,4,0.8,1.8,32,29,3,39,31,8,"January, 2023"
2022-2023,22,2023-02-03,Chelsea,Fulham,0,0,D,1,1,1,2,2,2,1,2,10,7,29,31,3,2,February,0.8660254037844386,0.5000000000000001,14,19,4,0,1,1.6,0.6,22,21,1,32,30,2,"February, 2023"
2022-2023,22,2023-02-04,Wolves,Liverpool,3,0,H,3,0,1,1,3,3,2,0,18,10,17,29,8,12,February,0.8660254037844386,0.5000000000000001,48,25,0,0,5,0.4,2.2,12,30,-18,34,25,9,"February, 2023"
2022-2023,22,2023-02-04,Newcastle,West Ham,1,1,D,1,1,1,3,1,2,0,3,4,17,39,18,13,21,February,0.8660254037844386,0.5000000000000001,30,45,2,2,1,2.0,1.8,33,11,22,17,25,-8,"February, 2023"
2022-2023,22,2023-02-04,Man United,Crystal Palace,2,1,H,3,0,4,0,1,2,2,1,4,12,39,24,8,15,February,0.8660254037844386,0.5000000000000001,28,16,1,2,2,0.6,1.0,32,25,7,18,27,-9,"February, 2023"
2022-2023,22,2023-02-04,Brentford,Southampton,3,0,H,3,0,4,0,1,0,1,4,8,20,30,15,12,15,February,0.8660254037844386,0.5000000000000001,9,38,1,0,1,2.0,2.0,32,28,4,17,35,-18,"February, 2023"
2022-2023,22,2023-02-04,Aston Villa,Leicester,2,4,A,0,3,2,1,2,1,2,2,11,14,28,18,3,10,February,0.8660254037844386,0.5000000000000001,1,24,2,1,2,0.8,1.4,23,27,-4,28,35,-7,"February, 2023"
2022-2023,22,2023-02-04,Everton,Arsenal,1,0,H,3,0,2,2,1,3,0,2,19,1,15,50,18,35,February,0.8660254037844386,0.5000000000000001,18,0,3,0,2,1.6,2.0,15,28,-13,45,16,29,"February, 2023"
2022-2023,22,2023-02-04,Brighton,Bournemouth,1,0,H,3,0,2,1,2,1,0,4,8,19,31,17,11,14,February,0.8660254037844386,0.5000000000000001,10,7,1,1,3,1.0,2.4,37,27,10,19,42,-23,"February, 2023"
2022-2023,22,2023-02-05,Nott'm Forest,Leeds,1,0,H,3,0,2,2,1,0,1,4,14,17,21,18,3,3,February,0.8660254037844386,0.5000000000000001,32,23,1,2,2,1.2,1.6,16,35,-19,26,33,-7,"February, 2023"
2022-2023,22,2023-02-05,Tottenham,Man City,1,0,H,3,0,2,0,3,3,1,1,5,2,36,45,3,9,February,0.8660254037844386,0.5000000000000001,42,27,3,0,2,1.6,1.8,40,31,9,53,20,33,"February, 2023"
2022-2023,22,2023-02-08,Man United,Leeds,2,2,D,1,1,4,0,1,0,1,4,3,17,42,18,14,24,February,0.8660254037844386,0.5000000000000001,28,23,3,2,0,3.2,1.2,34,26,8,26,34,-8,"February, 2023"
2022-2023,23,2023-02-11,Leicester,Tottenham,4,1,H,3,0,1,2,2,2,0,3,14,5,21,39,9,18,February,0.8660254037844386,0.5000000000000001,24,42,1,0,4,1.8,3.2,32,37,-5,41,31,10,"February, 2023"
2022-2023,23,2023-02-11,Bournemouth,Newcastle,1,1,D,1,1,1,0,4,1,3,1,19,4,17,40,15,23,February,0.8660254037844386,0.5000000000000001,7,30,0,2,3,1.2,2.2,19,43,-24,34,12,22,"February, 2023"
2022-2023,23,2023-02-11,Southampton,Wolves,1,2,A,0,3,0,1,4,1,1,3,20,16,15,20,4,5,February,0.8660254037844386,0.5000000000000001,38,48,0,1,4,0.6,1.6,17,38,-21,15,30,-15,"February, 2023"
2022-2023,23,2023-02-11,Crystal Palace,Brighton,1,1,D,1,1,2,2,1,2,1,2,12,6,24,34,6,10,February,0.8660254037844386,0.5000000000000001,16,10,2,3,0,1.2,0.8,19,29,-10,38,27,11,"February, 2023"
2022-2023,23,2023-02-11,Arsenal,Brentford,1,1,D,1,1,3,0,2,4,0,1,1,7,50,33,6,17,February,0.8660254037844386,0.5000000000000001,0,9,2,0,1,1.6666666666666667,1.0,45,17,28,35,28,7,"February, 2023"
2022-2023,23,2023-02-11,West Ham,Chelsea,1,1,D,1,1,2,0,3,1,2,2,17,9,19,30,8,11,February,0.8660254037844386,0.5000000000000001,45,14,1,0,4,0.8,1.8,18,26,-8,22,21,1,"February, 2023"
2022-2023,23,2023-02-11,Fulham,Nott'm Forest,2,0,H,3,0,2,1,2,2,2,1,8,13,32,24,5,8,February,0.8660254037844386,0.5000000000000001,19,32,1,0,0,3.0,2.0,32,30,2,17,35,-18,"February, 2023"
2022-2023,23,2023-02-12,Leeds,Man United,0,2,A,0,3,0,1,4,4,0,1,17,3,19,43,14,24,February,0.8660254037844386,0.5000000000000001,23,28,0,2,3,1.4,3.4,28,36,-8,36,28,8,"February, 2023"
2022-2023,23,2023-02-12,Man City,Aston Villa,3,1,H,3,0,3,1,1,2,1,2,3,11,45,28,8,17,February,0.8660254037844386,0.5000000000000001,27,1,4,1,0,2.0,1.0,53,21,32,25,31,-6,"February, 2023"
2022-2023,23,2023-02-13,Liverpool,Everton,2,0,H,3,0,3,2,0,2,2,1,10,18,29,18,8,11,February,0.8660254037844386,0.5000000000000001,25,18,2,2,1,1.6,1.0,34,28,6,16,28,-12,"February, 2023"
2022-2023,23,2023-02-15,Arsenal,Man City,1,3,A,0,3,3,0,2,3,1,1,1,2,51,48,1,3,February,0.8660254037844386,0.5000000000000001,0,27,0,0,5,0.2,2.4,46,18,28,56,22,34,"February, 2023"
2022-2023,24,2023-02-18,Wolves,Bournemouth,0,1,A,0,3,1,1,3,1,0,4,15,20,23,18,5,5,February,0.8660254037844386,0.5000000000000001,48,7,3,2,0,1.2,0.4,17,31,-14,20,44,-24,"February, 2023"
2022-2023,24,2023-02-18,Brighton,Fulham,0,1,A,0,3,2,1,2,2,1,2,6,8,35,35,2,0,February,0.8660254037844386,0.5000000000000001,10,19,0,3,2,1.0,1.6,39,28,11,34,30,4,"February, 2023"
2022-2023,24,2023-02-18,Newcastle,Liverpool,0,2,A,0,3,1,3,1,3,2,0,4,9,41,32,5,9,February,0.8660254037844386,0.5000000000000001,30,25,0,2,3,0.6,1.4,35,13,22,36,28,8,"February, 2023"
2022-2023,24,2023-02-18,Nott'm Forest,Man City,1,1,D,1,1,2,2,1,3,1,1,14,2,24,51,12,27,February,0.8660254037844386,0.5000000000000001,32,27,1,1,1,1.3333333333333333,2.333333333333333,17,37,-20,59,23,36,"February, 2023"
2022-2023,24,2023-02-18,Brentford,Crystal Palace,1,1,D,1,1,4,0,1,2,2,1,8,12,34,25,4,9,February,0.8660254037844386,0.5000000000000001,9,16,0,3,0,0.3333333333333333,0.3333333333333333,36,29,7,20,30,-10,"February, 2023"
2022-2023,24,2023-02-18,Chelsea,Southampton,0,1,A,0,3,1,2,2,0,1,4,10,20,31,15,10,16,February,0.8660254037844386,0.5000000000000001,14,38,2,2,1,2.8,1.4,23,22,1,18,40,-22,"February, 2023"
2022-2023,24,2023-02-18,Aston Villa,Arsenal,2,4,A,0,3,2,1,2,3,0,2,11,2,28,51,9,23,February,0.8660254037844386,0.5000000000000001,1,0,2,0,3,1.2,1.2,26,34,-8,47,21,26,"February, 2023"
2022-2023,24,2023-02-18,Everton,Leeds,1,0,H,3,0,2,2,1,0,1,4,18,17,18,19,1,1,February,0.8660254037844386,0.5000000000000001,18,23,2,2,1,1.6,1.0,16,30,-14,28,38,-10,"February, 2023"
2022-2023,24,2023-02-19,Man United,Leicester,3,0,H,3,0,4,0,1,1,2,2,3,14,46,24,11,22,February,0.8660254037844386,0.5000000000000001,28,24,1,2,2,1.4,1.8,38,28,10,36,38,-2,"February, 2023"
2022-2023,24,2023-02-19,Tottenham,West Ham,2,0,H,3,0,2,0,3,2,0,3,5,18,39,20,13,19,February,0.8660254037844386,0.5000000000000001,42,45,1,2,2,1.6,1.6,42,35,7,19,27,-8,"February, 2023"
2022-2023,25,2023-02-24,Fulham,Wolves,1,1,D,1,1,2,1,2,1,1,3,6,15,38,23,9,15,February,0.8660254037844386,0.5000000000000001,19,48,0,2,3,0.2,0.8,35,30,5,17,32,-15,"February, 2023"
2022-2023,25,2023-02-25,Everton,Aston Villa,0,2,A,0,3,2,2,1,2,1,2,16,11,21,28,5,7,February,0.8660254037844386,0.5000000000000001,18,1,0,1,4,0.4,1.6,17,30,-13,28,38,-10,"February, 2023"
2022-2023,25,2023-02-25,Leeds,Southampton,1,0,H,3,0,0,1,4,0,1,4,19,20,19,18,1,1,February,0.8660254037844386,0.5000000000000001,23,38,2,2,1,1.6,0.8,28,39,-11,19,40,-21,"February, 2023"
2022-2023,25,2023-02-25,Leicester,Arsenal,0,1,A,0,3,1,2,2,3,0,2,14,1,24,54,13,30,February,0.8660254037844386,0.5000000000000001,24,0,1,0,4,0.8,2.2,36,41,-5,51,23,28,"February, 2023"
2022-2023,25,2023-02-25,West Ham,Nott'm Forest,4,0,H,3,0,2,0,3,2,2,1,19,13,20,25,6,5,February,0.8660254037844386,0.5000000000000001,45,32,2,1,2,0.8,0.6,19,29,-10,18,38,-20,"February, 2023"
2022-2023,25,2023-02-25,Bournemouth,Man City,1,4,A,0,3,1,0,4,3,1,1,19,2,21,52,17,31,February,0.8660254037844386,0.5000000000000001,7,27,0,0,5,0.6,2.6,21,44,-23,60,24,36,"February, 2023"
2022-2023,25,2023-02-25,Crystal Palace,Liverpool,0,0,D,1,1,2,2,1,3,2,0,12,8,26,35,4,9,February,0.8660254037844386,0.5000000000000001,16,25,0,1,4,0.4,3.2,21,31,-10,38,28,10,"February, 2023"
2022-2023,25,2023-02-26,Tottenham,Chelsea,2,0,H,3,0,2,0,3,1,2,2,4,10,42,31,6,11,February,0.8660254037844386,0.5000000000000001,42,14,0,2,3,0.4,1.6,44,35,9,23,23,0,"February, 2023"
2022-2023,25,2023-03-01,Arsenal,Everton,4,0,H,3,0,3,0,2,2,2,1,1,18,57,21,17,36,March,1.0,6.123233995736766e-17,0,18,1,0,4,1.4,1.4,52,23,29,17,32,-15,"March, 2023"
2022-2023,25,2023-03-01,Liverpool,Wolves,2,0,H,3,0,3,2,0,1,1,3,7,15,36,24,8,12,March,1.0,6.123233995736766e-17,25,48,4,0,1,1.8,0.8,38,28,10,18,33,-15,"March, 2023"
2022-2023,26,2023-03-04,Chelsea,Leeds,1,0,H,3,0,1,2,2,0,1,4,11,17,31,22,6,9,March,1.0,6.123233995736766e-17,14,23,3,1,1,1.8,1.2,23,25,-2,29,39,-10,"March, 2023"
2022-2023,26,2023-03-04,Wolves,Tottenham,1,0,H,3,0,1,1,3,2,0,3,15,4,24,45,11,21,March,1.0,6.123233995736766e-17,48,42,1,1,3,0.6,1.0,18,35,-17,46,35,11,"March, 2023"
2022-2023,26,2023-03-04,Brighton,West Ham,4,0,H,3,0,2,1,2,2,0,3,8,16,35,23,8,12,March,1.0,6.123233995736766e-17,10,45,2,3,0,1.8,1.0,39,29,10,23,29,-6,"March, 2023"
2022-2023,26,2023-03-04,Southampton,Leicester,1,0,H,3,0,0,1,4,1,2,2,20,15,18,24,5,6,March,1.0,6.123233995736766e-17,38,24,1,2,2,1.2,2.0,19,41,-22,36,42,-6,"March, 2023"
2022-2023,26,2023-03-04,Arsenal,Bournemouth,3,2,H,3,0,3,0,2,1,0,4,1,19,60,21,18,39,March,1.0,6.123233995736766e-17,0,7,4,1,0,2.4,0.6,56,23,33,22,48,-26,"March, 2023"
2022-2023,26,2023-03-04,Man City,Newcastle,2,0,H,3,0,3,1,1,1,3,1,2,5,55,41,3,14,March,1.0,6.123233995736766e-17,27,30,4,1,0,3.6,1.2,64,25,39,35,15,20,"March, 2023"
2022-2023,26,2023-03-04,Aston Villa,Crystal Palace,1,0,H,3,0,2,1,2,2,2,1,11,12,31,27,1,4,March,1.0,6.123233995736766e-17,1,16,2,1,2,1.8,1.6,30,38,-8,21,31,-10,"March, 2023"
2022-2023,26,2023-03-05,Liverpool,Man United,7,0,H,3,0,3,2,0,4,0,1,6,3,39,49,3,10,March,1.0,6.123233995736766e-17,25,28,3,1,1,2.8,0.8,40,28,12,41,28,13,"March, 2023"
2022-2023,26,2023-03-05,Nott'm Forest,Everton,2,2,D,1,1,2,2,1,2,2,1,14,18,25,21,4,4,March,1.0,6.123233995736766e-17,32,18,1,1,3,0.4,1.2,18,42,-24,17,36,-19,"March, 2023"
2022-2023,26,2023-03-06,Brentford,Fulham,3,2,H,3,0,4,0,1,2,1,2,9,7,35,39,2,4,March,1.0,6.123233995736766e-17,9,19,0,0,1,2.0,3.0,37,30,7,36,31,5,"March, 2023"
2022-2023,27,2023-03-11,Bournemouth,Liverpool,1,0,H,3,0,1,0,4,3,2,0,20,5,21,42,15,21,March,1.0,6.123233995736766e-17,7,25,0,0,5,0.2,4.2,24,51,-27,47,28,19,"March, 2023"
2022-2023,27,2023-03-11,Everton,Brentford,1,0,H,3,0,2,2,1,4,0,1,19,9,22,38,10,16,March,1.0,6.123233995736766e-17,18,9,0,1,2,1.0,1.6666666666666667,19,38,-19,40,32,8,"March, 2023"
2022-2023,27,2023-03-11,Leeds,Brighton,2,2,D,1,1,0,1,4,2,1,2,19,8,22,38,11,16,March,1.0,6.123233995736766e-17,23,10,0,2,3,0.2,1.0,29,40,-11,43,29,14,"March, 2023"
2022-2023,27,2023-03-11,Leicester,Chelsea,1,3,A,0,3,1,2,2,1,2,2,16,10,24,34,6,10,March,1.0,6.123233995736766e-17,24,14,1,1,3,1.0,1.6,36,43,-7,24,25,-1,"March, 2023"
2022-2023,27,2023-03-11,Tottenham,Nott'm Forest,3,1,H,3,0,2,0,3,2,2,1,4,14,45,26,10,19,March,1.0,6.123233995736766e-17,42,32,3,0,2,1.2,0.6,46,36,10,20,44,-24,"March, 2023"
2022-2023,27,2023-03-11,Crystal Palace,Man City,0,1,A,0,3,2,2,1,3,1,1,12,2,27,58,10,31,March,1.0,6.123233995736766e-17,16,27,1,1,3,0.8,2.0,21,32,-11,66,25,41,"March, 2023"
2022-2023,27,2023-03-12,Fulham,Arsenal,0,3,A,0,3,2,1,2,3,0,2,8,1,39,63,7,24,March,1.0,6.123233995736766e-17,19,0,0,1,4,0.8,3.0,38,34,4,59,25,34,"March, 2023"
2022-2023,27,2023-03-12,Man United,Southampton,0,0,D,1,1,4,0,1,0,1,4,3,20,49,21,17,28,March,1.0,6.123233995736766e-17,28,38,3,2,0,3.0,0.8,41,35,6,20,41,-21,"March, 2023"
2022-2023,27,2023-03-12,West Ham,Aston Villa,1,1,D,1,1,2,0,3,2,1,2,18,11,23,34,7,11,March,1.0,6.123233995736766e-17,45,1,5,0,0,2.4,0.8,23,33,-10,31,38,-7,"March, 2023"
2022-2023,27,2023-03-12,Newcastle,Wolves,2,1,H,3,0,1,3,1,1,1,3,6,13,41,27,7,14,March,1.0,6.123233995736766e-17,30,48,1,3,1,1.0,1.0,35,17,18,19,35,-16,"March, 2023"
2022-2023,27,2023-03-15,Southampton,Brentford,0,2,A,0,3,0,1,4,4,0,1,20,9,22,38,11,16,March,1.0,6.123233995736766e-17,38,9,1,0,2,1.3333333333333333,2.333333333333333,20,41,-21,40,33,7,"March, 2023"
2022-2023,27,2023-03-15,Brighton,Crystal Palace,1,0,H,3,0,2,1,2,2,2,1,7,12,39,27,5,12,March,1.0,6.123233995736766e-17,10,16,0,4,1,1.0,1.2,45,31,14,21,33,-12,"March, 2023"
2022-2023,28,2023-03-17,Nott'm Forest,Newcastle,1,2,A,0,3,2,2,1,1,3,1,14,5,26,44,9,18,March,1.0,6.123233995736766e-17,32,30,0,1,4,0.2,2.2,21,47,-26,37,18,19,"March, 2023"
2022-2023,28,2023-03-18,Aston Villa,Bournemouth,3,0,H,3,0,2,1,2,1,0,4,11,18,35,24,7,11,March,1.0,6.123233995736766e-17,1,7,1,0,4,0.8,1.6,32,39,-7,25,51,-26,"March, 2023"
2022-2023,28,2023-03-18,Brentford,Leicester,1,1,D,1,1,4,0,1,1,2,2,8,16,41,24,8,17,March,1.0,6.123233995736766e-17,9,24,0,1,2,1.3333333333333333,2.0,42,33,9,37,46,-9,"March, 2023"
2022-2023,28,2023-03-18,Southampton,Tottenham,3,3,D,1,1,0,1,4,2,0,3,20,4,22,48,16,26,March,1.0,6.123233995736766e-17,38,42,1,1,3,1.6,2.8,20,43,-23,49,37,12,"March, 2023"
2022-2023,28,2023-03-18,Wolves,Leeds,2,4,A,0,3,1,1,3,0,1,4,13,19,27,23,6,4,March,1.0,6.123233995736766e-17,48,23,2,1,2,1.2,1.2,20,37,-17,31,42,-11,"March, 2023"
2022-2023,28,2023-03-18,Chelsea,Everton,2,2,D,1,1,1,2,2,2,2,1,11,17,37,25,6,12,March,1.0,6.123233995736766e-17,14,18,2,1,2,0.8,0.6,27,26,1,20,38,-18,"March, 2023"
2022-2023,28,2023-03-19,Arsenal,Crystal Palace,4,1,H,3,0,3,0,2,2,2,1,1,12,66,27,11,39,March,1.0,6.123233995736766e-17,0,16,2,2,1,1.4,1.2,62,25,37,21,34,-13,"March, 2023"
2022-2023,29,2023-04-01,Chelsea,Aston Villa,0,2,A,0,3,1,2,2,2,1,2,10,11,38,38,1,0,April,0.8660254037844388,-0.4999999999999998,14,1,3,1,1,2.0,0.8,29,28,1,35,39,-4,"April, 2023"
2022-2023,29,2023-04-01,Nott'm Forest,Wolves,1,1,D,1,1,2,2,1,1,1,3,17,13,26,27,4,1,April,0.8660254037844388,-0.4999999999999998,32,48,0,0,1,0.0,1.0,22,49,-27,22,41,-19,"April, 2023"
2022-2023,29,2023-04-01,Crystal Palace,Leicester,2,1,H,3,0,2,2,1,1,2,2,12,18,27,25,6,2,April,0.8660254037844388,-0.4999999999999998,16,24,0,3,2,1.0,1.4,22,38,-16,38,47,-9,"April, 2023"
2022-2023,29,2023-04-01,Bournemouth,Fulham,2,1,H,3,0,1,0,4,2,1,2,19,9,24,39,10,15,April,0.8660254037844388,-0.4999999999999998,7,19,1,1,1,1.6666666666666667,1.0,25,54,-29,38,37,1,"April, 2023"
2022-2023,29,2023-04-01,Arsenal,Leeds,4,1,H,3,0,3,0,2,0,1,4,1,14,69,26,13,43,April,0.8660254037844388,-0.4999999999999998,0,23,4,1,0,2.2,0.8,66,26,40,35,44,-9,"April, 2023"
2022-2023,29,2023-04-01,Man City,Liverpool,4,1,H,3,0,3,1,1,3,2,0,2,6,61,42,4,19,April,0.8660254037844388,-0.4999999999999998,27,25,1,3,1,1.8,1.4,67,25,42,47,29,18,"April, 2023"
2022-2023,29,2023-04-01,Brighton,Brentford,3,3,D,1,1,2,1,2,4,0,1,7,8,42,42,1,0,April,0.8660254037844388,-0.4999999999999998,10,9,2,0,1,1.0,0.6666666666666666,46,31,15,43,34,9,"April, 2023"
2022-2023,29,2023-04-02,West Ham,Southampton,1,0,H,3,0,2,0,3,0,1,4,19,20,24,23,1,1,April,0.8660254037844388,-0.4999999999999998,45,38,1,3,1,1.2,0.8,24,34,-10,23,46,-23,"April, 2023"
2022-2023,29,2023-04-02,Newcastle,Man United,2,0,H,3,0,1,3,1,4,0,1,5,3,47,50,2,3,April,0.8660254037844388,-0.4999999999999998,30,28,0,2,3,0.8,2.4,39,19,20,41,35,6,"April, 2023"
2022-2023,29,2023-04-03,Everton,Tottenham,1,1,D,1,1,2,2,1,2,0,3,18,5,26,49,13,23,April,0.8660254037844388,-0.4999999999999998,18,42,1,2,2,0.6,1.8,22,40,-18,52,40,12,"April, 2023"
2022-2023,29,2023-04-04,Bournemouth,Brighton,0,2,A,0,3,1,0,4,2,1,2,17,6,27,43,11,16,April,0.8660254037844388,-0.4999999999999998,7,10,3,0,2,2.0,0.8,27,55,-28,49,34,15,"April, 2023"
2022-2023,29,2023-04-04,Leeds,Nott'm Forest,2,1,H,3,0,0,1,4,2,2,1,18,16,26,27,2,1,April,0.8660254037844388,-0.4999999999999998,23,32,2,2,1,1.4,0.8,36,48,-12,23,50,-27,"April, 2023"
2022-2023,29,2023-04-04,Leicester,Aston Villa,1,2,A,0,3,1,2,2,2,1,2,19,9,25,41,10,16,April,0.8660254037844388,-0.4999999999999998,24,1,2,1,2,1.4,1.2,39,49,-10,37,39,-2,"April, 2023"
2022-2023,29,2023-04-04,Chelsea,Liverpool,0,0,D,1,1,1,2,2,3,2,0,11,9,38,42,2,4,April,0.8660254037844388,-0.4999999999999998,14,25,1,3,1,0.8,1.0,29,30,-1,48,33,15,"April, 2023"
2022-2023,29,2023-04-05,Man United,Brentford,1,0,H,3,0,4,0,1,4,0,1,5,9,50,43,4,7,April,0.8660254037844388,-0.4999999999999998,28,9,2,0,1,2.0,1.6666666666666667,41,37,4,46,37,9,"April, 2023"
2022-2023,29,2023-04-05,West Ham,Newcastle,1,5,A,0,3,2,0,3,1,3,1,15,4,27,50,11,23,April,0.8660254037844388,-0.4999999999999998,45,30,1,2,2,1.6,1.8,25,34,-9,41,19,22,"April, 2023"
2022-2023,30,2023-04-08,Wolves,Chelsea,1,0,H,3,0,1,1,3,1,2,2,16,11,28,39,5,11,April,0.8660254037844388,-0.4999999999999998,48,14,1,3,1,0.8,1.2,23,42,-19,29,30,-1,"April, 2023"
2022-2023,30,2023-04-08,Tottenham,Brighton,2,1,H,3,0,2,0,3,2,1,2,5,7,50,46,2,4,April,0.8660254037844388,-0.4999999999999998,42,10,3,0,2,1.0,0.6,53,41,12,51,34,17,"April, 2023"
2022-2023,30,2023-04-08,Leicester,Bournemouth,0,1,A,0,3,1,2,2,1,0,4,19,17,25,27,2,2,April,0.8660254037844388,-0.4999999999999998,24,7,2,0,3,1.8,2.2,40,51,-11,27,57,-30,"April, 2023"
2022-2023,30,2023-04-08,Southampton,Man City,1,4,A,0,3,0,1,4,3,1,1,20,2,23,64,18,41,April,0.8660254037844388,-0.4999999999999998,38,27,0,2,3,0.6,2.2,23,47,-24,71,26,45,"April, 2023"
2022-2023,30,2023-04-08,Brentford,Newcastle,1,2,A,0,3,4,0,1,1,3,1,9,4,43,53,5,10,April,0.8660254037844388,-0.4999999999999998,9,30,0,1,2,1.3333333333333333,3.333333333333333,46,38,8,46,20,26,"April, 2023"
2022-2023,30,2023-04-08,Aston Villa,Nott'm Forest,2,0,H,3,0,2,1,2,2,2,1,7,17,44,27,10,17,April,0.8660254037844388,-0.4999999999999998,1,32,2,3,0,1.4,0.6,39,40,-1,24,52,-28,"April, 2023"
2022-2023,30,2023-04-08,Man United,Everton,2,0,H,3,0,4,0,1,2,2,1,4,16,53,27,12,26,April,0.8660254037844388,-0.4999999999999998,28,18,2,2,1,1.8,1.4,42,37,5,23,41,-18,"April, 2023"
2022-2023,30,2023-04-08,Fulham,West Ham,0,1,A,0,3,2,1,2,2,0,3,10,15,39,27,5,12,April,0.8660254037844388,-0.4999999999999998,19,45,0,1,4,0.4,1.8,39,39,0,26,39,-13,"April, 2023"
2022-2023,30,2023-04-09,Liverpool,Arsenal,2,2,D,1,1,3,2,0,3,0,2,8,1,43,72,7,29,April,0.8660254037844388,-0.4999999999999998,25,0,4,0,1,2.8,0.8,48,33,15,70,27,43,"April, 2023"
2022-2023,30,2023-04-09,Leeds,Crystal Palace,1,5,A,0,3,0,1,4,2,2,1,16,14,29,30,2,1,April,0.8660254037844388,-0.4999999999999998,23,16,2,1,2,1.0,1.2,38,49,-11,24,39,-15,"April, 2023"
2022-2023,31,2023-04-15,Aston Villa,Newcastle,3,0,H,3,0,2,1,2,1,3,1,6,3,47,56,3,9,April,0.8660254037844388,-0.4999999999999998,1,30,2,1,2,1.0,1.2,41,40,1,48,21,27,"April, 2023"
2022-2023,31,2023-04-15,Chelsea,Brighton,1,2,A,0,3,1,2,2,2,1,2,11,7,39,46,4,7,April,0.8660254037844388,-0.4999999999999998,14,10,1,3,1,1.2,1.4,29,31,-2,52,36,16,"April, 2023"
2022-2023,31,2023-04-15,Everton,Fulham,1,3,A,0,3,2,2,1,2,1,2,17,10,27,39,7,12,April,0.8660254037844388,-0.4999999999999998,18,19,2,1,2,1.2,1.2,23,43,-20,39,40,-1,"April, 2023"
2022-2023,31,2023-04-15,Southampton,Crystal Palace,0,2,A,0,3,0,1,4,2,2,1,20,12,23,33,8,10,April,0.8660254037844388,-0.4999999999999998,38,16,1,1,3,1.2,1.4,24,51,-27,29,40,-11,"April, 2023"
2022-2023,31,2023-04-15,Tottenham,Bournemouth,2,3,A,0,3,2,0,3,1,0,4,5,15,53,30,10,23,April,0.8660254037844388,-0.4999999999999998,42,7,3,1,1,2.2,1.0,55,42,13,28,57,-29,"April, 2023"
2022-2023,31,2023-04-15,Wolves,Brentford,2,0,H,3,0,1,1,3,4,0,1,14,9,31,43,5,12,April,0.8660254037844388,-0.4999999999999998,48,9,1,1,1,1.0,1.3333333333333333,24,42,-18,47,40,7,"April, 2023"
2022-2023,31,2023-04-15,Man City,Leicester,3,1,H,3,0,3,1,1,1,2,2,2,19,67,25,17,42,April,0.8660254037844388,-0.4999999999999998,27,24,4,0,1,2.4,1.6,75,27,48,40,52,-12,"April, 2023"
2022-2023,31,2023-04-16,West Ham,Arsenal,2,2,D,1,1,2,0,3,3,0,2,15,1,30,73,14,43,April,0.8660254037844388,-0.4999999999999998,45,0,0,1,4,1.2,2.4,27,39,-12,72,29,43,"April, 2023"
2022-2023,31,2023-04-16,Nott'm Forest,Man United,0,2,A,0,3,2,2,1,4,0,1,18,4,27,56,14,29,April,0.8660254037844388,-0.4999999999999998,32,28,0,0,5,0.4,4.4,24,54,-30,44,37,7,"April, 2023"
2022-2023,31,2023-04-17,Leeds,Liverpool,1,6,A,0,3,0,1,4,3,2,0,16,8,29,44,8,15,April,0.8660254037844388,-0.4999999999999998,23,25,1,1,3,1.2,3.0,39,54,-15,50,35,15,"April, 2023"
2022-2023,32,2023-04-21,Arsenal,Southampton,3,3,D,1,1,3,0,2,0,1,4,1,20,74,23,19,51,April,0.8660254037844388,-0.4999999999999998,0,38,2,2,1,1.6,0.8,74,31,43,24,53,-29,"April, 2023"
2022-2023,32,2023-04-22,Liverpool,Nott'm Forest,3,2,H,3,0,3,2,0,2,2,1,8,19,47,27,11,20,April,0.8660254037844388,-0.4999999999999998,25,32,2,2,1,2.4,1.4,56,36,20,24,56,-32,"April, 2023"
2022-2023,32,2023-04-22,Leicester,Wolves,2,1,H,3,0,1,2,2,1,1,3,19,13,25,34,6,9,April,0.8660254037844388,-0.4999999999999998,24,48,3,1,1,1.4,0.4,41,55,-14,26,42,-16,"April, 2023"
2022-2023,32,2023-04-22,Fulham,Leeds,2,1,H,3,0,2,1,2,0,1,4,10,16,42,29,6,13,April,0.8660254037844388,-0.4999999999999998,19,23,2,0,3,2.2,2.2,42,41,1,40,60,-20,"April, 2023"
2022-2023,32,2023-04-22,Brentford,Aston Villa,1,1,D,1,1,4,0,1,2,1,2,10,6,43,50,4,7,April,0.8660254037844388,-0.4999999999999998,9,1,1,1,1,1.0,2.0,47,42,5,44,40,4,"April, 2023"
2022-2023,32,2023-04-22,Crystal Palace,Everton,0,0,D,1,1,2,2,1,2,2,1,12,17,36,27,5,9,April,0.8660254037844388,-0.4999999999999998,16,18,1,1,3,1.4,2.0,31,40,-9,24,46,-22,"April, 2023"
2022-2023,32,2023-04-23,Bournemouth,West Ham,0,4,A,0,3,1,0,4,2,0,3,14,15,33,31,1,2,April,0.8660254037844388,-0.4999999999999998,7,45,2,1,2,1.2,1.8,31,59,-28,29,41,-12,"April, 2023"
2022-2023,32,2023-04-23,Newcastle,Tottenham,6,1,H,3,0,1,3,1,2,0,3,4,5,56,53,1,3,April,0.8660254037844388,-0.4999999999999998,30,42,1,2,2,1.6,2.4,48,24,24,57,45,12,"April, 2023"
2022-2023,33,2023-04-25,Wolves,Crystal Palace,2,0,H,3,0,1,1,3,2,2,1,14,12,34,37,2,3,April,0.8660254037844388,-0.4999999999999998,48,16,1,0,4,0.6,1.4,27,44,-17,31,40,-9,"April, 2023"
2022-2023,33,2023-04-25,Aston Villa,Fulham,1,0,H,3,0,2,1,2,2,1,2,6,9,51,45,3,6,April,0.8660254037844388,-0.4999999999999998,1,19,2,0,3,1.4,1.6,45,41,4,44,42,2,"April, 2023"
2022-2023,33,2023-04-25,Leeds,Leicester,1,1,D,1,1,0,1,4,1,2,2,16,17,29,28,1,1,April,0.8660254037844388,-0.4999999999999998,23,24,1,1,3,1.0,1.8,41,62,-21,43,56,-13,"April, 2023"
2022-2023,33,2023-04-26,Man City,Arsenal,4,1,H,3,0,3,1,1,3,0,2,2,1,70,75,1,5,April,0.8660254037844388,-0.4999999999999998,27,0,5,0,0,2.4,0.4,78,28,50,77,34,43,"April, 2023"
2022-2023,33,2023-04-26,West Ham,Liverpool,1,2,A,0,3,2,0,3,3,2,0,14,7,34,50,7,16,April,0.8660254037844388,-0.4999999999999998,45,25,1,0,4,1.0,1.8,33,41,-8,59,38,21,"April, 2023"
2022-2023,33,2023-04-26,Nott'm Forest,Brighton,3,1,H,3,0,2,2,1,2,1,2,19,8,27,49,11,22,April,0.8660254037844388,-0.4999999999999998,32,10,0,1,0,0.0,0.0,26,59,-33,54,37,17,"April, 2023"
2022-2023,33,2023-04-26,Chelsea,Brentford,0,2,A,0,3,1,2,2,4,0,1,11,10,39,44,1,5,April,0.8660254037844388,-0.4999999999999998,14,9,1,1,1,0.6666666666666666,1.3333333333333333,30,33,-3,48,43,5,"April, 2023"
2022-2023,33,2023-04-27,Everton,Newcastle,1,4,A,0,3,2,2,1,1,3,1,19,3,28,59,16,31,April,0.8660254037844388,-0.4999999999999998,18,30,1,0,4,0.6,1.6,24,46,-22,54,25,29,"April, 2023"
2022-2023,33,2023-04-27,Southampton,Bournemouth,0,1,A,0,3,0,1,4,1,0,4,20,15,24,33,5,9,April,0.8660254037844388,-0.4999999999999998,38,7,2,2,1,1.4,1.2,27,56,-29,31,63,-32,"April, 2023"
2022-2023,33,2023-04-27,Tottenham,Man United,2,2,D,1,1,2,0,3,4,0,1,7,4,53,59,3,6,April,0.8660254037844388,-0.4999999999999998,42,28,1,0,4,1.8,2.4,58,51,7,46,37,9,"April, 2023"
2022-2023,34,2023-04-29,Crystal Palace,West Ham,4,3,H,3,0,2,2,1,2,0,3,12,15,37,34,3,3,April,0.8660254037844388,-0.4999999999999998,16,45,1,2,2,1.8,2.0,31,42,-11,34,43,-9,"April, 2023"
2022-2023,34,2023-04-29,Brentford,Nott'm Forest,2,1,H,3,0,4,0,1,2,2,1,9,17,47,30,8,17,April,0.8660254037844388,-0.4999999999999998,9,32,0,1,0,2.0,2.0,50,43,7,29,60,-31,"April, 2023"
2022-2023,34,2023-04-29,Brighton,Wolves,6,0,H,3,0,2,1,2,1,1,3,9,13,49,37,4,12,April,0.8660254037844388,-0.4999999999999998,10,48,2,1,2,2.0,1.6,55,40,15,29,44,-15,"April, 2023"
2022-2023,34,2023-04-30,Man United,Aston Villa,1,0,H,3,0,4,0,1,2,1,2,4,6,60,54,2,6,April,0.8660254037844388,-0.4999999999999998,28,1,2,1,2,1.6,1.6,48,39,9,46,41,5,"April, 2023"
2022-2023,34,2023-04-30,Liverpool,Tottenham,4,3,H,3,0,3,2,0,2,0,3,7,5,53,54,2,1,April,0.8660254037844388,-0.4999999999999998,25,42,3,2,0,2.0,1.2,61,39,22,60,53,7,"April, 2023"
2022-2023,34,2023-04-30,Newcastle,Southampton,3,1,H,3,0,1,3,1,0,1,4,4,20,62,24,16,38,April,0.8660254037844388,-0.4999999999999998,30,38,3,1,1,2.2,1.6,58,26,32,27,57,-30,"April, 2023"
2022-2023,34,2023-04-30,Fulham,Man City,1,2,A,0,3,2,1,2,3,1,1,10,2,45,73,8,28,April,0.8660254037844388,-0.4999999999999998,19,27,0,0,5,0.2,2.4,44,43,1,82,29,53,"April, 2023"
2022-2023,34,2023-04-30,Bournemouth,Leeds,4,1,H,3,0,1,0,4,0,1,4,14,16,36,30,2,6,April,0.8660254037844388,-0.4999999999999998,7,23,0,0,1,3.0,4.0,32,63,-31,42,63,-21,"April, 2023"
2022-2023,34,2023-05-01,Leicester,Everton,2,2,D,1,1,1,2,2,2,2,1,18,19,29,28,1,1,May,0.4999999999999999,-0.8660254037844387,24,18,1,2,2,1.0,1.2,44,57,-13,25,50,-25,"May, 2023"
2022-2023,34,2023-05-02,Arsenal,Chelsea,3,1,H,3,0,3,0,2,1,2,2,2,12,75,39,10,36,May,0.4999999999999999,-0.8660254037844387,0,14,4,0,1,1.8,1.0,78,38,40,30,35,-5,"May, 2023"
2022-2023,34,2023-05-03,Liverpool,Fulham,1,0,H,3,0,3,2,0,2,1,2,5,10,56,45,5,11,May,0.4999999999999999,-0.8660254037844387,25,19,2,2,1,1.4,1.0,65,42,23,45,45,0,"May, 2023"
2022-2023,34,2023-05-03,Man City,West Ham,3,0,H,3,0,3,1,1,2,0,3,2,15,76,34,13,42,May,0.4999999999999999,-0.8660254037844387,27,45,3,2,0,1.8,1.0,84,30,54,37,47,-10,"May, 2023"
2022-2023,34,2023-05-04,Brighton,Man United,1,0,H,3,0,2,1,2,4,0,1,8,4,52,63,4,11,May,0.4999999999999999,-0.8660254037844387,10,28,2,0,3,1.8,1.6,61,40,21,49,39,10,"May, 2023"
2022-2023,35,2023-05-06,Liverpool,Brentford,1,0,H,3,0,3,2,0,4,0,1,5,9,59,50,4,9,May,0.4999999999999999,-0.8660254037844387,25,9,1,1,1,2.333333333333333,2.0,66,42,24,52,44,8,"May, 2023"
2022-2023,35,2023-05-06,Wolves,Aston Villa,1,0,H,3,0,1,1,3,2,1,2,14,8,37,54,6,17,May,0.4999999999999999,-0.8660254037844387,48,1,2,2,1,1.2,1.0,29,50,-21,46,42,4,"May, 2023"
2022-2023,35,2023-05-06,Man City,Leeds,2,1,H,3,0,3,1,1,0,1,4,1,17,79,30,16,49,May,0.4999999999999999,-0.8660254037844387,27,23,3,1,1,3.2,0.8,87,30,57,43,67,-24,"May, 2023"
2022-2023,35,2023-05-06,Tottenham,Crystal Palace,1,0,H,3,0,2,0,3,2,2,1,7,12,54,40,5,14,May,0.4999999999999999,-0.8660254037844387,42,16,3,1,1,2.4,1.0,63,57,6,35,45,-10,"May, 2023"
2022-2023,35,2023-05-06,Bournemouth,Chelsea,1,3,A,0,3,1,0,4,1,2,2,13,12,39,39,1,0,May,0.4999999999999999,-0.8660254037844387,7,14,2,1,2,1.4,1.2,36,64,-28,31,38,-7,"May, 2023"
2022-2023,35,2023-05-07,Newcastle,Arsenal,0,2,A,0,3,1,3,1,3,0,2,3,2,65,78,1,13,May,0.4999999999999999,-0.8660254037844387,30,0,1,1,3,0.4,1.4,61,27,34,81,39,42,"May, 2023"
2022-2023,35,2023-05-07,West Ham,Man United,1,0,H,3,0,2,0,3,4,0,1,15,4,34,63,11,29,May,0.4999999999999999,-0.8660254037844387,45,28,0,0,5,0.4,1.6,37,50,-13,49,40,9,"May, 2023"
2022-2023,35,2023-05-08,Fulham,Leicester,5,3,H,3,0,2,1,2,1,2,2,10,16,45,30,6,15,May,0.4999999999999999,-0.8660254037844387,19,24,2,1,2,1.0,1.4,45,46,-1,46,59,-13,"May, 2023"
2022-2023,35,2023-05-08,Brighton,Everton,1,5,A,0,3,2,1,2,2,2,1,7,19,55,29,12,26,May,0.4999999999999999,-0.8660254037844387,10,18,2,1,2,1.8,1.8,62,40,22,27,52,-25,"May, 2023"
2022-2023,35,2023-05-08,Nott'm Forest,Southampton,4,3,H,3,0,2,2,1,0,1,4,19,20,30,24,1,6,May,0.4999999999999999,-0.8660254037844387,32,38,2,2,1,1.4,1.4,30,62,-32,28,60,-32,"May, 2023"
2022-2023,36,2023-05-13,Southampton,Fulham,0,2,A,0,3,0,1,4,2,1,2,20,10,24,48,10,24,May,0.4999999999999999,-0.8660254037844387,38,19,2,1,2,1.6,1.2,31,64,-33,50,49,1,"May, 2023"
2022-2023,36,2023-05-13,Man United,Wolves,2,0,H,3,0,4,0,1,1,1,3,4,13,63,40,9,23,May,0.4999999999999999,-0.8660254037844387,28,48,4,0,1,1.0,0.4,49,41,8,30,50,-20,"May, 2023"
2022-2023,36,2023-05-13,Crystal Palace,Bournemouth,2,0,H,3,0,2,2,1,1,0,4,12,14,40,39,2,1,May,0.4999999999999999,-0.8660254037844387,16,7,4,0,1,2.2,1.0,35,46,-11,37,67,-30,"May, 2023"
2022-2023,36,2023-05-13,Chelsea,Nott'm Forest,2,2,D,1,1,1,2,2,2,2,1,11,16,42,33,5,9,May,0.4999999999999999,-0.8660254037844387,14,32,2,2,1,1.4,1.2,34,39,-5,34,65,-31,"May, 2023"
2022-2023,36,2023-05-13,Aston Villa,Tottenham,2,1,H,3,0,2,1,2,2,0,3,8,6,54,57,2,3,May,0.4999999999999999,-0.8660254037844387,1,42,2,0,3,1.0,1.8,46,43,3,64,57,7,"May, 2023"
2022-2023,36,2023-05-13,Leeds,Newcastle,2,2,D,1,1,0,1,4,1,3,1,19,3,30,65,16,35,May,0.4999999999999999,-0.8660254037844387,23,30,2,2,1,1.6,1.0,44,69,-25,61,29,32,"May, 2023"
2022-2023,36,2023-05-14,Brentford,West Ham,2,0,H,3,0,4,0,1,2,0,3,10,15,50,37,5,13,May,0.4999999999999999,-0.8660254037844387,9,45,3,0,0,2.0,0.3333333333333333,52,45,7,38,50,-12,"May, 2023"
2022-2023,36,2023-05-14,Everton,Man City,0,3,A,0,3,2,2,1,3,1,1,17,1,32,82,16,50,May,0.4999999999999999,-0.8660254037844387,18,27,0,1,4,0.4,2.6,32,53,-21,89,31,58,"May, 2023"
2022-2023,36,2023-05-14,Arsenal,Brighton,0,3,A,0,3,3,0,2,2,1,2,2,8,81,55,6,26,May,0.4999999999999999,-0.8660254037844387,0,10,3,1,1,1.6,0.8,83,39,44,63,45,18,"May, 2023"
2022-2023,36,2023-05-15,Leicester,Liverpool,0,3,A,0,3,1,2,2,3,2,0,19,5,30,62,14,32,May,0.4999999999999999,-0.8660254037844387,24,25,2,0,3,1.0,1.6,49,64,-15,67,42,25,"May, 2023"
2022-2023,36,2023-05-18,Newcastle,Brighton,4,1,H,3,0,1,3,1,2,1,2,3,6,66,58,3,8,May,0.4999999999999999,-0.8660254037844387,30,10,1,2,2,0.6,1.6,63,31,32,66,45,21,"May, 2023"
2022-2023,37,2023-05-20,Nott'm Forest,Arsenal,1,0,H,3,0,2,2,1,3,0,2,16,2,34,81,14,47,May,0.4999999999999999,-0.8660254037844387,32,0,1,0,4,0.6,2.2,36,67,-31,83,42,41,"May, 2023"
2022-2023,37,2023-05-20,Wolves,Everton,1,1,D,1,1,1,1,3,2,2,1,13,17,40,32,4,8,May,0.4999999999999999,-0.8660254037844387,48,18,3,0,2,1.2,1.0,30,52,-22,32,56,-24,"May, 2023"
2022-2023,37,2023-05-20,Liverpool,Aston Villa,1,1,D,1,1,3,2,0,2,1,2,5,8,65,57,3,8,May,0.4999999999999999,-0.8660254037844387,25,1,4,0,1,2.0,2.0,70,42,28,48,44,4,"May, 2023"
2022-2023,37,2023-05-20,Bournemouth,Man United,0,1,A,0,3,1,0,4,4,0,1,14,4,39,66,10,27,May,0.4999999999999999,-0.8660254037844387,7,28,1,0,4,1.0,2.8,37,69,-32,51,41,10,"May, 2023"
2022-2023,37,2023-05-20,Tottenham,Brentford,1,3,A,0,3,2,0,3,4,0,1,7,9,57,53,2,4,May,0.4999999999999999,-0.8660254037844387,42,9,1,2,0,1.3333333333333333,0.6666666666666666,65,59,6,54,45,9,"May, 2023"
2022-2023,37,2023-05-20,Fulham,Crystal Palace,2,2,D,1,1,2,1,2,2,2,1,10,12,51,43,2,8,May,0.4999999999999999,-0.8660254037844387,19,16,1,1,3,0.8,1.2,52,49,3,37,46,-9,"May, 2023"
2022-2023,37,2023-05-21,West Ham,Leeds,3,1,H,3,0,2,0,3,0,1,4,15,18,37,31,3,6,May,0.4999999999999999,-0.8660254037844387,45,23,3,1,1,2.0,1.4,38,52,-14,46,71,-25,"May, 2023"
2022-2023,37,2023-05-21,Brighton,Southampton,3,1,H,3,0,2,1,2,0,1,4,6,20,58,24,14,34,May,0.4999999999999999,-0.8660254037844387,10,38,2,2,1,1.8,1.4,67,49,18,31,66,-35,"May, 2023"
2022-2023,37,2023-05-21,Man City,Chelsea,1,0,H,3,0,3,1,1,1,2,2,1,12,85,43,11,42,May,0.4999999999999999,-0.8660254037844387,27,14,4,0,1,1.4,0.6,92,31,61,36,41,-5,"May, 2023"
2022-2023,37,2023-05-22,Newcastle,Leicester,0,0,D,1,1,1,3,1,1,2,2,3,19,69,30,16,39,May,0.4999999999999999,-0.8660254037844387,30,24,3,0,2,2.0,1.8,67,32,35,49,67,-18,"May, 2023"
2022-2023,37,2023-05-24,Brighton,Man City,1,1,D,1,1,2,1,2,3,1,1,6,1,61,88,5,27,May,0.4999999999999999,-0.8660254037844387,10,27,1,0,4,1.0,2.6,70,50,20,93,31,62,"May, 2023"
2022-2023,37,2023-05-25,Man United,Chelsea,4,1,H,3,0,4,0,1,1,2,2,4,12,69,43,8,26,May,0.4999999999999999,-0.8660254037844387,28,14,0,5,0,0.6,0.6,52,41,11,36,42,-6,"May, 2023"
2022-2023,38,2023-05-28,Brentford,Man City,1,0,H,3,0,4,0,1,3,1,1,9,1,56,89,8,33,May,0.4999999999999999,-0.8660254037844387,9,27,1,0,2,0.6666666666666666,1.3333333333333333,57,46,11,94,32,62,"May, 2023"
2022-2023,38,2023-05-28,Leicester,West Ham,2,1,H,3,0,1,2,2,2,0,3,18,14,31,40,4,9,May,0.4999999999999999,-0.8660254037844387,24,45,1,1,3,1.4,2.4,49,67,-18,41,53,-12,"May, 2023"
2022-2023,38,2023-05-28,Leeds,Tottenham,1,4,A,0,3,0,1,4,2,0,3,19,9,31,57,10,26,May,0.4999999999999999,-0.8660254037844387,23,42,1,0,4,1.4,2.8,47,74,-27,66,62,4,"May, 2023"
2022-2023,38,2023-05-28,Everton,Bournemouth,1,0,H,3,0,2,2,1,1,0,4,17,15,33,39,2,6,May,0.4999999999999999,-0.8660254037844387,18,7,1,1,3,1.2,2.2,33,57,-24,37,70,-33,"May, 2023"
2022-2023,38,2023-05-28,Arsenal,Wolves,5,0,H,3,0,3,0,2,1,1,3,2,13,81,41,11,40,May,0.4999999999999999,-0.8660254037844387,0,48,3,0,2,1.4,1.0,83,43,40,31,53,-22,"May, 2023"
2022-2023,38,2023-05-28,Chelsea,Newcastle,1,1,D,1,1,1,2,2,1,3,1,12,4,43,70,8,27,May,0.4999999999999999,-0.8660254037844387,14,30,4,0,1,1.6,0.2,37,46,-9,67,32,35,"May, 2023"
2022-2023,38,2023-05-28,Aston Villa,Brighton,2,1,H,3,0,2,1,2,2,1,2,7,6,58,62,1,4,May,0.4999999999999999,-0.8660254037844387,1,10,3,1,1,1.4,0.6,49,45,4,71,51,20,"May, 2023"
2022-2023,38,2023-05-28,Man United,Fulham,2,1,H,3,0,4,0,1,2,1,2,3,10,72,52,7,20,May,0.4999999999999999,-0.8660254037844387,28,19,4,1,0,2.4,0.8,56,42,14,54,51,3,"May, 2023"
2022-2023,38,2023-05-28,Crystal Palace,Nott'm Forest,1,1,D,1,1,2,2,1,2,2,1,11,16,44,37,5,7,May,0.4999999999999999,-0.8660254037844387,16,32,0,0,1,0.0,1.0,39,48,-9,37,67,-30,"May, 2023"
2022-2023,38,2023-05-28,Southampton,Liverpool,4,4,D,1,1,0,1,4,3,2,0,20,5,24,66,15,42,May,0.4999999999999999,-0.8660254037844387,38,25,1,0,4,0.6,2.2,32,69,-37,71,43,28,"May, 2023"
2023-2024,1,2023-08-11,Burnley,Man City,0,3,A,0,3,1,1,3,5,0,0,6,13,0,0,7,0,August,-0.8660254037844384,-0.5000000000000004,11,27,0,0,5,0.0,3.2,0,0,0,0,0,0,"August, 2023"
2023-2024,1,2023-08-12,Sheffield United,Crystal Palace,0,1,A,0,3,0,0,5,4,1,0,14,10,0,0,4,0,August,-0.8660254037844384,-0.5000000000000004,36,16,2,0,2,0.5,1.0,0,0,0,0,0,0,"August, 2023"
2023-2024,1,2023-08-12,Newcastle,Aston Villa,5,1,H,3,0,3,1,1,1,2,2,13,8,0,0,5,0,August,-0.8660254037844384,-0.5000000000000004,30,1,2,1,2,1.2,1.2,0,0,0,0,0,0,"August, 2023"
2023-2024,1,2023-08-12,Everton,Fulham,0,1,A,0,3,3,1,1,1,2,2,10,11,0,0,1,0,August,-0.8660254037844384,-0.5000000000000004,18,19,1,1,3,0.8,1.8,0,0,0,0,0,0,"August, 2023"
2023-2024,1,2023-08-12,Brighton,Luton,4,1,H,3,0,1,1,3,0,1,4,7,13,0,0,6,0,August,-0.8660254037844384,-0.5000000000000004,10,26,0,0,0,0.0,0.0,0,0,0,0,0,0,"August, 2023"
2023-2024,1,2023-08-12,Arsenal,Nott'm Forest,2,1,H,3,0,5,0,0,2,0,3,2,15,0,0,13,0,August,-0.8660254037844384,-0.5000000000000004,0,32,4,0,1,2.0,0.4,0,0,0,0,0,0,"August, 2023"
2023-2024,1,2023-08-12,Bournemouth,West Ham,1,1,D,1,1,2,0,3,1,1,3,4,17,0,0,13,0,August,-0.8660254037844384,-0.5000000000000004,7,45,1,1,3,0.8,2.4,0,0,0,0,0,0,"August, 2023"
2023-2024,1,2023-08-13,Brentford,Tottenham,2,2,D,1,1,2,1,2,2,0,3,9,13,0,0,4,0,August,-0.8660254037844384,-0.5000000000000004,9,42,1,2,1,1.25,1.25,0,0,0,0,0,0,"August, 2023"
2023-2024,1,2023-08-13,Chelsea,Liverpool,1,1,D,1,1,5,0,0,2,2,1,11,12,0,0,1,0,August,-0.8660254037844384,-0.5000000000000004,14,25,1,4,0,0.8,0.6,0,0,0,0,0,0,"August, 2023"
2023-2024,1,2023-08-14,Man United,Wolves,1,0,H,3,0,2,1,2,1,0,4,13,14,0,0,1,0,August,-0.8660254037844384,-0.5000000000000004,28,48,4,0,1,1.2,0.4,0,0,0,0,0,0,"August, 2023"
2023-2024,2,2023-08-18,Nott'm Forest,Sheffield United,2,1,H,3,0,2,0,3,0,0,5,14,16,0,0,2,0,August,-0.8660254037844384,-0.5000000000000004,32,36,0,0,0,0.0,0.0,1,2,-1,0,1,-1,"August, 2023"
2023-2024,2,2023-08-19,Fulham,Brentford,0,3,A,0,3,1,2,2,2,1,2,6,9,3,1,3,2,August,-0.8660254037844384,-0.5000000000000004,19,9,1,0,1,2.5,2.5,1,0,1,2,2,0,"August, 2023"
2023-2024,2,2023-08-19,Liverpool,Bournemouth,3,1,H,3,0,2,2,1,2,0,3,13,11,1,1,2,0,August,-0.8660254037844384,-0.5000000000000004,25,7,4,0,1,3.4,0.4,1,1,0,1,1,0,"August, 2023"
2023-2024,2,2023-08-19,Tottenham,Man United,2,0,H,3,0,2,0,3,2,1,2,11,8,1,3,3,2,August,-0.8660254037844384,-0.5000000000000004,42,28,0,1,4,1.0,2.6,2,2,0,1,0,1,"August, 2023"
2023-2024,2,2023-08-19,Man City,Newcastle,1,0,H,3,0,5,0,0,3,1,1,6,5,3,3,1,0,August,-0.8660254037844384,-0.5000000000000004,27,30,4,1,0,3.6,1.2,3,0,3,5,1,4,"August, 2023"
2023-2024,2,2023-08-19,Wolves,Brighton,1,4,A,0,3,1,0,4,1,1,3,16,4,0,3,12,3,August,-0.8660254037844384,-0.5000000000000004,48,10,2,0,3,1.0,2.6,0,1,-1,4,1,3,"August, 2023"
2023-2024,2,2023-08-20,Aston Villa,Everton,4,0,H,3,0,1,2,2,3,1,1,19,15,0,0,4,0,August,-0.8660254037844384,-0.5000000000000004,1,18,4,1,0,1.6,0.2,1,5,-4,0,1,-1,"August, 2023"
2023-2024,2,2023-08-20,West Ham,Chelsea,3,1,H,3,0,1,1,3,5,0,0,14,13,1,1,1,0,August,-0.8660254037844384,-0.5000000000000004,45,14,1,1,3,1.0,1.4,1,1,0,1,1,0,"August, 2023"
2023-2024,2,2023-08-21,Crystal Palace,Arsenal,0,1,A,0,3,4,1,0,5,0,0,9,8,3,3,1,0,August,-0.8660254037844384,-0.5000000000000004,16,0,1,1,3,1.4,2.2,1,0,1,2,1,1,"August, 2023"
2023-2024,3,2023-08-25,Chelsea,Luton,3,0,H,3,0,5,0,0,0,1,4,15,17,1,0,2,1,August,-0.8660254037844384,-0.5000000000000004,14,26,0,0,0,0.0,0.0,2,4,-2,1,4,-3,"August, 2023"
2023-2024,3,2023-08-26,Man United,Nott'm Forest,3,2,H,3,0,2,1,2,2,0,3,14,13,3,3,1,0,August,-0.8660254037844384,-0.5000000000000004,28,32,5,0,0,4.0,0.2,1,2,-1,3,3,0,"August, 2023"
2023-2024,3,2023-08-26,Brighton,West Ham,1,3,A,0,3,1,1,3,1,1,3,3,8,6,4,5,2,August,-0.8660254037844384,-0.5000000000000004,10,45,3,2,0,2.2,0.6,8,2,6,4,2,2,"August, 2023"
2023-2024,3,2023-08-26,Everton,Wolves,0,1,A,0,3,3,1,1,1,0,4,19,18,0,0,1,0,August,-0.8660254037844384,-0.5000000000000004,18,48,1,1,3,0.8,1.2,0,5,-5,1,5,-4,"August, 2023"
2023-2024,3,2023-08-26,Arsenal,Fulham,2,2,D,1,1,5,0,0,1,2,2,4,14,6,3,10,3,August,-0.8660254037844384,-0.5000000000000004,0,19,4,1,0,2.6,0.6,3,1,2,1,3,-2,"August, 2023"
2023-2024,3,2023-08-26,Bournemouth,Tottenham,0,2,A,0,3,2,0,3,2,0,3,15,6,1,4,9,3,August,-0.8660254037844384,-0.5000000000000004,7,42,2,1,2,1.6,1.6,2,4,-2,4,2,2,"August, 2023"
2023-2024,3,2023-08-26,Brentford,Crystal Palace,1,1,D,1,1,2,1,2,4,1,0,5,13,4,3,8,1,August,-0.8660254037844384,-0.5000000000000004,9,16,0,4,0,0.5,0.5,5,2,3,1,1,0,"August, 2023"
2023-2024,3,2023-08-27,Burnley,Aston Villa,1,3,A,0,3,1,1,3,1,2,2,18,13,0,3,5,3,August,-0.8660254037844384,-0.5000000000000004,11,1,1,2,2,1.2,1.6,0,3,-3,5,5,0,"August, 2023"
2023-2024,3,2023-08-27,Sheffield United,Man City,1,2,A,0,3,0,0,5,5,0,0,17,5,0,6,12,6,August,-0.8660254037844384,-0.5000000000000004,36,27,0,0,5,0.0,1.2,1,3,-2,4,0,4,"August, 2023"
2023-2024,3,2023-08-27,Newcastle,Liverpool,1,2,A,0,3,3,1,1,2,2,1,13,9,3,4,4,1,August,-0.8660254037844384,-0.5000000000000004,30,25,0,1,4,0.6,1.8,5,2,3,4,2,2,"August, 2023"
2023-2024,4,2023-09-01,Luton,West Ham,1,2,A,0,3,0,1,4,1,1,3,19,2,0,7,17,7,September,-1.0,-1.8369701987210287e-16,26,45,0,0,0,0.0,0.0,1,7,-6,7,3,4,"September, 2023"
2023-2024,4,2023-09-02,Brighton,Newcastle,3,1,H,3,0,1,1,3,3,1,1,6,14,6,3,8,3,September,-1.0,-1.8369701987210287e-16,10,30,1,2,2,1.2,1.4,9,5,4,6,4,2,"September, 2023"
2023-2024,4,2023-09-02,Man City,Fulham,5,1,H,3,0,5,0,0,1,2,2,3,13,9,4,10,5,September,-1.0,-1.8369701987210287e-16,27,19,5,0,0,2.2,0.4,6,1,5,3,5,-2,"September, 2023"
2023-2024,4,2023-09-02,Chelsea,Nott'm Forest,0,1,A,0,3,5,0,0,2,0,3,10,14,4,3,4,1,September,-1.0,-1.8369701987210287e-16,14,32,2,2,1,1.6,1.4,5,4,1,5,6,-1,"September, 2023"
2023-2024,4,2023-09-02,Burnley,Tottenham,2,5,A,0,3,1,1,3,2,0,3,19,3,0,7,16,7,September,-1.0,-1.8369701987210287e-16,11,42,1,1,3,0.4,1.4,1,6,-5,6,2,4,"September, 2023"
2023-2024,4,2023-09-02,Sheffield United,Everton,2,2,D,1,1,0,0,5,3,1,1,17,19,0,0,2,0,September,-1.0,-1.8369701987210287e-16,36,18,2,1,2,0.8,0.6,2,5,-3,0,6,-6,"September, 2023"
2023-2024,4,2023-09-02,Brentford,Bournemouth,2,2,D,1,1,2,1,2,2,0,3,9,17,5,1,8,4,September,-1.0,-1.8369701987210287e-16,9,7,1,1,0,1.0,0.0,6,3,3,2,6,-4,"September, 2023"
2023-2024,4,2023-09-03,Crystal Palace,Wolves,3,2,H,3,0,4,1,0,1,0,4,12,15,4,3,3,1,September,-1.0,-1.8369701987210287e-16,16,48,4,0,1,1.4,0.6,2,2,0,2,5,-3,"September, 2023"
2023-2024,4,2023-09-03,Liverpool,Aston Villa,3,0,H,3,0,2,2,1,1,2,2,5,9,7,6,4,1,September,-1.0,-1.8369701987210287e-16,25,1,4,1,0,1.8,0.8,6,3,3,8,6,2,"September, 2023"
2023-2024,4,2023-09-03,Arsenal,Man United,3,1,H,3,0,5,0,0,2,1,2,6,10,7,6,4,1,September,-1.0,-1.8369701987210287e-16,0,28,2,1,2,1.8,1.8,5,3,2,4,4,0,"September, 2023"
2023-2024,5,2023-09-16,Tottenham,Sheffield United,2,1,H,3,0,2,0,3,0,0,5,4,17,10,1,13,9,September,-1.0,-1.8369701987210287e-16,42,36,2,1,2,2.0,1.4,11,4,7,4,7,-3,"September, 2023"
2023-2024,5,2023-09-16,West Ham,Man City,1,3,A,0,3,1,1,3,5,0,0,5,3,10,12,2,2,September,-1.0,-1.8369701987210287e-16,45,27,0,1,4,0.8,2.2,9,4,5,11,2,9,"September, 2023"
2023-2024,5,2023-09-16,Man United,Brighton,1,3,A,0,3,2,1,2,1,1,3,12,6,6,9,6,3,September,-1.0,-1.8369701987210287e-16,28,10,2,0,3,1.0,1.6,5,7,-2,12,6,6,"September, 2023"
2023-2024,5,2023-09-16,Newcastle,Brentford,1,0,H,3,0,3,1,1,2,1,2,14,10,3,6,4,3,September,-1.0,-1.8369701987210287e-16,30,9,3,1,0,3.0,1.25,7,7,0,8,5,3,"September, 2023"
2023-2024,5,2023-09-16,Aston Villa,Crystal Palace,3,1,H,3,0,1,2,2,4,1,0,10,7,6,7,3,1,September,-1.0,-1.8369701987210287e-16,1,16,2,1,2,1.4,1.6,8,9,-1,5,4,1,"September, 2023"
2023-2024,5,2023-09-16,Wolves,Liverpool,1,3,A,0,3,1,0,4,2,2,1,15,3,3,10,12,7,September,-1.0,-1.8369701987210287e-16,48,25,1,0,4,0.8,1.4,4,8,-4,9,3,6,"September, 2023"
2023-2024,5,2023-09-16,Fulham,Luton,1,0,H,3,0,1,2,2,0,1,4,13,19,4,0,6,4,September,-1.0,-1.8369701987210287e-16,19,26,0,0,0,0.0,0.0,4,10,-6,2,9,-7,"September, 2023"
2023-2024,5,2023-09-17,Everton,Arsenal,0,1,A,0,3,3,1,1,5,0,0,18,5,1,10,13,9,September,-1.0,-1.8369701987210287e-16,18,0,3,0,2,1.0,2.0,2,8,-6,8,4,4,"September, 2023"
2023-2024,5,2023-09-17,Bournemouth,Chelsea,0,0,D,1,1,2,0,3,5,0,0,16,14,2,4,2,2,September,-1.0,-1.8369701987210287e-16,7,14,2,1,2,1.6,1.4,4,8,-4,5,5,0,"September, 2023"
2023-2024,5,2023-09-18,Nott'm Forest,Burnley,1,1,D,1,1,2,0,3,1,1,3,12,19,6,0,7,6,September,-1.0,-1.8369701987210287e-16,32,11,0,0,0,0.0,0.0,6,6,0,3,11,-8,"September, 2023"
2023-2024,6,2023-09-23,Crystal Palace,Fulham,0,0,D,1,1,4,1,0,1,2,2,9,10,7,7,1,0,September,-1.0,-1.8369701987210287e-16,16,19,2,2,1,1.2,1.2,6,7,-1,5,10,-5,"September, 2023"
2023-2024,6,2023-09-23,Luton,Wolves,1,1,D,1,1,0,1,4,1,0,4,20,16,0,3,4,3,September,-1.0,-1.8369701987210287e-16,26,48,0,0,0,0.0,0.0,2,10,-8,5,11,-6,"September, 2023"
2023-2024,6,2023-09-23,Man City,Nott'm Forest,2,0,H,3,0,5,0,0,2,0,3,1,10,15,7,9,8,September,-1.0,-1.8369701987210287e-16,27,32,1,2,1,2.0,1.25,14,3,11,7,7,0,"September, 2023"
2023-2024,6,2023-09-23,Brentford,Everton,1,3,A,0,3,2,1,2,3,1,1,11,18,6,1,7,5,September,-1.0,-1.8369701987210287e-16,9,18,2,1,1,1.25,1.0,8,6,2,2,9,-7,"September, 2023"
2023-2024,6,2023-09-23,Burnley,Man United,0,1,A,0,3,1,1,3,2,1,2,19,13,1,6,6,5,September,-1.0,-1.8369701987210287e-16,11,28,1,1,3,1.0,1.6,4,12,-8,6,10,-4,"September, 2023"
2023-2024,6,2023-09-24,Arsenal,Tottenham,2,2,D,1,1,5,0,0,2,0,3,4,2,13,13,2,0,September,-1.0,-1.8369701987210287e-16,0,42,4,0,1,2.0,1.2,9,4,5,13,5,8,"September, 2023"
2023-2024,6,2023-09-24,Brighton,Bournemouth,3,1,H,3,0,1,1,3,2,0,3,5,17,12,3,12,9,September,-1.0,-1.8369701987210287e-16,10,7,3,0,2,1.2,1.6,15,7,8,4,8,-4,"September, 2023"
2023-2024,6,2023-09-24,Chelsea,Aston Villa,0,1,A,0,3,5,0,0,1,2,2,14,7,5,9,7,4,September,-1.0,-1.8369701987210287e-16,14,1,3,0,2,1.8,1.0,5,5,0,11,10,1,"September, 2023"
2023-2024,6,2023-09-24,Liverpool,West Ham,3,1,H,3,0,2,2,1,1,1,3,5,7,13,10,2,3,September,-1.0,-1.8369701987210287e-16,25,45,4,0,1,1.8,1.0,12,4,8,10,7,3,"September, 2023"
2023-2024,6,2023-09-24,Sheffield United,Newcastle,0,8,A,0,3,0,0,5,3,1,1,18,12,1,6,6,5,September,-1.0,-1.8369701987210287e-16,36,30,1,0,4,0.4,1.6,5,9,-4,8,7,1,"September, 2023"
2023-2024,7,2023-09-30,Tottenham,Liverpool,2,1,H,3,0,2,0,3,2,2,1,6,3,14,16,3,2,September,-1.0,-1.8369701987210287e-16,42,25,0,2,3,1.6,2.4,15,7,8,15,5,10,"September, 2023"
2023-2024,7,2023-09-30,Wolves,Man City,2,1,H,3,0,1,0,4,5,0,0,16,1,4,18,15,14,September,-1.0,-1.8369701987210287e-16,48,27,0,0,5,0.4,3.2,6,12,-6,16,3,13,"September, 2023"
2023-2024,7,2023-09-30,West Ham,Sheffield United,2,0,H,3,0,1,1,3,0,0,5,9,20,10,1,11,9,September,-1.0,-1.8369701987210287e-16,45,36,2,1,2,1.0,1.0,11,10,1,5,17,-12,"September, 2023"
2023-2024,7,2023-09-30,Newcastle,Burnley,2,0,H,3,0,3,1,1,1,1,3,9,19,9,1,10,8,September,-1.0,-1.8369701987210287e-16,30,11,4,1,0,1.6,0.6,16,7,9,4,13,-9,"September, 2023"
2023-2024,7,2023-09-30,Bournemouth,Arsenal,0,4,A,0,3,2,0,3,5,0,0,17,6,3,14,11,11,September,-1.0,-1.8369701987210287e-16,7,0,0,1,4,0.8,2.6,5,11,-6,11,6,5,"September, 2023"
2023-2024,7,2023-09-30,Everton,Luton,1,2,A,0,3,3,1,1,0,1,4,15,18,4,1,3,3,September,-1.0,-1.8369701987210287e-16,18,26,0,0,0,0.0,0.0,5,10,-5,3,11,-8,"September, 2023"
2023-2024,7,2023-09-30,Aston Villa,Brighton,6,1,H,3,0,1,2,2,1,1,3,6,3,12,15,3,3,September,-1.0,-1.8369701987210287e-16,1,10,4,1,0,1.6,0.4,12,10,2,18,8,10,"September, 2023"
2023-2024,7,2023-09-30,Man United,Crystal Palace,0,1,A,0,3,2,1,2,4,1,0,9,10,9,8,1,1,September,-1.0,-1.8369701987210287e-16,28,16,2,2,1,0.8,0.6,7,10,-3,6,7,-1,"September, 2023"
2023-2024,7,2023-10-01,Nott'm Forest,Brentford,1,1,D,1,1,2,0,3,2,1,2,12,14,7,6,2,1,October,-0.8660254037844386,0.5,32,9,0,1,1,1.5,2.0,7,9,-2,9,9,0,"October, 2023"
2023-2024,7,2023-10-02,Fulham,Chelsea,0,2,A,0,3,1,2,2,5,0,0,12,15,8,5,3,3,October,-0.8660254037844386,0.5,19,14,1,1,3,0.6,1.2,5,10,-5,5,6,-1,"October, 2023"
2023-2024,7,2023-10-03,Luton,Burnley,1,2,A,0,3,0,1,4,1,1,3,17,19,4,1,2,3,October,-0.8660254037844386,0.5,26,11,0,0,0,0.0,0.0,5,12,-7,4,15,-11,"October, 2023"
2023-2024,8,2023-10-07,Man United,Brentford,2,1,H,3,0,2,1,2,2,1,2,12,14,9,7,2,2,October,-0.8660254037844386,0.5,28,9,3,0,1,1.75,1.25,7,11,-4,10,10,0,"October, 2023"
2023-2024,8,2023-10-07,Crystal Palace,Nott'm Forest,0,0,D,1,1,4,1,0,2,0,3,11,13,11,8,2,3,October,-0.8660254037844386,0.5,16,32,0,1,1,0.5,1.0,7,7,0,8,10,-2,"October, 2023"
2023-2024,8,2023-10-07,Fulham,Sheffield United,3,1,H,3,0,1,2,2,0,0,5,13,20,8,1,7,7,October,-0.8660254037844386,0.5,19,36,2,1,1,0.75,0.75,5,12,-7,5,19,-14,"October, 2023"
2023-2024,8,2023-10-07,Luton,Tottenham,0,1,A,0,3,0,1,4,2,0,3,17,2,4,17,15,13,October,-0.8660254037844386,0.5,26,42,0,0,0,0.0,0.0,6,14,-8,17,8,9,"October, 2023"
2023-2024,8,2023-10-07,Burnley,Chelsea,1,4,A,0,3,1,1,3,5,0,0,18,11,4,8,7,4,October,-0.8660254037844386,0.5,11,14,0,1,4,0.2,2.6,6,16,-10,7,6,1,"October, 2023"
2023-2024,8,2023-10-07,Everton,Bournemouth,3,0,H,3,0,3,1,1,2,0,3,16,19,4,3,3,1,October,-0.8660254037844386,0.5,18,7,2,0,3,1.0,1.8,6,12,-6,5,15,-10,"October, 2023"
2023-2024,8,2023-10-08,Brighton,Liverpool,2,2,D,1,1,1,1,3,2,2,1,6,4,15,16,2,1,October,-0.8660254037844386,0.5,10,25,2,2,1,1.8,1.4,19,14,5,16,7,9,"October, 2023"
2023-2024,8,2023-10-08,West Ham,Newcastle,2,2,D,1,1,1,1,3,3,1,1,7,8,13,12,1,1,October,-0.8660254037844386,0.5,45,30,1,2,2,1.8,2.4,13,10,3,18,7,11,"October, 2023"
2023-2024,8,2023-10-08,Wolves,Aston Villa,1,1,D,1,1,1,0,4,1,2,2,16,6,7,15,10,8,October,-0.8660254037844386,0.5,48,1,3,2,0,1.4,0.8,8,13,-5,18,11,7,"October, 2023"
2023-2024,8,2023-10-08,Arsenal,Man City,1,0,H,3,0,5,0,0,5,0,0,4,2,17,18,2,1,October,-0.8660254037844386,0.5,0,27,0,0,5,0.6,3.0,15,6,9,17,5,12,"October, 2023"
2023-2024,9,2023-10-21,Sheffield United,Man United,1,2,A,0,3,0,0,5,2,1,2,20,10,1,12,10,11,October,-0.8660254037844386,0.5,36,28,1,1,3,1.4,2.4,6,22,-16,9,12,-3,"October, 2023"
2023-2024,9,2023-10-21,Chelsea,Arsenal,2,2,D,1,1,5,0,0,5,0,0,11,4,11,20,7,9,October,-0.8660254037844386,0.5,14,0,1,0,4,1.0,1.8,11,7,4,16,6,10,"October, 2023"
2023-2024,9,2023-10-21,Nott'm Forest,Luton,2,2,D,1,1,2,0,3,0,1,4,15,17,9,4,2,5,October,-0.8660254037844386,0.5,32,26,0,0,0,0.0,0.0,8,10,-2,6,15,-9,"October, 2023"
2023-2024,9,2023-10-21,Newcastle,Crystal Palace,4,0,H,3,0,3,1,1,4,1,0,8,9,13,12,1,1,October,-0.8660254037844386,0.5,30,16,1,3,1,0.6,0.6,20,9,11,7,7,0,"October, 2023"
2023-2024,9,2023-10-21,Man City,Brighton,2,1,H,3,0,5,0,0,1,1,3,4,6,18,16,2,2,October,-0.8660254037844386,0.5,27,10,3,1,1,2.6,1.2,17,6,11,21,16,5,"October, 2023"
2023-2024,9,2023-10-21,Bournemouth,Wolves,1,2,A,0,3,2,0,3,1,0,4,19,14,3,8,5,5,October,-0.8660254037844386,0.5,7,48,1,2,2,0.6,0.8,5,18,-13,9,14,-5,"October, 2023"
2023-2024,9,2023-10-21,Liverpool,Everton,2,0,H,3,0,2,2,1,3,1,1,4,16,17,7,12,10,October,-0.8660254037844386,0.5,25,18,3,1,1,1.6,0.6,18,9,9,9,12,-3,"October, 2023"
2023-2024,9,2023-10-21,Brentford,Burnley,3,0,H,3,0,2,1,2,1,1,3,15,18,7,4,3,3,October,-0.8660254037844386,0.5,9,11,1,0,1,1.5,1.5,11,12,-1,7,20,-13,"October, 2023"
2023-2024,9,2023-10-22,Aston Villa,West Ham,4,1,H,3,0,1,2,2,1,1,3,6,9,16,14,3,2,October,-0.8660254037844386,0.5,1,45,0,1,4,0.8,2.2,19,12,7,15,12,3,"October, 2023"
2023-2024,9,2023-10-23,Tottenham,Fulham,2,0,H,3,0,2,0,3,1,2,2,4,13,20,11,9,9,October,-0.8660254037844386,0.5,42,19,4,1,0,1.4,0.6,18,8,10,8,13,-5,"October, 2023"
2023-2024,10,2023-10-27,Crystal Palace,Tottenham,1,2,A,0,3,4,1,0,2,0,3,11,1,12,23,10,11,October,-0.8660254037844386,0.5,16,42,1,0,4,0.8,2.4,7,11,-4,20,8,12,"October, 2023"
2023-2024,10,2023-10-28,Wolves,Newcastle,2,2,D,1,1,1,0,4,3,1,1,13,6,11,16,7,5,October,-0.8660254037844386,0.5,48,30,1,2,2,1.0,1.2,11,15,-4,24,9,15,"October, 2023"
2023-2024,10,2023-10-28,Bournemouth,Burnley,2,1,H,3,0,2,0,3,1,1,3,19,18,3,4,1,1,October,-0.8660254037844386,0.5,7,11,1,0,4,0.6,2.4,6,20,-14,7,23,-16,"October, 2023"
2023-2024,10,2023-10-28,Arsenal,Sheffield United,5,0,H,3,0,5,0,0,0,0,5,3,20,21,1,17,20,October,-0.8660254037844386,0.5,0,36,2,1,2,1.2,0.8,18,8,10,7,24,-17,"October, 2023"
2023-2024,10,2023-10-28,Chelsea,Brentford,0,2,A,0,3,5,0,0,2,1,2,10,14,12,10,4,2,October,-0.8660254037844386,0.5,14,9,1,1,2,0.5,1.5,13,9,4,14,12,2,"October, 2023"
2023-2024,10,2023-10-29,West Ham,Everton,0,1,A,0,3,1,1,3,3,1,1,9,16,14,7,7,7,October,-0.8660254037844386,0.5,45,18,3,0,2,1.0,0.6,16,16,0,9,14,-5,"October, 2023"
2023-2024,10,2023-10-29,Aston Villa,Luton,3,1,H,3,0,1,2,2,0,1,4,5,18,19,5,13,14,October,-0.8660254037844386,0.5,1,26,0,0,0,0.0,0.0,23,13,10,8,17,-9,"October, 2023"
2023-2024,10,2023-10-29,Brighton,Fulham,1,1,D,1,1,1,1,3,1,2,2,7,14,16,11,7,5,October,-0.8660254037844386,0.5,10,19,0,2,3,0.6,1.4,22,18,4,8,15,-7,"October, 2023"
2023-2024,10,2023-10-29,Liverpool,Nott'm Forest,3,0,H,3,0,2,2,1,2,0,3,5,15,20,10,10,10,October,-0.8660254037844386,0.5,25,32,2,2,1,2.2,1.4,20,9,11,10,12,-2,"October, 2023"
2023-2024,10,2023-10-29,Man United,Man City,0,3,A,0,3,2,1,2,5,0,0,8,5,15,21,3,6,October,-0.8660254037844386,0.5,28,27,2,0,3,1.6,2.6,11,13,-2,19,7,12,"October, 2023"
2023-2024,11,2023-11-04,Newcastle,Arsenal,1,0,H,3,0,3,1,1,5,0,0,8,3,17,24,5,7,November,-0.5000000000000004,0.8660254037844384,30,0,1,1,3,0.4,1.2,26,11,15,23,8,15,"November, 2023"
2023-2024,11,2023-11-04,Man City,Bournemouth,6,1,H,3,0,5,0,0,2,0,3,3,17,24,6,14,18,November,-0.5000000000000004,0.8660254037844384,27,7,5,0,0,2.8,0.6,22,7,15,8,21,-13,"November, 2023"
2023-2024,11,2023-11-04,Everton,Brighton,1,1,D,1,1,3,1,1,1,1,3,15,8,10,17,7,7,November,-0.5000000000000004,0.8660254037844384,18,10,2,1,2,2.0,1.6,10,14,-4,23,19,4,"November, 2023"
2023-2024,11,2023-11-04,Sheffield United,Wolves,2,1,H,3,0,0,0,5,1,0,4,20,13,1,12,7,11,November,-0.5000000000000004,0.8660254037844384,36,48,1,1,2,0.5,1.0,7,29,-22,13,17,-4,"November, 2023"
2023-2024,11,2023-11-04,Brentford,West Ham,3,2,H,3,0,2,1,2,1,1,3,10,9,13,14,1,1,November,-0.5000000000000004,0.8660254037844384,9,45,4,0,0,2.0,0.25,16,12,4,16,17,-1,"November, 2023"
2023-2024,11,2023-11-04,Fulham,Man United,0,1,A,0,3,1,2,2,2,1,2,14,8,12,15,6,3,November,-0.5000000000000004,0.8660254037844384,19,28,0,1,4,0.8,2.0,9,16,-7,11,16,-5,"November, 2023"
2023-2024,11,2023-11-04,Burnley,Crystal Palace,0,2,A,0,3,1,1,3,4,1,0,19,13,4,12,6,8,November,-0.5000000000000004,0.8660254037844384,11,16,3,2,0,1.8,0.8,8,25,-17,8,13,-5,"November, 2023"
2023-2024,11,2023-11-05,Nott'm Forest,Aston Villa,2,0,H,3,0,2,0,3,1,2,2,16,5,10,22,11,12,November,-0.5000000000000004,0.8660254037844384,32,1,0,3,2,0.6,1.4,10,15,-5,26,14,12,"November, 2023"
2023-2024,11,2023-11-05,Luton,Liverpool,1,1,D,1,1,0,1,4,2,2,1,18,4,5,23,14,18,November,-0.5000000000000004,0.8660254037844384,26,25,0,0,0,0.0,0.0,9,20,-11,23,9,14,"November, 2023"
2023-2024,11,2023-11-06,Tottenham,Chelsea,1,4,A,0,3,2,0,3,5,0,0,2,13,26,12,11,14,November,-0.5000000000000004,0.8660254037844384,42,14,1,1,3,0.8,1.6,22,9,13,13,11,2,"November, 2023"
2023-2024,12,2023-11-11,Wolves,Tottenham,2,1,H,3,0,1,0,4,2,0,3,14,2,12,26,12,14,November,-0.5000000000000004,0.8660254037844384,48,42,2,0,3,0.6,0.8,14,19,-5,23,13,10,"November, 2023"
2023-2024,12,2023-11-11,Arsenal,Burnley,3,1,H,3,0,5,0,0,1,1,3,4,19,24,4,15,20,November,-0.5000000000000004,0.8660254037844384,0,11,1,3,1,0.4,0.4,23,9,14,8,27,-19,"November, 2023"
2023-2024,12,2023-11-11,Crystal Palace,Everton,2,3,A,0,3,4,1,0,3,1,1,11,16,15,11,5,4,November,-0.5000000000000004,0.8660254037844384,16,18,1,2,2,1.2,1.6,10,13,-3,11,15,-4,"November, 2023"
2023-2024,12,2023-11-11,Man United,Luton,1,0,H,3,0,2,1,2,0,1,4,8,17,18,6,9,12,November,-0.5000000000000004,0.8660254037844384,28,26,0,0,0,0.0,0.0,12,16,-4,10,21,-11,"November, 2023"
2023-2024,12,2023-11-11,Bournemouth,Newcastle,2,0,H,3,0,2,0,3,3,1,1,18,7,6,20,11,14,November,-0.5000000000000004,0.8660254037844384,7,30,0,3,2,1.2,2.0,9,27,-18,27,11,16,"November, 2023"
2023-2024,12,2023-11-12,Chelsea,Man City,4,4,D,1,1,5,0,0,5,0,0,11,1,15,27,10,12,November,-0.5000000000000004,0.8660254037844384,14,27,1,0,4,0.4,1.0,17,12,5,28,8,20,"November, 2023"
2023-2024,12,2023-11-12,West Ham,Nott'm Forest,3,2,H,3,0,1,1,3,2,0,3,13,15,14,13,2,1,November,-0.5000000000000004,0.8660254037844384,45,32,2,1,2,1.2,0.6,18,20,-2,12,15,-3,"November, 2023"
2023-2024,12,2023-11-12,Aston Villa,Fulham,3,1,H,3,0,1,2,2,1,2,2,5,16,22,12,11,10,November,-0.5000000000000004,0.8660254037844384,1,19,3,0,2,1.6,1.2,26,16,10,9,17,-8,"November, 2023"
2023-2024,12,2023-11-12,Brighton,Sheffield United,1,1,D,1,1,1,1,3,0,0,5,8,20,18,4,12,14,November,-0.5000000000000004,0.8660254037844384,10,36,0,2,2,0.5,1.0,24,20,4,9,30,-21,"November, 2023"
2023-2024,12,2023-11-12,Liverpool,Brentford,3,0,H,3,0,2,2,1,2,1,2,5,9,24,16,4,8,November,-0.5000000000000004,0.8660254037844384,25,9,2,1,1,2.0,1.5,24,10,14,19,14,5,"November, 2023"
2023-2024,13,2023-11-25,Man City,Liverpool,1,1,D,1,1,5,0,0,2,2,1,1,2,28,27,1,1,November,-0.5000000000000004,0.8660254037844384,27,25,2,2,1,2.4,1.4,32,12,20,27,10,17,"November, 2023"
2023-2024,13,2023-11-25,Burnley,West Ham,1,2,A,0,3,1,1,3,1,1,3,20,9,4,17,11,13,November,-0.5000000000000004,0.8660254037844384,11,45,1,2,2,0.6,0.8,9,30,-21,21,22,-1,"November, 2023"
2023-2024,13,2023-11-25,Luton,Crystal Palace,2,1,H,3,0,0,1,4,4,1,0,18,13,6,15,5,9,November,-0.5000000000000004,0.8660254037844384,26,16,0,0,0,0.0,0.0,10,22,-12,12,16,-4,"November, 2023"
2023-2024,13,2023-11-25,Newcastle,Chelsea,4,1,H,3,0,3,1,1,5,0,0,7,10,20,16,3,4,November,-0.5000000000000004,0.8660254037844384,30,14,1,1,3,0.4,1.4,27,13,14,21,16,5,"November, 2023"
2023-2024,13,2023-11-25,Nott'm Forest,Brighton,2,3,A,0,3,2,0,3,1,1,3,15,9,13,19,6,6,November,-0.5000000000000004,0.8660254037844384,32,10,1,1,0,1.5,0.5,14,18,-4,25,21,4,"November, 2023"
2023-2024,13,2023-11-25,Sheffield United,Bournemouth,1,3,A,0,3,0,0,5,2,0,3,19,18,5,9,1,4,November,-0.5000000000000004,0.8660254037844384,36,7,1,1,0,1.5,1.0,10,31,-21,11,27,-16,"November, 2023"
2023-2024,13,2023-11-25,Brentford,Arsenal,0,1,A,0,3,2,1,2,5,0,0,11,3,16,27,8,11,November,-0.5000000000000004,0.8660254037844384,9,0,1,1,2,1.0,1.5,19,17,2,26,10,16,"November, 2023"
2023-2024,13,2023-11-26,Everton,Man United,0,3,A,0,3,3,1,1,2,1,2,14,8,14,21,6,7,November,-0.5000000000000004,0.8660254037844384,18,28,1,2,2,1.2,1.6,14,17,-3,13,16,-3,"November, 2023"
2023-2024,13,2023-11-26,Tottenham,Aston Villa,1,2,A,0,3,2,0,3,1,2,2,4,5,26,25,1,1,November,-0.5000000000000004,0.8660254037844384,42,1,2,0,3,1.6,1.4,24,15,9,29,17,12,"November, 2023"
2023-2024,13,2023-11-27,Fulham,Wolves,3,2,H,3,0,1,2,2,1,0,4,16,12,12,15,4,3,November,-0.5000000000000004,0.8660254037844384,19,48,0,2,3,0.2,0.8,10,20,-10,16,20,-4,"November, 2023"
2023-2024,14,2023-12-02,Arsenal,Wolves,2,1,H,3,0,5,0,0,1,0,4,1,12,30,15,11,15,December,-2.4492935982947064e-16,1.0,0,48,4,0,1,2.2,0.6,27,10,17,18,23,-5,"December, 2023"
2023-2024,14,2023-12-02,Brentford,Luton,3,1,H,3,0,2,1,2,0,1,4,11,18,16,9,7,7,December,-2.4492935982947064e-16,1.0,9,26,0,0,0,0.0,0.0,19,18,1,12,23,-11,"December, 2023"
2023-2024,14,2023-12-02,Burnley,Sheffield United,5,0,H,3,0,1,1,3,0,0,5,20,19,4,5,1,1,December,-2.4492935982947064e-16,1.0,11,36,1,1,2,0.5,1.25,10,32,-22,11,34,-23,"December, 2023"
2023-2024,14,2023-12-02,Nott'm Forest,Everton,0,1,A,0,3,2,0,3,3,1,1,16,15,13,14,1,1,December,-2.4492935982947064e-16,1.0,32,18,1,2,2,0.8,1.4,16,21,-5,14,20,-6,"December, 2023"
2023-2024,14,2023-12-02,Newcastle,Man United,1,0,H,3,0,3,1,1,2,1,2,7,6,23,24,1,1,December,-2.4492935982947064e-16,1.0,30,28,1,2,2,1.0,1.6,31,14,17,16,16,0,"December, 2023"
2023-2024,14,2023-12-03,Man City,Tottenham,3,3,D,1,1,5,0,0,2,0,3,3,6,29,26,3,3,December,-2.4492935982947064e-16,1.0,27,42,2,0,3,1.8,1.4,33,13,20,25,17,8,"December, 2023"
2023-2024,14,2023-12-03,West Ham,Crystal Palace,1,1,D,1,1,1,1,3,4,1,0,9,13,20,15,4,5,December,-2.4492935982947064e-16,1.0,45,16,2,1,2,2.4,2.4,23,23,0,13,18,-5,"December, 2023"
2023-2024,14,2023-12-03,Bournemouth,Aston Villa,2,2,D,1,1,2,0,3,1,2,2,17,4,12,28,13,16,December,-2.4492935982947064e-16,1.0,7,1,4,0,1,1.6,1.2,14,28,-14,31,18,13,"December, 2023"
2023-2024,14,2023-12-03,Chelsea,Brighton,3,2,H,3,0,5,0,0,1,1,3,12,8,16,22,4,6,December,-2.4492935982947064e-16,1.0,14,10,0,3,2,0.8,1.6,22,20,2,28,23,5,"December, 2023"
2023-2024,14,2023-12-03,Liverpool,Fulham,4,3,H,3,0,2,2,1,1,2,2,4,15,28,15,11,13,December,-2.4492935982947064e-16,1.0,25,19,2,2,1,1.2,1.0,28,11,17,13,22,-9,"December, 2023"
2023-2024,15,2023-12-05,Wolves,Burnley,1,0,H,3,0,1,0,4,1,1,3,14,19,15,7,5,8,December,-2.4492935982947064e-16,1.0,48,11,0,2,3,0.4,1.6,19,25,-6,15,32,-17,"December, 2023"
2023-2024,15,2023-12-05,Luton,Arsenal,3,4,A,0,3,0,1,4,5,0,0,18,1,9,33,17,24,December,-2.4492935982947064e-16,1.0,26,0,0,0,0,0.0,0.0,13,26,-13,29,11,18,"December, 2023"
2023-2024,15,2023-12-06,Brighton,Brentford,2,1,H,3,0,1,1,3,2,1,2,8,11,22,19,3,3,December,-2.4492935982947064e-16,1.0,10,9,2,1,1,1.5,1.25,30,26,4,22,19,3,"December, 2023"
2023-2024,15,2023-12-06,Crystal Palace,Bournemouth,0,2,A,0,3,4,1,0,2,0,3,14,17,16,13,3,3,December,-2.4492935982947064e-16,1.0,16,7,5,0,0,2.4,0.6,14,19,-5,16,30,-14,"December, 2023"
2023-2024,15,2023-12-06,Fulham,Nott'm Forest,5,0,H,3,0,1,2,2,2,0,3,16,17,15,13,1,2,December,-2.4492935982947064e-16,1.0,19,32,2,0,0,2.5,1.0,16,26,-10,16,22,-6,"December, 2023"
2023-2024,15,2023-12-06,Sheffield United,Liverpool,0,2,A,0,3,0,0,5,2,2,1,20,2,5,31,18,26,December,-2.4492935982947064e-16,1.0,36,25,0,0,5,0.2,2.2,11,39,-28,32,14,18,"December, 2023"
2023-2024,15,2023-12-06,Aston Villa,Man City,1,0,H,3,0,1,2,2,5,0,0,4,3,29,30,1,1,December,-2.4492935982947064e-16,1.0,1,27,0,1,4,1.2,2.2,33,20,13,36,16,20,"December, 2023"
2023-2024,15,2023-12-06,Man United,Chelsea,2,1,H,3,0,2,1,2,5,0,0,8,10,24,19,2,5,December,-2.4492935982947064e-16,1.0,28,14,1,4,0,1.4,0.8,16,17,-1,25,22,3,"December, 2023"
2023-2024,15,2023-12-07,Tottenham,West Ham,1,2,A,0,3,2,0,3,1,1,3,5,9,27,21,4,6,December,-2.4492935982947064e-16,1.0,42,45,2,1,2,1.4,1.0,28,20,8,24,24,0,"December, 2023"
2023-2024,15,2023-12-07,Everton,Newcastle,3,0,H,3,0,3,1,1,3,1,1,14,7,17,26,7,9,December,-2.4492935982947064e-16,1.0,18,30,1,0,4,0.6,2.0,15,20,-5,32,14,18,"December, 2023"
2023-2024,16,2023-12-09,Crystal Palace,Liverpool,1,2,A,0,3,4,1,0,2,2,1,15,2,16,34,13,18,December,-2.4492935982947064e-16,1.0,16,25,0,2,3,0.4,1.8,14,21,-7,34,14,20,"December, 2023"
2023-2024,16,2023-12-09,Brighton,Burnley,1,1,D,1,1,1,1,3,1,1,3,8,19,25,7,11,18,December,-2.4492935982947064e-16,1.0,10,11,2,2,1,1.0,1.2,32,27,5,15,33,-18,"December, 2023"
2023-2024,16,2023-12-09,Man United,Bournemouth,0,3,A,0,3,2,1,2,2,0,3,6,16,27,16,10,11,December,-2.4492935982947064e-16,1.0,28,7,4,0,1,2.6,0.8,18,18,0,18,30,-12,"December, 2023"
2023-2024,16,2023-12-09,Sheffield United,Brentford,1,0,H,3,0,0,0,5,2,1,2,20,12,5,19,8,14,December,-2.4492935982947064e-16,1.0,36,9,0,0,0,0.0,0.0,11,41,-30,23,21,2,"December, 2023"
2023-2024,16,2023-12-09,Wolves,Nott'm Forest,1,1,D,1,1,1,0,4,2,0,3,15,17,18,13,2,5,December,-2.4492935982947064e-16,1.0,48,32,1,1,0,1.0,0.5,20,25,-5,16,27,-11,"December, 2023"
2023-2024,16,2023-12-09,Aston Villa,Arsenal,1,0,H,3,0,1,2,2,5,0,0,3,2,32,36,1,4,December,-2.4492935982947064e-16,1.0,1,0,1,0,4,1.0,2.0,34,20,14,33,14,19,"December, 2023"
2023-2024,16,2023-12-10,Fulham,West Ham,5,0,H,3,0,1,2,2,1,1,3,15,9,18,24,6,6,December,-2.4492935982947064e-16,1.0,19,45,0,1,4,0.4,1.6,21,26,-5,26,25,1,"December, 2023"
2023-2024,16,2023-12-10,Tottenham,Newcastle,4,1,H,3,0,2,0,3,3,1,1,5,7,27,26,2,1,December,-2.4492935982947064e-16,1.0,42,30,2,1,2,2.4,2.6,29,22,7,32,17,15,"December, 2023"
2023-2024,16,2023-12-10,Luton,Man City,1,2,A,0,3,0,1,4,5,0,0,18,4,9,30,14,21,December,-2.4492935982947064e-16,1.0,26,27,0,0,0,0.0,0.0,16,30,-14,36,17,19,"December, 2023"
2023-2024,16,2023-12-10,Everton,Chelsea,2,0,H,3,0,3,1,1,5,0,0,10,11,20,19,1,1,December,-2.4492935982947064e-16,1.0,18,14,1,2,2,0.8,1.2,18,20,-2,26,24,2,"December, 2023"
2023-2024,17,2023-12-15,Nott'm Forest,Tottenham,0,2,A,0,3,2,0,3,2,0,3,17,5,14,30,12,16,December,-2.4492935982947064e-16,1.0,32,42,1,0,4,0.4,1.6,17,28,-11,33,23,10,"December, 2023"
2023-2024,17,2023-12-16,Chelsea,Sheffield United,2,0,H,3,0,5,0,0,0,0,5,13,20,19,8,7,11,December,-2.4492935982947064e-16,1.0,14,36,3,1,1,2.2,1.4,26,26,0,12,41,-29,"December, 2023"
2023-2024,17,2023-12-16,Man City,Crystal Palace,2,2,D,1,1,5,0,0,4,1,0,4,16,33,16,12,17,December,-2.4492935982947064e-16,1.0,27,16,3,1,1,1.4,0.8,38,18,20,15,23,-8,"December, 2023"
2023-2024,17,2023-12-16,Newcastle,Fulham,3,0,H,3,0,3,1,1,1,2,2,7,12,26,21,5,5,December,-2.4492935982947064e-16,1.0,30,19,4,1,0,2.4,0.4,33,21,12,26,26,0,"December, 2023"
2023-2024,17,2023-12-16,Burnley,Everton,0,2,A,0,3,1,1,3,3,1,1,19,10,8,23,9,15,December,-2.4492935982947064e-16,1.0,11,18,2,1,2,1.4,1.6,16,34,-18,20,20,0,"December, 2023"
2023-2024,17,2023-12-17,West Ham,Wolves,3,0,H,3,0,1,1,3,1,0,4,10,14,24,19,4,5,December,-2.4492935982947064e-16,1.0,45,48,3,0,2,1.2,0.8,26,30,-4,21,26,-5,"December, 2023"
2023-2024,17,2023-12-17,Liverpool,Man United,0,0,D,1,1,2,2,1,2,1,2,3,8,37,27,5,10,December,-2.4492935982947064e-16,1.0,25,28,4,0,1,4.2,0.8,36,15,21,18,21,-3,"December, 2023"
2023-2024,17,2023-12-17,Arsenal,Brighton,2,0,H,3,0,5,0,0,1,1,3,2,8,36,26,6,10,December,-2.4492935982947064e-16,1.0,0,10,2,1,2,1.4,1.4,33,15,18,33,28,5,"December, 2023"
2023-2024,17,2023-12-17,Brentford,Aston Villa,1,2,A,0,3,2,1,2,1,2,2,13,3,19,35,10,16,December,-2.4492935982947064e-16,1.0,9,1,1,2,1,1.0,1.75,23,22,1,35,20,15,"December, 2023"
2023-2024,18,2023-12-21,Crystal Palace,Brighton,1,1,D,1,1,4,1,0,1,1,3,16,9,17,26,7,9,December,-2.4492935982947064e-16,1.0,16,10,1,3,1,1.0,1.0,17,25,-8,33,30,3,"December, 2023"
2023-2024,18,2023-12-22,Aston Villa,Sheffield United,1,1,D,1,1,1,2,2,0,0,5,3,20,38,8,17,30,December,-2.4492935982947064e-16,1.0,1,36,2,1,2,0.8,0.6,37,21,16,12,43,-31,"December, 2023"
2023-2024,18,2023-12-23,West Ham,Man United,2,0,H,3,0,1,1,3,2,1,2,9,7,27,28,2,1,December,-2.4492935982947064e-16,1.0,45,28,1,0,4,0.4,1.0,29,30,-1,18,21,-3,"December, 2023"
2023-2024,18,2023-12-23,Fulham,Burnley,0,2,A,0,3,1,2,2,1,1,3,12,20,21,8,8,13,December,-2.4492935982947064e-16,1.0,19,11,2,1,2,1.8,1.4,26,29,-3,16,36,-20,"December, 2023"
2023-2024,18,2023-12-23,Luton,Newcastle,1,0,H,3,0,0,1,4,3,1,1,19,7,9,29,12,20,December,-2.4492935982947064e-16,1.0,26,30,0,0,0,0.0,0.0,17,32,-15,36,21,15,"December, 2023"
2023-2024,18,2023-12-23,Nott'm Forest,Bournemouth,2,3,A,0,3,2,0,3,2,0,3,17,15,14,19,2,5,December,-2.4492935982947064e-16,1.0,32,7,0,1,1,1.5,2.0,17,30,-13,21,30,-9,"December, 2023"
2023-2024,18,2023-12-23,Tottenham,Everton,2,1,H,3,0,2,0,3,3,1,1,5,10,33,26,5,7,December,-2.4492935982947064e-16,1.0,42,18,2,3,0,2.0,0.6,35,23,12,22,20,2,"December, 2023"
2023-2024,18,2023-12-23,Liverpool,Arsenal,1,1,D,1,1,2,2,1,5,0,0,3,1,38,39,2,1,December,-2.4492935982947064e-16,1.0,25,0,3,1,1,2.6,1.0,36,15,21,35,15,20,"December, 2023"
2023-2024,18,2023-12-24,Wolves,Chelsea,2,1,H,3,0,1,0,4,5,0,0,15,11,19,22,4,3,December,-2.4492935982947064e-16,1.0,48,14,1,3,1,0.6,1.0,21,29,-8,28,26,2,"December, 2023"
2023-2024,19,2023-12-26,Man United,Aston Villa,3,2,H,3,0,2,1,2,1,2,2,8,3,28,39,5,11,December,-2.4492935982947064e-16,1.0,28,1,2,1,2,1.4,1.4,18,23,-5,38,22,16,"December, 2023"
2023-2024,19,2023-12-26,Burnley,Liverpool,0,2,A,0,3,1,1,3,2,2,1,19,2,11,39,17,28,December,-2.4492935982947064e-16,1.0,11,25,1,1,3,0.4,1.4,18,36,-18,37,16,21,"December, 2023"
2023-2024,19,2023-12-26,Sheffield United,Luton,2,3,A,0,3,0,0,5,0,1,4,20,18,9,12,2,3,December,-2.4492935982947064e-16,1.0,36,26,0,0,0,0.0,0.0,13,44,-31,18,32,-14,"December, 2023"
2023-2024,19,2023-12-26,Newcastle,Nott'm Forest,1,3,A,0,3,3,1,1,2,0,3,7,17,29,14,10,15,December,-2.4492935982947064e-16,1.0,30,32,5,0,0,2.6,0.4,36,22,14,19,33,-14,"December, 2023"
2023-2024,19,2023-12-26,Bournemouth,Fulham,3,0,H,3,0,2,0,3,1,2,2,13,14,22,21,1,1,December,-2.4492935982947064e-16,1.0,7,19,2,1,1,1.75,1.0,24,32,-8,26,31,-5,"December, 2023"
2023-2024,19,2023-12-27,Brentford,Wolves,1,4,A,0,3,2,1,2,1,0,4,15,13,19,22,2,3,December,-2.4492935982947064e-16,1.0,9,48,1,1,2,1.0,1.25,24,24,0,23,30,-7,"December, 2023"
2023-2024,19,2023-12-27,Chelsea,Crystal Palace,2,1,H,3,0,5,0,0,4,1,0,13,16,22,18,3,4,December,-2.4492935982947064e-16,1.0,14,16,5,0,0,2.2,0.4,29,28,1,18,26,-8,"December, 2023"
2023-2024,19,2023-12-27,Everton,Man City,1,3,A,0,3,3,1,1,5,0,0,10,5,26,34,5,8,December,-2.4492935982947064e-16,1.0,18,27,0,1,4,0.2,2.6,23,22,1,40,20,20,"December, 2023"
2023-2024,19,2023-12-28,Brighton,Tottenham,4,2,H,3,0,1,1,3,2,0,3,9,5,27,36,4,9,December,-2.4492935982947064e-16,1.0,10,42,2,0,3,0.6,1.0,34,31,3,37,24,13,"December, 2023"
2023-2024,19,2023-12-28,Arsenal,West Ham,0,2,A,0,3,5,0,0,1,1,3,2,8,40,30,6,10,December,-2.4492935982947064e-16,1.0,0,45,3,2,0,2.4,1.4,36,16,20,31,30,1,"December, 2023"
2023-2024,20,2023-12-30,Nott'm Forest,Man United,2,1,H,3,0,2,0,3,2,1,2,17,7,17,31,10,14,December,-2.4492935982947064e-16,1.0,32,28,0,0,5,0.6,3.8,22,34,-12,21,25,-4,"December, 2023"
2023-2024,20,2023-12-30,Wolves,Everton,3,0,H,3,0,1,0,4,3,1,1,12,11,25,26,1,1,December,-2.4492935982947064e-16,1.0,48,18,4,1,0,1.4,0.6,27,31,-4,24,25,-1,"December, 2023"
2023-2024,20,2023-12-30,Man City,Sheffield United,2,0,H,3,0,5,0,0,0,0,5,4,20,37,9,16,28,December,-2.4492935982947064e-16,1.0,27,36,5,0,0,1.4,0.2,43,21,22,15,47,-32,"December, 2023"
2023-2024,20,2023-12-30,Crystal Palace,Brentford,3,1,H,3,0,4,1,0,2,1,2,16,15,18,19,1,1,December,-2.4492935982947064e-16,1.0,16,9,0,5,0,0.6,0.6,19,28,-9,25,28,-3,"December, 2023"
2023-2024,20,2023-12-30,Aston Villa,Burnley,3,2,H,3,0,1,2,2,1,1,3,3,19,39,11,16,28,December,-2.4492935982947064e-16,1.0,1,11,2,2,1,1.8,1.2,40,25,15,18,38,-20,"December, 2023"
2023-2024,20,2023-12-30,Luton,Chelsea,2,3,A,0,3,0,1,4,5,0,0,18,11,15,25,7,10,December,-2.4492935982947064e-16,1.0,26,14,0,0,1,0.0,3.0,21,34,-13,31,29,2,"December, 2023"
2023-2024,20,2023-12-31,Fulham,Arsenal,2,1,H,3,0,1,2,2,5,0,0,15,4,21,40,11,19,December,-2.4492935982947064e-16,1.0,19,0,0,2,3,0.8,2.2,26,34,-8,36,18,18,"December, 2023"
2023-2024,20,2023-12-31,Tottenham,Bournemouth,3,1,H,3,0,2,0,3,2,0,3,5,13,36,25,8,11,December,-2.4492935982947064e-16,1.0,42,7,3,1,1,2.0,1.4,39,28,11,27,32,-5,"December, 2023"
2023-2024,20,2024-01-01,Liverpool,Newcastle,4,2,H,3,0,2,2,1,3,1,1,1,9,42,29,8,13,January,0.4999999999999999,0.8660254037844387,25,30,5,0,0,2.0,0.6,39,16,23,37,25,12,"January, 2024"
2023-2024,20,2024-01-02,West Ham,Brighton,0,0,D,1,1,1,1,3,1,1,3,6,8,33,30,2,3,January,0.4999999999999999,0.8660254037844387,45,10,1,1,3,1.0,2.2,33,30,3,38,33,5,"January, 2024"
2023-2024,21,2024-01-12,Burnley,Luton,1,1,D,1,1,1,1,3,0,1,4,19,18,11,15,1,4,January,0.4999999999999999,0.8660254037844387,11,26,1,0,0,2.0,1.0,20,41,-21,23,37,-14,"January, 2024"
2023-2024,21,2024-01-13,Chelsea,Fulham,1,0,H,3,0,5,0,0,1,2,2,10,14,28,24,4,4,January,0.4999999999999999,0.8660254037844387,14,19,3,1,1,1.2,0.4,34,31,3,28,35,-7,"January, 2024"
2023-2024,21,2024-01-13,Newcastle,Man City,2,3,A,0,3,3,1,1,5,0,0,10,3,29,40,7,11,January,0.4999999999999999,0.8660254037844387,30,27,0,1,4,0.6,3.0,39,29,10,45,21,24,"January, 2024"
2023-2024,21,2024-01-14,Man United,Tottenham,2,2,D,1,1,2,1,2,2,0,3,9,5,31,39,4,8,January,0.4999999999999999,0.8660254037844387,28,42,3,1,1,2.0,1.2,22,27,-5,42,29,13,"January, 2024"
2023-2024,21,2024-01-14,Everton,Aston Villa,0,0,D,1,1,3,1,1,1,2,2,12,3,26,42,9,16,January,0.4999999999999999,0.8660254037844387,18,1,0,0,5,0.2,2.4,24,28,-4,43,27,16,"January, 2024"
2023-2024,21,2024-01-20,Arsenal,Crystal Palace,5,0,H,3,0,5,0,0,4,1,0,4,15,40,21,11,19,January,0.4999999999999999,0.8660254037844387,0,16,3,1,1,1.8,1.2,37,20,17,22,29,-7,"January, 2024"
2023-2024,21,2024-01-20,Brentford,Nott'm Forest,3,2,H,3,0,2,1,2,2,0,3,17,16,19,20,1,1,January,0.4999999999999999,0.8660254037844387,9,32,1,2,0,1.6666666666666667,1.3333333333333333,26,31,-5,24,35,-11,"January, 2024"
2023-2024,21,2024-01-21,Sheffield United,West Ham,2,2,D,1,1,0,0,5,1,1,3,20,6,9,34,14,25,January,0.4999999999999999,0.8660254037844387,36,45,1,1,3,0.4,1.4,15,49,-34,33,30,3,"January, 2024"
2023-2024,21,2024-01-21,Bournemouth,Liverpool,0,4,A,0,3,2,0,3,2,2,1,13,1,25,45,12,20,January,0.4999999999999999,0.8660254037844387,7,25,1,0,4,0.6,3.4,28,35,-7,43,18,25,"January, 2024"
2023-2024,21,2024-01-22,Brighton,Wolves,0,0,D,1,1,1,1,3,1,0,4,8,11,31,28,3,3,January,0.4999999999999999,0.8660254037844387,10,48,4,0,1,3.2,0.8,38,33,5,30,31,-1,"January, 2024"
2023-2024,22,2024-01-30,Aston Villa,Newcastle,1,3,A,0,3,1,2,2,3,1,1,4,10,43,29,6,14,January,0.4999999999999999,0.8660254037844387,1,30,2,0,3,1.2,2.0,43,27,16,41,32,9,"January, 2024"
2023-2024,22,2024-01-30,Crystal Palace,Sheffield United,3,2,H,3,0,4,1,0,0,0,5,16,20,21,10,4,11,January,0.4999999999999999,0.8660254037844387,16,36,3,0,2,1.0,0.4,22,34,-12,17,51,-34,"January, 2024"
2023-2024,22,2024-01-30,Luton,Brighton,4,0,H,3,0,0,1,4,1,1,3,18,7,16,32,11,16,January,0.4999999999999999,0.8660254037844387,26,10,0,0,1,1.0,4.0,24,38,-14,38,33,5,"January, 2024"
2023-2024,22,2024-01-30,Fulham,Everton,0,0,D,1,1,1,2,2,3,1,1,14,12,24,27,2,3,January,0.4999999999999999,0.8660254037844387,19,18,3,1,1,1.6,0.8,28,36,-8,24,28,-4,"January, 2024"
2023-2024,22,2024-01-30,Nott'm Forest,Arsenal,1,2,A,0,3,2,0,3,5,0,0,17,3,20,43,14,23,January,0.4999999999999999,0.8660254037844387,32,0,1,0,4,0.6,2.0,26,38,-12,42,20,22,"January, 2024"
2023-2024,22,2024-01-31,Man City,Burnley,3,1,H,3,0,5,0,0,1,1,3,3,19,43,12,16,31,January,0.4999999999999999,0.8660254037844387,27,11,5,0,0,2.8,0.0,48,23,25,21,42,-21,"January, 2024"
2023-2024,22,2024-01-31,Tottenham,Brentford,3,2,H,3,0,2,0,3,2,1,2,5,16,40,22,11,18,January,0.4999999999999999,0.8660254037844387,42,9,1,3,1,1.4,1.4,44,31,13,29,33,-4,"January, 2024"
2023-2024,22,2024-01-31,Liverpool,Chelsea,4,1,H,3,0,2,2,1,5,0,0,1,10,48,31,9,17,January,0.4999999999999999,0.8660254037844387,25,14,0,5,0,0.8,0.8,47,18,29,35,31,4,"January, 2024"
2023-2024,22,2024-02-01,West Ham,Bournemouth,1,1,D,1,1,1,1,3,2,0,3,6,14,35,25,8,10,February,0.8660254037844386,0.5000000000000001,45,7,3,2,0,2.6,0.6,35,32,3,28,39,-11,"February, 2024"
2023-2024,22,2024-02-01,Wolves,Man United,3,4,A,0,3,1,0,4,2,1,2,11,9,29,32,2,3,February,0.8660254037844386,0.5000000000000001,48,28,1,0,4,0.2,1.0,30,31,-1,24,29,-5,"February, 2024"
2023-2024,23,2024-02-03,Newcastle,Luton,4,4,D,1,1,3,1,1,0,1,4,9,18,32,19,9,13,February,0.8660254037844386,0.5000000000000001,30,26,0,0,1,0.0,1.0,44,33,11,28,38,-10,"February, 2024"
2023-2024,23,2024-02-03,Burnley,Fulham,2,2,D,1,1,1,1,3,1,2,2,19,14,12,25,5,13,February,0.8660254037844386,0.5000000000000001,11,19,3,1,1,1.8,1.2,22,45,-23,28,36,-8,"February, 2024"
2023-2024,23,2024-02-03,Sheffield United,Aston Villa,0,5,A,0,3,0,0,5,1,2,2,20,5,10,43,15,33,February,0.8660254037844386,0.5000000000000001,36,1,2,2,1,0.8,0.4,19,54,-35,44,30,14,"February, 2024"
2023-2024,23,2024-02-03,Everton,Tottenham,2,2,D,1,1,3,1,1,2,0,3,12,4,28,43,8,15,February,0.8660254037844386,0.5000000000000001,18,42,0,2,3,0.4,2.0,24,28,-4,47,33,14,"February, 2024"
2023-2024,23,2024-02-03,Brighton,Crystal Palace,4,1,H,3,0,1,1,3,4,1,0,9,15,32,24,6,8,February,0.8660254037844386,0.5000000000000001,10,16,1,4,0,1.0,0.8,38,37,1,25,36,-11,"February, 2024"
2023-2024,23,2024-02-04,Arsenal,Liverpool,3,1,H,3,0,5,0,0,2,2,1,3,1,46,51,2,5,February,0.8660254037844386,0.5000000000000001,0,25,1,2,2,1.2,2.2,44,21,23,51,19,32,"February, 2024"
2023-2024,23,2024-02-04,Man United,West Ham,3,0,H,3,0,2,1,2,1,1,3,8,6,35,36,2,1,February,0.8660254037844386,0.5000000000000001,28,45,3,0,2,0.8,0.8,28,32,-4,36,33,3,"February, 2024"
2023-2024,23,2024-02-04,Chelsea,Wolves,2,4,A,0,3,5,0,0,1,0,4,10,11,31,29,1,2,February,0.8660254037844386,0.5000000000000001,14,48,1,2,2,1.2,1.0,36,35,1,33,35,-2,"February, 2024"
2023-2024,23,2024-02-04,Bournemouth,Nott'm Forest,1,1,D,1,1,2,0,3,2,0,3,14,18,26,20,4,6,February,0.8660254037844386,0.5000000000000001,7,32,2,1,0,2.333333333333333,1.6666666666666667,29,40,-11,27,40,-13,"February, 2024"
2023-2024,23,2024-02-05,Brentford,Man City,1,3,A,0,3,2,1,2,5,0,0,16,3,22,46,13,24,February,0.8660254037844386,0.5000000000000001,9,27,2,0,2,0.75,1.0,31,36,-5,51,24,27,"February, 2024"
2023-2024,24,2024-02-10,Man City,Everton,2,0,H,3,0,5,0,0,3,1,1,2,12,49,29,10,20,February,0.8660254037844386,0.5000000000000001,27,18,4,1,0,2.2,0.4,54,25,29,26,30,-4,"February, 2024"
2023-2024,24,2024-02-10,Fulham,Bournemouth,3,1,H,3,0,1,2,2,2,0,3,14,13,26,27,1,1,February,0.8660254037844386,0.5000000000000001,19,7,1,1,3,0.8,2.0,30,38,-8,30,41,-11,"February, 2024"
2023-2024,24,2024-02-10,Liverpool,Burnley,3,1,H,3,0,2,2,1,1,1,3,2,19,51,13,17,38,February,0.8660254037844386,0.5000000000000001,25,11,4,0,1,1.6,0.2,52,22,30,24,47,-23,"February, 2024"
2023-2024,24,2024-02-10,Luton,Sheffield United,1,3,A,0,3,0,1,4,0,0,5,18,20,20,10,2,10,February,0.8660254037844386,0.5000000000000001,26,36,1,0,0,3.0,2.0,32,42,-10,19,59,-40,"February, 2024"
2023-2024,24,2024-02-10,Tottenham,Brighton,2,1,H,3,0,2,0,3,1,1,3,5,8,44,35,3,9,February,0.8660254037844386,0.5000000000000001,42,10,3,0,2,1.4,1.2,49,35,14,42,38,4,"February, 2024"
2023-2024,24,2024-02-10,Wolves,Brentford,0,2,A,0,3,1,0,4,2,1,2,10,16,32,22,6,10,February,0.8660254037844386,0.5000000000000001,48,9,3,1,1,1.8,1.0,37,37,0,32,39,-7,"February, 2024"
2023-2024,24,2024-02-10,Nott'm Forest,Newcastle,2,3,A,0,3,2,0,3,3,1,1,17,9,21,33,8,12,February,0.8660254037844386,0.5000000000000001,32,30,1,0,4,1.0,1.8,28,41,-13,48,37,11,"February, 2024"
2023-2024,24,2024-02-11,Aston Villa,Man United,1,2,A,0,3,1,2,2,2,1,2,5,6,46,38,1,8,February,0.8660254037844386,0.5000000000000001,1,28,2,1,2,1.6,1.4,49,30,19,31,32,-1,"February, 2024"
2023-2024,24,2024-02-11,West Ham,Arsenal,0,6,A,0,3,1,1,3,5,0,0,8,3,36,49,5,13,February,0.8660254037844386,0.5000000000000001,45,0,1,1,3,1.2,1.8,36,36,0,47,22,25,"February, 2024"
2023-2024,24,2024-02-12,Crystal Palace,Chelsea,1,3,A,0,3,4,1,0,5,0,0,16,11,24,31,5,7,February,0.8660254037844386,0.5000000000000001,16,14,0,0,5,0.4,1.8,26,40,-14,38,39,-1,"February, 2024"
2023-2024,25,2024-02-17,Brentford,Liverpool,1,4,A,0,3,2,1,2,2,2,1,15,1,25,54,14,29,February,0.8660254037844386,0.5000000000000001,9,25,1,1,3,1.2,2.2,34,39,-5,55,23,32,"February, 2024"
2023-2024,25,2024-02-17,Burnley,Arsenal,0,5,A,0,3,1,1,3,5,0,0,19,3,13,52,16,39,February,0.8660254037844386,0.5000000000000001,11,0,1,2,2,0.6,1.0,25,50,-25,53,22,31,"February, 2024"
2023-2024,25,2024-02-17,Fulham,Aston Villa,1,2,A,0,3,1,2,2,1,2,2,12,5,29,46,7,17,February,0.8660254037844386,0.5000000000000001,19,1,1,0,4,1.0,2.0,33,39,-6,50,32,18,"February, 2024"
2023-2024,25,2024-02-17,Newcastle,Bournemouth,2,2,D,1,1,3,1,1,2,0,3,7,14,36,27,7,9,February,0.8660254037844386,0.5000000000000001,30,7,2,2,1,1.6,1.2,51,39,12,31,44,-13,"February, 2024"
2023-2024,25,2024-02-17,Nott'm Forest,West Ham,2,0,H,3,0,2,0,3,1,1,3,17,8,21,36,9,15,February,0.8660254037844386,0.5000000000000001,32,45,1,1,3,0.8,1.8,30,44,-14,36,42,-6,"February, 2024"
2023-2024,25,2024-02-17,Tottenham,Wolves,1,2,A,0,3,2,0,3,1,0,4,5,11,47,32,6,15,February,0.8660254037844386,0.5000000000000001,42,48,2,0,3,0.6,1.0,51,36,15,37,39,-2,"February, 2024"
2023-2024,25,2024-02-17,Man City,Chelsea,1,1,D,1,1,5,0,0,5,0,0,3,11,52,34,8,18,February,0.8660254037844386,0.5000000000000001,27,14,4,1,0,1.6,0.8,56,25,31,41,40,1,"February, 2024"
2023-2024,25,2024-02-18,Sheffield United,Brighton,0,5,A,0,3,0,0,5,1,1,3,20,9,13,35,11,22,February,0.8660254037844386,0.5000000000000001,36,10,2,3,0,1.0,0.6,22,60,-38,43,40,3,"February, 2024"
2023-2024,25,2024-02-18,Luton,Man United,1,2,A,0,3,0,1,4,2,1,2,18,6,20,41,12,21,February,0.8660254037844386,0.5000000000000001,26,28,0,0,1,0.0,1.0,33,45,-12,33,33,0,"February, 2024"
2023-2024,25,2024-02-19,Everton,Crystal Palace,1,1,D,1,1,3,1,1,4,1,0,12,17,29,24,5,5,February,0.8660254037844386,0.5000000000000001,18,16,3,1,1,2.0,1.4,26,32,-6,27,43,-16,"February, 2024"
2023-2024,25,2024-02-20,Man City,Brentford,1,0,H,3,0,5,0,0,2,1,2,3,15,53,25,12,28,February,0.8660254037844386,0.5000000000000001,27,9,3,0,2,1.4,0.8,57,26,31,35,43,-8,"February, 2024"
2023-2024,25,2024-02-21,Liverpool,Luton,4,1,H,3,0,2,2,1,0,1,4,1,18,57,20,17,37,February,0.8660254037844386,0.5000000000000001,25,26,0,1,0,1.0,1.0,59,24,35,34,47,-13,"February, 2024"
2023-2024,26,2024-02-24,Aston Villa,Nott'm Forest,4,2,H,3,0,1,2,2,2,0,3,4,17,49,24,13,25,February,0.8660254037844386,0.5000000000000001,1,32,2,2,1,1.4,1.0,52,33,19,32,44,-12,"February, 2024"
2023-2024,26,2024-02-24,Brighton,Everton,1,1,D,1,1,1,1,3,3,1,1,7,12,38,30,5,8,February,0.8660254037844386,0.5000000000000001,10,18,2,1,2,1.8,2.2,48,40,8,27,33,-6,"February, 2024"
2023-2024,26,2024-02-24,Crystal Palace,Burnley,3,0,H,3,0,4,1,0,1,1,3,16,19,25,13,3,12,February,0.8660254037844386,0.5000000000000001,16,11,1,2,2,1.2,1.6,28,44,-16,25,55,-30,"February, 2024"
2023-2024,26,2024-02-24,Man United,Fulham,1,2,A,0,3,2,1,2,1,2,2,6,13,44,29,7,15,February,0.8660254037844386,0.5000000000000001,28,19,4,1,0,1.6,0.8,35,34,1,34,41,-7,"February, 2024"
2023-2024,26,2024-02-24,Bournemouth,Man City,0,1,A,0,3,2,0,3,5,0,0,14,2,28,56,12,28,February,0.8660254037844386,0.5000000000000001,7,27,0,0,5,0.8,3.8,33,46,-13,58,26,32,"February, 2024"
2023-2024,26,2024-02-24,Arsenal,Newcastle,4,1,H,3,0,5,0,0,3,1,1,3,8,55,37,5,18,February,0.8660254037844386,0.5000000000000001,0,30,2,1,2,0.8,0.6,58,22,36,53,41,12,"February, 2024"
2023-2024,26,2024-02-25,Wolves,Sheffield United,1,0,H,3,0,1,0,4,0,0,5,11,20,35,13,9,22,February,0.8660254037844386,0.5000000000000001,48,36,2,1,2,1.0,0.8,39,40,-1,22,65,-43,"February, 2024"
2023-2024,26,2024-02-26,West Ham,Brentford,4,2,H,3,0,1,1,3,2,1,2,10,16,36,25,6,11,February,0.8660254037844386,0.5000000000000001,45,9,0,0,5,0.6,2.2,36,44,-8,35,44,-9,"February, 2024"
2023-2024,27,2024-03-02,Luton,Aston Villa,2,3,A,0,3,0,1,4,1,2,2,18,4,20,52,14,32,March,1.0,6.123233995736766e-17,26,1,0,0,1,1.0,3.0,35,51,-16,56,35,21,"March, 2024"
2023-2024,27,2024-03-02,Tottenham,Crystal Palace,3,1,H,3,0,2,0,3,4,1,0,5,14,47,28,9,19,March,1.0,6.123233995736766e-17,42,16,4,0,1,2.0,0.8,52,38,14,31,44,-13,"March, 2024"
2023-2024,27,2024-03-02,Nott'm Forest,Liverpool,0,1,A,0,3,2,0,3,2,2,1,17,1,24,60,16,36,March,1.0,6.123233995736766e-17,32,25,1,1,3,1.2,2.6,34,48,-14,63,25,38,"March, 2024"
2023-2024,27,2024-03-02,Brentford,Chelsea,2,2,D,1,1,2,1,2,5,0,0,16,11,25,35,5,10,March,1.0,6.123233995736766e-17,9,14,3,1,1,1.6,0.4,37,48,-11,42,41,1,"March, 2024"
2023-2024,27,2024-03-02,Fulham,Brighton,3,0,H,3,0,1,2,2,1,1,3,12,8,32,39,4,7,March,1.0,6.123233995736766e-17,19,10,2,3,0,0.8,0.4,36,42,-6,49,41,8,"March, 2024"
2023-2024,27,2024-03-02,Everton,West Ham,1,3,A,0,3,3,1,1,1,1,3,13,8,31,39,5,8,March,1.0,6.123233995736766e-17,18,45,2,0,3,0.6,1.0,28,34,-6,40,46,-6,"March, 2024"
2023-2024,27,2024-03-02,Newcastle,Wolves,3,0,H,3,0,3,1,1,1,0,4,10,9,37,38,1,1,March,1.0,6.123233995736766e-17,30,48,2,2,1,1.4,1.2,54,45,9,40,40,0,"March, 2024"
2023-2024,27,2024-03-03,Burnley,Bournemouth,0,2,A,0,3,1,1,3,2,0,3,19,14,13,28,5,15,March,1.0,6.123233995736766e-17,11,7,4,0,1,2.4,0.6,25,58,-33,33,47,-14,"March, 2024"
2023-2024,27,2024-03-03,Man City,Man United,3,1,H,3,0,5,0,0,2,1,2,2,6,59,44,4,15,March,1.0,6.123233995736766e-17,27,28,4,0,1,3.2,1.2,59,26,33,36,36,0,"March, 2024"
2023-2024,27,2024-03-04,Sheffield United,Arsenal,0,6,A,0,3,0,0,5,5,0,0,20,3,13,58,17,45,March,1.0,6.123233995736766e-17,36,0,1,1,3,0.6,2.2,22,66,-44,62,23,39,"March, 2024"
2023-2024,28,2024-03-09,Wolves,Fulham,2,1,H,3,0,1,0,4,1,2,2,10,12,38,35,2,3,March,1.0,6.123233995736766e-17,48,19,2,2,1,1.0,0.8,40,43,-3,39,42,-3,"March, 2024"
2023-2024,28,2024-03-09,Arsenal,Brentford,2,1,H,3,0,5,0,0,2,1,2,3,16,61,26,13,35,March,1.0,6.123233995736766e-17,0,9,3,1,1,1.4,0.8,68,23,45,39,50,-11,"March, 2024"
2023-2024,28,2024-03-09,Crystal Palace,Luton,1,1,D,1,1,4,1,0,0,1,4,15,18,28,20,3,8,March,1.0,6.123233995736766e-17,16,26,0,0,1,1.0,2.0,32,47,-15,37,54,-17,"March, 2024"
2023-2024,28,2024-03-09,Man United,Everton,2,0,H,3,0,2,1,2,3,1,1,6,13,44,31,7,13,March,1.0,6.123233995736766e-17,28,18,3,1,1,1.6,0.6,37,39,-2,29,37,-8,"March, 2024"
2023-2024,28,2024-03-09,Bournemouth,Sheffield United,2,2,D,1,1,2,0,3,0,0,5,14,20,31,13,6,18,March,1.0,6.123233995736766e-17,7,36,1,1,1,1.6666666666666667,1.3333333333333333,35,47,-12,22,72,-50,"March, 2024"
2023-2024,28,2024-03-10,Aston Villa,Tottenham,0,4,A,0,3,1,2,2,2,0,3,4,5,55,50,1,5,March,1.0,6.123233995736766e-17,1,42,3,0,2,1.4,1.6,59,37,22,55,39,16,"March, 2024"
2023-2024,28,2024-03-10,Brighton,Nott'm Forest,1,0,H,3,0,1,1,3,2,0,3,10,17,39,24,7,15,March,1.0,6.123233995736766e-17,10,32,1,1,1,1.3333333333333333,1.6666666666666667,49,44,5,34,49,-15,"March, 2024"
2023-2024,28,2024-03-10,West Ham,Burnley,2,2,D,1,1,1,1,3,1,1,3,8,20,42,13,12,29,March,1.0,6.123233995736766e-17,45,11,3,2,0,1.2,0.6,43,47,-4,25,60,-35,"March, 2024"
2023-2024,28,2024-03-10,Liverpool,Man City,1,1,D,1,1,2,2,1,5,0,0,2,3,63,62,1,1,March,1.0,6.123233995736766e-17,25,27,1,3,1,1.4,1.8,64,25,39,62,27,35,"March, 2024"
2023-2024,28,2024-03-11,Chelsea,Newcastle,3,2,H,3,0,5,0,0,3,1,1,11,10,36,40,1,4,March,1.0,6.123233995736766e-17,14,30,2,1,2,1.2,1.2,44,43,1,57,45,12,"March, 2024"
2023-2024,28,2024-03-13,Bournemouth,Luton,4,3,H,3,0,2,0,3,0,1,4,13,18,32,21,5,11,March,1.0,6.123233995736766e-17,7,26,0,0,0,0.0,0.0,37,49,-12,38,55,-17,"March, 2024"
2023-2024,29,2024-03-16,Burnley,Brentford,2,1,H,3,0,1,1,3,2,1,2,19,16,14,26,3,12,March,1.0,6.123233995736766e-17,11,9,1,0,2,1.0,2.0,27,62,-35,40,52,-12,"March, 2024"
2023-2024,29,2024-03-16,Luton,Nott'm Forest,1,1,D,1,1,0,1,4,2,0,3,18,17,21,24,1,3,March,1.0,6.123233995736766e-17,26,32,0,1,0,2.0,2.0,41,59,-18,34,50,-16,"March, 2024"
2023-2024,29,2024-03-16,Fulham,Tottenham,3,0,H,3,0,1,2,2,2,0,3,12,5,35,53,7,18,March,1.0,6.123233995736766e-17,19,42,0,1,4,0.4,1.4,40,44,-4,59,39,20,"March, 2024"
2023-2024,29,2024-03-17,West Ham,Aston Villa,1,1,D,1,1,1,1,3,1,2,2,7,4,43,55,3,12,March,1.0,6.123233995736766e-17,45,1,3,1,1,1.8,1.4,45,49,-4,59,41,18,"March, 2024"
2023-2024,30,2024-03-30,Aston Villa,Wolves,2,0,H,3,0,1,2,2,1,0,4,5,10,56,41,5,15,March,1.0,6.123233995736766e-17,1,48,0,2,3,1.0,1.6,60,42,18,42,44,-2,"March, 2024"
2023-2024,30,2024-03-30,Tottenham,Luton,2,1,H,3,0,2,0,3,0,1,4,5,18,53,22,13,31,March,1.0,6.123233995736766e-17,42,26,1,0,0,1.0,0.0,59,42,17,42,60,-18,"March, 2024"
2023-2024,30,2024-03-30,Sheffield United,Fulham,3,3,D,1,1,0,0,5,1,2,2,20,12,14,38,8,24,March,1.0,6.123233995736766e-17,36,19,1,1,3,0.8,1.2,24,74,-50,43,44,-1,"March, 2024"
2023-2024,30,2024-03-30,Brentford,Man United,1,1,D,1,1,2,1,2,2,1,2,16,6,26,47,10,21,March,1.0,6.123233995736766e-17,9,28,1,0,4,1.2,1.8,41,54,-13,39,39,0,"March, 2024"
2023-2024,30,2024-03-30,Chelsea,Burnley,2,2,D,1,1,5,0,0,1,1,3,11,19,39,17,8,22,March,1.0,6.123233995736766e-17,14,11,4,1,0,2.8,0.4,47,45,2,29,63,-34,"March, 2024"
2023-2024,30,2024-03-30,Bournemouth,Everton,2,1,H,3,0,2,0,3,3,1,1,13,14,35,31,1,4,March,1.0,6.123233995736766e-17,7,18,3,0,2,1.8,1.2,41,52,-11,29,39,-10,"March, 2024"
2023-2024,30,2024-03-30,Newcastle,West Ham,4,3,H,3,0,3,1,1,1,1,3,10,7,40,44,3,4,March,1.0,6.123233995736766e-17,30,45,1,3,1,2.2,1.8,59,48,11,46,50,-4,"March, 2024"
2023-2024,30,2024-03-30,Nott'm Forest,Crystal Palace,1,1,D,1,1,2,0,3,4,1,0,17,15,25,29,2,4,March,1.0,6.123233995736766e-17,32,16,1,2,0,0.6666666666666666,0.3333333333333333,35,51,-16,33,48,-15,"March, 2024"
2023-2024,30,2024-03-31,Liverpool,Brighton,2,1,H,3,0,2,2,1,1,1,3,2,9,64,42,7,22,March,1.0,6.123233995736766e-17,25,10,1,3,1,1.8,2.0,65,26,39,50,44,6,"March, 2024"
2023-2024,30,2024-03-31,Man City,Arsenal,0,0,D,1,1,5,0,0,5,0,0,3,2,63,64,1,1,March,1.0,6.123233995736766e-17,27,0,4,0,1,2.8,0.8,63,28,35,70,24,46,"March, 2024"
2023-2024,31,2024-04-02,Newcastle,Everton,1,1,D,1,1,3,1,1,3,1,1,8,14,43,31,6,12,April,0.8660254037844388,-0.4999999999999998,30,18,3,0,2,1.6,1.2,63,51,12,30,41,-11,"April, 2024"
2023-2024,31,2024-04-02,Nott'm Forest,Fulham,3,1,H,3,0,2,0,3,1,2,2,17,12,26,39,5,13,April,0.8660254037844388,-0.4999999999999998,32,19,0,0,3,0.6666666666666666,3.333333333333333,36,52,-16,46,47,-1,"April, 2024"
2023-2024,31,2024-04-02,Bournemouth,Crystal Palace,1,0,H,3,0,2,0,3,4,1,0,13,15,38,30,2,8,April,0.8660254037844388,-0.4999999999999998,7,16,1,0,4,0.4,1.4,43,53,-10,34,49,-15,"April, 2024"
2023-2024,31,2024-04-02,Burnley,Wolves,1,1,D,1,1,1,1,3,1,0,4,19,10,18,41,9,23,April,0.8660254037844388,-0.4999999999999998,11,48,3,1,1,1.4,0.4,31,65,-34,42,46,-4,"April, 2024"
2023-2024,31,2024-04-02,West Ham,Tottenham,1,1,D,1,1,1,1,3,2,0,3,8,5,44,56,3,12,April,0.8660254037844388,-0.4999999999999998,45,42,2,1,2,1.0,1.4,49,54,-5,61,43,18,"April, 2024"
2023-2024,31,2024-04-03,Man City,Aston Villa,4,1,H,3,0,5,0,0,1,2,2,3,4,64,59,1,5,April,0.8660254037844388,-0.4999999999999998,27,1,3,1,1,1.8,1.2,63,28,35,62,42,20,"April, 2024"
2023-2024,31,2024-04-03,Arsenal,Luton,2,0,H,3,0,5,0,0,0,1,4,2,18,65,22,16,43,April,0.8660254037844388,-0.4999999999999998,0,26,1,0,0,4.0,3.0,70,24,46,43,62,-19,"April, 2024"
2023-2024,31,2024-04-03,Brentford,Brighton,0,0,D,1,1,2,1,2,1,1,3,17,9,27,42,8,15,April,0.8660254037844388,-0.4999999999999998,9,10,1,1,3,1.2,1.6,42,55,-13,51,46,5,"April, 2024"
2023-2024,31,2024-04-04,Liverpool,Sheffield United,3,1,H,3,0,2,2,1,0,0,5,2,20,67,15,18,52,April,0.8660254037844388,-0.4999999999999998,25,36,5,0,0,1.8,0.2,67,27,40,27,77,-50,"April, 2024"
2023-2024,31,2024-04-04,Chelsea,Man United,4,3,H,3,0,5,0,0,2,1,2,12,6,40,48,6,8,April,0.8660254037844388,-0.4999999999999998,14,28,0,3,2,1.0,1.8,49,47,2,40,40,0,"April, 2024"
2023-2024,32,2024-04-06,Brighton,Arsenal,0,3,A,0,3,1,1,3,5,0,0,9,3,43,68,6,25,April,0.8660254037844388,-0.4999999999999998,10,0,2,1,2,1.4,1.4,51,46,5,72,24,48,"April, 2024"
2023-2024,32,2024-04-06,Crystal Palace,Man City,2,4,A,0,3,4,1,0,5,0,0,15,3,30,67,12,37,April,0.8660254037844388,-0.4999999999999998,16,27,1,2,2,1.2,1.4,34,50,-16,67,29,38,"April, 2024"
2023-2024,32,2024-04-06,Aston Villa,Brentford,3,3,D,1,1,1,2,2,2,1,2,4,17,59,28,13,31,April,0.8660254037844388,-0.4999999999999998,1,9,2,2,1,1.8,1.0,63,46,17,42,55,-13,"April, 2024"
2023-2024,32,2024-04-06,Everton,Burnley,1,0,H,3,0,3,1,1,1,1,3,14,19,32,19,5,13,April,0.8660254037844388,-0.4999999999999998,18,11,2,1,2,1.8,1.4,31,42,-11,32,66,-34,"April, 2024"
2023-2024,32,2024-04-06,Fulham,Newcastle,0,1,A,0,3,1,2,2,3,1,1,13,8,39,44,5,5,April,0.8660254037844388,-0.4999999999999998,19,30,0,1,4,0.4,2.2,47,50,-3,64,52,12,"April, 2024"
2023-2024,32,2024-04-06,Luton,Bournemouth,2,1,H,3,0,0,1,4,2,0,3,18,12,22,41,6,19,April,0.8660254037844388,-0.4999999999999998,26,7,0,0,1,3.0,4.0,43,64,-21,44,53,-9,"April, 2024"
2023-2024,32,2024-04-06,Wolves,West Ham,1,2,A,0,3,1,0,4,1,1,3,11,8,42,45,3,3,April,0.8660254037844388,-0.4999999999999998,48,45,2,0,3,0.4,1.2,43,47,-4,50,55,-5,"April, 2024"
2023-2024,32,2024-04-07,Sheffield United,Chelsea,2,2,D,1,1,0,0,5,5,0,0,20,9,15,43,11,28,April,0.8660254037844388,-0.4999999999999998,36,14,1,1,3,1.4,2.0,28,80,-52,53,50,3,"April, 2024"
2023-2024,32,2024-04-07,Tottenham,Nott'm Forest,3,1,H,3,0,2,0,3,2,0,3,5,17,57,29,12,28,April,0.8660254037844388,-0.4999999999999998,42,32,5,0,0,2.0,0.2,62,44,18,39,53,-14,"April, 2024"
2023-2024,32,2024-04-07,Man United,Liverpool,2,2,D,1,1,2,1,2,2,2,1,6,2,48,70,4,22,April,0.8660254037844388,-0.4999999999999998,28,25,1,1,3,0.4,3.4,43,44,-1,70,28,42,"April, 2024"
2023-2024,33,2024-04-13,Bournemouth,Man United,2,2,D,1,1,2,0,3,2,1,2,12,7,41,49,5,8,April,0.8660254037844388,-0.4999999999999998,7,28,2,0,3,1.2,1.8,45,55,-10,45,46,-1,"April, 2024"
2023-2024,33,2024-04-13,Nott'm Forest,Wolves,2,2,D,1,1,2,0,3,1,0,4,17,11,29,42,6,13,April,0.8660254037844388,-0.4999999999999998,32,48,0,2,1,0.6666666666666666,1.0,40,56,-16,44,49,-5,"April, 2024"
2023-2024,33,2024-04-13,Man City,Luton,5,1,H,3,0,5,0,0,0,1,4,3,18,70,25,15,45,April,0.8660254037844388,-0.4999999999999998,27,26,1,0,0,2.0,1.0,71,31,40,45,65,-20,"April, 2024"
2023-2024,33,2024-04-13,Newcastle,Tottenham,4,0,H,3,0,3,1,1,2,0,3,8,4,47,60,4,13,April,0.8660254037844388,-0.4999999999999998,30,42,2,0,3,2.4,2.8,65,52,13,65,45,20,"April, 2024"
2023-2024,33,2024-04-13,Brentford,Sheffield United,2,0,H,3,0,2,1,2,0,0,5,16,20,29,16,4,13,April,0.8660254037844388,-0.4999999999999998,9,36,0,0,1,0.0,1.0,45,58,-13,30,82,-52,"April, 2024"
2023-2024,33,2024-04-13,Burnley,Brighton,1,1,D,1,1,1,1,3,1,1,3,19,10,19,43,9,24,April,0.8660254037844388,-0.4999999999999998,11,10,1,3,1,1.2,0.8,32,67,-35,51,49,2,"April, 2024"
2023-2024,33,2024-04-14,Liverpool,Crystal Palace,0,1,A,0,3,2,2,1,4,1,0,3,17,71,30,14,41,April,0.8660254037844388,-0.4999999999999998,25,16,3,2,0,1.8,0.6,72,30,42,36,54,-18,"April, 2024"
2023-2024,33,2024-04-14,West Ham,Fulham,0,2,A,0,3,1,1,3,1,2,2,8,13,48,39,5,9,April,0.8660254037844388,-0.4999999999999998,45,19,3,1,1,1.0,1.2,52,56,-4,47,51,-4,"April, 2024"
2023-2024,33,2024-04-14,Arsenal,Aston Villa,0,2,A,0,3,5,0,0,1,2,2,2,4,71,60,2,11,April,0.8660254037844388,-0.4999999999999998,0,1,4,0,1,2.0,1.0,75,24,51,66,49,17,"April, 2024"
2023-2024,33,2024-04-15,Chelsea,Everton,6,0,H,3,0,5,0,0,3,1,1,9,14,44,35,5,9,April,0.8660254037844388,-0.4999999999999998,14,18,1,2,2,0.8,1.2,55,52,3,32,42,-10,"April, 2024"
2023-2024,34,2024-04-20,Luton,Brentford,1,5,A,0,3,0,1,4,2,1,2,18,16,25,32,2,7,April,0.8660254037844388,-0.4999999999999998,26,9,0,0,1,1.0,3.0,46,70,-24,47,58,-11,"April, 2024"
2023-2024,34,2024-04-20,Sheffield United,Burnley,1,4,A,0,3,0,0,5,1,1,3,20,19,16,20,1,4,April,0.8660254037844388,-0.4999999999999998,36,11,2,1,2,1.0,1.4,30,84,-54,33,68,-35,"April, 2024"
2023-2024,34,2024-04-20,Wolves,Arsenal,0,2,A,0,3,1,0,4,5,0,0,11,2,43,71,9,28,April,0.8660254037844388,-0.4999999999999998,48,0,0,0,5,0.4,2.4,46,51,-5,75,26,49,"April, 2024"
2023-2024,34,2024-04-21,Fulham,Liverpool,1,3,A,0,3,1,2,2,2,2,1,12,3,42,71,9,29,April,0.8660254037844388,-0.4999999999999998,19,25,1,2,2,1.4,1.6,49,51,-2,72,31,41,"April, 2024"
2023-2024,34,2024-04-21,Crystal Palace,West Ham,5,2,H,3,0,4,1,0,1,1,3,16,8,33,48,8,15,April,0.8660254037844388,-0.4999999999999998,16,45,2,2,1,2.2,2.0,37,54,-17,52,58,-6,"April, 2024"
2023-2024,34,2024-04-21,Aston Villa,Bournemouth,3,1,H,3,0,1,2,2,2,0,3,4,13,63,42,9,21,April,0.8660254037844388,-0.4999999999999998,1,7,1,1,3,1.4,1.6,68,49,19,47,57,-10,"April, 2024"
2023-2024,34,2024-04-21,Everton,Nott'm Forest,2,0,H,3,0,3,1,1,2,0,3,15,17,35,30,2,5,April,0.8660254037844388,-0.4999999999999998,18,32,2,2,1,1.2,0.8,32,48,-16,42,58,-16,"April, 2024"
2023-2024,34,2024-04-23,Arsenal,Chelsea,5,0,H,3,0,5,0,0,5,0,0,1,9,74,47,8,27,April,0.8660254037844388,-0.4999999999999998,0,14,3,1,1,2.0,1.4,77,26,51,61,52,9,"April, 2024"
2023-2024,34,2024-04-24,Wolves,Bournemouth,0,1,A,0,3,1,0,4,2,0,3,11,13,43,42,2,1,April,0.8660254037844388,-0.4999999999999998,48,7,3,1,1,1.0,0.6,46,53,-7,48,60,-12,"April, 2024"
2023-2024,34,2024-04-24,Crystal Palace,Newcastle,2,0,H,3,0,4,1,0,3,1,1,15,6,36,50,9,14,April,0.8660254037844388,-0.4999999999999998,16,30,0,3,2,0.2,1.2,42,56,-14,69,52,17,"April, 2024"
2023-2024,34,2024-04-24,Everton,Liverpool,2,0,H,3,0,3,1,1,2,2,1,15,2,38,74,13,36,April,0.8660254037844388,-0.4999999999999998,18,25,0,1,4,0.2,2.0,34,48,-14,75,32,43,"April, 2024"
2023-2024,34,2024-04-24,Man United,Sheffield United,4,2,H,3,0,2,1,2,0,0,5,7,20,50,16,13,34,April,0.8660254037844388,-0.4999999999999998,28,36,3,1,1,2.4,1.6,47,48,-1,31,88,-57,"April, 2024"
2023-2024,34,2024-04-25,Brighton,Man City,0,4,A,0,3,1,1,3,5,0,0,11,3,44,73,8,29,April,0.8660254037844388,-0.4999999999999998,10,27,0,1,4,0.8,2.6,52,50,2,76,32,44,"April, 2024"
2023-2024,35,2024-04-27,Aston Villa,Chelsea,2,2,D,1,1,1,2,2,5,0,0,4,9,66,47,5,19,April,0.8660254037844388,-0.4999999999999998,1,14,2,0,3,0.8,1.6,71,50,21,61,57,4,"April, 2024"
2023-2024,35,2024-04-27,Everton,Brentford,1,0,H,3,0,3,1,1,2,1,2,14,16,41,35,2,6,April,0.8660254037844388,-0.4999999999999998,18,9,2,1,2,1.4,1.2,36,48,-12,52,59,-7,"April, 2024"
2023-2024,35,2024-04-27,Wolves,Luton,2,1,H,3,0,1,0,4,0,1,4,13,18,43,25,5,18,April,0.8660254037844388,-0.4999999999999998,48,26,0,1,0,1.0,1.0,46,54,-8,47,75,-28,"April, 2024"
2023-2024,35,2024-04-27,Man United,Burnley,1,1,D,1,1,2,1,2,1,1,3,6,19,53,23,13,30,April,0.8660254037844388,-0.4999999999999998,28,11,4,1,0,1.8,0.6,51,50,1,37,69,-32,"April, 2024"
2023-2024,35,2024-04-27,Fulham,Crystal Palace,1,1,D,1,1,1,2,2,4,1,0,13,15,42,39,2,3,April,0.8660254037844388,-0.4999999999999998,19,16,1,3,1,1.2,0.8,50,54,-4,44,56,-12,"April, 2024"
2023-2024,35,2024-04-27,West Ham,Liverpool,2,2,D,1,1,1,1,3,2,2,1,8,3,48,74,5,26,April,0.8660254037844388,-0.4999999999999998,45,25,1,0,4,1.0,1.8,54,63,-9,75,34,41,"April, 2024"
2023-2024,35,2024-04-27,Newcastle,Sheffield United,5,1,H,3,0,3,1,1,0,0,5,7,20,50,16,13,34,April,0.8660254037844388,-0.4999999999999998,30,36,4,0,1,2.8,0.2,69,54,15,33,92,-59,"April, 2024"
2023-2024,35,2024-04-28,Bournemouth,Brighton,3,0,H,3,0,2,0,3,1,1,3,11,12,45,44,1,1,April,0.8660254037844388,-0.4999999999999998,7,10,1,0,4,0.8,1.8,49,60,-11,52,54,-2,"April, 2024"
2023-2024,35,2024-04-28,Tottenham,Arsenal,2,3,A,0,3,2,0,3,5,0,0,5,1,60,77,4,17,April,0.8660254037844388,-0.4999999999999998,42,0,1,1,3,1.4,2.0,65,49,16,82,26,56,"April, 2024"
2023-2024,35,2024-04-28,Nott'm Forest,Man City,0,2,A,0,3,2,0,3,5,0,0,17,2,30,76,15,46,April,0.8660254037844388,-0.4999999999999998,32,27,1,2,2,1.0,2.0,42,60,-18,80,32,48,"April, 2024"
2023-2024,35,2024-05-02,Chelsea,Tottenham,2,0,H,3,0,5,0,0,2,0,3,9,5,48,60,4,12,May,0.4999999999999999,-0.8660254037844387,14,42,3,1,1,2.2,1.0,63,59,4,67,52,15,"May, 2024"
2023-2024,36,2024-05-03,Luton,Everton,1,1,D,1,1,0,1,4,3,1,1,18,13,25,44,5,19,May,0.4999999999999999,-0.8660254037844387,26,18,1,0,0,2.0,1.0,48,77,-29,37,48,-11,"May, 2024"
2023-2024,36,2024-05-04,Burnley,Newcastle,1,4,A,0,3,1,1,3,3,1,1,19,7,24,53,12,29,May,0.4999999999999999,-0.8660254037844387,11,30,0,0,5,0.6,2.0,38,70,-32,74,55,19,"May, 2024"
2023-2024,36,2024-05-04,Man City,Wolves,5,1,H,3,0,5,0,0,1,0,4,2,11,79,46,9,33,May,0.4999999999999999,-0.8660254037844387,27,48,4,0,1,2.6,0.6,82,32,50,48,55,-7,"May, 2024"
2023-2024,36,2024-05-04,Sheffield United,Nott'm Forest,1,3,A,0,3,0,0,5,2,0,3,20,17,16,30,3,14,May,0.4999999999999999,-0.8660254037844387,36,32,0,0,1,1.0,2.0,34,97,-63,42,62,-20,"May, 2024"
2023-2024,36,2024-05-04,Arsenal,Bournemouth,3,0,H,3,0,5,0,0,2,0,3,1,10,80,48,9,32,May,0.4999999999999999,-0.8660254037844387,0,7,4,1,0,2.4,0.6,85,28,57,52,60,-8,"May, 2024"
2023-2024,36,2024-05-04,Brentford,Fulham,0,0,D,1,1,2,1,2,1,2,2,16,14,35,43,2,8,May,0.4999999999999999,-0.8660254037844387,9,19,2,0,1,2.6666666666666665,1.6666666666666667,52,60,-8,51,55,-4,"May, 2024"
2023-2024,36,2024-05-05,Brighton,Aston Villa,1,0,H,3,0,1,1,3,1,2,2,14,4,44,67,10,23,May,0.4999999999999999,-0.8660254037844387,10,1,0,0,5,0.6,2.8,52,57,-5,73,52,21,"May, 2024"
2023-2024,36,2024-05-05,Chelsea,West Ham,5,0,H,3,0,5,0,0,1,1,3,8,9,51,49,1,2,May,0.4999999999999999,-0.8660254037844387,14,45,2,1,2,1.4,1.6,65,59,6,56,65,-9,"May, 2024"
2023-2024,36,2024-05-05,Liverpool,Tottenham,4,2,H,3,0,2,2,1,2,0,3,3,5,75,60,2,15,May,0.4999999999999999,-0.8660254037844387,25,42,2,2,1,2.0,1.8,77,36,41,67,54,13,"May, 2024"
2023-2024,36,2024-05-06,Crystal Palace,Man United,4,0,H,3,0,4,1,0,2,1,2,15,8,40,54,7,14,May,0.4999999999999999,-0.8660254037844387,16,28,2,1,2,0.8,0.8,45,57,-12,52,51,1,"May, 2024"
2023-2024,37,2024-05-11,Nott'm Forest,Chelsea,2,3,A,0,3,2,0,3,5,0,0,17,7,33,54,10,21,May,0.4999999999999999,-0.8660254037844387,32,14,1,2,2,1.2,1.6,45,63,-18,70,59,11,"May, 2024"
2023-2024,37,2024-05-11,West Ham,Luton,3,1,H,3,0,1,1,3,0,1,4,9,18,49,26,9,23,May,0.4999999999999999,-0.8660254037844387,45,26,1,0,0,2.0,1.0,56,70,-14,49,78,-29,"May, 2024"
2023-2024,37,2024-05-11,Wolves,Crystal Palace,1,3,A,0,3,1,0,4,4,1,0,13,15,46,43,2,3,May,0.4999999999999999,-0.8660254037844387,48,16,1,0,4,1.0,1.8,49,60,-11,49,57,-8,"May, 2024"
2023-2024,37,2024-05-11,Tottenham,Burnley,2,1,H,3,0,2,0,3,1,1,3,5,19,60,24,14,36,May,0.4999999999999999,-0.8660254037844387,42,11,4,0,1,2.2,0.6,69,58,11,39,74,-35,"May, 2024"
2023-2024,37,2024-05-11,Bournemouth,Brentford,1,2,A,0,3,2,0,3,2,1,2,10,16,48,36,6,12,May,0.4999999999999999,-0.8660254037844387,7,9,0,2,1,0.6666666666666666,1.3333333333333333,52,63,-11,52,60,-8,"May, 2024"
2023-2024,37,2024-05-11,Everton,Sheffield United,1,0,H,3,0,3,1,1,0,0,5,13,20,45,16,7,29,May,0.4999999999999999,-0.8660254037844387,18,36,2,1,2,0.8,1.0,38,49,-11,35,100,-65,"May, 2024"
2023-2024,37,2024-05-11,Fulham,Man City,0,4,A,0,3,1,2,2,5,0,0,14,2,44,82,12,38,May,0.4999999999999999,-0.8660254037844387,19,27,0,0,5,0.6,2.8,51,55,-4,87,33,54,"May, 2024"
2023-2024,37,2024-05-11,Newcastle,Brighton,1,1,D,1,1,3,1,1,1,1,3,6,12,56,47,6,9,May,0.4999999999999999,-0.8660254037844387,30,10,2,2,1,1.6,1.2,78,56,22,53,57,-4,"May, 2024"
2023-2024,37,2024-05-12,Man United,Arsenal,0,1,A,0,3,2,1,2,5,0,0,8,2,54,83,6,29,May,0.4999999999999999,-0.8660254037844387,28,0,2,0,3,2.0,2.4,52,55,-3,88,28,60,"May, 2024"
2023-2024,37,2024-05-13,Aston Villa,Liverpool,3,3,D,1,1,1,2,2,2,2,1,4,3,67,78,1,11,May,0.4999999999999999,-0.8660254037844387,1,25,0,1,4,0.6,2.0,73,53,20,81,38,43,"May, 2024"
2023-2024,37,2024-05-14,Tottenham,Man City,0,2,A,0,3,2,0,3,5,0,0,5,2,63,85,3,22,May,0.4999999999999999,-0.8660254037844387,42,27,3,1,1,2.0,1.8,71,59,12,91,33,58,"May, 2024"
2023-2024,37,2024-05-15,Brighton,Chelsea,1,2,A,0,3,1,1,3,5,0,0,10,7,48,57,3,9,May,0.4999999999999999,-0.8660254037844387,10,14,2,2,1,2.0,1.4,54,58,-4,73,61,12,"May, 2024"
2023-2024,37,2024-05-15,Man United,Newcastle,3,2,H,3,0,2,1,2,3,1,1,8,7,54,57,1,3,May,0.4999999999999999,-0.8660254037844387,28,30,1,2,2,1.0,1.0,52,56,-4,79,57,22,"May, 2024"
2023-2024,38,2024-05-19,Luton,Fulham,2,4,A,0,3,0,1,4,1,2,2,18,15,26,44,3,18,May,0.4999999999999999,-0.8660254037844387,26,19,0,0,1,0.0,1.0,50,81,-31,51,59,-8,"May, 2024"
2023-2024,38,2024-05-19,Liverpool,Wolves,2,0,H,3,0,2,2,1,1,0,4,3,14,79,46,11,33,May,0.4999999999999999,-0.8660254037844387,25,48,4,0,1,1.8,1.0,84,41,43,50,63,-13,"May, 2024"
2023-2024,38,2024-05-19,Crystal Palace,Aston Villa,5,0,H,3,0,4,1,0,1,2,2,13,4,46,68,9,22,May,0.4999999999999999,-0.8660254037844387,16,1,1,1,3,1.2,1.6,52,58,-6,76,56,20,"May, 2024"
2023-2024,38,2024-05-19,Chelsea,Bournemouth,2,1,H,3,0,5,0,0,2,0,3,7,12,60,48,5,12,May,0.4999999999999999,-0.8660254037844387,14,7,2,2,1,1.4,0.8,75,62,13,53,65,-12,"May, 2024"
2023-2024,38,2024-05-19,Arsenal,Everton,2,1,H,3,0,5,0,0,3,1,1,2,11,86,48,9,38,May,0.4999999999999999,-0.8660254037844387,0,18,3,0,2,2.2,0.8,89,28,61,39,49,-10,"May, 2024"
2023-2024,38,2024-05-19,Brighton,Man United,0,2,A,0,3,1,1,3,2,1,2,10,8,48,57,2,9,May,0.4999999999999999,-0.8660254037844387,10,28,4,0,1,2.0,0.8,55,60,-5,55,58,-3,"May, 2024"
2023-2024,38,2024-05-19,Brentford,Newcastle,2,4,A,0,3,2,1,2,3,1,1,16,7,39,57,9,18,May,0.4999999999999999,-0.8660254037844387,9,30,0,1,4,1.0,2.6,54,61,-7,81,60,21,"May, 2024"
2023-2024,38,2024-05-19,Man City,West Ham,3,1,H,3,0,5,0,0,1,1,3,2,9,88,52,7,36,May,0.4999999999999999,-0.8660254037844387,27,45,4,1,0,2.4,0.8,93,33,60,59,71,-12,"May, 2024"
2023-2024,38,2024-05-19,Burnley,Nott'm Forest,1,2,A,0,3,1,1,3,2,0,3,19,17,24,33,2,9,May,0.4999999999999999,-0.8660254037844387,11,32,0,1,0,1.0,1.0,40,76,-36,47,66,-19,"May, 2024"
2023-2024,38,2024-05-19,Sheffield United,Tottenham,0,3,A,0,3,0,0,5,2,0,3,20,6,16,63,14,47,May,0.4999999999999999,-0.8660254037844387,36,42,1,1,3,1.2,2.2,35,101,-66,71,61,10,"May, 2024"
2024-2025,1,2024-08-16,Man United,Fulham,1,0,H,3,0,1,1,3,2,0,3,14,9,0,0,5,0,August,-0.8660254037844384,-0.5000000000000004,28,19,3,1,1,1.4,1.0,0,0,0,0,0,0,"August, 2024"
2024-2025,1,2024-08-17,Ipswich,Liverpool,0,2,A,0,3,0,1,4,1,2,2,10,12,0,0,2,0,August,-0.8660254037844384,-0.5000000000000004,22,25,1,1,2,0.5,3.0,0,0,0,0,0,0,"August, 2024"
2024-2025,1,2024-08-17,Arsenal,Wolves,2,0,H,3,0,2,2,1,1,1,3,3,18,0,0,15,0,August,-0.8660254037844384,-0.5000000000000004,0,48,5,0,0,2.6,0.4,0,0,0,0,0,0,"August, 2024"
2024-2025,1,2024-08-17,Everton,Brighton,0,3,A,0,3,3,1,1,4,1,0,10,7,0,0,3,0,August,-0.8660254037844384,-0.5000000000000004,18,10,1,2,2,2.0,2.0,0,0,0,0,0,0,"August, 2024"
2024-2025,1,2024-08-17,Newcastle,Southampton,1,0,H,3,0,2,1,2,0,1,4,12,14,0,0,2,0,August,-0.8660254037844384,-0.5000000000000004,30,38,4,1,0,2.8,1.4,0,0,0,0,0,0,"August, 2024"
2024-2025,1,2024-08-17,Nott'm Forest,Bournemouth,1,1,D,1,1,1,2,2,2,1,2,13,7,0,0,6,0,August,-0.8660254037844384,-0.5000000000000004,32,7,0,2,2,1.5,2.0,0,0,0,0,0,0,"August, 2024"
2024-2025,1,2024-08-17,West Ham,Aston Villa,1,2,A,0,3,2,1,2,3,0,2,15,8,0,0,7,0,August,-0.8660254037844384,-0.5000000000000004,45,1,2,2,1,1.2,1.4,0,0,0,0,0,0,"August, 2024"
2024-2025,1,2024-08-18,Brentford,Crystal Palace,2,1,H,3,0,3,1,1,2,3,0,9,11,0,0,2,0,August,-0.8660254037844384,-0.5000000000000004,9,16,0,4,1,0.8,1.2,0,0,0,0,0,0,"August, 2024"
2024-2025,1,2024-08-18,Chelsea,Man City,0,2,A,0,3,4,0,1,4,1,0,10,12,0,0,2,0,August,-0.8660254037844384,-0.5000000000000004,14,27,0,2,3,1.0,1.6,0,0,0,0,0,0,"August, 2024"
2024-2025,1,2024-08-19,Leicester,Tottenham,1,1,D,1,1,2,1,2,0,1,4,11,12,0,0,1,0,August,-0.8660254037844384,-0.5000000000000004,24,42,1,0,4,2.2,3.4,0,0,0,0,0,0,"August, 2024"
2024-2025,2,2024-08-24,Aston Villa,Arsenal,0,2,A,0,3,3,0,2,2,2,1,8,5,3,3,3,0,August,-0.8660254037844384,-0.5000000000000004,1,0,2,0,3,1.2,1.4,2,1,1,2,0,2,"August, 2024"
2024-2025,2,2024-08-24,Tottenham,Everton,4,0,H,3,0,0,1,4,3,1,1,13,19,1,0,6,1,August,-0.8660254037844384,-0.5000000000000004,42,18,3,2,0,2.4,0.8,1,1,0,0,3,-3,"August, 2024"
2024-2025,2,2024-08-24,Southampton,Nott'm Forest,0,1,A,0,3,0,1,4,1,2,2,15,12,0,1,3,1,August,-0.8660254037844384,-0.5000000000000004,38,32,1,1,3,1.6,1.8,0,1,-1,1,1,0,"August, 2024"
2024-2025,2,2024-08-24,Brighton,Man United,2,1,H,3,0,4,1,0,1,1,3,1,7,3,3,6,0,August,-0.8660254037844384,-0.5000000000000004,10,28,4,0,1,2.0,0.8,3,0,3,1,0,1,"August, 2024"
2024-2025,2,2024-08-24,Fulham,Leicester,2,1,H,3,0,2,0,3,2,1,2,14,11,0,1,3,1,August,-0.8660254037844384,-0.5000000000000004,19,24,3,0,2,1.8,1.8,0,1,-1,1,1,0,"August, 2024"
2024-2025,2,2024-08-24,Crystal Palace,West Ham,0,2,A,0,3,2,3,0,2,1,2,13,14,0,0,1,0,August,-0.8660254037844384,-0.5000000000000004,16,45,3,1,1,2.8,2.0,1,2,-1,1,2,-1,"August, 2024"
2024-2025,2,2024-08-24,Man City,Ipswich,4,1,H,3,0,4,1,0,0,1,4,4,17,3,0,13,3,August,-0.8660254037844384,-0.5000000000000004,27,22,0,0,2,1.5,2.5,2,0,2,0,2,-2,"August, 2024"
2024-2025,2,2024-08-25,Wolves,Chelsea,2,6,A,0,3,1,1,3,4,0,1,17,15,0,0,2,0,August,-0.8660254037844384,-0.5000000000000004,48,14,3,1,1,1.8,1.6,0,2,-2,0,2,-2,"August, 2024"
2024-2025,2,2024-08-25,Bournemouth,Newcastle,1,1,D,1,1,2,1,2,2,1,2,13,9,1,3,4,2,August,-0.8660254037844384,-0.5000000000000004,7,30,1,3,1,1.4,1.6,1,1,0,1,0,1,"August, 2024"
2024-2025,2,2024-08-25,Liverpool,Brentford,2,0,H,3,0,1,2,2,3,1,1,8,10,3,3,2,0,August,-0.8660254037844384,-0.5000000000000004,25,9,4,0,1,2.4,0.8,2,0,2,2,1,1,"August, 2024"
2024-2025,3,2024-08-31,Nott'm Forest,Wolves,1,1,D,1,1,1,2,2,1,1,3,10,19,4,0,9,4,August,-0.8660254037844384,-0.5000000000000004,32,48,0,3,1,1.0,1.25,2,1,1,2,8,-6,"August, 2024"
2024-2025,3,2024-08-31,West Ham,Man City,1,3,A,0,3,2,1,2,4,1,0,13,3,3,6,10,3,August,-0.8660254037844384,-0.5000000000000004,45,27,0,1,4,0.8,2.6,3,2,1,6,1,5,"August, 2024"
2024-2025,3,2024-08-31,Leicester,Aston Villa,1,2,A,0,3,2,1,2,3,0,2,15,14,1,3,1,2,August,-0.8660254037844384,-0.5000000000000004,24,1,2,1,2,1.6,1.4,2,3,-1,2,3,-1,"August, 2024"
2024-2025,3,2024-08-31,Ipswich,Fulham,1,1,D,1,1,0,1,4,2,0,3,18,12,0,3,6,3,August,-0.8660254037844384,-0.5000000000000004,22,19,1,1,0,1.0,0.5,1,6,-5,2,2,0,"August, 2024"
2024-2025,3,2024-08-31,Everton,Bournemouth,2,3,A,0,3,3,1,1,2,1,2,20,14,0,2,6,2,August,-0.8660254037844384,-0.5000000000000004,18,7,2,0,3,1.2,1.6,0,7,-7,2,2,0,"August, 2024"
2024-2025,3,2024-08-31,Brentford,Southampton,3,1,H,3,0,3,1,1,0,1,4,13,16,3,0,3,3,August,-0.8660254037844384,-0.5000000000000004,9,38,3,0,1,2.25,1.0,2,3,-1,0,2,-2,"August, 2024"
2024-2025,3,2024-08-31,Arsenal,Brighton,1,1,D,1,1,2,2,1,4,1,0,3,2,6,6,1,0,August,-0.8660254037844384,-0.5000000000000004,0,10,3,0,2,2.0,1.4,4,0,4,5,1,4,"August, 2024"
2024-2025,3,2024-09-01,Chelsea,Crystal Palace,1,1,D,1,1,4,0,1,2,3,0,12,18,3,0,6,3,September,-1.0,-1.8369701987210287e-16,14,16,5,0,0,1.8,0.6,6,4,2,1,4,-3,"September, 2024"
2024-2025,3,2024-09-01,Newcastle,Tottenham,2,1,H,3,0,2,1,2,0,1,4,11,9,4,4,2,0,September,-1.0,-1.8369701987210287e-16,30,42,3,0,2,2.8,2.2,2,1,1,5,1,4,"September, 2024"
2024-2025,3,2024-09-01,Man United,Liverpool,0,3,A,0,3,1,1,3,1,2,2,13,5,3,6,8,3,September,-1.0,-1.8369701987210287e-16,28,25,1,2,2,0.8,2.8,2,2,0,4,0,4,"September, 2024"
2024-2025,4,2024-09-14,Bournemouth,Chelsea,0,1,A,0,3,2,1,2,4,0,1,10,13,5,4,3,1,September,-1.0,-1.8369701987210287e-16,7,14,0,2,3,0.8,1.8,5,4,1,7,5,2,"September, 2024"
2024-2025,4,2024-09-14,Aston Villa,Everton,3,2,H,3,0,3,0,2,3,1,1,9,20,6,0,11,6,September,-1.0,-1.8369701987210287e-16,1,18,4,1,0,1.8,0.2,4,4,0,2,10,-8,"September, 2024"
2024-2025,4,2024-09-14,Man City,Brentford,2,1,H,3,0,4,1,0,3,1,1,1,7,9,6,6,3,September,-1.0,-1.8369701987210287e-16,27,9,3,0,2,1.4,0.8,9,2,7,5,4,1,"September, 2024"
2024-2025,4,2024-09-14,Liverpool,Nott'm Forest,0,1,A,0,3,1,2,2,1,2,2,2,10,9,5,8,4,September,-1.0,-1.8369701987210287e-16,25,32,3,1,1,1.8,1.0,7,0,7,3,2,1,"September, 2024"
2024-2025,4,2024-09-14,Fulham,West Ham,1,1,D,1,1,2,0,3,2,1,2,13,14,4,3,1,1,September,-1.0,-1.8369701987210287e-16,19,45,2,1,2,1.6,0.8,3,3,0,4,5,-1,"September, 2024"
2024-2025,4,2024-09-14,Crystal Palace,Leicester,2,2,D,1,1,2,3,0,2,1,2,17,16,1,1,1,0,September,-1.0,-1.8369701987210287e-16,16,24,1,2,2,1.2,1.4,2,5,-3,3,5,-2,"September, 2024"
2024-2025,4,2024-09-14,Brighton,Ipswich,0,0,D,1,1,4,1,0,0,1,4,3,17,7,1,14,6,September,-1.0,-1.8369701987210287e-16,10,22,0,0,0,0.0,0.0,6,2,4,2,7,-5,"September, 2024"
2024-2025,4,2024-09-14,Southampton,Man United,0,3,A,0,3,0,1,4,1,1,3,19,14,0,3,5,3,September,-1.0,-1.8369701987210287e-16,38,28,0,3,2,0.4,2.4,1,5,-4,2,5,-3,"September, 2024"
2024-2025,4,2024-09-15,Tottenham,Arsenal,0,1,A,0,3,0,1,4,2,2,1,13,6,4,7,7,3,September,-1.0,-1.8369701987210287e-16,42,0,1,1,3,1.6,2.0,6,3,3,5,1,4,"September, 2024"
2024-2025,4,2024-09-15,Wolves,Newcastle,1,2,A,0,3,1,1,3,2,1,2,18,8,1,7,10,6,September,-1.0,-1.8369701987210287e-16,48,30,0,2,3,0.8,1.8,3,9,-6,4,2,2,"September, 2024"
2024-2025,5,2024-09-21,Crystal Palace,Man United,0,0,D,1,1,2,3,0,1,1,3,17,11,2,6,6,4,September,-1.0,-1.8369701987210287e-16,16,28,3,1,1,1.6,0.6,4,7,-3,5,5,0,"September, 2024"
2024-2025,5,2024-09-21,Tottenham,Brentford,3,1,H,3,0,0,1,4,3,1,1,13,10,4,6,3,2,September,-1.0,-1.8369701987210287e-16,42,9,1,3,1,1.6,1.8,6,4,2,6,6,0,"September, 2024"
2024-2025,5,2024-09-21,Liverpool,Bournemouth,3,0,H,3,0,1,2,2,2,1,2,6,12,9,5,6,4,September,-1.0,-1.8369701987210287e-16,25,7,4,0,1,3.6,0.6,7,1,6,5,5,0,"September, 2024"
2024-2025,5,2024-09-21,Southampton,Ipswich,1,1,D,1,1,0,1,4,0,1,4,20,17,0,2,3,2,September,-1.0,-1.8369701987210287e-16,38,22,1,1,2,1.75,2.5,1,8,-7,2,7,-5,"September, 2024"
2024-2025,5,2024-09-21,Fulham,Newcastle,3,1,H,3,0,2,0,3,2,1,2,12,5,5,10,7,5,September,-1.0,-1.8369701987210287e-16,19,30,0,0,5,0.2,2.2,4,4,0,6,3,3,"September, 2024"
2024-2025,5,2024-09-21,Aston Villa,Wolves,3,1,H,3,0,3,0,2,1,1,3,6,18,9,1,12,8,September,-1.0,-1.8369701987210287e-16,1,48,1,2,2,1.0,1.0,7,6,1,4,11,-7,"September, 2024"
2024-2025,5,2024-09-21,West Ham,Chelsea,0,3,A,0,3,2,1,2,4,0,1,14,8,4,7,6,3,September,-1.0,-1.8369701987210287e-16,45,14,1,1,3,1.0,2.0,5,6,-1,8,5,3,"September, 2024"
2024-2025,5,2024-09-21,Leicester,Everton,1,1,D,1,1,2,1,2,3,1,1,15,20,2,0,5,2,September,-1.0,-1.8369701987210287e-16,24,18,1,3,1,1.4,1.2,5,7,-2,4,13,-9,"September, 2024"
2024-2025,5,2024-09-22,Brighton,Nott'm Forest,2,2,D,1,1,4,1,0,1,2,2,7,9,8,8,2,0,September,-1.0,-1.8369701987210287e-16,10,32,2,1,1,1.25,1.25,6,2,4,4,2,2,"September, 2024"
2024-2025,5,2024-09-22,Man City,Arsenal,2,2,D,1,1,4,1,0,2,2,1,2,5,12,10,3,2,September,-1.0,-1.8369701987210287e-16,27,0,3,1,1,1.8,0.8,11,3,8,6,1,5,"September, 2024"
2024-2025,6,2024-09-28,Wolves,Liverpool,1,2,A,0,3,1,1,3,1,2,2,20,4,1,12,16,11,September,-1.0,-1.8369701987210287e-16,48,25,1,0,4,1.0,2.0,5,14,-9,10,1,9,"September, 2024"
2024-2025,6,2024-09-28,Everton,Crystal Palace,2,1,H,3,0,3,1,1,2,3,0,19,15,1,3,4,2,September,-1.0,-1.8369701987210287e-16,18,16,3,2,0,2.0,1.0,5,14,-9,4,7,-3,"September, 2024"
2024-2025,6,2024-09-28,Chelsea,Brighton,4,2,H,3,0,4,0,1,4,1,0,6,7,10,9,1,1,September,-1.0,-1.8369701987210287e-16,14,10,2,1,2,1.6,2.0,11,5,6,8,4,4,"September, 2024"
2024-2025,6,2024-09-28,Nott'm Forest,Fulham,0,1,A,0,3,1,2,2,2,0,3,8,9,9,8,1,1,September,-1.0,-1.8369701987210287e-16,32,19,1,0,3,1.25,2.75,6,4,2,7,5,2,"September, 2024"
2024-2025,6,2024-09-28,Arsenal,Leicester,4,2,H,3,0,2,2,1,2,1,2,4,15,11,3,11,8,September,-1.0,-1.8369701987210287e-16,0,24,5,0,0,2.4,0.6,8,3,5,6,8,-2,"September, 2024"
2024-2025,6,2024-09-28,Newcastle,Man City,1,1,D,1,1,2,1,2,4,1,0,6,1,10,13,5,3,September,-1.0,-1.8369701987210287e-16,30,27,0,1,4,1.0,2.8,7,6,1,13,5,8,"September, 2024"
2024-2025,6,2024-09-28,Brentford,West Ham,1,1,D,1,1,3,1,1,2,1,2,12,14,6,4,2,2,September,-1.0,-1.8369701987210287e-16,9,45,4,0,1,2.2,1.2,7,9,-2,5,9,-4,"September, 2024"
2024-2025,6,2024-09-29,Ipswich,Aston Villa,2,2,D,1,1,0,1,4,3,0,2,18,5,3,12,13,9,September,-1.0,-1.8369701987210287e-16,22,1,0,1,3,0.75,1.5,3,8,-5,10,7,3,"September, 2024"
2024-2025,6,2024-09-29,Man United,Tottenham,0,3,A,0,3,1,1,3,0,1,4,11,10,7,7,1,0,September,-1.0,-1.8369701987210287e-16,28,42,2,2,1,1.8,1.6,5,5,0,9,5,4,"September, 2024"
2024-2025,6,2024-09-30,Bournemouth,Southampton,3,1,H,3,0,2,1,2,0,1,4,13,19,5,1,6,4,September,-1.0,-1.8369701987210287e-16,7,38,2,1,2,1.4,1.4,5,8,-3,2,9,-7,"September, 2024"
2024-2025,7,2024-10-05,Everton,Newcastle,0,0,D,1,1,3,1,1,2,1,2,16,7,4,11,9,7,October,-0.8660254037844386,0.5,18,30,2,1,2,1.2,1.2,7,15,-8,8,7,1,"October, 2024"
2024-2025,7,2024-10-05,Crystal Palace,Liverpool,0,1,A,0,3,2,3,0,1,2,2,18,1,3,15,17,12,October,-0.8660254037844386,0.5,16,25,1,2,2,0.8,1.2,5,9,-4,12,2,10,"October, 2024"
2024-2025,7,2024-10-05,Arsenal,Southampton,3,1,H,3,0,2,2,1,0,1,4,3,19,14,1,16,13,October,-0.8660254037844386,0.5,0,38,2,2,1,2.0,1.2,12,5,7,3,12,-9,"October, 2024"
2024-2025,7,2024-10-05,Brentford,Wolves,5,3,H,3,0,3,1,1,1,1,3,12,19,7,1,7,6,October,-0.8660254037844386,0.5,9,48,1,1,3,1.0,1.8,8,10,-2,6,16,-10,"October, 2024"
2024-2025,7,2024-10-05,Leicester,Bournemouth,1,0,H,3,0,2,1,2,2,1,2,17,12,3,8,5,5,October,-0.8660254037844386,0.5,24,7,2,0,3,1.4,1.6,8,12,-4,8,9,-1,"October, 2024"
2024-2025,7,2024-10-05,Man City,Fulham,3,2,H,3,0,4,1,0,2,0,3,3,6,14,11,3,3,October,-0.8660254037844386,0.5,27,19,5,0,0,3.2,0.6,14,6,8,8,5,3,"October, 2024"
2024-2025,7,2024-10-05,West Ham,Ipswich,4,1,H,3,0,2,1,2,0,1,4,15,16,5,4,1,1,October,-0.8660254037844386,0.5,45,22,2,1,1,1.75,1.25,6,10,-4,5,10,-5,"October, 2024"
2024-2025,7,2024-10-06,Brighton,Tottenham,3,2,H,3,0,4,1,0,0,1,4,11,8,9,10,3,1,October,-0.8660254037844386,0.5,10,42,2,0,3,1.4,1.4,10,8,2,12,5,7,"October, 2024"
2024-2025,7,2024-10-06,Chelsea,Nott'm Forest,1,1,D,1,1,4,0,1,1,2,2,5,11,13,9,6,4,October,-0.8660254037844386,0.5,14,32,2,2,1,1.8,1.4,15,7,8,6,5,1,"October, 2024"
2024-2025,7,2024-10-06,Aston Villa,Man United,0,0,D,1,1,3,0,2,1,1,3,5,14,13,7,9,6,October,-0.8660254037844386,0.5,1,28,1,1,3,1.6,1.8,12,9,3,5,8,-3,"October, 2024"
2024-2025,8,2024-10-19,Tottenham,West Ham,4,1,H,3,0,0,1,4,2,1,2,9,12,10,8,3,2,October,-0.8660254037844386,0.5,42,45,2,2,1,1.6,1.0,14,8,6,10,11,-1,"October, 2024"
2024-2025,8,2024-10-19,Fulham,Aston Villa,1,3,A,0,3,2,0,3,3,0,2,9,5,11,14,4,3,October,-0.8660254037844386,0.5,19,1,1,0,4,1.2,1.8,10,8,2,12,9,3,"October, 2024"
2024-2025,8,2024-10-19,Ipswich,Everton,0,2,A,0,3,0,1,4,3,1,1,17,16,4,5,1,1,October,-0.8660254037844386,0.5,22,18,3,1,0,1.75,0.25,6,14,-8,7,15,-8,"October, 2024"
2024-2025,8,2024-10-19,Man United,Brentford,2,1,H,3,0,1,1,3,3,1,1,13,11,8,10,2,2,October,-0.8660254037844386,0.5,28,9,3,1,1,1.4,1.2,5,8,-3,13,13,0,"October, 2024"
2024-2025,8,2024-10-19,Newcastle,Brighton,0,1,A,0,3,2,1,2,4,1,0,8,7,12,12,1,0,October,-0.8660254037844386,0.5,30,10,2,2,1,1.6,1.2,8,7,1,13,10,3,"October, 2024"
2024-2025,8,2024-10-19,Southampton,Leicester,2,3,A,0,3,0,1,4,2,1,2,19,16,1,6,3,5,October,-0.8660254037844386,0.5,38,24,2,2,1,1.4,1.6,4,15,-11,9,12,-3,"October, 2024"
2024-2025,8,2024-10-19,Bournemouth,Arsenal,2,0,H,3,0,2,1,2,2,2,1,14,3,8,17,11,9,October,-0.8660254037844386,0.5,7,0,0,1,4,0.6,2.8,8,10,-2,15,6,9,"October, 2024"
2024-2025,8,2024-10-20,Wolves,Man City,1,2,A,0,3,1,1,3,4,1,0,19,2,1,17,17,16,October,-0.8660254037844386,0.5,48,27,1,0,4,0.8,3.4,9,21,-12,17,8,9,"October, 2024"
2024-2025,8,2024-10-20,Liverpool,Chelsea,2,1,H,3,0,1,2,2,4,0,1,2,6,18,14,4,4,October,-0.8660254037844386,0.5,25,14,1,4,0,1.4,0.8,13,2,11,16,8,8,"October, 2024"
2024-2025,8,2024-10-21,Nott'm Forest,Crystal Palace,1,0,H,3,0,1,2,2,2,3,0,12,18,10,3,6,7,October,-0.8660254037844386,0.5,32,16,1,3,0,0.75,0.5,7,6,1,5,10,-5,"October, 2024"
2024-2025,9,2024-10-25,Leicester,Nott'm Forest,1,3,A,0,3,2,1,2,1,2,2,14,8,9,13,6,4,October,-0.8660254037844386,0.5,24,32,2,1,2,1.8,1.2,12,14,-2,8,6,2,"October, 2024"
2024-2025,9,2024-10-26,Aston Villa,Bournemouth,1,1,D,1,1,3,0,2,2,1,2,4,11,17,11,7,6,October,-0.8660254037844386,0.5,1,7,2,1,2,1.8,1.4,15,10,5,10,10,0,"October, 2024"
2024-2025,9,2024-10-26,Brentford,Ipswich,4,3,H,3,0,3,1,1,0,1,4,13,17,10,4,4,6,October,-0.8660254037844386,0.5,9,22,0,0,0,0.0,0.0,14,15,-1,6,16,-10,"October, 2024"
2024-2025,9,2024-10-26,Brighton,Wolves,2,2,D,1,1,4,1,0,1,1,3,6,20,15,1,14,14,October,-0.8660254037844386,0.5,10,48,4,1,0,3.2,0.6,14,10,4,10,23,-13,"October, 2024"
2024-2025,9,2024-10-26,Man City,Southampton,1,0,H,3,0,4,1,0,0,1,4,2,20,20,1,18,19,October,-0.8660254037844386,0.5,27,38,3,2,0,2.8,0.8,19,9,10,6,18,-12,"October, 2024"
2024-2025,9,2024-10-26,Everton,Fulham,1,1,D,1,1,3,1,1,2,0,3,16,12,8,11,4,3,October,-0.8660254037844386,0.5,18,19,0,2,3,0.2,1.2,9,15,-6,11,11,0,"October, 2024"
2024-2025,9,2024-10-27,Chelsea,Newcastle,2,1,H,3,0,4,0,1,2,1,2,7,12,14,12,5,2,October,-0.8660254037844386,0.5,14,30,2,1,2,1.2,1.6,17,10,7,8,8,0,"October, 2024"
2024-2025,9,2024-10-27,Crystal Palace,Tottenham,1,0,H,3,0,2,3,0,0,1,4,18,8,3,13,10,10,October,-0.8660254037844386,0.5,16,42,0,0,5,0.4,2.6,5,11,-6,18,9,9,"October, 2024"
2024-2025,9,2024-10-27,West Ham,Man United,2,1,H,3,0,2,1,2,1,1,3,16,13,8,11,3,3,October,-0.8660254037844386,0.5,45,28,2,0,3,0.6,1.0,11,15,-4,7,9,-2,"October, 2024"
2024-2025,9,2024-10-27,Arsenal,Liverpool,2,2,D,1,1,2,2,1,1,2,2,5,2,17,21,3,4,October,-0.8660254037844386,0.5,0,25,2,2,1,1.8,1.6,15,8,7,15,3,12,"October, 2024"
2024-2025,10,2024-11-02,Wolves,Crystal Palace,2,2,D,1,1,1,1,3,2,3,0,20,17,2,6,3,4,November,-0.5000000000000004,0.8660254037844384,48,16,1,0,4,1.2,2.0,12,25,-13,6,11,-5,"November, 2024"
2024-2025,10,2024-11-02,Southampton,Everton,1,0,H,3,0,0,1,4,3,1,1,20,16,1,9,4,8,November,-0.5000000000000004,0.8660254037844384,38,18,2,0,3,1.2,1.4,6,19,-13,10,16,-6,"November, 2024"
2024-2025,10,2024-11-02,Nott'm Forest,West Ham,3,0,H,3,0,1,2,2,2,1,2,6,13,16,11,7,5,November,-0.5000000000000004,0.8660254037844384,32,45,2,0,3,1.2,1.8,11,7,4,13,16,-3,"November, 2024"
2024-2025,10,2024-11-02,Newcastle,Arsenal,1,0,H,3,0,2,1,2,2,2,1,12,3,12,18,9,6,November,-0.5000000000000004,0.8660254037844384,30,0,2,1,2,0.8,1.2,9,10,-1,17,10,7,"November, 2024"
2024-2025,10,2024-11-02,Ipswich,Leicester,1,1,D,1,1,0,1,4,2,1,2,18,15,4,9,3,5,November,-0.5000000000000004,0.8660254037844384,22,24,2,1,1,1.5,0.75,9,20,-11,13,17,-4,"November, 2024"
2024-2025,10,2024-11-02,Bournemouth,Man City,2,1,H,3,0,2,1,2,4,1,0,12,1,12,23,11,11,November,-0.5000000000000004,0.8660254037844384,7,27,0,0,5,0.6,3.4,11,11,0,20,9,11,"November, 2024"
2024-2025,10,2024-11-02,Liverpool,Brighton,2,1,H,3,0,1,2,2,4,1,0,2,6,22,16,4,6,November,-0.5000000000000004,0.8660254037844384,25,10,2,2,1,1.8,1.8,17,5,12,16,12,4,"November, 2024"
2024-2025,10,2024-11-03,Tottenham,Aston Villa,4,1,H,3,0,0,1,4,3,0,2,10,5,13,18,5,5,November,-0.5000000000000004,0.8660254037844384,42,1,2,0,3,2.0,1.2,18,10,8,16,11,5,"November, 2024"
2024-2025,10,2024-11-03,Man United,Chelsea,1,1,D,1,1,1,1,3,4,0,1,13,6,11,17,7,6,November,-0.5000000000000004,0.8660254037844384,28,14,2,2,1,2.2,1.6,8,11,-3,19,11,8,"November, 2024"
2024-2025,10,2024-11-04,Fulham,Brentford,2,1,H,3,0,2,0,3,3,1,1,12,11,12,13,1,1,November,-0.5000000000000004,0.8660254037844384,19,9,1,1,2,1.25,2.0,12,12,0,18,18,0,"November, 2024"
2024-2025,11,2024-11-09,West Ham,Everton,0,0,D,1,1,2,1,2,3,1,1,14,16,11,9,2,2,November,-0.5000000000000004,0.8660254037844384,45,18,3,0,2,1.4,0.8,13,19,-6,10,17,-7,"November, 2024"
2024-2025,11,2024-11-09,Crystal Palace,Fulham,0,2,A,0,3,2,3,0,2,0,3,17,10,7,15,7,8,November,-0.5000000000000004,0.8660254037844384,16,19,0,4,1,0.6,1.2,8,13,-5,14,13,1,"November, 2024"
2024-2025,11,2024-11-09,Brentford,Bournemouth,3,2,H,3,0,3,1,1,2,1,2,12,10,13,15,2,2,November,-0.5000000000000004,0.8660254037844384,9,7,2,2,0,1.5,0.75,19,20,-1,13,12,1,"November, 2024"
2024-2025,11,2024-11-09,Brighton,Man City,2,1,H,3,0,4,1,0,4,1,0,8,2,16,23,6,7,November,-0.5000000000000004,0.8660254037844384,10,27,0,1,4,0.6,2.6,17,14,3,21,11,10,"November, 2024"
2024-2025,11,2024-11-09,Wolves,Southampton,2,0,H,3,0,1,1,3,0,1,4,20,19,3,4,1,1,November,-0.5000000000000004,0.8660254037844384,48,38,5,0,0,1.8,0.6,14,27,-13,7,19,-12,"November, 2024"
2024-2025,11,2024-11-09,Liverpool,Aston Villa,2,0,H,3,0,1,2,2,3,0,2,1,7,25,18,6,7,November,-0.5000000000000004,0.8660254037844384,25,1,3,2,0,2.4,1.2,19,6,13,17,15,2,"November, 2024"
2024-2025,11,2024-11-10,Man United,Leicester,3,0,H,3,0,1,1,3,2,1,2,13,15,12,10,2,2,November,-0.5000000000000004,0.8660254037844384,28,24,2,1,2,1.6,1.4,9,12,-3,14,18,-4,"November, 2024"
2024-2025,11,2024-11-10,Nott'm Forest,Newcastle,1,3,A,0,3,1,2,2,2,1,2,3,13,19,15,10,4,November,-0.5000000000000004,0.8660254037844384,32,30,1,0,4,1.4,2.0,14,7,7,10,10,0,"November, 2024"
2024-2025,11,2024-11-10,Tottenham,Ipswich,1,2,A,0,3,0,1,4,0,1,4,10,19,16,5,9,11,November,-0.5000000000000004,0.8660254037844384,42,22,1,0,3,1.25,2.0,22,11,11,10,21,-11,"November, 2024"
2024-2025,11,2024-11-10,Chelsea,Arsenal,1,1,D,1,1,4,0,1,2,2,1,5,6,18,18,1,0,November,-0.5000000000000004,0.8660254037844384,14,0,0,1,4,1.0,3.0,20,12,8,17,11,6,"November, 2024"
2024-2025,12,2024-11-23,Fulham,Wolves,1,4,A,0,3,2,0,3,1,1,3,8,19,18,6,11,12,November,-0.5000000000000004,0.8660254037844384,19,48,1,2,2,1.0,1.2,16,13,3,16,27,-11,"November, 2024"
2024-2025,12,2024-11-23,Man City,Tottenham,0,4,A,0,3,4,1,0,0,1,4,2,11,23,16,9,7,November,-0.5000000000000004,0.8660254037844384,27,42,2,1,2,2.2,1.8,22,13,9,23,13,10,"November, 2024"
2024-2025,12,2024-11-23,Everton,Brentford,0,0,D,1,1,3,1,1,3,1,1,15,11,10,16,4,6,November,-0.5000000000000004,0.8660254037844384,18,9,3,1,1,1.6,1.0,10,17,-7,22,22,0,"November, 2024"
2024-2025,12,2024-11-23,Arsenal,Nott'm Forest,3,0,H,3,0,2,2,1,1,2,2,4,5,19,19,1,0,November,-0.5000000000000004,0.8660254037844384,0,32,4,0,1,2.0,0.6,18,12,6,15,10,5,"November, 2024"
2024-2025,12,2024-11-23,Aston Villa,Crystal Palace,2,2,D,1,1,3,0,2,2,3,0,9,18,18,7,9,11,November,-0.5000000000000004,0.8660254037844384,1,16,2,1,2,1.2,2.0,17,17,0,8,15,-7,"November, 2024"
2024-2025,12,2024-11-23,Leicester,Chelsea,1,2,A,0,3,2,1,2,4,0,1,15,3,10,19,12,9,November,-0.5000000000000004,0.8660254037844384,24,14,0,1,4,0.8,2.2,14,21,-7,21,13,8,"November, 2024"
2024-2025,12,2024-11-23,Bournemouth,Brighton,1,2,A,0,3,2,1,2,4,1,0,12,5,15,19,7,4,November,-0.5000000000000004,0.8660254037844384,7,10,2,0,3,1.4,1.4,15,15,0,19,15,4,"November, 2024"
2024-2025,12,2024-11-24,Southampton,Liverpool,2,3,A,0,3,0,1,4,1,2,2,20,1,4,28,19,24,November,-0.5000000000000004,0.8660254037844384,38,25,0,1,4,1.2,3.0,7,21,-14,21,6,15,"November, 2024"
2024-2025,12,2024-11-24,Ipswich,Man United,1,1,D,1,1,0,1,4,1,1,3,19,12,8,15,7,7,November,-0.5000000000000004,0.8660254037844384,22,28,0,1,3,0.25,2.0,12,22,-10,12,12,0,"November, 2024"
2024-2025,12,2024-11-25,Newcastle,West Ham,0,2,A,0,3,2,1,2,2,1,2,9,14,18,12,5,6,November,-0.5000000000000004,0.8660254037844384,30,45,2,3,0,2.6,1.6,13,11,2,13,19,-6,"November, 2024"
2024-2025,13,2024-11-29,Brighton,Southampton,1,1,D,1,1,4,1,0,0,1,4,5,20,22,4,15,18,November,-0.5000000000000004,0.8660254037844384,10,38,3,2,0,2.2,1.2,21,16,5,9,24,-15,"November, 2024"
2024-2025,13,2024-11-30,Wolves,Bournemouth,2,4,A,0,3,1,1,3,2,1,2,18,13,9,15,5,6,November,-0.5000000000000004,0.8660254037844384,48,7,2,1,2,0.6,0.6,20,28,-8,16,17,-1,"November, 2024"
2024-2025,13,2024-11-30,Nott'm Forest,Ipswich,1,0,H,3,0,1,2,2,0,1,4,8,19,19,9,11,10,November,-0.5000000000000004,0.8660254037844384,32,22,0,0,0,0.0,0.0,15,13,2,13,23,-10,"November, 2024"
2024-2025,13,2024-11-30,West Ham,Arsenal,2,5,A,0,3,2,1,2,2,2,1,14,5,15,22,9,7,November,-0.5000000000000004,0.8660254037844384,45,0,1,1,3,1.2,2.6,15,19,-4,21,12,9,"November, 2024"
2024-2025,13,2024-11-30,Brentford,Leicester,4,1,H,3,0,3,1,1,2,1,2,11,16,17,10,5,7,November,-0.5000000000000004,0.8660254037844384,9,24,0,2,2,1.25,1.75,22,22,0,15,23,-8,"November, 2024"
2024-2025,13,2024-11-30,Crystal Palace,Newcastle,1,1,D,1,1,2,3,0,2,1,2,19,11,8,18,8,10,November,-0.5000000000000004,0.8660254037844384,16,30,1,2,2,0.4,1.0,10,17,-7,13,13,0,"November, 2024"
2024-2025,13,2024-12-01,Chelsea,Aston Villa,3,0,H,3,0,4,0,1,3,0,2,5,9,22,19,4,3,December,-2.4492935982947064e-16,1.0,14,1,2,1,2,1.4,1.2,23,14,9,19,19,0,"December, 2024"
2024-2025,13,2024-12-01,Man United,Everton,4,0,H,3,0,1,1,3,3,1,1,13,15,16,11,2,5,December,-2.4492935982947064e-16,1.0,28,18,4,0,1,1.8,0.4,13,13,0,10,17,-7,"December, 2024"
2024-2025,13,2024-12-01,Tottenham,Fulham,1,1,D,1,1,0,1,4,2,0,3,8,13,19,18,5,1,December,-2.4492935982947064e-16,1.0,42,19,4,0,1,1.2,0.8,27,13,14,17,17,0,"December, 2024"
2024-2025,13,2024-12-01,Liverpool,Man City,2,0,H,3,0,1,2,2,4,1,0,1,5,31,23,4,8,December,-2.4492935982947064e-16,1.0,25,27,1,3,1,1.2,1.6,24,8,16,22,17,5,"December, 2024"
2024-2025,14,2024-12-03,Ipswich,Crystal Palace,0,1,A,0,3,0,1,4,2,3,0,19,17,9,9,2,0,December,-2.4492935982947064e-16,1.0,22,16,0,0,0,0.0,0.0,13,24,-11,11,18,-7,"December, 2024"
2024-2025,14,2024-12-03,Leicester,West Ham,3,1,H,3,0,2,1,2,2,1,2,17,14,10,15,3,5,December,-2.4492935982947064e-16,1.0,24,45,2,1,2,1.8,2.0,16,27,-11,17,24,-7,"December, 2024"
2024-2025,14,2024-12-04,Aston Villa,Brentford,3,1,H,3,0,3,0,2,3,1,1,12,8,19,20,4,1,December,-2.4492935982947064e-16,1.0,1,9,2,2,1,2.2,1.4,19,22,-3,26,23,3,"December, 2024"
2024-2025,14,2024-12-04,Arsenal,Man United,2,0,H,3,0,2,2,1,1,1,3,4,10,25,19,6,6,December,-2.4492935982947064e-16,1.0,0,28,4,0,1,2.2,1.4,26,14,12,17,13,4,"December, 2024"
2024-2025,14,2024-12-04,Southampton,Chelsea,1,5,A,0,3,0,1,4,4,0,1,20,4,5,25,16,20,December,-2.4492935982947064e-16,1.0,38,14,2,1,2,1.0,2.2,10,25,-15,26,14,12,"December, 2024"
2024-2025,14,2024-12-04,Newcastle,Liverpool,3,3,D,1,1,2,1,2,1,2,2,11,1,19,34,10,15,December,-2.4492935982947064e-16,1.0,30,25,0,0,5,0.8,2.2,14,14,0,26,8,18,"December, 2024"
2024-2025,14,2024-12-04,Man City,Nott'm Forest,3,0,H,3,0,4,1,0,1,2,2,5,6,23,22,1,1,December,-2.4492935982947064e-16,1.0,27,32,3,2,0,2.4,0.4,22,19,3,16,13,3,"December, 2024"
2024-2025,14,2024-12-04,Everton,Wolves,4,0,H,3,0,3,1,1,1,1,3,17,18,11,9,1,2,December,-2.4492935982947064e-16,1.0,18,48,0,1,4,0.4,1.6,10,21,-11,22,32,-10,"December, 2024"
2024-2025,14,2024-12-05,Fulham,Brighton,3,1,H,3,0,2,0,3,4,1,0,12,5,19,23,7,4,December,-2.4492935982947064e-16,1.0,19,10,3,2,0,1.4,0.4,18,18,0,22,17,5,"December, 2024"
2024-2025,14,2024-12-05,Bournemouth,Tottenham,1,0,H,3,0,2,1,2,0,1,4,13,9,18,20,4,2,December,-2.4492935982947064e-16,1.0,7,42,1,1,3,1.2,2.0,20,19,1,28,14,14,"December, 2024"
2024-2025,15,2024-12-07,Aston Villa,Southampton,1,0,H,3,0,3,0,2,0,1,4,8,20,22,5,12,17,December,-2.4492935982947064e-16,1.0,1,38,4,0,1,1.4,0.2,22,23,-1,11,30,-19,"December, 2024"
2024-2025,15,2024-12-07,Brentford,Newcastle,4,2,H,3,0,3,1,1,2,1,2,11,12,20,20,1,0,December,-2.4492935982947064e-16,1.0,9,30,0,0,5,0.8,2.8,27,26,1,17,17,0,"December, 2024"
2024-2025,15,2024-12-07,Crystal Palace,Man City,2,2,D,1,1,2,3,0,4,1,0,17,4,12,26,13,14,December,-2.4492935982947064e-16,1.0,16,27,0,2,3,1.2,2.2,12,18,-6,25,19,6,"December, 2024"
2024-2025,15,2024-12-07,Man United,Nott'm Forest,2,3,A,0,3,1,1,3,1,2,2,13,9,19,22,4,3,December,-2.4492935982947064e-16,1.0,28,32,4,0,1,3.4,1.0,17,15,2,16,16,0,"December, 2024"
2024-2025,15,2024-12-08,Tottenham,Chelsea,3,4,A,0,3,0,1,4,4,0,1,11,3,20,28,8,8,December,-2.4492935982947064e-16,1.0,42,14,1,1,3,1.0,2.0,28,15,13,31,15,16,"December, 2024"
2024-2025,15,2024-12-08,Leicester,Brighton,2,2,D,1,1,2,1,2,4,1,0,17,9,13,23,8,10,December,-2.4492935982947064e-16,1.0,24,10,1,2,2,1.6,2.2,19,28,-9,23,20,3,"December, 2024"
2024-2025,15,2024-12-08,Fulham,Arsenal,1,1,D,1,1,2,0,3,2,2,1,9,3,22,28,6,6,December,-2.4492935982947064e-16,1.0,19,0,1,2,2,1.2,1.8,21,19,2,28,14,14,"December, 2024"
2024-2025,15,2024-12-08,Ipswich,Bournemouth,1,2,A,0,3,0,1,4,2,1,2,18,10,9,21,8,12,December,-2.4492935982947064e-16,1.0,22,7,0,0,0,0.0,0.0,13,25,-12,21,19,2,"December, 2024"
2024-2025,15,2024-12-09,West Ham,Wolves,2,1,H,3,0,2,1,2,1,1,3,14,19,15,9,5,6,December,-2.4492935982947064e-16,1.0,45,48,4,0,1,1.6,0.4,18,27,-9,22,36,-14,"December, 2024"
2024-2025,16,2024-12-14,Nott'm Forest,Aston Villa,2,1,H,3,0,1,2,2,3,0,2,5,6,25,25,1,0,December,-2.4492935982947064e-16,1.0,32,1,1,1,3,1.0,1.8,19,18,1,23,23,0,"December, 2024"
2024-2025,16,2024-12-14,Arsenal,Everton,0,0,D,1,1,2,2,1,3,1,1,3,15,29,14,12,15,December,-2.4492935982947064e-16,1.0,0,18,4,0,1,2.4,0.6,29,15,14,14,21,-7,"December, 2024"
2024-2025,16,2024-12-14,Liverpool,Fulham,2,2,D,1,1,1,2,2,2,0,3,1,10,35,23,9,12,December,-2.4492935982947064e-16,1.0,25,19,3,1,1,2.0,1.4,29,11,18,22,20,2,"December, 2024"
2024-2025,16,2024-12-14,Newcastle,Leicester,4,0,H,3,0,2,1,2,2,1,2,12,16,20,14,4,6,December,-2.4492935982947064e-16,1.0,30,24,3,1,1,1.8,1.4,19,21,-2,21,30,-9,"December, 2024"
2024-2025,16,2024-12-14,Wolves,Ipswich,1,2,A,0,3,1,1,3,0,1,4,19,18,9,9,1,0,December,-2.4492935982947064e-16,1.0,48,22,0,0,0,0.0,0.0,23,38,-15,14,27,-13,"December, 2024"
2024-2025,16,2024-12-15,Southampton,Tottenham,0,5,A,0,3,0,1,4,0,1,4,20,13,5,20,7,15,December,-2.4492935982947064e-16,1.0,38,42,1,2,2,1.8,2.4,11,31,-20,31,19,12,"December, 2024"
2024-2025,16,2024-12-15,Chelsea,Brentford,2,1,H,3,0,4,0,1,3,1,1,2,10,31,23,8,8,December,-2.4492935982947064e-16,1.0,14,9,0,2,3,0.6,2.0,35,18,17,31,28,3,"December, 2024"
2024-2025,16,2024-12-15,Brighton,Crystal Palace,1,3,A,0,3,4,1,0,2,3,0,7,17,24,13,10,11,December,-2.4492935982947064e-16,1.0,10,16,2,3,0,1.6,0.8,25,22,3,14,20,-6,"December, 2024"
2024-2025,16,2024-12-15,Man City,Man United,1,2,A,0,3,4,1,0,1,1,3,5,13,27,19,8,8,December,-2.4492935982947064e-16,1.0,27,28,4,0,1,3.4,1.4,27,21,6,19,18,1,"December, 2024"
2024-2025,16,2024-12-16,Bournemouth,West Ham,1,1,D,1,1,2,1,2,2,1,2,7,14,24,18,7,6,December,-2.4492935982947064e-16,1.0,7,45,0,2,3,0.4,2.4,23,20,3,20,28,-8,"December, 2024"
2024-2025,17,2024-12-21,Aston Villa,Man City,2,1,H,3,0,3,0,2,4,1,0,7,5,25,27,2,2,December,-2.4492935982947064e-16,1.0,1,27,1,1,3,1.2,2.2,24,25,-1,28,23,5,"December, 2024"
2024-2025,17,2024-12-21,Brentford,Nott'm Forest,0,2,A,0,3,3,1,1,1,2,2,11,4,23,28,7,5,December,-2.4492935982947064e-16,1.0,9,32,2,2,0,2.0,1.5,32,30,2,21,19,2,"December, 2024"
2024-2025,17,2024-12-21,Ipswich,Newcastle,0,4,A,0,3,0,1,4,2,1,2,18,11,12,23,7,11,December,-2.4492935982947064e-16,1.0,22,30,1,1,2,1.0,1.25,16,28,-12,23,21,2,"December, 2024"
2024-2025,17,2024-12-21,West Ham,Brighton,1,1,D,1,1,2,1,2,4,1,0,14,10,19,24,4,5,December,-2.4492935982947064e-16,1.0,45,10,1,1,3,0.8,2.0,21,29,-8,26,25,1,"December, 2024"
2024-2025,17,2024-12-21,Crystal Palace,Arsenal,1,5,A,0,3,2,3,0,2,2,1,15,4,16,30,11,14,December,-2.4492935982947064e-16,1.0,16,0,1,0,4,0.8,2.4,17,21,-4,29,15,14,"December, 2024"
2024-2025,17,2024-12-22,Tottenham,Liverpool,3,6,A,0,3,0,1,4,1,2,2,11,1,23,36,10,13,December,-2.4492935982947064e-16,1.0,42,25,1,1,3,1.8,2.4,36,19,17,31,13,18,"December, 2024"
2024-2025,17,2024-12-22,Man United,Bournemouth,0,3,A,0,3,1,1,3,2,1,2,13,8,22,25,5,3,December,-2.4492935982947064e-16,1.0,28,7,3,1,1,2.2,1.4,21,19,2,24,21,3,"December, 2024"
2024-2025,17,2024-12-22,Everton,Chelsea,0,0,D,1,1,3,1,1,4,0,1,16,2,15,34,14,19,December,-2.4492935982947064e-16,1.0,18,14,2,1,2,1.0,1.8,14,21,-7,37,19,18,"December, 2024"
2024-2025,17,2024-12-22,Fulham,Southampton,0,0,D,1,1,2,0,3,0,1,4,10,20,24,5,10,19,December,-2.4492935982947064e-16,1.0,19,38,2,1,2,1.0,1.2,24,22,2,11,36,-25,"December, 2024"
2024-2025,17,2024-12-22,Leicester,Wolves,0,3,A,0,3,2,1,2,1,1,3,17,19,14,9,2,5,December,-2.4492935982947064e-16,1.0,24,48,3,1,1,1.6,0.6,21,34,-13,24,40,-16,"December, 2024"
2024-2025,18,2024-12-26,Liverpool,Leicester,3,1,H,3,0,1,2,2,2,1,2,1,18,39,14,17,25,December,-2.4492935982947064e-16,1.0,25,24,3,0,2,1.6,1.0,37,16,21,21,37,-16,"December, 2024"
2024-2025,18,2024-12-26,Man City,Everton,1,1,D,1,1,4,1,0,3,1,1,7,15,27,16,8,11,December,-2.4492935982947064e-16,1.0,27,18,4,1,0,2.0,0.4,29,25,4,14,21,-7,"December, 2024"
2024-2025,18,2024-12-26,Bournemouth,Crystal Palace,0,0,D,1,1,2,1,2,2,3,0,5,16,28,16,11,12,December,-2.4492935982947064e-16,1.0,7,16,2,0,3,0.6,1.2,27,21,6,18,26,-8,"December, 2024"
2024-2025,18,2024-12-26,Chelsea,Fulham,1,2,A,0,3,4,0,1,2,0,3,2,9,35,25,7,10,December,-2.4492935982947064e-16,1.0,14,19,3,1,1,1.2,0.4,37,19,18,24,22,2,"December, 2024"
2024-2025,18,2024-12-26,Newcastle,Aston Villa,3,0,H,3,0,2,1,2,3,0,2,9,8,26,28,1,2,December,-2.4492935982947064e-16,1.0,30,1,4,0,1,2.6,1.0,27,21,6,26,26,0,"December, 2024"
2024-2025,18,2024-12-26,Nott'm Forest,Tottenham,1,0,H,3,0,1,2,2,0,1,4,4,11,31,23,7,8,December,-2.4492935982947064e-16,1.0,32,42,0,0,5,0.4,2.2,23,19,4,39,25,14,"December, 2024"
2024-2025,18,2024-12-26,Southampton,West Ham,0,1,A,0,3,0,1,4,2,1,2,20,14,6,20,6,14,December,-2.4492935982947064e-16,1.0,38,45,1,2,2,0.8,1.4,11,36,-25,22,30,-8,"December, 2024"
2024-2025,18,2024-12-26,Wolves,Man United,2,0,H,3,0,1,1,3,1,1,3,18,14,12,22,4,10,December,-2.4492935982947064e-16,1.0,48,28,1,0,4,0.8,1.6,27,40,-13,21,22,-1,"December, 2024"
2024-2025,18,2024-12-27,Arsenal,Ipswich,1,0,H,3,0,2,2,1,0,1,4,4,19,33,12,15,21,December,-2.4492935982947064e-16,1.0,0,22,3,1,0,1.5,0.25,34,16,18,16,32,-16,"December, 2024"
2024-2025,18,2024-12-27,Brighton,Brentford,0,0,D,1,1,4,1,0,3,1,1,10,12,25,23,2,2,December,-2.4492935982947064e-16,1.0,10,9,2,2,1,1.4,1.2,27,26,1,32,32,0,"December, 2024"
2024-2025,19,2024-12-29,Leicester,Man City,0,2,A,0,3,2,1,2,4,1,0,18,7,14,28,11,14,December,-2.4492935982947064e-16,1.0,24,27,0,0,5,0.8,2.6,22,40,-18,30,26,4,"December, 2024"
2024-2025,19,2024-12-29,Crystal Palace,Southampton,2,1,H,3,0,2,3,0,0,1,4,16,20,17,6,4,11,December,-2.4492935982947064e-16,1.0,16,38,3,1,1,1.6,1.2,18,26,-8,11,37,-26,"December, 2024"
2024-2025,19,2024-12-29,Everton,Nott'm Forest,0,2,A,0,3,3,1,1,1,2,2,16,4,17,34,12,17,December,-2.4492935982947064e-16,1.0,18,32,2,2,1,1.2,0.8,15,22,-7,24,19,5,"December, 2024"
2024-2025,19,2024-12-29,Fulham,Bournemouth,2,2,D,1,1,2,0,3,2,1,2,8,7,28,29,1,1,December,-2.4492935982947064e-16,1.0,19,7,2,1,2,1.4,1.6,26,23,3,27,21,6,"December, 2024"
2024-2025,19,2024-12-29,Tottenham,Wolves,2,2,D,1,1,0,1,4,1,1,3,12,17,23,15,5,8,December,-2.4492935982947064e-16,1.0,42,48,1,0,4,0.6,1.4,39,26,13,29,40,-11,"December, 2024"
2024-2025,19,2024-12-29,West Ham,Liverpool,0,5,A,0,3,2,1,2,1,2,2,13,1,23,42,12,19,December,-2.4492935982947064e-16,1.0,45,25,0,1,4,0.8,1.8,23,30,-7,40,17,23,"December, 2024"
2024-2025,19,2024-12-30,Man United,Newcastle,0,2,A,0,3,1,1,3,2,1,2,14,7,22,29,7,7,December,-2.4492935982947064e-16,1.0,28,30,1,2,2,0.8,1.2,21,24,-3,30,21,9,"December, 2024"
2024-2025,19,2024-12-30,Aston Villa,Brighton,2,2,D,1,1,3,0,2,4,1,0,9,10,28,26,1,2,December,-2.4492935982947064e-16,1.0,1,10,4,0,1,2.4,0.8,26,29,-3,27,26,1,"December, 2024"
2024-2025,19,2024-12-30,Ipswich,Chelsea,2,0,H,3,0,0,1,4,4,0,1,19,4,12,35,15,23,December,-2.4492935982947064e-16,1.0,22,14,0,2,2,1.0,2.0,16,33,-17,38,21,17,"December, 2024"
2024-2025,19,2025-01-01,Brentford,Arsenal,1,3,A,0,3,3,1,1,2,2,1,12,3,24,36,9,12,January,0.4999999999999999,0.8660254037844387,9,0,0,1,4,0.6,1.8,32,32,0,35,16,19,"January, 2025"
2024-2025,20,2025-01-04,Brighton,Arsenal,1,1,D,1,1,4,1,0,2,2,1,11,2,27,39,9,12,January,0.4999999999999999,0.8660254037844387,10,0,1,1,3,1.2,2.0,29,28,1,38,17,21,"January, 2025"
2024-2025,20,2025-01-04,Southampton,Brentford,0,5,A,0,3,0,1,4,3,1,1,20,12,6,24,8,18,January,0.4999999999999999,0.8660254037844387,38,9,1,0,4,1.0,2.4,12,39,-27,33,35,-2,"January, 2025"
2024-2025,20,2025-01-04,Man City,West Ham,4,1,H,3,0,4,1,0,2,1,2,8,13,31,23,5,8,January,0.4999999999999999,0.8660254037844387,27,45,5,0,0,2.8,0.6,32,26,6,23,35,-12,"January, 2025"
2024-2025,20,2025-01-04,Tottenham,Newcastle,1,2,A,0,3,0,1,4,2,1,2,11,5,24,32,6,8,January,0.4999999999999999,0.8660254037844387,42,30,1,0,4,1.4,3.0,41,28,13,32,21,11,"January, 2025"
2024-2025,20,2025-01-04,Bournemouth,Everton,1,0,H,3,0,2,1,2,3,1,1,8,16,30,17,8,13,January,0.4999999999999999,0.8660254037844387,7,18,3,0,2,1.6,1.4,29,23,6,15,24,-9,"January, 2025"
2024-2025,20,2025-01-04,Aston Villa,Leicester,2,1,H,3,0,3,0,2,2,1,2,9,19,29,14,10,15,January,0.4999999999999999,0.8660254037844387,1,24,3,1,1,1.6,1.4,28,31,-3,22,42,-20,"January, 2025"
2024-2025,20,2025-01-04,Crystal Palace,Chelsea,1,1,D,1,1,2,3,0,4,0,1,15,4,20,35,11,15,January,0.4999999999999999,0.8660254037844387,16,14,0,1,4,0.8,1.8,20,27,-7,38,23,15,"January, 2025"
2024-2025,20,2025-01-05,Fulham,Ipswich,2,2,D,1,1,2,0,3,0,1,4,9,18,29,15,9,14,January,0.4999999999999999,0.8660254037844387,19,22,0,2,1,0.6666666666666666,1.0,28,25,3,18,33,-15,"January, 2025"
2024-2025,20,2025-01-05,Liverpool,Man United,2,2,D,1,1,1,2,2,1,1,3,1,14,45,22,13,23,January,0.4999999999999999,0.8660254037844387,25,28,2,2,1,2.6,0.8,45,17,28,21,26,-5,"January, 2025"
2024-2025,20,2025-01-06,Wolves,Nott'm Forest,0,3,A,0,3,1,1,3,1,2,2,17,3,16,37,14,21,January,0.4999999999999999,0.8660254037844387,48,32,1,4,0,1.2,1.0,31,42,-11,26,19,7,"January, 2025"
2024-2025,21,2025-01-14,Nott'm Forest,Liverpool,1,1,D,1,1,1,2,2,1,2,2,3,1,40,46,2,6,January,0.4999999999999999,0.8660254037844387,32,25,2,0,3,0.8,1.4,29,19,10,47,19,28,"January, 2025"
2024-2025,21,2025-01-14,West Ham,Fulham,3,2,H,3,0,2,1,2,2,0,3,14,9,23,30,5,7,January,0.4999999999999999,0.8660254037844387,45,19,2,1,2,1.0,1.8,24,39,-15,30,27,3,"January, 2025"
2024-2025,21,2025-01-14,Chelsea,Bournemouth,2,2,D,1,1,4,0,1,2,1,2,4,7,36,33,3,3,January,0.4999999999999999,0.8660254037844387,14,7,4,1,0,1.6,0.4,39,24,15,30,23,7,"January, 2025"
2024-2025,21,2025-01-14,Brentford,Man City,2,2,D,1,1,3,1,1,4,1,0,11,6,27,34,5,7,January,0.4999999999999999,0.8660254037844387,9,27,2,0,3,1.0,1.4,38,35,3,36,27,9,"January, 2025"
2024-2025,21,2025-01-15,Everton,Aston Villa,0,1,A,0,3,3,1,1,3,0,2,16,8,17,32,8,15,January,0.4999999999999999,0.8660254037844387,18,1,0,1,4,0.6,2.2,15,25,-10,30,32,-2,"January, 2025"
2024-2025,21,2025-01-15,Leicester,Crystal Palace,0,2,A,0,3,2,1,2,2,3,0,19,15,14,21,4,7,January,0.4999999999999999,0.8660254037844387,24,16,1,3,1,1.4,1.4,23,44,-21,21,28,-7,"January, 2025"
2024-2025,21,2025-01-15,Newcastle,Wolves,3,0,H,3,0,2,1,2,1,1,3,5,17,35,16,12,19,January,0.4999999999999999,0.8660254037844387,30,48,3,2,0,2.0,1.0,34,22,12,31,45,-14,"January, 2025"
2024-2025,21,2025-01-15,Arsenal,Tottenham,2,1,H,3,0,2,2,1,0,1,4,3,13,40,24,10,16,January,0.4999999999999999,0.8660254037844387,0,42,4,1,0,2.2,1.0,39,18,21,42,30,12,"January, 2025"
2024-2025,21,2025-01-16,Ipswich,Brighton,0,2,A,0,3,0,1,4,4,1,0,17,11,16,28,6,12,January,0.4999999999999999,0.8660254037844387,22,10,0,1,0,0.0,0.0,20,35,-15,30,29,1,"January, 2025"
2024-2025,21,2025-01-16,Man United,Southampton,3,1,H,3,0,1,1,3,0,1,4,15,20,23,6,5,17,January,0.4999999999999999,0.8660254037844387,28,38,2,3,0,1.2,0.4,23,28,-5,12,44,-32,"January, 2025"
2024-2025,22,2025-01-18,Arsenal,Aston Villa,2,2,D,1,1,2,2,1,3,0,2,2,8,43,35,6,8,January,0.4999999999999999,0.8660254037844387,0,1,3,0,2,1.6,1.2,41,19,22,31,32,-1,"January, 2025"
2024-2025,22,2025-01-18,West Ham,Crystal Palace,0,2,A,0,3,2,1,2,2,3,0,13,15,26,24,2,2,January,0.4999999999999999,0.8660254037844387,45,16,1,1,3,1.8,2.4,27,41,-14,23,28,-5,"January, 2025"
2024-2025,22,2025-01-18,Brentford,Liverpool,0,2,A,0,3,3,1,1,1,2,2,11,1,28,47,10,19,January,0.4999999999999999,0.8660254037844387,9,25,1,0,4,0.8,2.2,40,37,3,48,20,28,"January, 2025"
2024-2025,22,2025-01-18,Newcastle,Bournemouth,1,4,A,0,3,2,1,2,2,1,2,4,8,38,34,4,4,January,0.4999999999999999,0.8660254037844387,30,7,0,4,1,1.0,1.4,37,22,15,32,25,7,"January, 2025"
2024-2025,22,2025-01-18,Leicester,Fulham,0,2,A,0,3,2,1,2,2,0,3,19,10,14,30,9,16,January,0.4999999999999999,0.8660254037844387,24,19,1,0,4,1.4,2.0,23,46,-23,32,30,2,"January, 2025"
2024-2025,22,2025-01-19,Everton,Tottenham,3,2,H,3,0,3,1,1,0,1,4,16,15,17,24,1,7,January,0.4999999999999999,0.8660254037844387,18,42,0,2,3,0.8,2.2,15,26,-11,43,32,11,"January, 2025"
2024-2025,22,2025-01-19,Man United,Brighton,1,3,A,0,3,1,1,3,4,1,0,13,10,26,31,3,5,January,0.4999999999999999,0.8660254037844387,28,10,1,0,4,1.0,1.6,26,29,-3,32,29,3,"January, 2025"
2024-2025,22,2025-01-19,Nott'm Forest,Southampton,3,2,H,3,0,1,2,2,0,1,4,3,20,41,6,17,35,January,0.4999999999999999,0.8660254037844387,32,38,4,1,0,1.8,1.0,30,20,10,13,47,-34,"January, 2025"
2024-2025,22,2025-01-19,Ipswich,Man City,0,6,A,0,3,0,1,4,4,1,0,18,8,16,35,10,19,January,0.4999999999999999,0.8660254037844387,22,27,2,0,1,2.0,2.333333333333333,20,37,-17,38,29,9,"January, 2025"
2024-2025,22,2025-01-20,Chelsea,Wolves,3,1,H,3,0,4,0,1,1,1,3,6,17,37,16,11,21,January,0.4999999999999999,0.8660254037844387,14,48,2,0,3,2.4,1.8,41,26,15,31,48,-17,"January, 2025"
2024-2025,23,2025-01-25,Man City,Chelsea,3,1,H,3,0,4,1,0,4,0,1,7,5,38,40,2,2,January,0.4999999999999999,0.8660254037844387,27,14,3,2,0,1.8,1.0,44,29,15,44,27,17,"January, 2025"
2024-2025,23,2025-01-25,Wolves,Arsenal,0,1,A,0,3,1,1,3,2,2,1,17,2,16,44,15,28,January,0.4999999999999999,0.8660254037844387,48,0,0,0,5,0.2,2.6,32,51,-19,43,21,22,"January, 2025"
2024-2025,23,2025-01-25,Southampton,Newcastle,1,3,A,0,3,0,1,4,2,1,2,20,7,6,38,13,32,January,0.4999999999999999,0.8660254037844387,38,30,0,1,4,1.0,2.4,15,50,-35,38,26,12,"January, 2025"
2024-2025,23,2025-01-25,Brighton,Everton,0,1,A,0,3,4,1,0,3,1,1,9,16,34,20,7,14,January,0.4999999999999999,0.8660254037844387,10,18,2,2,1,2.0,1.6,35,30,5,18,28,-10,"January, 2025"
2024-2025,23,2025-01-25,Bournemouth,Nott'm Forest,5,0,H,3,0,2,1,2,1,2,2,7,3,37,44,4,7,January,0.4999999999999999,0.8660254037844387,7,32,2,3,0,1.8,1.4,36,26,10,33,22,11,"January, 2025"
2024-2025,23,2025-01-25,Liverpool,Ipswich,4,1,H,3,0,1,2,2,0,1,4,1,18,50,16,17,34,January,0.4999999999999999,0.8660254037844387,25,22,3,1,1,2.8,0.4,50,20,30,20,43,-23,"January, 2025"
2024-2025,23,2025-01-26,Crystal Palace,Brentford,1,2,A,0,3,2,3,0,3,1,1,12,11,27,28,1,1,January,0.4999999999999999,0.8660254037844387,16,9,1,3,1,1.4,1.2,25,28,-3,40,39,1,"January, 2025"
2024-2025,23,2025-01-26,Tottenham,Leicester,1,2,A,0,3,0,1,4,2,1,2,15,19,24,14,4,10,January,0.4999999999999999,0.8660254037844387,42,24,3,1,1,2.8,2.0,45,35,10,23,48,-25,"January, 2025"
2024-2025,23,2025-01-26,Aston Villa,West Ham,1,1,D,1,1,3,0,2,2,1,2,8,14,36,26,6,10,January,0.4999999999999999,0.8660254037844387,1,45,2,2,1,1.6,1.0,33,34,-1,27,43,-16,"January, 2025"
2024-2025,23,2025-01-26,Fulham,Man United,0,1,A,0,3,2,0,3,1,1,3,10,14,33,26,4,7,January,0.4999999999999999,0.8660254037844387,19,28,1,0,4,0.8,1.4,34,30,4,27,32,-5,"January, 2025"
2024-2025,24,2025-02-01,Ipswich,Southampton,1,2,A,0,3,0,1,4,0,1,4,19,20,16,6,1,10,February,0.8660254037844386,0.5000000000000001,22,38,2,2,1,2.2,1.6,21,47,-26,16,53,-37,"February, 2025"
2024-2025,24,2025-02-01,Wolves,Aston Villa,2,0,H,3,0,1,1,3,3,0,2,18,8,16,37,10,21,February,0.8660254037844386,0.5000000000000001,48,1,1,2,2,0.8,1.4,32,52,-20,34,35,-1,"February, 2025"
2024-2025,24,2025-02-01,Newcastle,Fulham,1,2,A,0,3,2,1,2,2,0,3,5,10,41,33,5,8,February,0.8660254037844386,0.5000000000000001,30,19,4,0,1,2.0,0.8,41,27,14,34,31,3,"February, 2025"
2024-2025,24,2025-02-01,Everton,Leicester,4,0,H,3,0,3,1,1,2,1,2,16,17,23,17,1,6,February,0.8660254037844386,0.5000000000000001,18,24,1,3,1,1.2,1.4,19,28,-9,25,49,-24,"February, 2025"
2024-2025,24,2025-02-01,Bournemouth,Liverpool,0,2,A,0,3,2,1,2,1,2,2,7,1,40,53,6,13,February,0.8660254037844386,0.5000000000000001,7,25,1,0,4,0.4,3.8,41,26,15,54,21,33,"February, 2025"
2024-2025,24,2025-02-01,Nott'm Forest,Brighton,7,0,H,3,0,1,2,2,4,1,0,3,9,44,34,6,10,February,0.8660254037844386,0.5000000000000001,32,10,1,2,2,1.4,1.4,33,27,6,35,31,4,"February, 2025"
2024-2025,24,2025-02-02,Brentford,Tottenham,0,2,A,0,3,3,1,1,0,1,4,11,16,31,24,5,7,February,0.8660254037844386,0.5000000000000001,9,42,1,2,2,2.0,2.2,42,40,2,46,37,9,"February, 2025"
2024-2025,24,2025-02-02,Man United,Crystal Palace,0,2,A,0,3,1,1,3,2,3,0,12,14,29,27,2,2,February,0.8660254037844386,0.5000000000000001,28,16,1,2,2,0.6,1.4,28,32,-4,26,30,-4,"February, 2025"
2024-2025,24,2025-02-02,Arsenal,Man City,5,1,H,3,0,2,2,1,4,1,0,2,4,47,41,2,6,February,0.8660254037844386,0.5000000000000001,0,27,1,2,2,1.0,1.8,44,21,23,47,30,17,"February, 2025"
2024-2025,24,2025-02-03,Chelsea,West Ham,2,1,H,3,0,4,0,1,2,1,2,6,15,40,27,9,13,February,0.8660254037844386,0.5000000000000001,14,45,3,1,1,2.4,1.0,45,30,15,28,44,-16,"February, 2025"
2024-2025,15,2025-02-12,Everton,Liverpool,2,2,D,1,1,3,1,1,1,2,2,16,1,26,56,15,30,February,0.8660254037844386,0.5000000000000001,18,25,1,1,3,0.4,1.2,23,28,-5,56,21,35,"February, 2025"
2024-2025,25,2025-02-14,Brighton,Chelsea,3,0,H,3,0,4,1,0,4,0,1,10,4,34,43,6,9,February,0.8660254037844386,0.5000000000000001,10,14,2,0,3,2.2,2.2,35,38,-3,47,31,16,"February, 2025"
2024-2025,25,2025-02-15,West Ham,Brentford,0,1,A,0,3,2,1,2,3,1,1,16,11,27,31,5,4,February,0.8660254037844386,0.5000000000000001,45,9,1,1,3,1.4,2.0,29,46,-17,42,42,0,"February, 2025"
2024-2025,25,2025-02-15,Crystal Palace,Everton,1,2,A,0,3,2,3,0,3,1,1,12,15,30,27,3,3,February,0.8660254037844386,0.5000000000000001,16,18,0,2,3,0.8,1.8,28,30,-2,25,30,-5,"February, 2025"
2024-2025,25,2025-02-15,Man City,Newcastle,4,0,H,3,0,4,1,0,2,1,2,5,6,41,41,1,0,February,0.8660254037844386,0.5000000000000001,27,30,3,2,0,2.0,1.2,48,35,13,42,29,13,"February, 2025"
2024-2025,25,2025-02-15,Southampton,Bournemouth,1,3,A,0,3,0,1,4,2,1,2,20,7,9,40,13,31,February,0.8660254037844386,0.5000000000000001,38,7,2,0,3,1.0,1.4,18,54,-36,41,28,13,"February, 2025"
2024-2025,25,2025-02-15,Fulham,Nott'm Forest,2,1,H,3,0,2,0,3,1,2,2,10,3,36,47,7,11,February,0.8660254037844386,0.5000000000000001,19,32,4,0,1,2.4,1.0,36,32,4,40,27,13,"February, 2025"
2024-2025,25,2025-02-15,Aston Villa,Ipswich,1,1,D,1,1,3,0,2,0,1,4,9,19,37,16,10,21,February,0.8660254037844386,0.5000000000000001,1,22,3,2,0,1.6,1.0,34,37,-3,22,49,-27,"February, 2025"
2024-2025,25,2025-02-15,Leicester,Arsenal,0,2,A,0,3,2,1,2,2,2,1,18,2,17,50,16,33,February,0.8660254037844386,0.5000000000000001,24,0,0,0,5,0.8,2.6,25,53,-28,49,22,27,"February, 2025"
2024-2025,25,2025-02-16,Liverpool,Wolves,2,1,H,3,0,1,2,2,1,1,3,1,17,57,19,16,38,February,0.8660254037844386,0.5000000000000001,25,48,4,0,1,1.8,1.0,58,23,35,34,52,-18,"February, 2025"
2024-2025,25,2025-02-16,Tottenham,Man United,1,0,H,3,0,0,1,4,1,1,3,15,14,27,29,1,2,February,0.8660254037844386,0.5000000000000001,42,28,2,2,1,1.8,1.2,48,37,11,28,34,-6,"February, 2025"
2024-2025,29,2025-02-19,Aston Villa,Liverpool,2,2,D,1,1,3,0,2,1,2,2,9,1,38,60,8,22,February,0.8660254037844386,0.5000000000000001,1,25,0,2,3,1.0,2.4,35,38,-3,60,24,36,"February, 2025"
2024-2025,26,2025-02-21,Leicester,Brentford,0,4,A,0,3,2,1,2,3,1,1,19,11,17,34,8,17,February,0.8660254037844386,0.5000000000000001,24,9,2,2,1,1.6,1.8,25,55,-30,43,42,1,"February, 2025"
2024-2025,26,2025-02-22,Aston Villa,Chelsea,2,1,H,3,0,3,0,2,4,0,1,10,6,39,43,4,4,February,0.8660254037844386,0.5000000000000001,1,14,2,1,2,1.0,1.4,37,40,-3,47,34,13,"February, 2025"
2024-2025,26,2025-02-22,Southampton,Brighton,0,4,A,0,3,0,1,4,4,1,0,20,11,9,37,9,28,February,0.8660254037844386,0.5000000000000001,38,10,0,3,2,1.2,2.0,19,57,-38,38,38,0,"February, 2025"
2024-2025,26,2025-02-22,Fulham,Crystal Palace,0,2,A,0,3,2,0,3,2,3,0,8,14,39,30,6,9,February,0.8660254037844386,0.5000000000000001,19,16,2,3,0,1.6,0.6,38,33,5,29,32,-3,"February, 2025"
2024-2025,26,2025-02-22,Ipswich,Tottenham,1,4,A,0,3,0,1,4,0,1,4,18,14,17,30,4,13,February,0.8660254037844386,0.5000000000000001,22,42,4,0,1,2.0,1.2,23,50,-27,49,37,12,"February, 2025"
2024-2025,26,2025-02-22,Arsenal,West Ham,0,1,A,0,3,2,2,1,2,1,2,2,16,53,27,14,26,February,0.8660254037844386,0.5000000000000001,0,45,3,1,1,3.2,1.4,51,22,29,29,47,-18,"February, 2025"
2024-2025,26,2025-02-22,Everton,Man United,2,2,D,1,1,3,1,1,1,1,3,14,15,30,29,1,1,February,0.8660254037844386,0.5000000000000001,18,28,0,0,5,0.2,2.6,27,31,-4,28,35,-7,"February, 2025"
2024-2025,26,2025-02-22,Bournemouth,Wolves,0,1,A,0,3,2,1,2,1,1,3,5,17,43,19,12,24,February,0.8660254037844386,0.5000000000000001,7,48,3,1,1,1.4,0.8,44,29,15,35,54,-19,"February, 2025"
2024-2025,26,2025-02-23,Newcastle,Nott'm Forest,4,3,H,3,0,2,1,2,1,2,2,8,3,41,47,5,6,February,0.8660254037844386,0.5000000000000001,30,32,4,0,1,2.2,1.4,42,33,9,41,29,12,"February, 2025"
2024-2025,26,2025-02-23,Man City,Liverpool,0,2,A,0,3,4,1,0,1,2,2,4,1,44,61,3,17,February,0.8660254037844386,0.5000000000000001,27,25,1,2,2,1.2,1.2,52,35,17,62,26,36,"February, 2025"
2024-2025,27,2025-02-25,Brighton,Bournemouth,2,1,H,3,0,4,1,0,2,1,2,9,6,40,43,3,3,February,0.8660254037844386,0.5000000000000001,10,7,4,0,1,1.6,1.0,42,38,4,44,30,14,"February, 2025"
2024-2025,27,2025-02-25,Crystal Palace,Aston Villa,4,1,H,3,0,2,3,0,3,0,2,13,9,33,42,4,9,February,0.8660254037844386,0.5000000000000001,16,1,2,1,2,2.2,1.4,31,32,-1,39,41,-2,"February, 2025"
2024-2025,27,2025-02-25,Wolves,Fulham,1,2,A,0,3,1,1,3,2,0,3,17,10,22,39,7,17,February,0.8660254037844386,0.5000000000000001,48,19,2,2,1,1.8,1.2,36,54,-18,38,35,3,"February, 2025"
2024-2025,27,2025-02-25,Chelsea,Southampton,4,0,H,3,0,4,0,1,0,1,4,7,20,43,9,13,34,February,0.8660254037844386,0.5000000000000001,14,38,3,0,2,3.0,1.0,48,36,12,19,61,-42,"February, 2025"
2024-2025,27,2025-02-26,Tottenham,Man City,0,1,A,0,3,0,1,4,4,1,0,13,5,33,44,8,11,February,0.8660254037844386,0.5000000000000001,42,27,2,1,2,2.0,1.8,53,38,15,52,37,15,"February, 2025"
2024-2025,27,2025-02-26,Liverpool,Newcastle,2,0,H,3,0,1,2,2,2,1,2,1,6,64,44,5,20,February,0.8660254037844386,0.5000000000000001,25,30,4,1,0,2.6,1.4,64,26,38,46,36,10,"February, 2025"
2024-2025,27,2025-02-26,Nott'm Forest,Arsenal,0,0,D,1,1,1,2,2,2,2,1,3,2,47,53,1,6,February,0.8660254037844386,0.5000000000000001,32,0,1,0,4,0.6,2.4,44,33,11,51,23,28,"February, 2025"
2024-2025,27,2025-02-26,Brentford,Everton,1,1,D,1,1,3,1,1,3,1,1,11,14,37,31,3,6,February,0.8660254037844386,0.5000000000000001,9,18,0,2,3,0.4,1.2,47,42,5,29,33,-4,"February, 2025"
2024-2025,27,2025-02-26,Man United,Ipswich,3,2,H,3,0,1,1,3,0,1,4,15,18,30,17,3,13,February,0.8660254037844386,0.5000000000000001,28,22,3,2,0,1.8,0.4,30,37,-7,24,54,-30,"February, 2025"
2024-2025,27,2025-02-27,West Ham,Leicester,2,0,H,3,0,2,1,2,2,1,2,16,19,30,17,3,13,February,0.8660254037844386,0.5000000000000001,45,24,1,1,3,1.6,2.0,30,47,-17,25,59,-34,"February, 2025"
2024-2025,28,2025-03-08,Nott'm Forest,Man City,1,0,H,3,0,1,2,2,4,1,0,3,4,48,47,1,1,March,1.0,6.123233995736766e-17,32,27,0,1,4,0.2,2.8,44,33,11,53,37,16,"March, 2025"
2024-2025,28,2025-03-08,Brighton,Fulham,2,1,H,3,0,4,1,0,2,0,3,8,9,43,42,1,1,March,1.0,6.123233995736766e-17,10,19,0,1,4,0.6,2.0,44,39,5,40,36,4,"March, 2025"
2024-2025,28,2025-03-08,Crystal Palace,Ipswich,1,0,H,3,0,2,3,0,0,1,4,12,18,36,17,6,19,March,1.0,6.123233995736766e-17,16,22,1,0,0,1.0,0.0,35,33,2,26,57,-31,"March, 2025"
2024-2025,28,2025-03-08,Liverpool,Southampton,3,1,H,3,0,1,2,2,0,1,4,1,20,67,9,19,58,March,1.0,6.123233995736766e-17,25,38,4,1,0,3.2,1.6,66,26,40,19,65,-46,"March, 2025"
2024-2025,28,2025-03-08,Brentford,Aston Villa,0,1,A,0,3,3,1,1,3,0,2,12,10,38,42,2,4,March,1.0,6.123233995736766e-17,9,1,0,2,3,1.2,2.6,48,43,5,40,45,-5,"March, 2025"
2024-2025,28,2025-03-08,Wolves,Everton,1,1,D,1,1,1,1,3,3,1,1,17,16,22,32,1,10,March,1.0,6.123233995736766e-17,48,18,3,1,1,1.4,1.2,37,56,-19,30,34,-4,"March, 2025"
2024-2025,28,2025-03-09,Chelsea,Leicester,1,0,H,3,0,4,0,1,2,1,2,5,19,46,17,14,29,March,1.0,6.123233995736766e-17,14,24,4,1,0,2.2,0.8,52,36,16,25,61,-36,"March, 2025"
2024-2025,28,2025-03-09,Tottenham,Bournemouth,2,2,D,1,1,0,1,4,2,1,2,13,9,33,43,4,10,March,1.0,6.123233995736766e-17,42,7,3,0,2,2.0,1.4,53,39,14,45,32,13,"March, 2025"
2024-2025,28,2025-03-09,Man United,Arsenal,1,1,D,1,1,1,1,3,2,2,1,15,2,33,54,13,21,March,1.0,6.123233995736766e-17,28,0,1,0,4,1.2,2.0,33,39,-6,51,23,28,"March, 2025"
2024-2025,28,2025-03-10,West Ham,Newcastle,0,1,A,0,3,2,1,2,2,1,2,16,9,33,44,7,11,March,1.0,6.123233995736766e-17,45,30,1,2,2,1.8,2.4,32,47,-15,46,38,8,"March, 2025"
2024-2025,29,2025-03-15,Man City,Brighton,2,2,D,1,1,4,1,0,4,1,0,5,7,47,46,2,1,March,1.0,6.123233995736766e-17,27,10,3,1,1,2.2,1.0,53,38,15,46,40,6,"March, 2025"
2024-2025,29,2025-03-15,Southampton,Wolves,1,2,A,0,3,0,1,4,1,1,3,20,17,9,23,3,14,March,1.0,6.123233995736766e-17,38,48,0,0,5,0.4,1.8,20,68,-48,38,57,-19,"March, 2025"
2024-2025,29,2025-03-15,Everton,West Ham,1,1,D,1,1,3,1,1,2,1,2,15,16,33,33,1,0,March,1.0,6.123233995736766e-17,18,45,2,1,2,0.6,1.0,31,35,-4,32,48,-16,"March, 2025"
2024-2025,29,2025-03-15,Ipswich,Nott'm Forest,2,4,A,0,3,0,1,4,1,2,2,18,3,17,51,15,34,March,1.0,6.123233995736766e-17,22,32,0,0,1,0.0,1.0,26,58,-32,45,33,12,"March, 2025"
2024-2025,29,2025-03-15,Bournemouth,Brentford,1,2,A,0,3,2,1,2,3,1,1,9,12,44,38,3,6,March,1.0,6.123233995736766e-17,7,9,0,2,3,1.0,1.8,47,34,13,48,44,4,"March, 2025"
2024-2025,29,2025-03-16,Leicester,Man United,0,3,A,0,3,2,1,2,1,1,3,19,15,17,34,4,17,March,1.0,6.123233995736766e-17,24,28,1,1,3,1.0,2.0,25,62,-37,34,40,-6,"March, 2025"
2024-2025,29,2025-03-16,Arsenal,Chelsea,1,0,H,3,0,2,2,1,4,0,1,2,4,55,49,2,6,March,1.0,6.123233995736766e-17,0,14,3,2,0,2.4,0.8,52,24,28,53,36,17,"March, 2025"
2024-2025,29,2025-03-16,Fulham,Tottenham,2,0,H,3,0,2,0,3,0,1,4,10,13,42,34,3,8,March,1.0,6.123233995736766e-17,19,42,1,1,3,1.0,1.2,41,38,3,55,41,14,"March, 2025"
2024-2025,30,2025-04-01,Nott'm Forest,Man United,1,0,H,3,0,1,2,2,1,1,3,3,13,54,37,10,17,April,0.8660254037844388,-0.4999999999999998,32,28,2,0,3,1.4,2.2,49,35,14,37,40,-3,"April, 2025"
2024-2025,30,2025-04-01,Wolves,West Ham,1,0,H,3,0,1,1,3,2,1,2,17,16,26,34,1,8,April,0.8660254037844388,-0.4999999999999998,48,45,1,0,4,0.6,1.8,40,58,-18,33,49,-16,"April, 2025"
2024-2025,30,2025-04-01,Arsenal,Fulham,2,1,H,3,0,2,2,1,2,0,3,2,8,58,45,6,13,April,0.8660254037844388,-0.4999999999999998,0,19,2,2,1,1.8,1.2,53,24,29,43,38,5,"April, 2025"
2024-2025,30,2025-04-02,Man City,Leicester,2,0,H,3,0,4,1,0,2,1,2,5,19,48,17,14,31,April,0.8660254037844388,-0.4999999999999998,27,24,5,0,0,2.6,0.8,55,40,15,25,65,-40,"April, 2025"
2024-2025,30,2025-04-02,Bournemouth,Ipswich,1,2,A,0,3,2,1,2,0,1,4,10,18,44,17,8,27,April,0.8660254037844388,-0.4999999999999998,7,22,1,0,0,2.0,1.0,48,36,12,28,62,-34,"April, 2025"
2024-2025,30,2025-04-02,Brighton,Aston Villa,0,3,A,0,3,4,1,0,3,0,2,7,9,47,45,2,2,April,0.8660254037844388,-0.4999999999999998,10,1,1,1,3,1.2,2.4,48,42,6,41,45,-4,"April, 2025"
2024-2025,30,2025-04-02,Newcastle,Brentford,2,1,H,3,0,2,1,2,3,1,1,7,11,47,41,4,6,April,0.8660254037844388,-0.4999999999999998,30,9,4,0,1,2.8,1.6,47,38,9,50,45,5,"April, 2025"
2024-2025,30,2025-04-02,Southampton,Crystal Palace,1,1,D,1,1,0,1,4,2,3,0,20,12,9,39,8,30,April,0.8660254037844388,-0.4999999999999998,38,16,0,1,4,0.8,1.8,21,70,-49,36,33,3,"April, 2025"
2024-2025,30,2025-04-02,Liverpool,Everton,1,0,H,3,0,1,2,2,3,1,1,1,15,70,34,14,36,April,0.8660254037844388,-0.4999999999999998,25,18,2,2,1,1.2,0.8,69,27,42,32,36,-4,"April, 2025"
2024-2025,30,2025-04-03,Chelsea,Tottenham,1,0,H,3,0,4,0,1,0,1,4,6,14,49,34,8,15,April,0.8660254037844388,-0.4999999999999998,14,42,3,1,1,2.4,1.6,53,37,16,55,43,12,"April, 2025"
2024-2025,31,2025-04-05,Aston Villa,Nott'm Forest,2,1,H,3,0,3,0,2,1,2,2,7,3,48,57,4,9,April,0.8660254037844388,-0.4999999999999998,1,32,2,1,2,1.6,1.4,44,45,-1,50,35,15,"April, 2025"
2024-2025,31,2025-04-05,West Ham,Bournemouth,2,2,D,1,1,2,1,2,2,1,2,16,10,34,44,6,10,April,0.8660254037844388,-0.4999999999999998,45,7,2,3,0,1.8,0.6,33,50,-17,49,38,11,"April, 2025"
2024-2025,31,2025-04-05,Crystal Palace,Brighton,2,1,H,3,0,2,3,0,4,1,0,12,8,40,47,4,7,April,0.8660254037844388,-0.4999999999999998,16,10,1,2,2,1.2,1.6,37,34,3,48,45,3,"April, 2025"
2024-2025,31,2025-04-05,Everton,Arsenal,1,1,D,1,1,3,1,1,2,2,1,15,2,34,61,13,27,April,0.8660254037844388,-0.4999999999999998,18,0,1,1,3,0.4,1.4,32,37,-5,55,25,30,"April, 2025"
2024-2025,31,2025-04-05,Ipswich,Wolves,1,2,A,0,3,0,1,4,1,1,3,18,17,20,29,1,9,April,0.8660254037844388,-0.4999999999999998,22,48,1,0,0,2.0,1.0,30,63,-33,41,58,-17,"April, 2025"
2024-2025,31,2025-04-06,Brentford,Chelsea,0,0,D,1,1,3,1,1,4,0,1,12,4,41,52,8,11,April,0.8660254037844388,-0.4999999999999998,9,14,2,2,1,1.4,0.8,51,47,4,54,37,17,"April, 2025"
2024-2025,31,2025-04-06,Fulham,Liverpool,3,2,H,3,0,2,0,3,1,2,2,10,1,45,73,9,28,April,0.8660254037844388,-0.4999999999999998,19,25,0,2,3,1.6,2.4,44,40,4,70,27,43,"April, 2025"
2024-2025,31,2025-04-06,Tottenham,Southampton,3,1,H,3,0,0,1,4,0,1,4,16,20,34,10,4,24,April,0.8660254037844388,-0.4999999999999998,42,38,2,2,1,3.0,1.6,55,44,11,22,71,-49,"April, 2025"
2024-2025,31,2025-04-06,Man United,Man City,0,0,D,1,1,1,1,3,4,1,0,14,5,37,51,9,14,April,0.8660254037844388,-0.4999999999999998,28,27,2,0,3,1.6,2.8,37,41,-4,57,40,17,"April, 2025"
2024-2025,31,2025-04-07,Leicester,Newcastle,0,3,A,0,3,2,1,2,2,1,2,19,7,17,50,12,33,April,0.8660254037844388,-0.4999999999999998,24,30,1,1,3,1.0,1.8,25,67,-42,49,39,10,"April, 2025"
2024-2025,32,2025-04-12,Arsenal,Brentford,1,1,D,1,1,2,2,1,3,1,1,2,12,62,42,10,20,April,0.8660254037844388,-0.4999999999999998,0,9,4,1,0,2.0,0.6,56,26,30,51,47,4,"April, 2025"
2024-2025,32,2025-04-12,Southampton,Aston Villa,0,3,A,0,3,0,1,4,3,0,2,20,7,10,51,13,41,April,0.8660254037844388,-0.4999999999999998,38,1,1,0,4,0.2,1.4,23,74,-51,46,46,0,"April, 2025"
2024-2025,32,2025-04-12,Brighton,Leicester,2,2,D,1,1,4,1,0,2,1,2,9,19,47,17,10,30,April,0.8660254037844388,-0.4999999999999998,10,24,2,3,0,2.4,1.6,49,47,2,25,70,-45,"April, 2025"
2024-2025,32,2025-04-12,Man City,Crystal Palace,5,2,H,3,0,4,1,0,2,3,0,6,11,52,43,5,9,April,0.8660254037844388,-0.4999999999999998,27,16,3,2,0,2.6,1.6,57,40,17,39,35,4,"April, 2025"
2024-2025,32,2025-04-12,Nott'm Forest,Everton,0,1,A,0,3,1,2,2,3,1,1,3,15,57,35,12,22,April,0.8660254037844388,-0.4999999999999998,32,18,1,2,2,1.0,1.2,51,37,14,33,38,-5,"April, 2025"
2024-2025,32,2025-04-13,Chelsea,Ipswich,2,2,D,1,1,4,0,1,0,1,4,6,18,53,20,12,33,April,0.8660254037844388,-0.4999999999999998,14,22,2,2,1,1.6,1.2,54,37,17,31,65,-34,"April, 2025"
2024-2025,32,2025-04-13,Liverpool,West Ham,2,1,H,3,0,1,2,2,2,1,2,1,16,73,35,15,38,April,0.8660254037844388,-0.4999999999999998,25,45,4,1,0,2.6,0.8,72,30,42,35,52,-17,"April, 2025"
2024-2025,32,2025-04-13,Wolves,Tottenham,4,2,H,3,0,1,1,3,0,1,4,17,15,32,37,2,5,April,0.8660254037844388,-0.4999999999999998,48,42,3,1,1,1.4,1.0,43,59,-16,58,45,13,"April, 2025"
2024-2025,32,2025-04-13,Newcastle,Man United,4,1,H,3,0,2,1,2,1,1,3,7,13,53,38,6,15,April,0.8660254037844388,-0.4999999999999998,30,28,3,1,1,1.4,0.6,52,39,13,37,41,-4,"April, 2025"
2024-2025,32,2025-04-14,Bournemouth,Fulham,1,0,H,3,0,2,1,2,2,0,3,10,8,45,48,2,3,April,0.8660254037844388,-0.4999999999999998,7,19,2,2,1,2.0,1.6,51,40,11,47,42,5,"April, 2025"
2024-2025,29,2025-04-16,Newcastle,Crystal Palace,5,0,H,3,0,2,1,2,2,3,0,4,12,56,43,8,13,April,0.8660254037844388,-0.4999999999999998,30,16,1,3,1,1.0,0.6,56,40,16,41,40,1,"April, 2025"
2024-2025,33,2025-04-19,Brentford,Brighton,4,2,H,3,0,3,1,1,4,1,0,11,10,43,48,1,5,April,0.8660254037844388,-0.4999999999999998,9,10,1,3,1,1.2,1.0,52,48,4,51,49,2,"April, 2025"
2024-2025,33,2025-04-19,Crystal Palace,Bournemouth,0,0,D,1,1,2,3,0,2,1,2,12,8,43,48,4,5,April,0.8660254037844388,-0.4999999999999998,16,7,2,1,2,0.8,0.6,41,45,-4,52,40,12,"April, 2025"
2024-2025,33,2025-04-19,Everton,Man City,0,2,A,0,3,3,1,1,4,1,0,13,5,38,55,8,17,April,0.8660254037844388,-0.4999999999999998,18,27,0,2,3,0.6,2.0,34,38,-4,62,42,20,"April, 2025"
2024-2025,33,2025-04-19,West Ham,Southampton,1,1,D,1,1,2,1,2,0,1,4,17,20,35,10,3,25,April,0.8660254037844388,-0.4999999999999998,45,38,2,2,1,1.0,0.8,36,54,-18,23,77,-54,"April, 2025"
2024-2025,33,2025-04-19,Aston Villa,Newcastle,4,1,H,3,0,3,0,2,2,1,2,7,3,54,59,4,5,April,0.8660254037844388,-0.4999999999999998,1,30,1,0,4,1.0,3.0,49,46,3,61,40,21,"April, 2025"
2024-2025,33,2025-04-20,Man United,Wolves,0,1,A,0,3,1,1,3,1,1,3,14,17,38,35,3,3,April,0.8660254037844388,-0.4999999999999998,28,48,4,0,1,1.6,1.0,38,45,-7,47,61,-14,"April, 2025"
2024-2025,33,2025-04-20,Leicester,Liverpool,0,1,A,0,3,2,1,2,1,2,2,19,1,18,76,18,58,April,0.8660254037844388,-0.4999999999999998,24,25,1,0,4,0.6,2.0,27,72,-45,74,31,43,"April, 2025"
2024-2025,33,2025-04-20,Fulham,Chelsea,1,2,A,0,3,2,0,3,4,0,1,9,7,48,54,2,6,April,0.8660254037844388,-0.4999999999999998,19,14,2,1,2,0.8,1.0,47,43,4,56,39,17,"April, 2025"
2024-2025,33,2025-04-20,Ipswich,Arsenal,0,4,A,0,3,0,1,4,2,2,1,18,2,21,63,16,42,April,0.8660254037844388,-0.4999999999999998,22,0,0,1,4,0.2,1.4,33,67,-34,57,27,30,"April, 2025"
2024-2025,33,2025-04-21,Tottenham,Nott'm Forest,1,2,A,0,3,0,1,4,1,2,2,16,6,37,57,10,20,April,0.8660254037844388,-0.4999999999999998,42,32,4,0,1,2.0,0.6,60,49,11,51,38,13,"April, 2025"
2024-2025,34,2025-04-22,Man City,Aston Villa,2,1,H,3,0,4,1,0,3,0,2,5,7,58,57,2,1,April,0.8660254037844388,-0.4999999999999998,27,1,2,1,2,1.8,1.2,64,42,22,53,47,6,"April, 2025"
2024-2025,34,2025-04-23,Arsenal,Crystal Palace,2,2,D,1,1,2,2,1,2,3,0,2,12,66,44,10,22,April,0.8660254037844388,-0.4999999999999998,0,16,5,0,0,3.4,0.4,61,27,34,41,45,-4,"April, 2025"
2024-2025,34,2025-04-26,Wolves,Leicester,3,0,H,3,0,1,1,3,2,1,2,15,19,38,18,4,20,April,0.8660254037844388,-0.4999999999999998,48,24,2,0,3,1.2,1.6,48,61,-13,27,73,-46,"April, 2025"
2024-2025,34,2025-04-26,Southampton,Fulham,1,2,A,0,3,0,1,4,2,0,3,20,10,11,48,10,37,April,0.8660254037844388,-0.4999999999999998,38,19,1,2,2,0.8,1.0,24,78,-54,48,45,3,"April, 2025"
2024-2025,34,2025-04-26,Chelsea,Everton,1,0,H,3,0,4,0,1,3,1,1,6,13,57,38,7,19,April,0.8660254037844388,-0.4999999999999998,14,18,2,2,1,1.8,0.8,58,40,18,34,40,-6,"April, 2025"
2024-2025,34,2025-04-26,Brighton,West Ham,3,2,H,3,0,4,1,0,2,1,2,10,17,48,36,7,12,April,0.8660254037844388,-0.4999999999999998,10,45,2,2,1,1.6,0.8,53,53,0,37,55,-18,"April, 2025"
2024-2025,34,2025-04-26,Newcastle,Ipswich,3,0,H,3,0,2,1,2,0,1,4,6,18,59,21,12,38,April,0.8660254037844388,-0.4999999999999998,30,22,3,1,1,1.8,0.8,62,44,18,33,71,-38,"April, 2025"
2024-2025,34,2025-04-27,Bournemouth,Man United,1,1,D,1,1,2,1,2,1,1,3,10,15,49,38,5,11,April,0.8660254037844388,-0.4999999999999998,7,28,2,1,2,1.6,1.2,52,40,12,38,46,-8,"April, 2025"
2024-2025,34,2025-04-27,Liverpool,Tottenham,5,1,H,3,0,1,2,2,0,1,4,1,16,79,37,15,42,April,0.8660254037844388,-0.4999999999999998,25,42,4,0,1,3.4,2.2,75,31,44,61,51,10,"April, 2025"
2024-2025,34,2025-05-01,Nott'm Forest,Brentford,0,2,A,0,3,1,2,2,3,1,1,6,11,60,46,5,14,May,0.4999999999999999,-0.8660254037844387,32,9,1,2,2,1.6,1.6,53,39,14,56,50,6,"May, 2025"
2024-2025,35,2025-05-02,Man City,Wolves,1,0,H,3,0,4,1,0,1,1,3,4,13,61,41,9,20,May,0.4999999999999999,-0.8660254037844387,27,48,4,0,1,2.8,0.8,66,43,23,51,61,-10,"May, 2025"
2024-2025,35,2025-05-03,Aston Villa,Fulham,1,0,H,3,0,3,0,2,2,0,3,7,8,57,51,1,6,May,0.4999999999999999,-0.8660254037844387,1,19,4,0,1,1.8,1.2,54,49,5,50,46,4,"May, 2025"
2024-2025,35,2025-05-03,Everton,Ipswich,2,2,D,1,1,3,1,1,0,1,4,15,18,38,21,3,17,May,0.4999999999999999,-0.8660254037844387,18,22,1,1,3,0.6,1.4,34,41,-7,33,74,-41,"May, 2025"
2024-2025,35,2025-05-03,Arsenal,Bournemouth,1,2,A,0,3,2,2,1,2,1,2,2,10,67,50,8,17,May,0.4999999999999999,-0.8660254037844387,0,7,4,0,1,2.6,0.8,63,29,34,53,41,12,"May, 2025"
2024-2025,35,2025-05-03,Leicester,Southampton,2,0,H,3,0,2,1,2,0,1,4,19,20,18,11,1,7,May,0.4999999999999999,-0.8660254037844387,24,38,2,1,2,2.0,1.6,27,76,-49,25,80,-55,"May, 2025"
2024-2025,35,2025-05-04,Brentford,Man United,4,3,H,3,0,3,1,1,1,1,3,11,15,49,39,4,10,May,0.4999999999999999,-0.8660254037844387,9,28,1,1,3,1.4,1.2,58,50,8,39,47,-8,"May, 2025"
2024-2025,35,2025-05-04,Brighton,Newcastle,1,1,D,1,1,4,1,0,2,1,2,11,4,51,62,7,11,May,0.4999999999999999,-0.8660254037844387,10,30,2,2,1,1.2,1.2,56,55,1,65,44,21,"May, 2025"
2024-2025,35,2025-05-04,West Ham,Tottenham,1,1,D,1,1,2,1,2,0,1,4,17,16,36,37,1,1,May,0.4999999999999999,-0.8660254037844387,45,42,1,2,2,1.0,1.8,39,58,-19,62,56,6,"May, 2025"
2024-2025,35,2025-05-04,Chelsea,Liverpool,3,1,H,3,0,4,0,1,1,2,2,5,1,60,82,4,22,May,0.4999999999999999,-0.8660254037844387,14,25,0,3,2,0.6,1.4,59,40,19,80,32,48,"May, 2025"
2024-2025,35,2025-05-05,Crystal Palace,Nott'm Forest,1,1,D,1,1,2,3,0,1,2,2,12,6,45,60,6,15,May,0.4999999999999999,-0.8660254037844387,16,32,0,3,2,0.4,0.8,43,47,-4,53,41,12,"May, 2025"
2024-2025,36,2025-05-10,Wolves,Brighton,0,2,A,0,3,1,1,3,4,1,0,14,10,41,52,4,11,May,0.4999999999999999,-0.8660254037844387,48,10,0,2,3,1.0,3.0,51,62,-11,57,56,1,"May, 2025"
2024-2025,36,2025-05-10,Bournemouth,Aston Villa,0,1,A,0,3,2,1,2,3,0,2,10,7,53,60,3,7,May,0.4999999999999999,-0.8660254037844387,7,1,1,2,2,1.2,1.8,55,42,13,55,49,6,"May, 2025"
2024-2025,36,2025-05-10,Southampton,Man City,0,0,D,1,1,0,1,4,4,1,0,20,3,11,64,17,53,May,0.4999999999999999,-0.8660254037844387,38,27,0,2,3,0.4,2.0,25,82,-57,67,43,24,"May, 2025"
2024-2025,36,2025-05-10,Fulham,Everton,1,3,A,0,3,2,0,3,3,1,1,11,14,51,39,3,12,May,0.4999999999999999,-0.8660254037844387,19,18,2,3,0,1.0,0.4,50,47,3,36,43,-7,"May, 2025"
2024-2025,36,2025-05-10,Ipswich,Brentford,0,1,A,0,3,0,1,4,3,1,1,18,9,22,52,9,30,May,0.4999999999999999,-0.8660254037844387,22,9,0,0,1,3.0,4.0,35,76,-41,62,53,9,"May, 2025"
2024-2025,36,2025-05-11,Newcastle,Chelsea,2,0,H,3,0,2,1,2,4,0,1,4,5,63,63,1,0,May,0.4999999999999999,-0.8660254037844387,30,14,2,1,2,1.8,1.4,66,45,21,62,41,21,"May, 2025"
2024-2025,36,2025-05-11,Man United,West Ham,0,2,A,0,3,1,1,3,2,1,2,15,17,39,37,2,2,May,0.4999999999999999,-0.8660254037844387,28,45,2,0,3,1.0,1.0,42,51,-9,40,59,-19,"May, 2025"
2024-2025,36,2025-05-11,Nott'm Forest,Leicester,2,2,D,1,1,1,2,2,2,1,2,7,19,61,21,12,40,May,0.4999999999999999,-0.8660254037844387,32,24,3,0,2,1.4,1.6,54,42,12,29,76,-47,"May, 2025"
2024-2025,36,2025-05-11,Tottenham,Crystal Palace,0,2,A,0,3,0,1,4,2,3,0,17,12,38,46,5,8,May,0.4999999999999999,-0.8660254037844387,42,16,4,0,1,2.0,0.6,63,57,6,44,48,-4,"May, 2025"
2024-2025,36,2025-05-11,Liverpool,Arsenal,2,2,D,1,1,1,2,2,2,2,1,1,2,82,67,1,15,May,0.4999999999999999,-0.8660254037844387,25,0,0,3,2,1.6,2.2,81,35,46,64,31,33,"May, 2025"
2024-2025,37,2025-05-16,Chelsea,Man United,1,0,H,3,0,4,0,1,1,1,3,6,16,63,39,10,24,May,0.4999999999999999,-0.8660254037844387,14,28,1,2,2,1.6,2.2,62,43,19,42,53,-11,"May, 2025"
2024-2025,37,2025-05-16,Aston Villa,Tottenham,2,0,H,3,0,3,0,2,0,1,4,6,17,63,38,11,25,May,0.4999999999999999,-0.8660254037844387,1,42,3,0,2,1.4,2.0,56,49,7,63,59,4,"May, 2025"
2024-2025,37,2025-05-18,Everton,Southampton,2,0,H,3,0,3,1,1,0,1,4,13,20,42,12,7,30,May,0.4999999999999999,-0.8660254037844387,18,38,2,0,3,1.2,1.4,39,44,-5,25,82,-57,"May, 2025"
2024-2025,37,2025-05-18,West Ham,Nott'm Forest,1,2,A,0,3,2,1,2,1,2,2,15,7,40,62,8,22,May,0.4999999999999999,-0.8660254037844387,45,32,2,0,3,1.4,1.6,42,59,-17,56,44,12,"May, 2025"
2024-2025,37,2025-05-18,Brentford,Fulham,2,3,A,0,3,3,1,1,2,0,3,8,11,55,51,3,4,May,0.4999999999999999,-0.8660254037844387,9,19,2,1,2,1.8,1.4,63,53,10,51,50,1,"May, 2025"
2024-2025,37,2025-05-18,Leicester,Ipswich,2,0,H,3,0,2,1,2,0,1,4,19,18,22,22,1,0,May,0.4999999999999999,-0.8660254037844387,24,22,1,2,2,0.8,1.4,31,78,-47,35,77,-42,"May, 2025"
2024-2025,37,2025-05-18,Arsenal,Newcastle,1,0,H,3,0,2,2,1,2,1,2,2,3,68,66,1,2,May,0.4999999999999999,-0.8660254037844387,0,30,2,1,2,1.2,0.6,66,33,33,68,45,23,"May, 2025"
2024-2025,37,2025-05-19,Brighton,Liverpool,3,2,H,3,0,4,1,0,1,2,2,9,1,55,83,8,28,May,0.4999999999999999,-0.8660254037844387,10,25,1,2,2,2.0,1.8,59,56,3,83,37,46,"May, 2025"
2024-2025,37,2025-05-20,Man City,Bournemouth,3,1,H,3,0,4,1,0,2,1,2,6,11,65,53,5,12,May,0.4999999999999999,-0.8660254037844387,27,7,4,0,1,3.2,0.8,67,43,24,55,43,12,"May, 2025"
2024-2025,37,2025-05-20,Crystal Palace,Wolves,4,2,H,3,0,2,3,0,1,1,3,12,14,49,41,2,8,May,0.4999999999999999,-0.8660254037844387,16,48,3,1,1,2.0,1.6,46,48,-2,51,64,-13,"May, 2025"
2024-2025,38,2025-05-25,Nott'm Forest,Chelsea,0,1,A,0,3,1,2,2,4,0,1,7,5,65,66,2,1,May,0.4999999999999999,-0.8660254037844387,32,14,1,3,1,1.4,1.4,58,45,13,63,43,20,"May, 2025"
2024-2025,38,2025-05-25,Newcastle,Everton,0,1,A,0,3,2,1,2,3,1,1,4,13,66,45,9,21,May,0.4999999999999999,-0.8660254037844387,30,18,2,2,1,1.2,1.0,68,46,22,41,44,-3,"May, 2025"
2024-2025,38,2025-05-25,Southampton,Arsenal,1,2,A,0,3,0,1,4,2,2,1,20,2,12,71,18,59,May,0.4999999999999999,-0.8660254037844387,38,0,1,2,2,1.2,2.0,25,84,-59,67,33,34,"May, 2025"
2024-2025,38,2025-05-25,Man United,Aston Villa,2,0,H,3,0,1,1,3,3,0,2,16,6,39,66,10,27,May,0.4999999999999999,-0.8660254037844387,28,1,3,1,1,1.4,1.2,42,54,-12,58,49,9,"May, 2025"
2024-2025,38,2025-05-25,Tottenham,Brighton,1,4,A,0,3,0,1,4,4,1,0,17,8,38,58,9,20,May,0.4999999999999999,-0.8660254037844387,42,10,3,0,2,1.8,1.8,63,61,2,62,58,4,"May, 2025"
2024-2025,38,2025-05-25,Ipswich,West Ham,1,3,A,0,3,0,1,4,2,1,2,19,15,22,40,4,18,May,0.4999999999999999,-0.8660254037844387,22,45,1,1,3,1.2,2.2,35,79,-44,43,61,-18,"May, 2025"
2024-2025,38,2025-05-25,Fulham,Man City,0,2,A,0,3,2,0,3,4,1,0,11,3,54,68,8,14,May,0.4999999999999999,-0.8660254037844387,19,27,0,0,5,1.0,3.2,54,52,2,70,44,26,"May, 2025"
2024-2025,38,2025-05-25,Bournemouth,Leicester,2,0,H,3,0,2,1,2,2,1,2,11,18,53,25,7,28,May,0.4999999999999999,-0.8660254037844387,7,24,3,0,2,1.6,1.2,56,46,10,33,78,-45,"May, 2025"
2024-2025,38,2025-05-25,Liverpool,Crystal Palace,1,1,D,1,1,1,2,2,2,3,0,1,12,83,52,11,31,May,0.4999999999999999,-0.8660254037844387,25,16,2,2,1,0.8,0.6,85,40,45,50,50,0,"May, 2025"
2024-2025,38,2025-05-25,Wolves,Brentford,1,1,D,1,1,1,1,3,3,1,1,16,10,41,55,6,14,May,0.4999999999999999,-0.8660254037844387,48,9,2,1,2,2.0,1.8,53,68,-15,65,56,9,"May, 2025"
